gene	FR	FS	PR	PS	Tsil	Trepl	npop	nout	mk_pval	alpha	mk_pval_fdr	dos	total_poly	total_div
2KTGRL-LOC420808	7	4	5	4	325.71	651.42	15	1	1	0.285714285714286	1	0.0808080808080808	9	11
44G24.1	11	12	0	4	124.74	249.48	15	1	0.122507122507122	1	1	0.478260869565217	4	23
A1CF	2	40	0	2	580.8	1161.6	15	1	1	1	1	0.0476190476190476	2	42
A2M	56	45	6	11	1295.58	2591.16	15	1	0.188532447641282	0.561688311688312	1	0.201514269073966	17	101
A2ML1	36	51	6	10	1441.44	2882.88	15	1	1	0.15	1	0.0387931034482759	16	87
A2ML2	44	52	7	6	1409.1	2818.2	15	1	0.768408454897039	-0.378787878787879	1	-0.0801282051282051	13	96
A2ML4	78	120	9	8	1443.75	2887.5	15	1	0.309487681974232	-0.730769230769231	1	-0.135472370766488	17	198
A4GALT	9	19	0	0	357.39	714.78	15	1	1	NA	1	NA	0	28
A4GNT	7	13	1	6	385.11	770.22	15	1	0.633363737711564	0.69047619047619	1	0.207142857142857	7	20
AAAS	3	7	1	3	239.58	479.16	15	1	1	0.222222222222222	1	0.05	4	10
AACS	3	38	0	2	595.98	1191.96	15	1	1	1	1	0.0731707317073171	2	41
AADAC	18	25	6	9	399.96	799.92	15	1	1	0.0740740740740741	1	0.0186046511627907	15	43
AADACL4L1	8	15	10	4	403.26	806.52	15	1	0.0448115523755124	-3.6875	0.822543273817637	-0.366459627329193	14	23
AADACL4L2	19	15	8	8	398.31	796.62	15	1	0.766636805410862	0.210526315789474	1	0.0588235294117647	16	34
AADACL4L3	6	15	6	8	348.48	696.96	15	1	0.476918798665183	-0.875	1	-0.142857142857143	14	21
AADACL4L5	11	7	5	2	403.92	807.84	15	1	1	-0.590909090909091	1	-0.103174603174603	7	18
AADAT	5	18	1	0	420.75	841.5	15	1	0.25	-Inf	1	-0.782608695652174	1	23
AAED1	3	4	0	0	170.94	341.88	15	1	1	NA	1	NA	0	7
AAGAB	5	15	2	4	287.76	575.52	15	1	1	-0.5	1	-0.0833333333333333	6	20
AAK1	23	32	4	5	1331.22	2662.44	15	1	1	-0.11304347826087	1	-0.0262626262626263	9	55
AAMDC	2	8	1	1	121.77	243.54	15	1	0.454545454545455	-3	1	-0.3	2	10
AAMP	9	16	5	9	368.61	737.22	15	1	1	0.0123456790123457	1	0.00285714285714284	14	25
AANAT	0	3	3	2	203.94	407.88	15	1	0.196428571428571	-Inf	1	-0.6	5	3
AAR2	10	13	0	0	380.49	760.98	15	1	1	NA	1	NA	0	23
AAREL	16	17	11	5	215.16	430.32	15	1	0.229295197301859	-1.3375	1	-0.202651515151515	16	33
AARS	5	42	7	17	951.39	1902.78	15	1	0.0902766839359054	-2.45882352941176	0.953786405978059	-0.185283687943262	24	47
AARS2	13	38	2	15	898.59	1797.18	15	1	0.32294563218835	0.61025641025641	1	0.137254901960784	17	51
AARSD1	11	21	6	12	520.08	1040.16	15	1	1	0.0454545454545454	1	0.0104166666666667	18	32
AASDHPPT	3	19	2	2	283.47	566.94	15	1	0.154849498327759	-5.33333333333333	1	-0.363636363636364	4	22
AASS	9	31	1	4	875.82	1751.64	15	1	1	0.138888888888889	1	0.025	5	40
AATF	28	32	8	6	596.64	1193.28	15	1	0.560082077032924	-0.523809523809524	1	-0.104761904761905	14	60
AATK	26	41	22	31	1288.32	2576.64	15	1	0.851666051303983	-0.119106699751861	1	-0.0270346381301042	53	67
ABAT	2	19	0	1	495.99	991.98	15	1	1	1	1	0.0952380952380952	1	21
ABCA1	12	70	5	13	2286.9	4573.8	15	1	0.182649864634246	-1.24358974358974	1	-0.131436314363144	18	82
ABCA12	94	140	29	14	3934.59	7869.18	15	1	0.00132948513501683	-2.08510638297872	0.2630636980271	-0.272709202941761	43	234
ABCA13	188	109	31	16	3488.43	6976.86	15	1	0.870507537610635	-0.123337765957447	1	-0.0265778350884733	47	297
ABCA2	31	113	2	2	2658.48	5316.96	15	1	0.215178208295153	-2.64516129032258	1	-0.284722222222222	4	144
ABCA3	9	56	3	34	1689.6	3379.2	15	1	0.528626241126493	0.450980392156863	1	0.0573804573804574	37	65
ABCA4	40	82	21	24	2385.24	4770.48	15	1	0.106528877349296	-0.79375	0.983875031494079	-0.13879781420765	45	122
ABCA5	10	87	7	25	1632.51	3265.02	15	1	0.129244933462012	-1.436	1	-0.115657216494845	32	97
ABCA7	21	45	27	37	1172.16	2344.32	15	1	0.275948021383547	-0.563706563706564	1	-0.103693181818182	64	66
ABCA8	24	77	13	21	1587.96	3175.92	15	1	0.121451162750846	-0.986111111111111	1	-0.144729178800233	34	101
ABCA9	86	78	18	17	1584.66	3169.32	15	1	1	0.039671682626539	1	0.0101045296167248	35	164
ABCB1	44	44	5	6	1250.37	2500.74	15	1	1	0.166666666666667	1	0.0454545454545455	11	88
ABCB10	6	25	0	2	571.56	1143.12	15	1	1	1	1	0.193548387096774	2	31
ABCB11	12	40	2	6	1291.29	2582.58	15	1	1	-0.111111111111111	1	-0.0192307692307692	8	52
ABCB1LA	32	38	6	6	1287.66	2575.32	15	1	1	-0.1875	1	-0.0428571428571429	12	70
ABCB5	21	45	7	3	1324.62	2649.24	15	1	0.0323411252543357	-4	0.784275503573749	-0.381818181818182	10	66
ABCB6	3	13	4	17	554.07	1108.14	15	1	1	-0.0196078431372548	1	-0.00297619047619047	21	16
ABCB9	5	33	5	8	727.32	1454.64	15	1	0.0986724427524597	-3.125	0.971353639774823	-0.253036437246964	13	38
ABCC1	15	55	8	2	1499.19	2998.38	15	1	0.000504262993364413	-13.6666666666667	0.179013362644367	-0.585714285714286	10	70
ABCC10	56	63	17	12	1524.6	3049.2	15	1	0.304150547693119	-0.59375	1	-0.115618661257606	29	119
ABCC13	35	55	11	3	1269.84	2539.68	15	1	0.00801610656070503	-4.76190476190476	0.529186532206378	-0.396825396825397	14	90
ABCC2	4	50	3	9	675.18	1350.36	15	1	0.106623479640402	-3.16666666666667	0.983875031494079	-0.175925925925926	12	54
ABCC3	12	55	4	10	1514.7	3029.4	15	1	0.459999947077398	-0.833333333333333	1	-0.106609808102345	14	67
ABCC5	1	47	5	7	1438.47	2876.94	15	1	0.000777806585429088	-32.5714285714286	0.234703137153227	-0.395833333333333	12	48
ABCC6	46	58	5	3	1375.11	2750.22	15	1	0.465179115698659	-1.10144927536232	1	-0.182692307692308	8	104
ABCC8	5	53	4	5	1517.01	3034.02	15	1	0.0148150278957592	-7.48	0.641111817849989	-0.35823754789272	9	58
ABCC9	14	48	5	5	1618.65	3237.3	15	1	0.11581662148904	-2.42857142857143	1	-0.274193548387097	10	62
ABCD2	4	23	0	10	630.96	1261.92	15	1	0.55712014535544	1	1	0.148148148148148	10	27
ABCD3	0	17	2	3	632.61	1265.22	15	1	0.0432900432900433	-Inf	0.818982480424487	-0.4	5	17
ABCD4	7	25	1	8	596.64	1193.28	15	1	0.658571311278402	0.553571428571429	1	0.107638888888889	9	32
ABCE1	0	15	4	3	594	1188	15	1	0.00478468899521532	-Inf	0.460299276725364	-0.571428571428571	7	15
ABCF2	2	13	0	7	593.34	1186.68	15	1	1	1	1	0.133333333333333	7	15
ABCF3	4	33	4	8	616.77	1233.54	15	1	0.0875681124589327	-3.125	0.951277979139867	-0.225225225225225	12	37
ABCG1	0	26	0	1	651.75	1303.5	15	1	1	NA	1	0	1	26
ABCG2	7	18	1	3	744.48	1488.96	15	1	1	0.142857142857143	1	0.03	4	25
ABCG4	1	14	4	8	548.46	1096.92	15	1	0.138981791155704	-6	1	-0.266666666666667	12	15
ABHD10	5	9	2	1	256.08	512.16	15	1	0.536764705882353	-2.6	1	-0.309523809523809	3	14
ABHD11	5	11	2	0	197.01	394.02	15	1	0.137254901960784	-Inf	1	-0.6875	2	16
ABHD12	0	22	2	10	353.43	706.86	15	1	0.117647058823529	-Inf	1	-0.166666666666667	12	22
ABHD12B	3	9	1	7	269.28	538.56	15	1	0.618575851393189	0.571428571428571	1	0.125	8	12
ABHD13	2	4	0	0	334.62	669.24	15	1	1	NA	1	NA	0	6
ABHD14A	8	7	2	4	175.56	351.12	15	1	0.635117204776648	0.5625	1	0.2	6	15
ABHD17A	0	14	0	5	289.74	579.48	15	1	1	NA	1	0	5	14
ABHD17B	0	8	0	0	286.11	572.22	15	1	1	NA	1	NA	0	8
ABHD17C	1	9	0	2	267.96	535.92	15	1	1	1	1	0.1	2	10
ABHD18	3	16	2	0	377.19	754.38	15	1	0.0476190476190476	-Inf	0.828231827900648	-0.842105263157895	2	19
ABHD2	1	16	0	2	421.74	843.48	15	1	1	1	1	0.0588235294117647	2	17
ABHD5	2	22	0	2	330.99	661.98	15	1	1	1	1	0.0833333333333333	2	24
ABHD6	0	8	0	9	334.62	669.24	15	1	1	NA	1	0	9	8
ABHD8	1	10	2	7	430.65	861.3	15	1	0.565789473684211	-1.85714285714286	1	-0.131313131313131	9	11
ABI2	0	11	1	1	466.95	933.9	15	1	0.153846153846154	-Inf	1	-0.5	2	11
ABI3	13	13	1	0	342.87	685.74	15	1	1	-Inf	1	-0.5	1	26
ABI3BP	28	33	2	2	1148.07	2296.14	15	1	1	-0.178571428571429	1	-0.040983606557377	4	61
ABL2	2	41	5	8	1123.65	2247.3	15	1	0.00533666296707363	-11.8125	0.467685236262114	-0.338103756708408	13	43
ABLIM1	9	20	1	4	590.04	1180.08	15	1	1	0.444444444444444	1	0.110344827586207	5	29
ABLIM2	4	11	1	0	252.45	504.9	15	1	0.3125	-Inf	1	-0.733333333333333	1	15
ABLIM3	8	31	0	0	575.19	1150.38	15	1	1	NA	1	NA	0	39
ABR	1	29	0	15	759.99	1519.98	15	1	1	1	1	0.0333333333333333	15	30
ABRA	20	21	3	4	404.58	809.16	15	1	1	0.2125	1	0.0592334494773519	7	41
ABRACL	1	3	0	2	81.18	162.36	15	1	1	1	1	0.25	2	4
ABTB1	1	11	0	7	453.75	907.5	15	1	1	1	1	0.0833333333333333	7	12
ACAA1	7	27	0	8	387.09	774.18	15	1	0.312396231523318	1	1	0.205882352941176	8	34
ACAA2	3	39	1	13	370.26	740.52	15	1	1	0	1	0	14	42
ACACA	0	103	3	18	2275.02	4550.04	15	1	0.00428860713779005	-Inf	0.454065685553736	-0.142857142857143	21	103
ACACB	18	109	9	42	2329.47	4658.94	15	1	0.644527536378233	-0.297619047619048	1	-0.0347383047707272	51	127
ACAD11	13	21	5	6	569.25	1138.5	15	1	0.732294357484673	-0.346153846153846	1	-0.072192513368984	11	34
ACAD6L	4	21	2	3	393.36	786.72	15	1	0.254347185381668	-2.5	1	-0.24	5	25
ACAD8	2	16	1	5	375.87	751.74	15	1	1	-0.6	1	-0.0555555555555556	6	18
ACAD9	3	21	0	5	523.71	1047.42	15	1	1	1	1	0.125	5	24
ACADSB	1	16	0	0	328.68	657.36	15	1	1	NA	1	NA	0	17
ACAN	48	88	22	21	2058.87	4117.74	15	1	0.0740759364614623	-0.920634920634921	0.913861472365723	-0.158686730506156	43	136
ACAP2	5	27	3	1	791.34	1582.68	15	1	0.027807486631016	-15.2	0.761210061313465	-0.59375	4	32
ACAP3	0	36	3	16	840.84	1681.68	15	1	0.0369353916523728	-Inf	0.788413232354762	-0.157894736842105	19	36
ACAT1	7	31	3	7	459.03	918.06	15	1	0.414318921520085	-0.897959183673469	1	-0.115789473684211	10	38
ACAT2	2	14	1	1	373.89	747.78	15	1	0.313725490196078	-6	1	-0.375	2	16
ACBD4	14	21	4	7	312.51	625.02	15	1	1	0.142857142857143	1	0.0363636363636364	11	35
ACBD5	10	11	5	3	462.99	925.98	15	1	0.681659170414793	-0.833333333333333	1	-0.148809523809524	8	21
ACCS	8	35	2	12	864.27	1728.54	15	1	1	0.270833333333333	1	0.0431893687707641	14	43
ACCSL	68	25	7	10	569.58	1139.16	15	1	0.020560850365242	0.742647058823529	0.70665477455864	0.319418089816572	17	93
ACD	43	27	13	8	587.07	1174.14	15	1	1	-0.0203488372093024	1	-0.00476190476190474	21	70
ACE	19	58	10	23	1236.51	2473.02	15	1	0.63764289473311	-0.327231121281464	1	-0.0562770562770563	33	77
ACE2	29	24	3	7	798.93	1597.86	15	1	0.183638451505257	0.645320197044335	1	0.247169811320755	10	53
ACER3	2	10	1	0	231.33	462.66	15	1	0.230769230769231	-Inf	1	-0.833333333333333	1	12
ACKR1	14	9	0	2	240.57	481.14	15	1	0.183333333333333	1	1	0.608695652173913	2	23
ACKR3	2	21	0	1	361.35	722.7	15	1	1	1	1	0.0869565217391304	1	23
ACKR4	5	20	3	1	354.42	708.84	15	1	0.0524609490126731	-11	0.843251957917679	-0.55	4	25
ACLY	2	43	1	17	1068.54	2137.08	15	1	1	-0.264705882352941	1	-0.0111111111111111	18	45
ACMSD	1	5	1	3	330.99	661.98	15	1	1	-0.666666666666667	1	-0.0833333333333333	4	6
ACO1	7	35	0	6	881.1	1762.2	15	1	0.572523255487995	1	1	0.166666666666667	6	42
ACO2	1	35	1	7	766.26	1532.52	15	1	0.334038054968287	-4	1	-0.0972222222222222	8	36
ACOD1	8	14	2	5	470.25	940.5	15	1	1	0.3	1	0.0779220779220779	7	22
ACOT11	4	6	1	6	388.41	776.82	15	1	0.338235294117647	0.75	1	0.257142857142857	7	10
ACOT12	11	23	2	0	484.77	969.54	15	1	0.123809523809524	-Inf	1	-0.676470588235294	2	34
ACOT13	2	7	0	1	143.55	287.1	15	1	1	1	1	0.222222222222222	1	9
ACOT2L	3	9	1	1	377.19	754.38	15	1	0.505494505494505	-2	1	-0.25	2	12
ACOT4	19	22	7	11	700.26	1400.52	15	1	0.776677719098239	0.263157894736842	1	0.0745257452574526	18	41
ACOT7	1	12	1	1	270.93	541.86	15	1	0.257142857142857	-11	1	-0.423076923076923	2	13
ACOT8	0	8	4	3	206.91	413.82	15	1	0.0256410256410256	-Inf	0.761210061313465	-0.571428571428571	7	8
ACOT9	4	20	3	2	442.53	885.06	15	1	0.0747421161214264	-6.5	0.91494659390022	-0.433333333333333	5	24
ACOX1	40	75	12	31	1677.39	3354.78	15	1	0.45243573621475	0.274193548387097	1	0.0687563195146613	43	115
ACOX2	22	19	2	2	716.76	1433.52	15	1	1	0.136363636363636	1	0.0365853658536586	4	41
ACOX3	15	27	1	4	697.95	1395.9	15	1	0.648356290569573	0.55	1	0.157142857142857	5	42
ACP1	1	3	1	0	143.22	286.44	15	1	0.4	-Inf	1	-0.75	1	4
ACP6	6	8	4	3	314.82	629.64	15	1	0.659442724458204	-0.777777777777778	1	-0.142857142857143	7	14
ACPP	13	9	1	0	368.28	736.56	15	1	1	-Inf	1	-0.409090909090909	1	22
ACR-ACRL	30	14	8	5	539.55	1079.1	15	1	0.741929445461415	0.253333333333333	1	0.0664335664335663	13	44
ACRBP	30	20	7	3	478.5	957	15	1	0.726954999161186	-0.555555555555556	1	-0.1	10	50
ACSBG1	9	33	2	3	689.37	1378.74	15	1	0.577587505109395	-1.44444444444444	1	-0.185714285714286	5	42
ACSF2	16	20	4	4	391.38	782.76	15	1	1	-0.25	1	-0.0555555555555556	8	36
ACSF3	25	39	13	18	617.76	1235.52	15	1	0.825806385557586	-0.126666666666667	1	-0.0287298387096774	31	64
ACSL3	13	35	2	8	728.31	1456.62	15	1	1	0.326923076923077	1	0.0708333333333333	10	48
ACSL4	4	25	1	3	664.29	1328.58	15	1	0.499633431085044	-1.08333333333333	1	-0.112068965517241	4	29
ACSL5	13	18	0	4	677.16	1354.32	15	1	0.273529411764706	1	1	0.419354838709677	4	31
ACSL6	2	32	2	6	697.29	1394.58	15	1	0.15797373358349	-4.33333333333333	1	-0.191176470588235	8	34
ACSM3	11	25	0	1	573.21	1146.42	15	1	1	1	1	0.305555555555556	1	36
ACSS1	9	23	5	7	642.18	1284.36	15	1	0.475285806151257	-0.825396825396825	1	-0.135416666666667	12	32
ACSS3	29	15	5	1	363.99	727.98	15	1	0.649787611621892	-1.58620689655172	1	-0.174242424242424	6	44
ACT85CL	7	23	0	5	374.22	748.44	15	1	0.558500086251509	1	1	0.233333333333333	5	30
ACTA1	0	6	0	5	333.96	667.92	15	1	1	NA	1	0	5	6
ACTA2	0	13	0	1	374.22	748.44	15	1	1	NA	1	0	1	13
ACTB	0	12	0	3	372.24	744.48	15	1	1	NA	1	0	3	12
ACTBL2L	0	10	0	1	374.22	748.44	15	1	1	NA	1	0	1	10
ACTC1	0	14	0	1	368.61	737.22	15	1	1	NA	1	0	1	14
ACTC2L	0	21	0	12	314.49	628.98	15	1	1	NA	1	0	12	21
ACTG1	0	11	0	16	315.15	630.3	15	1	1	NA	1	0	16	11
ACTG2	0	14	0	0	337.26	674.52	15	1	1	NA	1	NA	0	14
ACTL6A	4	17	0	2	397.65	795.3	15	1	1	1	1	0.19047619047619	2	21
ACTN1	0	16	1	1	858.66	1717.32	15	1	0.111111111111111	-Inf	0.98538656216834	-0.5	2	16
ACTN2	1	15	1	1	889.02	1778.04	15	1	0.215686274509804	-14	1	-0.4375	2	16
ACTN4	0	6	0	2	149.82	299.64	15	1	1	NA	1	0	2	6
ACTR10-ACTR10L	2	20	2	4	410.52	821.04	15	1	0.191452991452991	-4	1	-0.242424242424242	6	22
ACTR1A	0	16	1	9	357.39	714.78	15	1	0.384615384615385	-Inf	1	-0.1	10	16
ACTR2	0	6	0	1	375.21	750.42	15	1	1	NA	1	0	1	6
ACTR3	0	4	0	2	400.29	800.58	15	1	1	NA	1	0	2	4
ACTR3B	0	9	0	1	299.31	598.62	15	1	1	NA	1	0	1	9
ACTR5	3	30	1	8	550.11	1100.22	15	1	1	-0.25	1	-0.0202020202020202	9	33
ACTR6	0	11	0	2	348.15	696.3	15	1	1	NA	1	0	2	11
ACTR8	0	13	2	2	562.32	1124.64	15	1	0.0441176470588235	-Inf	0.822543273817637	-0.5	4	13
ACTRT2	16	20	2	4	373.23	746.46	15	1	0.685159859742658	0.375	1	0.111111111111111	6	36
ACVR1	3	14	2	0	527.01	1054.02	15	1	0.0584795321637427	-Inf	0.861744483565755	-0.823529411764706	2	17
ACVR1B	0	23	0	6	449.46	898.92	15	1	1	NA	1	0	6	23
ACVR1C	3	24	4	9	460.68	921.36	15	1	0.186616182746213	-2.55555555555556	1	-0.196581196581197	13	27
ACVR2A	1	26	1	5	499.95	999.9	15	1	0.335227272727273	-4.2	1	-0.12962962962963	6	27
ACVRL1	3	9	3	10	389.73	779.46	15	1	1	0.1	1	0.0192307692307692	13	12
ACY1	0	13	3	10	362.67	725.34	15	1	0.22	-Inf	1	-0.230769230769231	13	13
ACYP1	0	1	2	2	50.49	100.98	15	1	1	-Inf	1	-0.5	4	1
ACYP2	1	1	0	0	77.22	154.44	15	1	1	NA	1	NA	0	2
ADA	6	15	5	8	351.45	702.9	15	1	0.709399332591769	-0.5625	1	-0.0989010989010989	13	21
ADAD1	24	34	7	4	576.18	1152.36	15	1	0.201913767644598	-1.47916666666667	1	-0.22257053291536	11	58
ADAL	6	14	0	3	324.06	648.12	15	1	0.539243365330322	1	1	0.3	3	20
ADAM10	4	18	1	3	724.35	1448.7	15	1	1	-0.5	1	-0.0681818181818182	4	22
ADAM12	7	29	3	6	820.38	1640.76	15	1	0.392931641192679	-1.07142857142857	1	-0.138888888888889	9	36
ADAM15	38	62	14	29	994.95	1989.9	15	1	0.574543208366104	0.212341197822142	1	0.0544186046511628	43	100
ADAM17	8	33	1	15	788.7	1577.4	15	1	0.420237666250034	0.725	1	0.132621951219512	16	41
ADAM19	20	44	6	4	851.4	1702.8	15	1	0.15066458605248	-2.3	1	-0.2875	10	64
ADAM20	39	49	5	17	762.3	1524.6	15	1	0.0884671584639223	0.630467571644042	0.953024314709457	0.215909090909091	22	88
ADAM22	2	25	0	8	873.18	1746.36	15	1	1	1	1	0.0740740740740741	8	27
ADAM23	5	21	0	0	893.64	1787.28	15	1	1	NA	1	NA	0	26
ADAM28	22	39	4	6	768.24	1536.48	15	1	1	-0.181818181818182	1	-0.039344262295082	10	61
ADAM33	10	35	7	23	813.12	1626.24	15	1	1	-0.0652173913043479	1	-0.0111111111111111	30	45
ADAM5P	15	29	5	7	791.01	1582.02	15	1	0.737436013248815	-0.380952380952381	1	-0.0757575757575758	12	44
ADAM8	79	36	3	1	721.38	1442.76	15	1	1	-0.367088607594937	1	-0.0630434782608695	4	115
ADAM9	22	27	10	4	876.48	1752.96	15	1	0.128862485066295	-2.06818181818182	1	-0.26530612244898	14	49
ADAM9L-LOC100857794	15	5	2	1	219.78	439.56	15	1	1	0.333333333333333	1	0.0833333333333334	3	20
ADAMTS1	11	71	3	3	864.93	1729.86	15	1	0.0488083842430518	-5.45454545454545	0.833370237838852	-0.365853658536585	6	82
ADAMTS12	59	65	6	2	1604.13	3208.26	15	1	0.161488603202072	-2.30508474576271	1	-0.274193548387097	8	124
ADAMTS13	40	38	11	5	1450.35	2900.7	15	1	0.273180196168906	-1.09	1	-0.174679487179487	16	78
ADAMTS15	4	40	3	22	798.93	1597.86	15	1	0.698022772229742	-0.363636363636364	1	-0.0290909090909091	25	44
ADAMTS17	1	26	2	5	1062.27	2124.54	15	1	0.100601604278075	-9.4	0.97452757916241	-0.248677248677249	7	27
ADAMTS18	13	34	2	0	1237.5	2475	15	1	0.0892857142857143	-Inf	0.953786405978059	-0.723404255319149	2	47
ADAMTS19	7	19	2	0	818.73	1637.46	15	1	0.0952380952380952	-Inf	0.960983694935281	-0.730769230769231	2	26
ADAMTS20	39	51	8	6	1789.26	3578.52	15	1	0.394199192514126	-0.743589743589744	1	-0.138095238095238	14	90
ADAMTS5	3	31	0	1	733.92	1467.84	15	1	1	1	1	0.0882352941176471	1	34
ADAMTS6	12	24	4	0	1235.19	2470.38	15	1	0.0199146514935989	-Inf	0.694710530426989	-0.666666666666667	4	36
ADAMTS7	49	84	13	33	1680.69	3361.38	15	1	0.369278145334697	0.324675324675325	1	0.085812356979405	46	133
ADAMTS8	2	38	2	22	702.9	1405.8	15	1	0.626803656417617	-0.727272727272727	1	-0.0333333333333333	24	40
ADAMTS9	10	70	6	25	1852.95	3705.9	15	1	0.375680447043056	-0.68	1	-0.0685483870967742	31	80
ADAMTSL2	7	32	5	16	819.39	1638.78	15	1	0.73686547013852	-0.428571428571429	1	-0.0586080586080586	21	39
ADAMTSL2L	20	36	6	7	959.64	1919.28	15	1	0.535085524395871	-0.542857142857143	1	-0.104395604395604	13	56
ADAMTSL3	26	58	6	4	1701.48	3402.96	15	1	0.0842829642333897	-2.34615384615385	0.949431371776132	-0.29047619047619	10	84
ADAMTSL5	7	17	4	10	297.99	595.98	15	1	1	0.0285714285714286	1	0.00595238095238099	14	24
ADAP1	0	11	0	1	347.49	694.98	15	1	1	NA	1	0	1	11
ADAP2	7	7	1	1	333.3	666.6	15	1	1	0	1	0	2	14
ADAR	49	61	11	13	1153.35	2306.7	15	1	1	-0.053375196232339	1	-0.0128787878787879	24	110
ADARB1	4	17	4	4	654.72	1309.44	15	1	0.163780347588444	-3.25	1	-0.30952380952381	8	21
ADARB2	4	21	1	7	677.49	1354.98	15	1	1	0.25	1	0.035	8	25
ADAT1	14	20	7	3	486.75	973.5	15	1	0.155485298990687	-2.33333333333333	1	-0.288235294117647	10	34
ADAT2	2	5	0	0	43.56	87.12	15	1	1	NA	1	NA	0	7
ADCK2	4	17	1	8	313.83	627.66	15	1	1	0.46875	1	0.0793650793650794	9	21
ADCY1	3	20	0	1	652.41	1304.82	15	1	1	1	1	0.130434782608696	1	23
ADCY2	8	18	4	2	1063.26	2126.52	15	1	0.165057736108904	-3.5	1	-0.358974358974359	6	26
ADCY3	0	14	4	20	888.36	1776.72	15	1	0.275865339023234	-Inf	1	-0.166666666666667	24	14
ADCY7	25	46	5	6	1034.22	2068.44	15	1	0.519968491728158	-0.533333333333333	1	-0.102432778489117	11	71
ADCY8	5	20	3	4	846.12	1692.24	15	1	0.326507135183442	-2	1	-0.228571428571429	7	25
ADCYAP1	0	1	1	0	91.08	182.16	15	1	1	-Inf	1	-1	1	1
ADCYAP1R1	1	16	1	2	466.29	932.58	15	1	0.28421052631579	-7	1	-0.274509803921569	3	17
ADD1	2	7	1	0	658.35	1316.7	15	1	0.3	-Inf	1	-0.777777777777778	1	9
ADD3	1	22	4	1	703.89	1407.78	15	1	0.00118030118030118	-87	0.254094564439392	-0.756521739130435	5	23
ADGB	81	67	15	8	1628.88	3257.76	15	1	0.37616434630016	-0.550925925925926	1	-0.104876615746181	23	148
ADGRA1L	2	19	0	3	706.86	1413.72	15	1	1	1	1	0.0952380952380952	3	21
ADGRA2	1	25	9	21	732.27	1464.54	15	1	0.0140724696141002	-9.71428571428571	0.628451090139802	-0.261538461538461	30	26
ADGRA3L	12	43	5	4	1234.53	2469.06	15	1	0.0481685356903728	-3.47916666666667	0.829468895324472	-0.337373737373737	9	55
ADGRB1	3	37	1	15	1290.63	2581.26	15	1	1	0.177777777777778	1	0.0125	16	40
ADGRB2	4	34	5	24	919.71	1839.42	15	1	0.485258772489605	-0.770833333333333	1	-0.0671506352087115	29	38
ADGRB3	4	18	0	3	594.99	1189.98	15	1	1	1	1	0.181818181818182	3	22
ADGRD1	7	23	2	6	898.92	1797.84	15	1	1	-0.0952380952380953	1	-0.0166666666666667	8	30
ADGRD2	21	39	10	9	1075.47	2150.94	15	1	0.188408349981184	-1.06349206349206	1	-0.176315789473684	19	60
ADGRF4	22	28	4	1	670.89	1341.78	15	1	0.177673890215511	-4.09090909090909	1	-0.36	5	50
ADGRF5	83	53	9	6	1330.56	2661.12	15	1	1	0.0421686746987951	1	0.0102941176470589	15	136
ADGRG1	14	26	3	2	664.29	1328.58	15	1	0.350435724230392	-1.78571428571429	1	-0.25	5	40
ADGRG2	40	38	12	7	1291.95	2583.9	15	1	0.444698294067203	-0.628571428571429	1	-0.118758434547908	19	78
ADGRG3	17	15	1	2	545.49	1090.98	15	1	0.602597402597403	0.558823529411765	1	0.197916666666667	3	32
ADGRG4	39	26	7	5	1086.03	2172.06	15	1	1	0.0666666666666667	1	0.0166666666666666	12	65
ADGRG5	50	17	3	0	486.09	972.18	15	1	1	-Inf	1	-0.253731343283582	3	67
ADGRG6	86	59	6	4	2221.56	4443.12	15	1	1	-0.0290697674418605	1	-0.00689655172413794	10	145
ADGRG7	30	23	3	3	745.8	1491.6	15	1	1	0.233333333333333	1	0.0660377358490566	6	53
ADGRL2	7	29	4	4	1482.03	2964.06	15	1	0.091852517651843	-3.14285714285714	0.953786405978059	-0.305555555555556	8	36
ADGRL3	9	36	2	4	1046.76	2093.52	15	1	0.598095223288205	-1	1	-0.133333333333333	6	45
ADGRV1	153	225	40	31	5782.59	11565.18	15	1	0.0182413058508952	-0.897533206831119	0.677255339142531	-0.158618376928236	71	378
ADH1C	2	10	1	3	378.18	756.36	15	1	1	-0.666666666666667	1	-0.0833333333333333	4	12
ADH5	2	11	3	5	367.29	734.58	15	1	0.325372254164824	-2.3	1	-0.221153846153846	8	13
ADHFE1	5	13	7	3	458.37	916.74	15	1	0.0496676473793179	-5.06666666666667	0.838445459955758	-0.422222222222222	10	18
ADI1	2	7	1	3	179.19	358.38	15	1	1	-0.166666666666667	1	-0.0277777777777778	4	9
ADIPOQ	6	12	1	12	243.54	487.08	15	1	0.191160548757879	0.833333333333333	1	0.256410256410256	13	18
ADIPOR1	0	17	1	5	296.01	592.02	15	1	0.260869565217391	-Inf	1	-0.166666666666667	6	17
ADIPOR2	2	8	0	1	383.13	766.26	15	1	1	1	1	0.2	1	10
ADIRF	0	1	1	0	76.23	152.46	15	1	1	-Inf	1	-1	1	1
ADK	7	11	0	0	373.23	746.46	15	1	1	NA	1	NA	0	18
ADM	1	1	1	2	153.45	306.9	15	1	1	0.5	1	0.166666666666667	3	2
ADMP	13	19	4	9	599.28	1198.56	15	1	0.736557287502148	0.35042735042735	1	0.0985576923076923	13	32
ADNP	12	35	8	4	1284.69	2569.38	15	1	0.0142480635053664	-4.83333333333333	0.629301355578728	-0.411347517730496	12	47
ADNP2	17	42	1	11	1063.26	2126.52	15	1	0.272678455318762	0.775401069518717	1	0.204802259887006	12	59
ADORA1	2	5	1	7	223.74	447.48	15	1	0.569230769230769	0.642857142857143	1	0.160714285714286	8	7
ADORA2B	4	7	1	7	337.59	675.18	15	1	0.33780529755762	0.75	1	0.238636363636364	8	11
ADPGK	1	22	0	2	428.67	857.34	15	1	1	1	1	0.0434782608695652	2	23
ADPRH	10	14	0	8	348.48	696.96	15	1	0.0352685319871082	1	0.788199921465956	0.416666666666667	8	24
ADPRHL1	97	80	36	27	1929.51	3859.02	15	1	0.769899819140716	-0.0996563573883162	1	-0.023405972558515	63	177
ADPRHL2	1	19	0	4	295.68	591.36	15	1	1	1	1	0.05	4	20
ADPRM	3	7	0	0	140.91	281.82	15	1	1	NA	1	NA	0	10
ADRA1A	6	19	0	4	472.23	944.46	15	1	0.552608311229001	1	1	0.24	4	25
ADRA1D	2	16	2	4	283.47	566.94	15	1	0.251270468661773	-3	1	-0.222222222222222	6	18
ADRA2A	4	24	3	6	440.55	881.1	15	1	0.327010942286085	-2	1	-0.19047619047619	9	28
ADRA2BL2	9	15	8	9	321.75	643.5	15	1	0.748374592341059	-0.481481481481481	1	-0.0955882352941176	17	24
ADRA2C	0	12	0	0	392.37	784.74	15	1	1	NA	1	NA	0	12
ADRB2	2	17	1	6	389.4	778.8	15	1	1	-0.416666666666667	1	-0.037593984962406	7	19
ADRB3	3	6	3	10	323.73	647.46	15	1	0.655019902697922	0.4	1	0.102564102564103	13	9
ADRM1	0	8	0	3	381.81	763.62	15	1	1	NA	1	0	3	8
ADSL	2	18	0	3	449.79	899.58	15	1	1	1	1	0.1	3	20
ADSS	0	7	2	2	392.04	784.08	15	1	0.109090909090909	-Inf	0.98538656216834	-0.5	4	7
ADSSL1	0	13	0	1	390.06	780.12	15	1	1	NA	1	0	1	13
ADTRP	6	8	0	0	231.66	463.32	15	1	1	NA	1	NA	0	14
AEN	3	4	0	2	152.79	305.58	15	1	0.5	1	1	0.428571428571429	2	7
AES	0	6	0	0	127.71	255.42	15	1	1	NA	1	NA	0	6
AFAP1	3	27	4	1	807.84	1615.68	15	1	0.00308349146110057	-35	0.395933424845573	-0.7	5	30
AFAP1L1	27	49	1	3	714.45	1428.9	15	1	1	0.395061728395062	1	0.105263157894737	4	76
AFAP1L2	25	44	10	11	813.78	1627.56	15	1	0.444449604162542	-0.6	1	-0.113871635610766	21	69
AFDN	8	51	3	9	1838.43	3676.86	15	1	0.381665580945104	-1.125	1	-0.114406779661017	12	59
AFF1	28	39	10	10	1166.55	2333.1	15	1	0.6101164464813	-0.392857142857143	1	-0.082089552238806	20	67
AFF3	12	21	4	1	408.21	816.42	15	1	0.140936602236912	-6	1	-0.436363636363636	5	33
AFF4	6	32	6	9	1156.32	2312.64	15	1	0.0759945541836588	-2.55555555555556	0.919736921581953	-0.242105263157895	15	38
AFG1L	1	12	1	4	445.17	890.34	15	1	0.490196078431373	-2	1	-0.123076923076923	5	13
AFG3L2	5	30	0	11	760.32	1520.64	15	1	0.317211549264127	1	1	0.142857142857143	11	35
AFMID	2	13	0	6	249.48	498.96	15	1	1	1	1	0.133333333333333	6	15
AFP	10	23	3	2	609.84	1219.68	15	1	0.314960692669671	-2.45	1	-0.296969696969697	5	33
AFTPH	19	26	14	8	845.46	1690.92	15	1	0.12319965725757	-1.39473684210526	1	-0.214141414141414	22	45
AGA	7	7	4	0	323.73	647.46	15	1	0.119281045751634	-Inf	1	-0.5	4	14
AGAP3	6	36	4	17	911.13	1822.26	15	1	0.719251759736371	-0.411764705882353	1	-0.0476190476190476	21	42
AGBL1	33	34	8	1	869.22	1738.44	15	1	0.0332015061776282	-7.24242424242424	0.784275503573749	-0.396351575456053	9	67
AGBL2	13	14	19	7	481.14	962.28	15	1	0.0929131710829544	-1.92307692307692	0.958704007647278	-0.249287749287749	26	27
AGBL3	33	25	3	2	768.24	1536.48	15	1	1	-0.136363636363636	1	-0.0310344827586206	5	58
AGBL4	5	10	0	1	460.68	921.36	15	1	1	1	1	0.333333333333333	1	15
AGFG1	0	8	1	4	451.77	903.54	15	1	0.384615384615385	-Inf	1	-0.2	5	8
AGGF1	14	29	6	3	718.41	1436.82	15	1	0.071471033184044	-3.14285714285714	0.908058284769907	-0.341085271317829	9	43
AGK	6	16	5	3	384.45	768.9	15	1	0.103998769845846	-3.44444444444444	0.983379501385042	-0.352272727272727	8	22
AGL	5	48	5	12	1512.39	3024.78	15	1	0.0551342562306927	-3	0.846060006968071	-0.199778024417314	17	53
AGMAT	7	14	5	4	282.81	565.62	15	1	0.41810633144966	-1.5	1	-0.222222222222222	9	21
AGO1	0	32	0	11	841.17	1682.34	15	1	1	NA	1	0	11	32
AGO3	0	19	0	3	848.76	1697.52	15	1	1	NA	1	0	3	19
AGPAT1	10	8	0	0	265.98	531.96	15	1	1	NA	1	NA	0	18
AGPAT2	1	4	3	6	256.41	512.82	15	1	1	-1	1	-0.133333333333333	9	5
AGPAT3	1	12	1	2	312.18	624.36	15	1	0.35	-5	1	-0.256410256410256	3	13
AGPAT4	4	12	1	2	336.6	673.2	15	1	1	-0.5	1	-0.0833333333333333	3	16
AGPAT5	0	6	0	1	362.34	724.68	15	1	1	NA	1	0	1	6
AGPAT9L	11	12	1	1	408.54	817.08	15	1	1	-0.0909090909090908	1	-0.0217391304347826	2	23
AGPS	2	21	1	2	469.92	939.84	15	1	0.318846153846154	-4.25	1	-0.246376811594203	3	23
AGR2	2	7	0	2	171.27	342.54	15	1	1	1	1	0.222222222222222	2	9
AGR3	0	3	0	2	164.34	328.68	15	1	1	NA	1	0	2	3
AGRN	16	46	7	38	1502.16	3004.32	15	1	0.239434099404104	0.470394736842105	1	0.102508960573477	45	62
AGT	14	20	4	0	460.35	920.7	15	1	0.0414549888234098	-Inf	0.800205836669235	-0.588235294117647	4	34
AGTR1	6	10	1	0	356.4	712.8	15	1	0.411764705882353	-Inf	1	-0.625	1	16
AGTR2	8	13	0	5	369.27	738.54	15	1	0.280510793554272	1	1	0.380952380952381	5	21
AGTRAP	4	12	0	1	169.95	339.9	15	1	1	1	1	0.25	1	16
AGXT	9	18	6	4	304.92	609.84	15	1	0.257815387526505	-2	1	-0.266666666666667	10	27
AGXT2	14	17	2	3	491.37	982.74	15	1	1	0.19047619047619	1	0.0516129032258064	5	31
AHCYL1	0	20	0	6	486.09	972.18	15	1	1	NA	1	0	6	20
AHDC1-LOC107055013-LOC112530227	1	13	7	14	831.6	1663.2	15	1	0.107798028706882	-5.5	0.983875031494079	-0.261904761904762	21	14
AHI1	33	38	8	1	1017.72	2035.44	15	1	0.0293708718886454	-8.21212121212121	0.768994411487961	-0.424100156494523	9	71
AHNAK2	148	82	13	5	2266.11	4532.22	15	1	0.613021489250804	-0.44054054054054	1	-0.078743961352657	18	230
AHR	10	22	1	3	834.9	1669.8	15	1	1	0.266666666666667	1	0.0625	4	32
AHR1B	55	44	20	13	873.51	1747.02	15	1	0.687206260149421	-0.230769230769231	1	-0.0505050505050505	33	99
AHR2	42	45	16	16	866.25	1732.5	15	1	1	-0.0714285714285714	1	-0.0172413793103448	32	87
AHRR	9	23	6	5	660	1320	15	1	0.150387100133258	-2.06666666666667	1	-0.264204545454545	11	32
AHSA1	0	16	0	4	334.29	668.58	15	1	1	NA	1	0	4	16
AHSA2	3	12	0	2	280.83	561.66	15	1	1	1	1	0.2	2	15
AHSG	11	9	3	4	342.54	685.08	15	1	0.677616747181965	0.386363636363636	1	0.121428571428571	7	20
AICDA	1	6	0	1	197.01	394.02	15	1	1	1	1	0.142857142857143	1	7
AIFM1	8	24	5	4	538.23	1076.46	15	1	0.112932686518732	-2.75	0.99134365547716	-0.305555555555556	9	32
AIFM2	6	13	2	7	371.25	742.5	15	1	1	0.380952380952381	1	0.0935672514619883	9	19
AIFM3	0	17	1	8	593.01	1186.02	15	1	0.346153846153846	-Inf	1	-0.111111111111111	9	17
AIG1	3	3	0	0	144.21	288.42	15	1	1	NA	1	NA	0	6
AIM1	35	64	8	9	1731.51	3463.02	15	1	0.418751911721379	-0.625396825396825	1	-0.117052881758764	17	99
AIM1L	24	20	13	27	895.62	1791.24	15	1	0.0501380024069812	0.598765432098765	0.838764987711203	0.220454545454545	40	44
AIMP1	7	15	2	2	306.9	613.8	15	1	0.590635451505017	-1.14285714285714	1	-0.181818181818182	4	22
AIMP2	5	17	0	2	290.73	581.46	15	1	1	1	1	0.227272727272727	2	22
AIPL1	15	19	3	5	349.14	698.28	15	1	1	0.24	1	0.0661764705882353	8	34
AJAP1	0	6	0	2	165.66	331.32	15	1	1	NA	1	0	2	6
AK2	0	11	0	1	159.39	318.78	15	1	1	NA	1	0	1	11
AK3	9	13	0	3	285.78	571.56	15	1	0.28	1	1	0.409090909090909	3	22
AK4	0	11	0	4	170.61	341.22	15	1	1	NA	1	0	4	11
AK5	11	14	1	1	568.26	1136.52	15	1	1	-0.272727272727273	1	-0.06	2	25
AK6	1	9	0	0	170.28	340.56	15	1	1	NA	1	NA	0	10
AK7	15	29	2	2	712.47	1424.94	15	1	0.607282351731936	-0.933333333333333	1	-0.159090909090909	4	44
AK8	6	21	0	2	450.45	900.9	15	1	1	1	1	0.222222222222222	2	27
AK9	74	80	13	14	2407.68	4815.36	15	1	1	-0.00386100386100385	1	-0.000962000962000942	27	154
AKAIN1	0	3	0	0	67.65	135.3	15	1	1	NA	1	NA	0	3
AKAP1	25	26	6	8	870.21	1740.42	15	1	0.768068367219958	0.22	1	0.061624649859944	14	51
AKAP10	10	49	3	14	1101.21	2202.42	15	1	1	-0.05	1	-0.00697906281156532	17	59
AKAP12	75	57	27	10	1880.34	3760.68	15	1	0.0886167465844601	-1.052	0.953024314709457	-0.161547911547911	37	132
AKAP13	12	42	6	7	1456.29	2912.58	15	1	0.0944697269098652	-2	0.960983694935281	-0.239316239316239	13	54
AKAP14	11	3	2	1	167.31	334.62	15	1	1	0.454545454545455	1	0.119047619047619	3	14
AKAP17A	9	35	1	5	685.08	1370.16	15	1	1	0.222222222222222	1	0.0378787878787879	6	44
AKAP2	35	32	5	1	868.56	1737.12	15	1	0.21238063798362	-3.57142857142857	1	-0.310945273631841	6	67
AKAP5	22	21	4	4	498.63	997.26	15	1	1	0.0454545454545454	1	0.0116279069767442	8	43
AKAP6	56	70	11	5	2412.63	4825.26	15	1	0.108586410259619	-1.75	0.985224113668503	-0.243055555555556	16	126
AKAP7	11	11	1	1	238.26	476.52	15	1	1	0	1	0	2	22
AKAP7L	35	37	11	2	627.66	1255.32	15	1	0.0312373616401532	-4.81428571428571	0.777391659786904	-0.360042735042735	13	72
AKAP9	98	117	28	19	3874.53	7749.06	15	1	0.106610307187082	-0.759398496240602	0.983875031494079	-0.139930727362692	47	215
AKIP1	1	5	1	1	85.14	170.28	15	1	0.464285714285714	-4	1	-0.333333333333333	2	6
AKNA	17	12	11	7	326.04	652.08	15	1	1	-0.109243697478992	1	-0.0249042145593871	18	29
AKNAD1	67	27	23	8	718.74	1437.48	15	1	0.821275700278483	-0.158582089552239	1	-0.0291695264241593	31	94
AKR1A1	3	8	1	1	324.72	649.44	15	1	1	-1.66666666666667	1	-0.227272727272727	2	11
AKR1B10L2	7	10	0	2	295.68	591.36	15	1	0.508771929824561	1	1	0.411764705882353	2	17
AKR1B10L3	5	7	2	1	267.3	534.6	15	1	0.569230769230769	-1.8	1	-0.25	3	12
AKR1D1	1	9	1	4	317.13	634.26	15	1	1	-1.25	1	-0.1	5	10
AKR7A2	6	16	2	9	284.13	568.26	15	1	0.687045435098828	0.407407407407407	1	0.0909090909090909	11	22
AKT1	1	10	0	4	491.04	982.08	15	1	1	1	1	0.0909090909090909	4	11
AKT3	1	16	1	1	470.25	940.5	15	1	0.204678362573099	-15	1	-0.441176470588235	2	17
AKTIP	1	12	2	0	291.06	582.12	15	1	0.0285714285714286	-Inf	0.761210061313465	-0.923076923076923	2	13
ALAD	2	12	3	2	280.5	561	15	1	0.0843653250773993	-8	0.949431371776132	-0.457142857142857	5	14
ALAS1	7	22	2	6	618.09	1236.18	15	1	1	-0.0476190476190477	1	-0.0086206896551724	8	29
ALB	15	19	2	6	609.84	1219.68	15	1	0.438826601856127	0.577777777777778	1	0.191176470588235	8	34
ALDH18A1	7	29	1	1	469.26	938.52	15	1	0.38122332859175	-3.14285714285714	1	-0.305555555555556	2	36
ALDH1A1	3	22	3	0	485.76	971.52	15	1	0.0061050061050061	-Inf	0.467685236262114	-0.88	3	25
ALDH1A2	1	8	0	0	512.16	1024.32	15	1	1	NA	1	NA	0	9
ALDH1A3	2	27	0	4	506.22	1012.44	15	1	1	1	1	0.0689655172413793	4	29
ALDH1L2	9	24	3	4	896.94	1793.88	15	1	0.409589155719187	-1	1	-0.155844155844156	7	33
ALDH3A2	30	68	15	30	1119.69	2239.38	15	1	0.846536083511033	-0.133333333333333	1	-0.0272108843537415	45	98
ALDH4A1	7	31	7	15	489.39	978.78	15	1	0.342805326397578	-1.06666666666667	1	-0.133971291866029	22	38
ALDH5A1	2	14	1	1	401.28	802.56	15	1	0.313725490196078	-6	1	-0.375	2	16
ALDH6A1	3	12	2	1	494.01	988.02	15	1	0.171568627450981	-7	1	-0.466666666666667	3	15
ALDH7A1	3	17	6	2	456.72	913.44	15	1	0.00484443093138746	-16	0.460299276725364	-0.6	8	20
ALDH8A1	13	25	0	3	970.2	1940.4	15	1	0.539024390243903	1	1	0.342105263157895	3	38
ALDH9A1	3	23	5	8	461.01	922.02	15	1	0.0895926886638961	-3.79166666666667	0.953786405978059	-0.269230769230769	13	26
ALDOB	2	20	0	2	361.35	722.7	15	1	1	1	1	0.0909090909090909	2	22
ALDOC	1	9	1	8	298.32	596.64	15	1	1	-0.125	1	-0.0111111111111111	9	10
ALG1	12	17	5	3	368.94	737.88	15	1	0.428258170193654	-1.36111111111111	1	-0.211206896551724	8	29
ALG10	15	19	6	7	445.17	890.34	15	1	1	-0.0857142857142856	1	-0.0203619909502263	13	34
ALG11	6	19	3	5	396	792	15	1	0.651008242776875	-0.9	1	-0.135	8	25
ALG12	1	11	2	0	351.78	703.56	15	1	0.032967032967033	-Inf	0.784275503573749	-0.916666666666667	2	12
ALG13	14	34	3	1	864.93	1729.86	15	1	0.0967032967032967	-6.28571428571429	0.971055566729444	-0.458333333333333	4	48
ALG14	3	7	1	1	210.87	421.74	15	1	1	-1.33333333333333	1	-0.2	2	10
ALG2	3	18	1	6	319.11	638.22	15	1	1	0	1	0	7	21
ALG3	3	7	2	5	277.86	555.72	15	1	1	0.0666666666666667	1	0.0142857142857143	7	10
ALG5	6	10	4	0	298.98	597.96	15	1	0.086687306501548	-Inf	0.951277979139867	-0.625	4	16
ALG6	15	17	5	1	441.54	883.08	15	1	0.183924183924184	-4.66666666666667	1	-0.364583333333333	6	32
ALG8	13	20	8	3	403.26	806.52	15	1	0.083474940536767	-3.1025641025641	0.949431371776132	-0.333333333333333	11	33
ALG9	15	29	7	11	786.06	1572.12	15	1	0.774562698277434	-0.23030303030303	1	-0.047979797979798	18	44
ALK	24	35	7	6	1221.33	2442.66	15	1	0.537598436838405	-0.701388888888889	1	-0.131681877444589	13	59
ALKBH1	6	12	3	4	322.74	645.48	15	1	0.672877054295819	-0.5	1	-0.0952380952380952	7	18
ALKBH2	2	8	2	0	167.97	335.94	15	1	0.0909090909090909	-Inf	0.953786405978059	-0.8	2	10
ALKBH3-HSD17B12	8	17	2	6	447.15	894.3	15	1	1	0.291666666666667	1	0.07	8	25
ALKBH4	12	16	0	1	275.22	550.44	15	1	1	1	1	0.428571428571429	1	28
ALKBH5	1	11	1	10	369.27	738.54	15	1	1	-0.1	1	-0.00757575757575758	11	12
ALKBH8	26	31	6	7	688.38	1376.76	15	1	1	-0.0219780219780219	1	-0.00539811066126861	13	57
ALMS1	206	123	74	34	3016.53	6033.06	15	1	0.298977294673982	-0.299543118218161	1	-0.0590453675560059	108	329
ALOX5	4	15	1	5	667.59	1335.18	15	1	1	0.25	1	0.043859649122807	6	19
ALOX5AP	0	7	0	5	160.38	320.76	15	1	1	NA	1	0	5	7
ALPI	11	17	9	12	491.37	982.74	15	1	1	-0.159090909090909	1	-0.0357142857142857	21	28
ALPK1	48	68	19	9	1130.58	2261.16	15	1	0.0191573569686447	-1.99074074074074	0.683149554847669	-0.264778325123153	28	116
ALPK2	101	38	11	7	1805.76	3611.52	15	1	0.405419839241724	0.408769448373409	1	0.11550759392486	18	139
ALPK3	34	47	9	8	1546.71	3093.42	15	1	0.432609296598716	-0.555147058823529	1	-0.109658678286129	17	81
ALPL	1	8	1	6	303.6	607.2	15	1	1	-0.333333333333333	1	-0.0317460317460317	7	9
ALPP	21	9	1	7	341.88	683.76	15	1	0.0054096341422817	0.938775510204082	0.467685236262114	0.575	8	30
ALS2	17	68	7	5	1608.42	3216.84	15	1	0.00853714776764238	-4.6	0.54233354502865	-0.383333333333333	12	85
ALS2CL	5	37	5	9	970.2	1940.4	15	1	0.0997745103661698	-3.11111111111111	0.971353639774823	-0.238095238095238	14	42
ALX1	2	6	1	0	320.76	641.52	15	1	0.333333333333333	-Inf	1	-0.75	1	8
ALX3	0	4	0	1	105.27	210.54	15	1	1	NA	1	0	1	4
ALX4	2	8	1	5	291.06	582.12	15	1	1	0.2	1	0.0333333333333334	6	10
ALYREF	0	4	0	0	71.28	142.56	15	1	1	NA	1	NA	0	4
AMACR	2	9	0	1	351.78	703.56	15	1	1	1	1	0.181818181818182	1	11
AMBP	6	21	1	0	303.27	606.54	15	1	0.25	-Inf	1	-0.777777777777778	1	27
AMBRA1	3	36	1	14	1266.54	2533.08	15	1	1	0.142857142857143	1	0.0102564102564103	15	39
AMD1	0	3	0	2	322.74	645.48	15	1	1	NA	1	0	2	3
AMDHD1	4	13	3	1	424.38	848.76	15	1	0.087719298245614	-8.75	0.951277979139867	-0.514705882352941	4	17
AMDHD2	5	20	1	2	380.16	760.32	15	1	0.52991452991453	-1	1	-0.133333333333333	3	25
AMER1	44	57	17	21	1079.43	2158.86	15	1	1	-0.0487012987012987	1	-0.0117248566961959	38	101
AMER2	13	19	3	3	608.19	1216.38	15	1	0.682034976152623	-0.461538461538461	1	-0.09375	6	32
AMER3	40	41	6	8	982.08	1964.16	15	1	0.775057316280208	0.23125	1	0.0652557319223986	14	81
AMFR	2	17	2	3	553.41	1106.82	15	1	0.179277244494636	-4.66666666666667	1	-0.294736842105263	5	19
AMH	22	28	3	1	441.21	882.42	15	1	0.326010036331901	-2.81818181818182	1	-0.31	4	50
AMHR2	11	31	2	8	587.4	1174.8	15	1	1	0.295454545454545	1	0.0619047619047619	10	42
AMIGO2	5	20	4	3	516.78	1033.56	15	1	0.0763526425372922	-4.33333333333333	0.919736921581953	-0.371428571428571	7	25
AMMECR1	8	8	1	1	257.07	514.14	15	1	1	0	1	0	2	16
AMMECR1L	1	5	0	1	279.18	558.36	15	1	1	1	1	0.166666666666667	1	6
AMN	19	21	8	5	454.08	908.16	15	1	0.5255884695891	-0.768421052631579	1	-0.140384615384615	13	40
AMN1	2	14	1	1	264.33	528.66	15	1	0.313725490196078	-6	1	-0.375	2	16
AMOTL2	12	23	6	12	660.33	1320.66	15	1	1	0.0416666666666666	1	0.00952380952380955	18	35
AMPD1	9	27	2	3	726.66	1453.32	15	1	0.597737116992573	-1	1	-0.15	5	36
AMPD2	0	10	0	4	595.98	1191.96	15	1	1	NA	1	0	4	10
AMPD3	2	31	0	3	767.25	1534.5	15	1	1	1	1	0.0606060606060606	3	33
AMPH	61	44	8	7	1394.91	2789.82	15	1	0.784245117924975	0.175644028103044	1	0.0476190476190477	15	105
AMY1A	3	4	1	1	198.99	397.98	15	1	1	-0.333333333333333	1	-0.0714285714285715	2	7
AMZ1	4	35	0	10	498.96	997.92	15	1	0.568662802771432	1	1	0.102564102564103	10	39
AN1ZNF5L	4	7	3	4	185.46	370.92	15	1	1	-0.3125	1	-0.0649350649350649	7	11
ANAPC1	7	50	4	9	1908.39	3816.78	15	1	0.197865498489402	-2.17460317460317	1	-0.184885290148448	13	57
ANAPC10	0	5	0	1	184.14	368.28	15	1	1	NA	1	0	1	5
ANAPC11	2	2	3	3	73.59	147.18	15	1	1	0	1	0	6	4
ANAPC2	2	28	3	5	776.16	1552.32	15	1	0.0528268206286783	-7.4	0.844529437070393	-0.308333333333333	8	30
ANAPC4	15	26	5	4	745.8	1491.6	15	1	0.454248152725015	-1.16666666666667	1	-0.18970189701897	9	41
ANAPC5	5	32	2	10	749.43	1498.86	15	1	1	-0.28	1	-0.0315315315315315	12	37
ANAPC7	1	28	0	2	560.34	1120.68	15	1	1	1	1	0.0344827586206897	2	29
ANGEL1	17	28	2	8	659.34	1318.68	15	1	0.465324245161223	0.588235294117647	1	0.177777777777778	10	45
ANGEL2	16	27	4	5	547.8	1095.6	15	1	0.719206929001781	-0.35	1	-0.0723514211886305	9	43
ANGPT2	2	14	1	0	768.24	1536.48	15	1	0.176470588235294	-Inf	1	-0.875	1	16
ANGPT4	8	2	4	10	289.74	579.48	15	1	0.0360748418360478	0.9	0.788199921465956	0.514285714285714	14	10
ANGPTL1	3	23	2	0	476.85	953.7	15	1	0.0264550264550265	-Inf	0.761210061313465	-0.884615384615385	2	26
ANGPTL2	13	18	1	1	572.55	1145.1	15	1	1	-0.384615384615385	1	-0.0806451612903226	2	31
ANGPTL3	6	20	2	2	459.36	918.72	15	1	0.283524904214559	-2.33333333333333	1	-0.269230769230769	4	26
ANGPTL4	5	14	4	8	432.3	864.6	15	1	0.703917768163065	-0.4	1	-0.0701754385964912	12	19
ANGPTL5	4	10	2	1	387.09	774.18	15	1	0.514705882352941	-4	1	-0.380952380952381	3	14
ANGPTL7	3	15	1	1	345.51	691.02	15	1	0.368421052631579	-4	1	-0.333333333333333	2	18
ANK1	15	81	4	6	2053.92	4107.84	15	1	0.0770083354233338	-2.6	0.922367800589409	-0.24375	10	96
ANK2	79	183	24	37	3867.6	7735.2	15	1	0.172561038834091	-0.502565856996237	1	-0.0919159053935678	61	262
ANK3	24	88	12	21	4614.06	9228.12	15	1	0.107685024239322	-1.0952380952381	0.983875031494079	-0.149350649350649	33	112
ANKDD1A	9	21	3	4	499.95	999.9	15	1	0.65940561054413	-0.75	1	-0.128571428571429	7	30
ANKDD1B	13	24	3	5	531.63	1063.26	15	1	1	-0.107692307692308	1	-0.0236486486486486	8	37
ANKEF1	28	40	10	5	764.28	1528.56	15	1	0.0905570207907762	-1.85714285714286	0.953786405978059	-0.254901960784314	15	68
ANKFN1	10	18	4	2	1067.88	2135.76	15	1	0.202239713763956	-2.6	1	-0.309523809523809	6	28
ANKFN1L	11	27	4	19	1069.2	2138.4	15	1	0.371256092842225	0.483253588516746	1	0.115560640732265	23	38
ANKFY1	7	34	0	8	1153.02	2306.04	15	1	0.581247270682118	1	1	0.170731707317073	8	41
ANKH	5	18	0	1	481.8	963.6	15	1	1	1	1	0.217391304347826	1	23
ANKHD1	2	55	1	7	2022.24	4044.48	15	1	0.330128205128205	-2.92857142857143	1	-0.0899122807017544	8	57
ANKIB1	4	25	2	6	1084.05	2168.1	15	1	0.591342679577974	-1.08333333333333	1	-0.112068965517241	8	29
ANKK1	17	37	9	7	763.29	1526.58	15	1	0.0850107657822194	-1.79831932773109	0.950356516076024	-0.247685185185185	16	54
ANKLE1	24	12	11	13	300.3	600.6	15	1	0.120412998722008	0.576923076923077	1	0.208333333333333	24	36
ANKLE2	19	36	5	6	911.79	1823.58	15	1	0.510685014469166	-0.578947368421053	1	-0.109090909090909	11	55
ANKMY2	6	13	2	1	454.08	908.16	15	1	0.527272727272727	-3.33333333333333	1	-0.350877192982456	3	19
ANKRA2	1	13	0	1	252.12	504.24	15	1	1	1	1	0.0714285714285714	1	14
ANKRD1	8	12	0	1	316.8	633.6	15	1	1	1	1	0.4	1	20
ANKRD10	4	6	1	2	295.02	590.04	15	1	1	0.25	1	0.0666666666666667	3	10
ANKRD11	15	92	10	31	2685.87	5371.74	15	1	0.146111193355376	-0.978494623655914	1	-0.10371552313654	41	107
ANKRD12	31	68	11	16	1923.24	3846.48	15	1	0.366194869511659	-0.508064516129032	1	-0.0942760942760942	27	99
ANKRD13A	4	25	3	5	552.42	1104.84	15	1	0.156320370741623	-2.75	1	-0.237068965517241	8	29
ANKRD13C	0	2	0	2	381.15	762.3	15	1	1	NA	1	0	2	2
ANKRD17	11	82	4	13	2413.62	4827.24	15	1	0.244384035020478	-1.29370629370629	1	-0.117014547754586	17	93
ANKRD2	3	7	6	6	261.03	522.06	15	1	0.414860681114551	-1.33333333333333	1	-0.2	12	10
ANKRD22	4	4	2	2	190.08	380.16	15	1	1	0	1	0	4	8
ANKRD24	12	13	8	9	404.91	809.82	15	1	1	0.0370370370370371	1	0.00941176470588234	17	25
ANKRD26	81	79	23	8	2074.05	4148.1	15	1	0.0181538439027595	-1.80401234567901	0.677255339142531	-0.235685483870968	31	160
ANKRD27	41	34	2	0	1087.02	2174.04	15	1	0.500341763499658	-Inf	1	-0.453333333333333	2	75
ANKRD28	11	30	4	10	1064.91	2129.82	15	1	1	-0.0909090909090908	1	-0.0174216027874564	14	41
ANKRD29	0	6	2	2	292.05	584.1	15	1	0.133333333333333	-Inf	1	-0.5	4	6
ANKRD31	119	52	16	6	1497.54	2995.08	15	1	1	-0.165266106442577	1	-0.0313662945241893	22	171
ANKRD33	14	16	9	9	390.39	780.78	15	1	1	-0.142857142857143	1	-0.0333333333333333	18	30
ANKRD33B	7	19	1	6	397.65	795.3	15	1	0.651773575577802	0.547619047619048	1	0.126373626373626	7	26
ANKRD34C	12	7	6	3	461.01	922.02	15	1	1	-0.166666666666667	1	-0.0350877192982456	9	19
ANKRD40	5	13	2	3	338.58	677.16	15	1	0.621385479509049	-0.733333333333333	1	-0.122222222222222	5	18
ANKRD40L	18	17	6	3	321.09	642.18	15	1	0.477131566751533	-0.888888888888889	1	-0.152380952380952	9	35
ANKRD46	0	13	0	2	226.71	453.42	15	1	1	NA	1	0	2	13
ANKRD49	3	20	0	4	241.56	483.12	15	1	1	1	1	0.130434782608696	4	23
ANKRD50	4	44	2	11	1403.82	2807.64	15	1	0.599103055086241	-1	1	-0.0705128205128205	13	48
ANKRD52	0	18	1	8	1021.02	2042.04	15	1	0.333333333333333	-Inf	1	-0.111111111111111	9	18
ANKRD54	0	10	1	4	219.78	439.56	15	1	0.333333333333333	-Inf	1	-0.2	5	10
ANKRD55	11	20	2	2	655.71	1311.42	15	1	0.617647058823529	-0.818181818181818	1	-0.145161290322581	4	31
ANKRD6	11	47	5	9	811.47	1622.94	15	1	0.279857575227267	-1.37373737373737	1	-0.167487684729064	14	58
ANKRD60	13	5	0	0	251.46	502.92	15	1	1	NA	1	NA	0	18
ANKRD66	7	11	0	3	176.22	352.44	15	1	0.521052631578947	1	1	0.388888888888889	3	18
ANKRD9	6	9	5	3	277.86	555.72	15	1	0.400323058285099	-1.5	1	-0.225	8	15
ANKRD9L	0	6	0	1	294.03	588.06	15	1	1	NA	1	0	1	6
ANKS1A	8	34	6	14	1018.38	2036.76	15	1	0.349286496139908	-0.821428571428571	1	-0.10952380952381	20	42
ANKS1B	2	26	1	0	628.32	1256.64	15	1	0.103448275862069	-Inf	0.983165897366278	-0.928571428571429	1	28
ANKS4B	12	14	2	0	400.95	801.9	15	1	0.481481481481482	-Inf	1	-0.538461538461538	2	26
ANKS6	22	39	1	4	1014.42	2028.84	15	1	0.65063240970499	0.556818181818182	1	0.160655737704918	5	61
ANKZF1	25	13	9	5	693	1386	15	1	1	0.0639999999999999	1	0.0150375939849624	14	38
ANLN	40	30	4	2	1080.09	2160.18	15	1	1	-0.5	1	-0.0952380952380952	6	70
ANO1	5	30	1	6	966.9	1933.8	15	1	1	0	1	0	7	35
ANO10	3	22	3	2	544.5	1089	15	1	0.0413035240621448	-10	0.798931947804628	-0.48	5	25
ANO4	5	23	2	2	944.46	1888.92	15	1	0.200500556173526	-3.6	1	-0.321428571428571	4	28
ANO5	2	35	0	1	884.73	1769.46	15	1	1	1	1	0.0540540540540541	1	37
ANO6	6	32	3	3	849.42	1698.84	15	1	0.0891400148348532	-4.33333333333333	0.953786405978059	-0.342105263157895	6	38
ANO8	3	14	3	12	608.85	1217.7	15	1	1	-0.166666666666667	1	-0.0235294117647059	15	17
ANO9	13	33	4	7	749.1	1498.2	15	1	0.716571494113503	-0.450549450549451	1	-0.0810276679841898	11	46
ANOS1	20	29	2	4	720.72	1441.44	15	1	1	0.275	1	0.0748299319727891	6	49
ANP32A	0	5	0	3	233.97	467.94	15	1	1	NA	1	0	3	5
ANP32E	0	12	0	2	238.59	477.18	15	1	1	NA	1	0	2	12
ANPEP	50	40	5	16	917.4	1834.8	15	1	0.0141102108888058	0.75	0.628451090139802	0.317460317460317	21	90
ANTXR2	1	10	0	3	422.07	844.14	15	1	1	1	1	0.0909090909090909	3	11
ANTXRL	1	13	0	1	483.45	966.9	15	1	1	1	1	0.0714285714285714	1	14
ANXA1	5	15	1	0	337.59	675.18	15	1	0.285714285714286	-Inf	1	-0.75	1	20
ANXA10	3	10	1	2	297	594	15	1	1	-0.666666666666667	1	-0.102564102564103	3	13
ANXA11	3	24	3	0	543.84	1087.68	15	1	0.00492610837438424	-Inf	0.460299276725364	-0.888888888888889	3	27
ANXA13	15	11	7	3	401.28	802.56	15	1	0.706170436287233	-0.711111111111111	1	-0.123076923076923	10	26
ANXA2	0	9	1	0	336.6	673.2	15	1	0.1	-Inf	0.971353639774823	-1	1	9
ANXA5	1	16	0	1	318.78	637.56	15	1	1	1	1	0.0588235294117647	1	17
ANXA6	5	20	8	17	600.27	1200.54	15	1	0.520194749554762	-0.882352941176471	1	-0.12	25	25
ANXA7	4	9	0	5	448.47	896.94	15	1	0.277777777777778	1	1	0.307692307692308	5	13
ANXA8	2	9	2	5	323.73	647.46	15	1	1	-0.8	1	-0.103896103896104	7	11
AOAH	11	30	2	2	559.68	1119.36	15	1	0.567233799791939	-1.72727272727273	1	-0.231707317073171	4	41
AOC1	15	19	13	15	706.2	1412.4	15	1	1	-0.0977777777777777	1	-0.023109243697479	28	34
AOC3	30	48	25	46	1314.72	2629.44	15	1	0.735403204399712	0.130434782608696	1	0.0325027085590466	71	78
AOX2	56	42	16	14	1487.31	2974.62	15	1	0.833828382627466	0.142857142857143	1	0.0380952380952381	30	98
AP1AR	7	15	1	2	277.2	554.4	15	1	1	-0.0714285714285714	1	-0.0151515151515151	3	22
AP1B1	0	19	2	25	702.9	1405.8	15	1	0.504347826086957	-Inf	1	-0.0740740740740741	27	19
AP1M1	0	23	0	6	415.14	830.28	15	1	1	NA	1	0	6	23
AP1S2	2	4	0	1	147.51	295.02	15	1	1	1	1	0.333333333333333	1	6
AP1S3	2	2	0	0	153.45	306.9	15	1	1	NA	1	NA	0	4
AP2A2	0	16	0	2	853.05	1706.1	15	1	1	NA	1	0	2	16
AP2B1	1	36	0	12	940.5	1881	15	1	1	1	1	0.027027027027027	12	37
AP2M1	0	17	0	4	429.66	859.32	15	1	1	NA	1	0	4	17
AP3B2	6	6	1	0	1186.68	2373.36	15	1	1	-Inf	1	-0.5	1	12
AP3D1	9	48	2	2	1247.07	2494.14	15	1	0.145548092861044	-4.33333333333333	1	-0.342105263157895	4	57
AP3M1	0	17	1	3	414.81	829.62	15	1	0.19047619047619	-Inf	1	-0.25	4	17
AP3M2	3	10	0	0	384.12	768.24	15	1	1	NA	1	NA	0	13
AP3S1	0	3	1	2	169.29	338.58	15	1	1	-Inf	1	-0.333333333333333	3	3
AP3S2	0	7	0	4	150.81	301.62	15	1	1	NA	1	0	4	7
AP4B1	10	24	0	0	585.42	1170.84	15	1	1	NA	1	NA	0	34
AP4E1	28	54	12	11	1045.11	2090.22	15	1	0.146458849304898	-1.1038961038961	1	-0.180275715800636	23	82
AP4S1	1	3	0	0	139.59	279.18	15	1	1	NA	1	NA	0	4
AP5M1	5	18	7	5	479.82	959.64	15	1	0.0587413700827298	-4.04	0.862540555837651	-0.365942028985507	12	23
AP5Z1	13	36	6	7	799.92	1599.84	15	1	0.191961538860101	-1.37362637362637	1	-0.196232339089482	13	49
APAF1	17	51	1	6	1235.52	2471.04	15	1	1	0.5	1	0.107142857142857	7	68
APBA1	5	33	5	1	765.27	1530.54	15	1	0.00124350975173437	-32	0.254177858674395	-0.701754385964912	6	38
APBA2	3	20	0	5	736.56	1473.12	15	1	1	1	1	0.130434782608696	5	23
APBA3	8	33	6	14	568.26	1136.52	15	1	0.51745355695712	-0.767857142857143	1	-0.104878048780488	20	41
APBB1	6	20	2	4	461.01	922.02	15	1	0.624768261030775	-0.666666666666667	1	-0.102564102564103	6	26
APBB1IP	28	30	3	4	736.23	1472.46	15	1	1	0.196428571428571	1	0.0541871921182266	7	58
APBB2	17	30	5	8	826.65	1653.3	15	1	1	-0.102941176470588	1	-0.0229132569558101	13	47
APBB3	6	18	0	6	366.63	733.26	15	1	0.302068965517241	1	1	0.25	6	24
APC	11	83	2	6	2781.9	5563.8	15	1	0.269483141865074	-1.51515151515152	1	-0.132978723404255	8	94
APC2	20	37	27	35	1716.99	3433.98	15	1	0.356189822749258	-0.427142857142857	1	-0.0846066779852858	62	57
APCDD1	1	18	0	4	507.87	1015.74	15	1	1	1	1	0.0526315789473684	4	19
APCDD1L	2	12	1	2	202.95	405.9	15	1	0.464705882352941	-2	1	-0.19047619047619	3	14
APEH	4	7	1	4	93.39	186.78	15	1	1	0.5625	1	0.163636363636364	5	11
APH1AL	2	8	0	2	174.57	349.14	15	1	1	1	1	0.2	2	10
API5	2	18	0	2	518.1	1036.2	15	1	1	1	1	0.1	2	20
APIP	1	6	0	0	214.17	428.34	15	1	1	NA	1	NA	0	7
APLF	26	15	6	1	491.04	982.08	15	1	0.398298541641269	-2.46153846153846	1	-0.222996515679442	7	41
APMAP	5	11	3	0	381.48	762.96	15	1	0.0577915376676986	-Inf	0.855882036379291	-0.6875	3	16
APOA1	0	3	0	3	191.4	382.8	15	1	1	NA	1	0	3	3
APOA1BP	18	30	9	14	554.73	1109.46	15	1	1	-0.0714285714285714	1	-0.016304347826087	23	48
APOA2	1	0	0	1	83.49	166.98	15	1	1	1	1	1	1	1
APOA4	1	2	2	2	184.14	368.28	15	1	1	-1	1	-0.166666666666667	4	3
APOB	95	126	13	12	4636.5	9273	15	1	0.403529743627206	-0.436842105263158	1	-0.0901357466063348	25	221
APOBEC2	5	7	8	1	264.33	528.66	15	1	0.0668730650154799	-10.2	0.884435842948953	-0.472222222222222	9	12
APOD	3	11	4	2	188.1	376.2	15	1	0.121929824561404	-6.33333333333333	1	-0.452380952380952	6	14
APOH	3	18	3	4	347.49	694.98	15	1	0.144258639910814	-3.5	1	-0.285714285714286	7	21
APOLD1	2	6	1	3	232.65	465.3	15	1	1	0	1	0	4	8
APOO	5	3	3	1	220.77	441.54	15	1	1	-0.8	1	-0.125	4	8
APOOL	16	19	4	1	267.3	534.6	15	1	0.341649341649342	-3.75	1	-0.342857142857143	5	35
APOV1	1	5	0	1	105.93	211.86	15	1	1	1	1	0.166666666666667	1	6
APP	0	26	1	6	726.66	1453.32	15	1	0.212121212121212	-Inf	1	-0.142857142857143	7	26
APPBP2	0	14	0	4	534.27	1068.54	15	1	1	NA	1	0	4	14
APPL2	3	34	1	6	634.59	1269.18	15	1	0.513484246893209	-0.888888888888889	1	-0.0617760617760618	7	37
APRT	2	5	0	3	143.22	286.44	15	1	1	1	1	0.285714285714286	3	7
APTX	17	10	0	0	294.36	588.72	15	1	1	NA	1	NA	0	27
AQP1	1	9	0	0	254.76	509.52	15	1	1	NA	1	NA	0	10
AQP10	1	8	3	6	231.66	463.32	15	1	0.576470588235294	-3	1	-0.222222222222222	9	9
AQP11	8	17	5	3	258.39	516.78	15	1	0.213376815990832	-2.54166666666667	1	-0.305	8	25
AQP12A	10	10	7	3	297.99	595.98	15	1	0.440413126769948	-1.33333333333333	1	-0.2	10	20
AQP2	0	11	2	0	273.24	546.48	15	1	0.0128205128205128	-Inf	0.61231737012987	-1	2	11
AQP3	0	7	1	0	290.07	580.14	15	1	0.125	-Inf	1	-1	1	7
AQP4	2	10	1	2	331.98	663.96	15	1	0.516483516483516	-1.5	1	-0.166666666666667	3	12
AQP5	0	16	0	4	263.34	526.68	15	1	1	NA	1	0	4	16
AQP7	13	16	2	0	281.16	562.32	15	1	0.225806451612903	-Inf	1	-0.551724137931034	2	29
AQP8	8	15	4	9	256.41	512.82	15	1	1	0.166666666666667	1	0.040133779264214	13	23
AQP9	4	12	0	1	285.12	570.24	15	1	1	1	1	0.25	1	16
AQR	40	89	4	3	2160.18	4320.36	15	1	0.212697213951513	-1.96666666666667	1	-0.261351052048726	7	129
AR	0	20	0	1	391.05	782.1	15	1	1	NA	1	0	1	20
ARAP2	51	43	9	6	1637.46	3274.92	15	1	0.783552530205499	-0.264705882352941	1	-0.0574468085106383	15	94
ARC	0	12	1	4	400.95	801.9	15	1	0.294117647058824	-Inf	1	-0.2	5	12
AREG	0	5	0	1	183.81	367.62	15	1	1	NA	1	0	1	5
AREL1	1	19	2	1	799.59	1599.18	15	1	0.0344438170525127	-37	0.788199921465956	-0.616666666666667	3	20
ARF1	0	9	0	2	180.18	360.36	15	1	1	NA	1	0	2	9
ARF4	0	3	0	0	175.56	351.12	15	1	1	NA	1	NA	0	3
ARF6	0	4	2	4	164.34	328.68	15	1	0.466666666666667	-Inf	1	-0.333333333333333	6	4
ARFGAP1	1	10	2	2	418.77	837.54	15	1	0.153846153846154	-9	1	-0.409090909090909	4	11
ARFGAP2	4	14	1	4	487.41	974.82	15	1	1	0.125	1	0.0222222222222222	5	18
ARFGAP3	16	16	1	0	507.87	1015.74	15	1	1	-Inf	1	-0.5	1	32
ARFGEF1	6	49	3	8	1787.61	3575.22	15	1	0.164841762527658	-2.0625	1	-0.163636363636364	11	55
ARFGEF2	5	71	0	6	1810.71	3621.42	15	1	1	1	1	0.0657894736842105	6	76
ARFGEF3	12	76	7	17	2158.86	4317.72	15	1	0.120280866519046	-1.6078431372549	1	-0.15530303030303	24	88
ARFIP1	4	9	0	2	399.96	799.92	15	1	1	1	1	0.307692307692308	2	13
ARFRP1	9	13	3	5	267.63	535.26	15	1	1	0.133333333333333	1	0.0340909090909091	8	22
ARG2	0	18	0	0	314.82	629.64	15	1	1	NA	1	NA	0	18
ARHGAP1	3	13	1	4	433.62	867.24	15	1	1	-0.0833333333333333	1	-0.0125	5	16
ARHGAP10	8	27	3	2	807.51	1615.02	15	1	0.11705328810592	-4.0625	1	-0.371428571428571	5	35
ARHGAP11A	63	32	1	2	992.31	1984.62	15	1	0.27540500736377	0.746031746031746	1	0.329824561403509	3	95
ARHGAP12	9	23	3	3	895.95	1791.9	15	1	0.356658737463691	-1.55555555555556	1	-0.21875	6	32
ARHGAP15	0	1	1	0	145.53	291.06	15	1	1	-Inf	1	-1	1	1
ARHGAP17	13	19	5	3	845.79	1691.58	15	1	0.429521829521829	-1.43589743589744	1	-0.21875	8	32
ARHGAP18	14	21	3	2	651.42	1302.84	15	1	0.633961897119792	-1.25	1	-0.2	5	35
ARHGAP19	5	19	1	6	476.19	952.38	15	1	1	0.366666666666667	1	0.0654761904761905	7	24
ARHGAP20	4	25	8	12	883.08	1766.16	15	1	0.0480089907358885	-3.16666666666667	0.829468895324472	-0.262068965517241	20	29
ARHGAP21	22	61	11	11	1972.08	3944.16	15	1	0.0421392489421515	-1.77272727272727	0.807456060329624	-0.234939759036145	22	83
ARHGAP22	6	20	5	4	589.05	1178.1	15	1	0.102636449462989	-3.16666666666667	0.981633870854417	-0.324786324786325	9	26
ARHGAP23	5	16	7	17	829.62	1659.24	15	1	0.746046181440396	-0.317647058823529	1	-0.0535714285714286	24	21
ARHGAP24	3	22	0	4	648.45	1296.9	15	1	1	1	1	0.12	4	25
ARHGAP25	13	43	2	2	1053.03	2106.06	15	1	0.257959334338183	-2.30769230769231	1	-0.267857142857143	4	56
ARHGAP26	2	14	1	10	653.4	1306.8	15	1	1	0.3	1	0.0340909090909091	11	16
ARHGAP27	16	52	1	0	606.21	1212.42	15	1	0.246376811594203	-Inf	1	-0.764705882352941	1	68
ARHGAP28	4	28	5	1	663.96	1327.92	15	1	0.00135401373791467	-34	0.263595900268226	-0.708333333333333	6	32
ARHGAP29	33	53	9	12	1336.5	2673	15	1	0.804401649640861	-0.204545454545455	1	-0.0448504983388704	21	86
ARHGAP32	58	117	9	13	1859.88	3719.76	15	1	0.481096363436346	-0.396551724137931	1	-0.0776623376623377	22	175
ARHGAP36	7	22	0	4	473.22	946.44	15	1	0.555229716520039	1	1	0.241379310344828	4	29
ARHGAP39	19	37	5	9	945.78	1891.56	15	1	1	-0.0818713450292399	1	-0.0178571428571428	14	56
ARHGAP39L	14	22	5	22	1100.88	2201.76	15	1	0.101401184689376	0.642857142857143	0.975691437149951	0.203703703703704	27	36
ARHGAP40	9	24	2	8	654.39	1308.78	15	1	1	0.333333333333333	1	0.0727272727272727	10	33
ARHGAP42	1	18	2	2	648.45	1296.9	15	1	0.0666290231507622	-17	0.884435842948953	-0.447368421052632	4	19
ARHGAP44	1	18	1	6	526.68	1053.36	15	1	0.473846153846154	-2	1	-0.0902255639097744	7	19
ARHGAP45	45	35	5	13	624.03	1248.06	15	1	0.0375110098274762	0.700854700854701	0.789311843512415	0.284722222222222	18	80
ARHGAP5	8	62	0	9	1490.94	2981.88	15	1	0.586451683081327	1	1	0.114285714285714	9	70
ARHGAP8	13	2	0	0	207.24	414.48	15	1	1	NA	1	NA	0	15
ARHGDIA	1	9	0	1	202.95	405.9	15	1	1	1	1	0.1	1	10
ARHGDIB	0	8	0	0	198.99	397.98	15	1	1	NA	1	NA	0	8
ARHGEF1	36	51	6	15	1155.33	2310.66	15	1	0.327069143112873	0.433333333333333	1	0.12807881773399	21	87
ARHGEF10	16	53	4	6	1323.96	2647.92	15	1	0.263165366316613	-1.20833333333333	1	-0.168115942028986	10	69
ARHGEF10L	7	34	7	23	906.18	1812.36	15	1	0.556910933632769	-0.478260869565217	1	-0.0626016260162602	30	41
ARHGEF11	7	16	7	15	829.62	1659.24	15	1	1	-0.0666666666666667	1	-0.0138339920948616	22	23
ARHGEF12	11	56	9	7	1543.74	3087.48	15	1	0.00206437610150831	-5.54545454545455	0.327855520331649	-0.398320895522388	16	67
ARHGEF16	12	41	8	9	644.16	1288.32	15	1	0.0679764096174077	-2.03703703703704	0.887960242513107	-0.244173140954495	17	53
ARHGEF17	4	13	3	15	780.12	1560.24	15	1	0.690565274547477	0.35	1	0.0686274509803922	18	17
ARHGEF18	20	45	11	24	1557.27	3114.54	15	1	1	-0.03125	1	-0.00659340659340657	35	65
ARHGEF26	35	53	9	9	941.16	1882.32	15	1	0.442829349608987	-0.514285714285714	1	-0.102272727272727	18	88
ARHGEF28	62	86	8	9	1744.71	3489.42	15	1	0.796931326029002	-0.232974910394265	1	-0.0516693163751987	17	148
ARHGEF3	15	18	3	1	506.88	1013.76	15	1	0.33976833976834	-2.6	1	-0.295454545454545	4	33
ARHGEF33	2	23	38	14	803.88	1607.76	15	1	6.26800527561164e-08	-30.2142857142857	0.000756548236766325	-0.650769230769231	52	25
ARHGEF37	36	52	2	0	670.89	1341.78	15	1	0.175530586766542	-Inf	1	-0.590909090909091	2	88
ARHGEF38	13	22	0	4	792.66	1585.32	15	1	0.280859807175597	1	1	0.371428571428571	4	35
ARHGEF39	8	12	2	0	314.49	628.98	15	1	0.194805194805195	-Inf	1	-0.6	2	20
ARHGEF4	68	56	10	12	1652.31	3304.62	15	1	0.489694481209768	0.313725490196078	1	0.093841642228739	22	124
ARHGEF5	79	53	4	3	1716	3432	15	1	1	0.105485232067511	1	0.0270562770562771	7	132
ARHGEF6	6	24	1	4	745.47	1490.94	15	1	1	0	1	0	5	30
ARHGEF7	4	21	3	6	766.59	1533.18	15	1	0.348172806386181	-1.625	1	-0.173333333333333	9	25
ARHGEF9	3	8	0	2	522.72	1045.44	15	1	1	1	1	0.272727272727273	2	11
ARID1A	15	56	8	12	2015.31	4030.62	15	1	0.142467112776034	-1.48888888888889	1	-0.188732394366197	20	71
ARID1B	2	21	0	5	1091.64	2183.28	15	1	1	1	1	0.0869565217391304	5	23
ARID2	8	32	2	5	1841.73	3683.46	15	1	0.630350041426108	-0.6	1	-0.0857142857142857	7	40
ARID3A	1	10	3	8	351.78	703.56	15	1	0.586466165413534	-2.75	1	-0.181818181818182	11	11
ARID3B	4	31	3	8	551.43	1102.86	15	1	0.332840102920746	-1.90625	1	-0.158441558441558	11	35
ARID3C	3	12	2	0	307.89	615.78	15	1	0.0735294117647059	-Inf	0.913861472365723	-0.8	2	15
ARID4A	12	34	1	3	1282.38	2564.76	15	1	1	0.0555555555555556	1	0.0108695652173913	4	46
ARID4B	13	39	3	6	1347.72	2695.44	15	1	0.685986122551496	-0.5	1	-0.0833333333333333	9	52
ARID5A	5	12	7	6	277.86	555.72	15	1	0.264122224601985	-1.8	1	-0.244343891402715	13	17
ARID5B	45	61	12	14	1453.32	2906.64	15	1	0.826089013372819	-0.161904761904762	1	-0.0370101596516691	26	106
ARIH1	0	7	0	5	428.67	857.34	15	1	1	NA	1	0	5	7
ARIH2	0	6	0	0	486.09	972.18	15	1	1	NA	1	NA	0	6
ARL1	0	8	0	2	178.86	357.72	15	1	1	NA	1	0	2	8
ARL10	4	6	0	5	159.72	319.44	15	1	0.230769230769231	1	1	0.4	5	10
ARL11	3	8	2	2	164.01	328.02	15	1	0.56043956043956	-1.66666666666667	1	-0.227272727272727	4	11
ARL13A	10	9	2	0	265.65	531.3	15	1	0.485714285714286	-Inf	1	-0.473684210526316	2	19
ARL13B	3	2	0	0	141.57	283.14	15	1	1	NA	1	NA	0	5
ARL14	5	11	2	1	193.05	386.1	15	1	0.523219814241486	-3.4	1	-0.354166666666667	3	16
ARL14EP	2	11	0	5	284.13	568.26	15	1	1	1	1	0.153846153846154	5	13
ARL14EPL	5	3	0	0	156.42	312.84	15	1	1	NA	1	NA	0	8
ARL15	14	14	6	1	250.8	501.6	15	1	0.198679608358664	-5	1	-0.357142857142857	7	28
ARL16	5	3	3	3	94.38	188.76	15	1	1	0.4	1	0.125	6	8
ARL2	4	16	1	2	199.32	398.64	15	1	0.539243365330322	-1	1	-0.133333333333333	3	20
ARL4A	0	9	0	0	198.99	397.98	15	1	1	NA	1	NA	0	9
ARL4C	0	7	0	3	191.07	382.14	15	1	1	NA	1	0	3	7
ARL5A	0	3	0	1	163.02	326.04	15	1	1	NA	1	0	1	3
ARL5B	0	13	0	0	151.47	302.94	15	1	1	NA	1	NA	0	13
ARL6	3	5	1	1	185.13	370.26	15	1	1	-0.666666666666667	1	-0.125	2	8
ARL6IP1	3	5	1	1	282.15	564.3	15	1	1	-0.666666666666667	1	-0.125	2	8
ARL6IP4	5	15	2	3	214.5	429	15	1	0.596837944664032	-1	1	-0.15	5	20
ARL6IP5	2	7	0	0	177.54	355.08	15	1	1	NA	1	NA	0	9
ARL8A	0	3	0	1	122.43	244.86	15	1	1	NA	1	0	1	3
ARL8B	0	3	0	0	144.54	289.08	15	1	1	NA	1	NA	0	3
ARL8BL	0	2	0	0	144.54	289.08	15	1	1	NA	1	NA	0	2
ARMC1	1	8	0	2	277.2	554.4	15	1	1	1	1	0.111111111111111	2	9
ARMC10	9	15	2	2	250.47	500.94	15	1	1	-0.666666666666667	1	-0.125	4	24
ARMC2	23	32	7	4	802.23	1604.46	15	1	0.205791559501513	-1.43478260869565	1	-0.218181818181818	11	55
ARMC3	28	27	4	6	854.37	1708.74	15	1	0.733016256202521	0.357142857142857	1	0.109090909090909	10	55
ARMC4	16	38	2	9	1005.84	2011.68	15	1	0.713321188776239	0.472222222222222	1	0.114478114478114	11	54
ARMC6	3	27	4	6	462.33	924.66	15	1	0.0519557423582192	-5	0.843251957917679	-0.3	10	30
ARMC7	1	7	2	2	181.17	362.34	15	1	0.236363636363636	-6	1	-0.375	4	8
ARMC8	1	15	0	3	652.41	1304.82	15	1	1	1	1	0.0625	3	16
ARMC9	24	32	10	8	841.5	1683	15	1	0.419698389485459	-0.666666666666667	1	-0.126984126984127	18	56
ARMT1	13	17	1	0	423.06	846.12	15	1	0.451612903225806	-Inf	1	-0.566666666666667	1	30
ARNT	5	18	6	0	764.94	1529.88	15	1	0.000972590627763039	-Inf	0.248251522554939	-0.782608695652174	6	23
ARNT2	2	22	1	1	714.45	1428.9	15	1	0.221538461538462	-10	1	-0.416666666666667	2	24
ARNTL	3	18	2	4	664.95	1329.9	15	1	0.303121516164994	-2	1	-0.19047619047619	6	21
ARNTL2	14	20	1	2	577.5	1155	15	1	1	0.285714285714286	1	0.0784313725490196	3	34
ARPC1A	1	8	0	2	367.29	734.58	15	1	1	1	1	0.111111111111111	2	9
ARPC1B	2	2	0	2	165.33	330.66	15	1	0.466666666666667	1	1	0.5	2	4
ARPC2	0	11	0	2	273.57	547.14	15	1	1	NA	1	0	2	11
ARPC5	0	3	1	1	82.83	165.66	15	1	0.4	-Inf	1	-0.5	2	3
ARPC5L	1	10	1	2	79.2	158.4	15	1	0.395604395604396	-4	1	-0.242424242424242	3	11
ARPP19	0	3	0	0	111.87	223.74	15	1	1	NA	1	NA	0	3
ARPP21	15	26	2	1	748.44	1496.88	15	1	0.549456357595893	-2.46666666666667	1	-0.300813008130081	3	41
ARR3	1	14	2	9	329.34	658.68	15	1	0.555769230769231	-2.11111111111111	1	-0.115151515151515	11	15
ARRDC1	0	22	0	3	396	792	15	1	1	NA	1	0	3	22
ARRDC2	1	13	2	3	310.53	621.06	15	1	0.154798761609907	-7.66666666666667	1	-0.328571428571429	5	14
ARRDC3	0	4	1	1	370.92	741.84	15	1	0.333333333333333	-Inf	1	-0.5	2	4
ARRDC4	1	5	0	0	313.5	627	15	1	1	NA	1	NA	0	6
ARSA	5	22	1	1	442.86	885.72	15	1	0.376847290640394	-3.4	1	-0.314814814814815	2	27
ARSB	14	15	3	4	500.94	1001.88	15	1	1	0.196428571428571	1	0.0541871921182266	7	29
ARSE	27	28	2	6	841.17	1682.34	15	1	0.269576391480184	0.654320987654321	1	0.240909090909091	8	55
ARSG	21	23	9	19	501.6	1003.2	15	1	0.226452626610895	0.481203007518797	1	0.155844155844156	28	44
ARSH	34	21	2	1	576.51	1153.02	15	1	1	-0.235294117647059	1	-0.0484848484848485	3	55
ARSI	2	26	3	16	542.19	1084.38	15	1	0.381187257120394	-1.4375	1	-0.0864661654135338	19	28
ARSJ	3	44	3	7	582.12	1164.24	15	1	0.0602085765938796	-5.28571428571429	0.870851370851371	-0.236170212765957	10	47
ART4	8	5	6	1	298.98	597.96	15	1	0.354360165118679	-2.75	1	-0.241758241758242	7	13
ARTN	6	6	2	5	214.5	429	15	1	0.633246010954989	0.6	1	0.214285714285714	7	12
ARV1	3	6	4	2	202.29	404.58	15	1	0.314685314685315	-3	1	-0.333333333333333	6	9
ARVCF	5	42	3	11	936.54	1873.08	15	1	0.369199057724858	-1.29090909090909	1	-0.10790273556231	14	47
ARX	0	4	0	1	121.77	243.54	15	1	1	NA	1	0	1	4
AS3MT	7	32	2	8	525.69	1051.38	15	1	1	-0.142857142857143	1	-0.0205128205128205	10	39
ASAH1	6	15	1	3	392.7	785.4	15	1	1	0.166666666666667	1	0.0357142857142857	4	21
ASAH2	29	43	2	1	732.6	1465.2	15	1	0.565701592002962	-1.96551724137931	1	-0.263888888888889	3	72
ASAP1	11	32	3	5	1164.57	2329.14	15	1	0.667764415664508	-0.745454545454545	1	-0.119186046511628	8	43
ASAP2	23	41	1	10	1071.84	2143.68	15	1	0.0934762825646052	0.821739130434783	0.958791526417971	0.268465909090909	11	64
ASAP3	1	1	1	5	263.01	526.02	15	1	0.464285714285714	0.8	1	0.333333333333333	6	2
ASB1	1	25	5	5	318.45	636.9	15	1	0.00347162325340694	-24	0.414682332734186	-0.461538461538462	10	26
ASB10	10	23	4	5	427.68	855.36	15	1	0.450806239298273	-0.84	1	-0.141414141414141	9	33
ASB11	6	11	1	3	319.77	639.54	15	1	1	0.388888888888889	1	0.102941176470588	4	17
ASB12	3	12	4	7	315.15	630.3	15	1	0.406521739130435	-1.28571428571429	1	-0.163636363636364	11	15
ASB14	9	9	1	0	122.1	244.2	15	1	1	-Inf	1	-0.5	1	18
ASB15	11	22	6	2	586.08	1172.16	15	1	0.048586020601425	-5	0.833370237838852	-0.416666666666667	8	33
ASB2	2	20	0	3	606.87	1213.74	15	1	1	1	1	0.0909090909090909	3	22
ASB3	12	27	4	5	487.08	974.16	15	1	0.456581818792394	-0.8	1	-0.136752136752137	9	39
ASB4	6	15	2	4	431.64	863.28	15	1	1	-0.25	1	-0.0476190476190476	6	21
ASB5	6	8	0	1	297.33	594.66	15	1	1	1	1	0.428571428571429	1	14
ASB6	13	28	5	6	417.12	834.24	15	1	0.482199393569756	-0.794871794871795	1	-0.137472283813747	11	41
ASB7	0	1	0	1	315.81	631.62	15	1	1	NA	1	0	1	1
ASB9	6	15	0	1	250.8	501.6	15	1	1	1	1	0.285714285714286	1	21
ASCC2	11	27	7	2	685.74	1371.48	15	1	0.0177985294960134	-7.59090909090909	0.677255339142531	-0.488304093567251	9	38
ASCC3	14	50	2	3	1733.49	3466.98	15	1	0.327768273258215	-1.38095238095238	1	-0.18125	5	64
ASCL4	5	11	1	3	187.11	374.22	15	1	1	0.266666666666667	1	0.0625	4	16
ASF1A	0	6	0	1	168.96	337.92	15	1	1	NA	1	0	1	6
ASH1L	21	93	7	12	2952.18	5904.36	15	1	0.12360370926258	-1.58333333333333	1	-0.184210526315789	19	114
ASH2L	0	26	2	5	538.56	1077.12	15	1	0.0397727272727273	-Inf	0.795233318314363	-0.285714285714286	7	26
ASIC1	4	20	1	14	724.35	1448.7	15	1	0.630885946675421	0.642857142857143	1	0.1	15	24
ASIC2	8	16	0	0	411.84	823.68	15	1	1	NA	1	NA	0	24
ASIC4	1	2	1	4	262.68	525.36	15	1	1	0.5	1	0.133333333333333	5	3
ASIC5	5	12	0	0	499.95	999.9	15	1	1	NA	1	NA	0	17
ASL2	7	23	4	2	931.26	1862.52	15	1	0.0569937652480347	-5.57142857142857	0.850327251599232	-0.433333333333333	6	30
ASMT	7	14	1	1	343.53	687.06	15	1	1	-1	1	-0.166666666666667	2	21
ASMTL	24	18	6	3	626.67	1253.34	15	1	0.719654554865151	-0.5	1	-0.0952380952380952	9	42
ASNS	7	16	1	5	556.38	1112.76	15	1	0.647214854111406	0.542857142857143	1	0.13768115942029	6	23
ASNSD1	39	31	8	1	684.75	1369.5	15	1	0.0757303998006479	-5.35897435897436	0.918659221702332	-0.331746031746032	9	70
ASPA	4	5	0	0	316.8	633.6	15	1	1	NA	1	NA	0	9
ASPG	23	20	5	6	550.11	1100.22	15	1	0.741107201612078	0.27536231884058	1	0.080338266384778	11	43
ASPHD2	0	5	0	4	316.14	632.28	15	1	1	NA	1	0	4	5
ASPM	147	110	30	27	3306.6	6613.2	15	1	0.557050819720248	0.168556311413454	1	0.0456686463239812	57	257
ASPN	3	26	0	2	368.28	736.56	15	1	1	1	1	0.103448275862069	2	29
ASRGL1	8	11	3	3	312.84	625.68	15	1	1	-0.375	1	-0.0789473684210527	6	19
ASS1	4	10	1	9	289.08	578.16	15	1	0.357707509881423	0.722222222222222	1	0.185714285714286	10	14
ASTE1	21	20	4	7	612.15	1224.3	15	1	0.502939721163082	0.45578231292517	1	0.148558758314856	11	41
ASTL	4	13	4	1	405.9	811.8	15	1	0.0393407761828815	-12	0.794052121283243	-0.564705882352941	5	17
ASTN1	2	38	1	16	1111.77	2223.54	15	1	1	-0.1875	1	-0.0088235294117647	17	40
ASTN2	16	18	1	3	598.95	1197.9	15	1	0.613086770981508	0.625	1	0.220588235294118	4	34
ASXL1	71	108	6	20	2208.69	4417.38	15	1	0.130187563731665	0.543661971830986	1	0.165878813923507	26	179
ASXL2	29	69	13	20	1287.66	2575.32	15	1	0.388460523968429	-0.546551724137931	1	-0.0980210265924552	33	98
ASXL3	29	53	11	12	2112.33	4224.66	15	1	0.333753213485833	-0.675287356321839	1	-0.124602332979852	23	82
ASZ1	16	17	3	3	488.4	976.8	15	1	1	-0.0625	1	-0.0151515151515151	6	33
ATAD1	0	19	0	0	359.37	718.74	15	1	1	NA	1	NA	0	19
ATAD2	67	56	22	19	861.96	1723.92	15	1	1	0.0322073841319718	1	0.00813008130081294	41	123
ATAD2B	8	28	3	2	1376.1	2752.2	15	1	0.109603975457634	-4.25	0.98538656216834	-0.377777777777778	5	36
ATAD3A	2	35	1	16	513.48	1026.96	15	1	1	-0.09375	1	-0.00476947535771065	17	37
ATAD5	86	77	8	7	1787.94	3575.88	15	1	1	-0.0232558139534884	1	-0.00572597137014319	15	163
ATE1	15	32	3	3	520.41	1040.82	15	1	0.396516690856313	-1.13333333333333	1	-0.180851063829787	6	47
ATF1	0	4	0	0	315.81	631.62	15	1	1	NA	1	NA	0	4
ATF2	0	5	0	1	483.12	966.24	15	1	1	NA	1	0	1	5
ATF3	0	3	0	1	180.18	360.36	15	1	1	NA	1	0	1	3
ATF4	3	10	3	3	351.45	702.9	15	1	0.320101724900487	-2.33333333333333	1	-0.269230769230769	6	13
ATF6	26	30	3	5	604.56	1209.12	15	1	0.71903391387251	0.307692307692308	1	0.0892857142857143	8	56
ATF7	5	21	6	10	488.07	976.14	15	1	0.281002100038572	-1.52	1	-0.182692307692308	16	26
ATF7IP	33	53	12	1	1596.87	3193.74	15	1	0.000441989569087629	-18.2727272727273	0.164755839006111	-0.539355992844365	13	86
ATG12	0	2	0	1	40.59	81.18	15	1	1	NA	1	0	1	2
ATG14	0	10	1	5	386.43	772.86	15	1	0.375	-Inf	1	-0.166666666666667	6	10
ATG2B	19	84	2	6	2044.02	4088.04	15	1	0.644645199344062	-0.473684210526316	1	-0.0655339805825243	8	103
ATG4A	1	5	2	2	125.4	250.8	15	1	0.5	-4	1	-0.333333333333333	4	6
ATG4B	1	11	0	3	386.76	773.52	15	1	1	1	1	0.0833333333333333	3	12
ATG4C	3	15	1	2	455.4	910.8	15	1	0.488721804511278	-1.5	1	-0.166666666666667	3	18
ATG7	4	29	6	6	715.77	1431.54	15	1	0.0132907300414838	-6.25	0.618176018064783	-0.378787878787879	12	33
ATG9A	2	29	1	16	809.49	1618.98	15	1	1	0.09375	1	0.00569259962049336	17	31
ATG9B	3	3	3	10	432.96	865.92	15	1	0.320101724900487	0.7	1	0.269230769230769	13	6
ATIC	3	38	1	3	608.85	1217.7	15	1	0.320312762173227	-3.22222222222222	1	-0.176829268292683	4	41
ATL1	1	22	2	11	537.24	1074.48	15	1	0.539355742296919	-3	1	-0.110367892976589	13	23
ATL2	7	11	3	4	592.02	1184.04	15	1	1	-0.178571428571429	1	-0.0396825396825397	7	18
ATM	66	104	16	19	2971.65	5943.3	15	1	0.455247989698444	-0.32695374800638	1	-0.0689075630252101	35	170
ATMIN	8	42	0	2	756.69	1513.38	15	1	1	1	1	0.16	2	50
ATN1	0	20	0	9	607.2	1214.4	15	1	1	NA	1	0	9	20
ATOH7	1	3	1	1	150.48	300.96	15	1	1	-2	1	-0.25	2	4
ATOX1	0	6	0	0	69.63	139.26	15	1	1	NA	1	NA	0	6
ATP10A	13	36	4	5	1267.86	2535.72	15	1	0.425752646832673	-1.21538461538462	1	-0.179138321995465	9	49
ATP10B	45	63	7	10	1549.35	3098.7	15	1	1	0.02	1	0.00490196078431376	17	108
ATP10D	47	49	2	3	1444.41	2888.82	15	1	1	0.304964539007092	1	0.0895833333333333	5	96
ATP11A	16	32	4	8	1210.44	2420.88	15	1	1	0	1	0	12	48
ATP11B	10	24	0	2	1156.32	2312.64	15	1	1	1	1	0.294117647058824	2	34
ATP11C	9	41	2	4	1009.8	2019.6	15	1	0.586079569708871	-1.27777777777778	1	-0.153333333333333	6	50
ATP12A	4	40	5	11	1024.65	2049.3	15	1	0.0480559713410762	-3.54545454545455	0.829468895324472	-0.221590909090909	16	44
ATP13A2	45	48	14	18	1431.54	2863.08	15	1	0.685985094366285	0.17037037037037	1	0.0463709677419355	32	93
ATP13A3	19	35	4	6	1290.63	2581.26	15	1	1	-0.228070175438597	1	-0.0481481481481482	10	54
ATP13A4	24	42	5	8	1184.37	2368.74	15	1	1	-0.09375	1	-0.020979020979021	13	66
ATP13A5	33	68	16	9	1180.08	2360.16	15	1	0.00572337278424058	-2.66329966329966	0.467685236262114	-0.313267326732673	25	101
ATP1A1	2	39	0	8	1009.8	2019.6	15	1	1	1	1	0.0487804878048781	8	41
ATP1B1	1	12	0	6	262.35	524.7	15	1	1	1	1	0.0769230769230769	6	13
ATP1B3	2	6	0	0	251.13	502.26	15	1	1	NA	1	NA	0	8
ATP1B4	6	12	0	1	312.84	625.68	15	1	1	1	1	0.333333333333333	1	18
ATP23	1	7	0	1	183.48	366.96	15	1	1	1	1	0.125	1	8
ATP2A2	2	35	0	14	998.91	1997.82	15	1	1	1	1	0.0540540540540541	14	37
ATP2A3	13	54	14	47	957.66	1915.32	15	1	0.668638281112175	-0.237315875613748	1	-0.0354783459750428	61	67
ATP2B4	2	44	4	21	1088.67	2177.34	15	1	0.175120962827006	-3.19047619047619	1	-0.116521739130435	25	46
ATP2C1	11	25	1	6	952.38	1904.76	15	1	0.651995831444737	0.621212121212121	1	0.162698412698413	7	36
ATP2C2	11	44	9	9	934.56	1869.12	15	1	0.0299662856883321	-3	0.771992783106328	-0.3	18	55
ATP4B	3	23	3	4	286.11	572.22	15	1	0.0929315400950551	-4.75	0.958704007647278	-0.313186813186813	7	26
ATP5A1Z	0	23	0	4	528.66	1057.32	15	1	1	NA	1	0	4	23
ATP5C1	0	11	0	1	277.53	555.06	15	1	1	NA	1	0	1	11
ATP5D	1	3	0	0	87.45	174.9	15	1	1	NA	1	NA	0	4
ATP5F1	4	7	1	1	227.04	454.08	15	1	1	-0.75	1	-0.136363636363636	2	11
ATP5F1B	0	33	0	4	423.72	847.44	15	1	1	NA	1	0	4	33
ATP5G1	1	2	1	0	110.22	220.44	15	1	1	-Inf	1	-0.666666666666667	1	3
ATP5G3	0	1	1	0	127.71	255.42	15	1	1	-Inf	1	-1	1	1
ATP5H	6	12	1	5	132.66	265.32	15	1	0.628666527980029	0.6	1	0.166666666666667	6	18
ATP5I	0	1	0	1	53.79	107.58	15	1	1	NA	1	0	1	1
ATP5J	1	1	0	0	30.36	60.72	15	1	1	NA	1	NA	0	2
ATP5J2	3	5	1	1	78.87	157.74	15	1	1	-0.666666666666667	1	-0.125	2	8
ATP5L	1	1	0	0	74.91	149.82	15	1	1	NA	1	NA	0	2
ATP5O	2	11	0	2	181.5	363	15	1	1	1	1	0.153846153846154	2	13
ATP5S	5	9	0	0	197.34	394.68	15	1	1	NA	1	NA	0	14
ATP5SL	0	1	0	1	45.54	91.08	15	1	1	NA	1	0	1	1
ATP6AP1	11	13	5	0	478.17	956.34	15	1	0.0476190476190476	-Inf	0.828231827900648	-0.541666666666667	5	24
ATP6AP2	1	8	2	5	333.3	666.6	15	1	0.55	-2.2	1	-0.174603174603175	7	9
ATP6V0A1	4	28	3	14	847.44	1694.88	15	1	0.681176370116413	-0.5	1	-0.0514705882352941	17	32
ATP6V0A2	4	29	2	2	766.92	1533.84	15	1	0.115224468165645	-6.25	1	-0.378787878787879	4	33
ATP6V0A4	4	35	4	6	835.56	1671.12	15	1	0.0437628223808118	-4.83333333333333	0.822543273817637	-0.297435897435897	10	39
ATP6V0B	0	4	0	2	181.83	363.66	15	1	1	NA	1	0	2	4
ATP6V0C	0	2	0	3	128.37	256.74	15	1	1	NA	1	0	3	2
ATP6V0D2	1	14	1	1	348.48	696.96	15	1	0.227941176470588	-13	1	-0.433333333333333	2	15
ATP6V0E1	0	3	0	0	46.86	93.72	15	1	1	NA	1	NA	0	3
ATP6V1A-ATP6V1AL	0	18	0	4	611.82	1223.64	15	1	1	NA	1	0	4	18
ATP6V1B2	1	9	2	9	889.68	1779.36	15	1	1	-1	1	-0.0818181818181818	11	10
ATP6V1D	0	6	0	1	231.99	463.98	15	1	1	NA	1	0	1	6
ATP6V1E1	3	6	2	0	213.84	427.68	15	1	0.181818181818182	-Inf	1	-0.666666666666667	2	9
ATP6V1G1	1	4	1	2	102.3	204.6	15	1	1	-1	1	-0.133333333333333	3	5
ATP6V1G3	3	4	1	2	117.81	235.62	15	1	1	0.333333333333333	1	0.0952380952380952	3	7
ATP6V1H	0	24	1	3	476.19	952.38	15	1	0.142857142857143	-Inf	1	-0.25	4	24
ATP7B	30	67	9	8	1422.3	2844.6	15	1	0.0982714788185529	-1.5125	0.971353639774823	-0.220133414190418	17	97
ATP8A1	3	27	1	2	1134.54	2269.08	15	1	0.330278592375367	-3.5	1	-0.233333333333333	3	30
ATP8A2	3	17	2	1	754.71	1509.42	15	1	0.107284020327499	-10.3333333333333	0.983875031494079	-0.516666666666667	3	20
ATP8B1	7	50	1	5	1239.81	2479.62	15	1	0.573339425861493	-0.428571428571429	1	-0.043859649122807	6	57
ATP8B3	38	69	11	3	1168.2	2336.4	15	1	0.00302760530328031	-5.65789473684211	0.392937591511756	-0.430574098798398	14	107
ATP8B4	7	77	0	3	1195.92	2391.84	15	1	1	1	1	0.0833333333333333	3	84
ATP9A	2	36	0	3	1050.72	2101.44	15	1	1	1	1	0.0526315789473684	3	38
ATP9B	5	32	4	2	1145.76	2291.52	15	1	0.0123110910047054	-11.8	0.611501516159645	-0.531531531531531	6	37
ATPAF1	6	6	1	0	237.93	475.86	15	1	1	-Inf	1	-0.5	1	12
ATPAF2	3	7	2	1	228.36	456.72	15	1	0.510489510489511	-3.66666666666667	1	-0.366666666666667	3	10
ATR	50	99	15	25	2627.13	5254.26	15	1	0.708580537884249	-0.188	1	-0.0394295302013423	40	149
ATRIP	20	17	6	8	670.23	1340.46	15	1	0.541362628250875	0.3625	1	0.111969111969112	14	37
ATRN	15	54	5	12	1199.88	2399.76	15	1	0.52937703991728	-0.5	1	-0.0767263427109975	17	69
ATRNL1	7	34	4	13	1049.4	2098.8	15	1	0.714646431116363	-0.494505494505495	1	-0.0645624103299856	17	41
ATXN1	3	18	6	16	741.51	1483.02	15	1	0.456552630120412	-1.25	1	-0.12987012987013	22	21
ATXN10	17	10	0	1	389.07	778.14	15	1	0.392857142857143	1	1	0.62962962962963	1	27
ATXN1L	9	15	0	2	560.01	1120.02	15	1	0.529230769230769	1	1	0.375	2	24
ATXN2	2	10	3	2	939.51	1879.02	15	1	0.116515837104072	-6.5	1	-0.433333333333333	5	12
ATXN3	1	11	0	1	336.27	672.54	15	1	1	1	1	0.0833333333333333	1	12
ATXN7	7	7	1	4	792.66	1585.32	15	1	0.33780529755762	0.75	1	0.3	5	14
ATXN7L1	5	16	1	3	606.21	1212.42	15	1	1	-0.0666666666666667	1	-0.0119047619047619	4	21
AUP1	7	27	3	5	423.39	846.78	15	1	0.369337597835672	-1.31428571428571	1	-0.169117647058824	8	34
AURKA	5	19	1	3	432.96	865.92	15	1	1	-0.266666666666667	1	-0.0416666666666667	4	24
AURKAIP1	8	2	1	0	200.97	401.94	15	1	1	-Inf	1	-0.2	1	10
AUTS2	5	24	0	7	926.31	1852.62	15	1	0.55899064171123	1	1	0.172413793103448	7	29
AvBD1-AvBD5	4	5	1	0	96.03	192.06	15	1	1	-Inf	1	-0.555555555555556	1	9
AvBD10-AvBD9	1	5	0	3	68.31	136.62	15	1	1	1	1	0.166666666666667	3	6
AvBD12	6	9	0	1	93.06	186.12	15	1	1	1	1	0.4	1	15
AvBD4-AvBD6-AvBD7	7	1	0	0	66.33	132.66	15	1	1	NA	1	NA	0	8
AVD-AVR2-LOC427416-LOC769899	4	4	3	3	122.1	244.2	15	1	1	0	1	0	6	8
AVL9	6	26	3	0	606.87	1213.74	15	1	0.0128342245989305	-Inf	0.61231737012987	-0.8125	3	32
AVPR1A	0	7	0	1	301.62	603.24	15	1	1	NA	1	0	1	7
AVPR1B	6	23	10	11	393.36	786.72	15	1	0.0660988801127105	-2.48484848484848	0.884435842948953	-0.269293924466338	21	29
AVPR2	2	8	2	0	368.28	736.56	15	1	0.0909090909090909	-Inf	0.953786405978059	-0.8	2	10
AWAT1	1	7	2	6	336.6	673.2	15	1	1	-1.33333333333333	1	-0.125	8	8
AXDND1	38	47	10	4	1037.52	2075.04	15	1	0.0850294754755179	-2.09210526315789	0.950356516076024	-0.267226890756303	14	85
AXIN2	3	20	3	10	678.15	1356.3	15	1	0.645398481973435	-1	1	-0.100334448160535	13	23
AZI2	8	15	2	1	386.1	772.2	15	1	0.538461538461538	-2.75	1	-0.318840579710145	3	23
AZIN1	0	6	1	1	446.49	892.98	15	1	0.25	-Inf	1	-0.5	2	6
AZIN2	16	35	2	6	453.42	906.84	15	1	1	0.270833333333333	1	0.0637254901960784	8	51
B3GALNT1	18	17	2	3	316.8	633.6	15	1	1	0.37037037037037	1	0.114285714285714	5	35
B3GALNT2	4	17	2	2	459.03	918.06	15	1	0.23399209486166	-3.25	1	-0.30952380952381	4	21
B3GALT1	0	20	1	2	323.73	647.46	15	1	0.130434782608696	-Inf	1	-0.333333333333333	3	20
B3GALT2	4	20	1	4	412.5	825	15	1	1	-0.25	1	-0.0333333333333334	5	24
B3GALT5	12	12	3	4	316.8	633.6	15	1	1	0.25	1	0.0714285714285715	7	24
B3GALT6	8	20	4	8	344.19	688.38	15	1	1	-0.25	1	-0.0476190476190476	12	28
B3GAT1L	1	11	0	4	341.55	683.1	15	1	1	1	1	0.0833333333333333	4	12
B3GAT2	0	6	0	1	125.73	251.46	15	1	1	NA	1	0	1	6
B3GLCT	9	17	5	4	533.28	1066.56	15	1	0.431767620588533	-1.36111111111111	1	-0.209401709401709	9	26
B3GNT2	2	14	0	4	394.02	788.04	15	1	1	1	1	0.125	4	16
B3GNT4	10	20	5	9	366.3	732.6	15	1	1	-0.111111111111111	1	-0.0238095238095238	14	30
B3GNT5	1	10	0	1	357.06	714.12	15	1	1	1	1	0.0909090909090909	1	11
B3GNT7	8	22	4	10	402.93	805.86	15	1	1	-0.1	1	-0.019047619047619	14	30
B3GNT9	8	12	3	4	411.84	823.68	15	1	1	-0.125	1	-0.0285714285714285	7	20
B3GNTL	5	16	8	1	367.29	734.58	15	1	0.00157921039480261	-24.6	0.284493574108469	-0.650793650793651	9	21
B3GNTL1	5	13	1	3	227.7	455.4	15	1	1	0.133333333333333	1	0.0277777777777778	4	18
B4GALNT3	22	50	6	8	1002.54	2005.08	15	1	0.369622904251251	-0.704545454545455	1	-0.123015873015873	14	72
B4GALNT4	18	37	8	24	1065.24	2130.48	15	1	0.478586305511921	0.314814814814815	1	0.0772727272727273	32	55
B4GALT1	0	4	1	2	260.04	520.08	15	1	0.428571428571428	-Inf	1	-0.333333333333333	3	4
B4GALT2	2	11	1	5	367.29	734.58	15	1	1	-0.1	1	-0.0128205128205128	6	13
B4GALT3	6	17	2	5	324.06	648.12	15	1	1	-0.133333333333333	1	-0.0248447204968944	7	23
B4GALT4	8	20	4	5	352.44	704.88	15	1	0.431783415948828	-1	1	-0.158730158730159	9	28
B4GALT5	0	7	0	3	299.31	598.62	15	1	1	NA	1	0	3	7
B4GALT6	0	5	0	2	341.22	682.44	15	1	1	NA	1	0	2	5
B4GALT7	0	8	0	0	247.83	495.66	15	1	1	NA	1	NA	0	8
B9D1	2	10	1	0	168.63	337.26	15	1	0.230769230769231	-Inf	1	-0.833333333333333	1	12
BAALC	2	0	2	0	94.71	189.42	15	1	1	NA	1	0	2	2
BAAT	7	12	4	12	409.2	818.4	15	1	0.492769744160178	0.428571428571429	1	0.118421052631579	16	19
BACE1	0	14	1	7	410.85	821.7	15	1	0.363636363636364	-Inf	1	-0.125	8	14
BACE2	3	15	4	4	340.56	681.12	15	1	0.149017938583156	-4	1	-0.333333333333333	8	18
BACH1	16	27	4	4	758.34	1516.68	15	1	0.695807506418596	-0.6875	1	-0.127906976744186	8	43
BACH2	0	15	3	5	817.74	1635.48	15	1	0.0316205533596838	-Inf	0.778718235934639	-0.375	8	15
BAG1	1	7	0	1	198.33	396.66	15	1	1	1	1	0.125	1	8
BAG2	1	7	2	4	206.25	412.5	15	1	0.538461538461538	-2.5	1	-0.208333333333333	6	8
BAG3	11	15	5	5	498.96	997.92	15	1	0.722475028370468	-0.363636363636364	1	-0.0769230769230769	10	26
BAG4	10	6	6	2	240.57	481.14	15	1	0.667413127098145	-0.8	1	-0.125	8	16
BAG5	12	11	1	3	446.49	892.98	15	1	0.595555555555556	0.694444444444444	1	0.271739130434783	4	23
BAHCC1	6	9	5	10	364.98	729.96	15	1	1	0.25	1	0.0666666666666667	15	15
BAHD1	3	28	5	8	830.61	1661.22	15	1	0.0374507116006355	-4.83333333333333	0.789311843512415	-0.287841191066998	13	31
BAIAP2	1	18	2	15	510.84	1021.68	15	1	0.592857142857143	-1.4	1	-0.065015479876161	17	19
BAIAP2L1	3	21	1	0	490.05	980.1	15	1	0.16	-Inf	1	-0.875	1	24
BAIAP2L2	9	23	3	3	489.39	978.78	15	1	0.356658737463691	-1.55555555555556	1	-0.21875	6	32
BAK1	6	4	1	3	213.84	427.68	15	1	0.559440559440559	0.777777777777778	1	0.35	4	10
BAMBI	1	5	0	1	257.4	514.8	15	1	1	1	1	0.166666666666667	1	6
BANK1	35	31	5	5	726.33	1452.66	15	1	1	0.114285714285714	1	0.0303030303030303	10	66
BANP	3	17	2	4	462.66	925.32	15	1	0.558072362420189	-1.83333333333333	1	-0.183333333333333	6	20
BAP1	4	28	1	7	681.45	1362.9	15	1	1	0	1	0	8	32
BARD1	31	27	2	1	734.58	1469.16	15	1	1	-0.741935483870968	1	-0.132183908045977	3	58
BARHL1	8	3	0	0	195.36	390.72	15	1	1	NA	1	NA	0	11
BARHL2	3	4	0	0	181.5	363	15	1	1	NA	1	NA	0	7
BARL	9	24	0	1	499.95	999.9	15	1	1	1	1	0.272727272727273	1	33
BARX1	0	6	0	2	166.65	333.3	15	1	1	NA	1	0	2	6
BARX2	4	4	0	3	209.55	419.1	15	1	0.236363636363636	1	1	0.5	3	8
BASP1	3	6	2	2	242.55	485.1	15	1	1	-1	1	-0.166666666666667	4	9
BATF	0	4	0	1	113.85	227.7	15	1	1	NA	1	0	1	4
BATF3	1	2	0	2	61.38	122.76	15	1	1	1	1	0.333333333333333	2	3
BAZ1A	7	40	9	11	1516.02	3032.04	15	1	0.0127530546742218	-3.67532467532468	0.61231737012987	-0.301063829787234	20	47
BAZ1B	15	62	1	2	1491.93	2983.86	15	1	0.492891918208374	-1.06666666666667	1	-0.138528138528139	3	77
BAZ2A	21	45	6	17	1264.23	2528.46	15	1	0.793076382453093	0.243697478991597	1	0.0573122529644269	23	66
BAZ2B	31	58	3	9	2130.48	4260.96	15	1	0.746251564480299	0.376344086021505	1	0.0983146067415731	12	89
BBIP1	1	2	0	0	60.39	120.78	15	1	1	NA	1	NA	0	3
BBOF1	14	19	4	1	435.27	870.54	15	1	0.16988416988417	-4.42857142857143	1	-0.375757575757576	5	33
BBS10	34	29	7	9	518.1	1036.2	15	1	0.578325834761198	0.336601307189543	1	0.10218253968254	16	63
BBS12	37	39	17	17	756.03	1512.06	15	1	1	-0.0540540540540539	1	-0.0131578947368421	34	76
BBS2	7	21	3	3	690.36	1380.72	15	1	0.328420467185762	-2	1	-0.25	6	28
BBS4	7	21	2	7	523.71	1047.42	15	1	1	0.142857142857143	1	0.0277777777777778	9	28
BBS5	2	5	0	0	319.11	638.22	15	1	1	NA	1	NA	0	7
BBS7	7	18	3	5	668.25	1336.5	15	1	0.67282022760332	-0.542857142857143	1	-0.095	8	25
BBX	6	12	0	3	930.6	1861.2	15	1	0.526315789473684	1	1	0.333333333333333	3	18
BCAN	3	8	6	5	384.12	768.24	15	1	0.386996904024768	-2.2	1	-0.272727272727273	11	11
BCAP29	2	4	1	0	241.56	483.12	15	1	0.428571428571428	-Inf	1	-0.666666666666667	1	6
BCAR3	19	20	4	4	811.8	1623.6	15	1	1	-0.0526315789473684	1	-0.0128205128205128	8	39
BCAS1	27	25	7	2	602.91	1205.82	15	1	0.275669312617581	-2.24074074074074	1	-0.258547008547009	9	52
BCAS2	1	6	0	1	154.77	309.54	15	1	1	1	1	0.142857142857143	1	7
BCAS3	8	30	8	9	881.76	1763.52	15	1	0.061893095284018	-2.33333333333333	0.876180863544705	-0.260061919504644	17	38
BCAT1	12	19	2	0	429.33	858.66	15	1	0.172348484848485	-Inf	1	-0.612903225806452	2	31
BCCIP	5	9	3	0	260.37	520.74	15	1	0.0823529411764706	-Inf	0.949431371776132	-0.642857142857143	3	14
BCDIN3D	9	6	0	2	198.99	397.98	15	1	0.205882352941177	1	1	0.6	2	15
BCHE	9	11	1	4	629.64	1259.28	15	1	0.614624505928854	0.694444444444444	1	0.25	5	20
BCKDHB	17	13	1	1	439.23	878.46	15	1	1	0.235294117647059	1	0.0666666666666667	2	30
BCL10	0	12	1	1	215.82	431.64	15	1	0.142857142857143	-Inf	1	-0.5	2	12
BCL11A	1	17	1	7	629.64	1259.28	15	1	0.529230769230769	-1.42857142857143	1	-0.0694444444444444	8	18
BCL11B	1	23	0	1	658.35	1316.7	15	1	1	1	1	0.0416666666666667	1	24
BCL2A1	3	6	0	0	173.25	346.5	15	1	1	NA	1	NA	0	9
BCL2L1	0	4	0	3	227.7	455.4	15	1	1	NA	1	0	3	4
BCL2L11	1	1	0	0	112.2	224.4	15	1	1	NA	1	NA	0	2
BCL2L13	10	18	3	2	489.72	979.44	15	1	0.359958034179391	-1.7	1	-0.242857142857143	5	28
BCL2L15	6	5	0	0	159.39	318.78	15	1	1	NA	1	NA	0	11
BCL6	0	16	0	8	669.57	1339.14	15	1	1	NA	1	0	8	16
BCL7A	0	4	0	1	178.53	357.06	15	1	1	NA	1	0	1	4
BCL7B	2	8	1	0	150.48	300.96	15	1	0.272727272727273	-Inf	1	-0.8	1	10
BCL9	4	24	9	8	1342.11	2684.22	15	1	0.00826991070893509	-5.75	0.54233354502865	-0.38655462184874	17	28
BCL9L	19	39	1	1	1443.09	2886.18	15	1	1	-1.05263157894737	1	-0.172413793103448	2	58
BCO1	5	15	0	2	521.73	1043.46	15	1	1	1	1	0.25	2	20
BCO2	11	24	4	7	573.21	1146.42	15	1	1	-0.246753246753247	1	-0.0493506493506494	11	35
BCOR	16	59	12	23	1691.25	3382.5	15	1	0.163968845284666	-0.923913043478261	1	-0.12952380952381	35	75
BCORL1	20	58	12	23	1541.43	3082.86	15	1	0.37237862322926	-0.513043478260869	1	-0.0864468864468865	35	78
BCS1L	7	16	6	4	386.43	772.86	15	1	0.139341692789969	-2.42857142857143	1	-0.295652173913043	10	23
BDH1	3	11	2	3	245.19	490.38	15	1	0.569573443412453	-1.44444444444444	1	-0.185714285714286	5	14
BDH1A	0	15	2	4	340.56	681.12	15	1	0.0714285714285714	-Inf	0.908058284769907	-0.333333333333333	6	15
BDH1B	5	13	2	3	308.22	616.44	15	1	0.621385479509049	-0.733333333333333	1	-0.122222222222222	5	18
BDH2	0	4	3	2	243.54	487.08	15	1	0.166666666666667	-Inf	1	-0.6	5	4
BDKRB1	27	20	0	0	358.38	716.76	15	1	1	NA	1	NA	0	47
BDKRB2	12	21	2	0	378.18	756.36	15	1	0.152941176470588	-Inf	1	-0.636363636363636	2	33
BDP1L	152	95	6	3	2296.8	4593.6	15	1	1	-0.25	1	-0.0512820512820512	9	247
BEAN1	3	4	0	2	305.91	611.82	15	1	0.5	1	1	0.428571428571429	2	7
BEND2	12	30	3	5	575.85	1151.7	15	1	0.682550609900394	-0.5	1	-0.0892857142857143	8	42
BEND3	3	36	0	9	828.63	1657.26	15	1	1	1	1	0.0769230769230769	9	39
BEND4	0	9	1	2	385.11	770.22	15	1	0.25	-Inf	1	-0.333333333333333	3	9
BEND6	9	8	2	0	474.21	948.42	15	1	0.485380116959064	-Inf	1	-0.470588235294118	2	17
BEND7	6	12	0	5	448.47	896.94	15	1	0.272489524205771	1	1	0.333333333333333	5	18
BEST1	13	28	2	1	660.66	1321.32	15	1	0.264270613107822	-3.30769230769231	1	-0.349593495934959	3	41
BEST2-BEST4	7	9	6	12	385.11	770.22	15	1	0.725376021666586	0.357142857142857	1	0.104166666666667	18	16
BEST3	3	21	1	5	662.31	1324.62	15	1	1	-0.4	1	-0.0416666666666667	6	24
BET1	1	5	0	1	108.57	217.14	15	1	1	1	1	0.166666666666667	1	6
BET1L	2	4	0	0	104.61	209.22	15	1	1	NA	1	NA	0	6
BF1-BF2-HLA-F10AL1-HLA-F10AL3-HLA-F10AL4-LOC101751283-LOC107049114-LOC107049124-LOC107050538-LOC107050833-LOC107054704-LOC112529954-LOC417056-MHCIA2-MHCIA3-MHCIA6-MHCIA7-MHCIA9-MHCIY-MICA-MR1-YF5-YF6	21	7	10	5	212.85	425.7	15	1	0.723407502786121	0.333333333333333	1	0.0833333333333334	15	28
BFAR	19	15	5	3	445.5	891	15	1	1	-0.315789473684211	1	-0.0661764705882353	8	34
BFSP1	13	20	6	6	651.42	1302.84	15	1	0.734044067566473	-0.538461538461539	1	-0.106060606060606	12	33
BFSP2	1	11	2	5	397.98	795.96	15	1	0.523219814241486	-3.4	1	-0.202380952380952	7	12
BGLAP	0	4	1	2	93.72	187.44	15	1	0.428571428571428	-Inf	1	-0.333333333333333	3	4
BHLHA9	13	9	9	7	216.48	432.96	15	1	1	0.10989010989011	1	0.0284090909090909	16	22
BHLHE23	3	15	1	3	177.87	355.74	15	1	1	-0.666666666666667	1	-0.0833333333333333	4	18
BHLHE40	0	9	1	3	256.41	512.82	15	1	0.307692307692308	-Inf	1	-0.25	4	9
BHMT	1	10	3	2	382.47	764.94	15	1	0.0631868131868132	-14	0.878646123461792	-0.509090909090909	5	11
BICC1	14	16	1	0	186.78	373.56	15	1	0.483870967741936	-Inf	1	-0.533333333333333	1	30
BICD1	4	31	1	7	822.36	1644.72	15	1	1	-0.107142857142857	1	-0.0107142857142857	8	35
BICD2	13	33	2	3	833.58	1667.16	15	1	0.623860182370821	-0.692307692307692	1	-0.117391304347826	5	46
BID	3	10	0	1	192.06	384.12	15	1	1	1	1	0.230769230769231	1	13
BIN1	1	19	0	2	533.61	1067.22	15	1	1	1	1	0.05	2	20
BIN2-CELA1	28	41	20	20	1226.61	2453.22	15	1	0.423933320758774	-0.464285714285714	1	-0.0942028985507246	40	69
BIN3	17	13	3	4	317.79	635.58	15	1	0.679995244511373	0.426470588235294	1	0.138095238095238	7	30
BIRC2	7	17	2	3	605.88	1211.76	15	1	0.632815460401667	-0.619047619047619	1	-0.108333333333333	5	24
BIRC5	5	5	1	1	90.75	181.5	15	1	1	0	1	0	2	10
BIRC6	6	132	8	20	4731.87	9463.74	15	1	0.000375596113190438	-7.8	0.161908753078878	-0.24223602484472	28	138
BIRC7	11	23	4	5	384.12	768.24	15	1	0.696027639425556	-0.672727272727273	1	-0.120915032679739	9	34
BIVM	6	21	4	3	524.7	1049.4	15	1	0.157233527448799	-3.66666666666667	1	-0.349206349206349	7	27
BLCAP	0	2	0	0	87.12	174.24	15	1	1	NA	1	NA	0	2
BLEC1	9	5	2	2	194.04	388.08	15	1	1	0.444444444444444	1	0.142857142857143	4	14
BLEC3-LOC107054697	7	4	3	3	156.09	312.18	15	1	0.643665158371041	0.428571428571429	1	0.136363636363636	6	11
BLK	6	28	0	6	521.73	1043.46	15	1	0.565041501883607	1	1	0.176470588235294	6	34
BLM	54	58	17	10	1253.34	2506.68	15	1	0.201242399461334	-0.825925925925926	1	-0.147486772486772	27	112
BLMH	0	14	1	4	381.81	763.62	15	1	0.263157894736842	-Inf	1	-0.2	5	14
BLNK	8	19	3	0	539.88	1079.76	15	1	0.0406403940886699	-Inf	0.798931947804628	-0.703703703703704	3	27
BLOC1S2	0	6	0	2	123.42	246.84	15	1	1	NA	1	0	2	6
BLOC1S4	6	5	4	3	192.39	384.78	15	1	1	-0.111111111111111	1	-0.025974025974026	7	11
BLOC1S5	3	5	0	0	189.09	378.18	15	1	1	NA	1	NA	0	8
BLOC1S6	7	8	0	0	178.2	356.4	15	1	1	NA	1	NA	0	15
BLZF1	11	14	1	3	394.02	788.04	15	1	0.622079070354932	0.575757575757576	1	0.19	4	25
BMI1	0	4	0	2	306.9	613.8	15	1	1	NA	1	0	2	4
BMP10	9	16	2	2	421.74	843.48	15	1	0.622079070354932	-0.777777777777778	1	-0.14	4	25
BMP2K	19	28	9	11	1023.33	2046.66	15	1	0.79029722421252	-0.205741626794258	1	-0.0457446808510639	20	47
BMP3	9	15	0	2	468.6	937.2	15	1	0.529230769230769	1	1	0.375	2	24
BMP4	0	3	1	4	377.52	755.04	15	1	1	-Inf	1	-0.2	5	3
BMP5	1	11	2	1	372.24	744.48	15	1	0.0813186813186813	-21	0.94404191396991	-0.583333333333333	3	12
BMP6	2	15	0	1	302.94	605.88	15	1	1	1	1	0.117647058823529	1	17
BMP7	0	10	0	3	335.94	671.88	15	1	1	NA	1	0	3	10
BMPER	14	14	2	2	726.66	1453.32	15	1	1	0	1	0	4	28
BMPR1A	2	15	0	0	523.05	1046.1	15	1	1	NA	1	NA	0	17
BMPR1B	0	16	0	7	496.98	993.96	15	1	1	NA	1	0	7	16
BMPR2	7	40	1	1	1013.76	2027.52	15	1	0.302721088435374	-4.71428571428571	1	-0.351063829787234	2	47
BMS1	27	40	8	8	1287.33	2574.66	15	1	0.576555725711994	-0.481481481481481	1	-0.0970149253731343	16	67
BMT2	6	8	0	1	373.23	746.46	15	1	1	1	1	0.428571428571429	1	14
BMX	12	21	1	0	605.88	1211.76	15	1	0.382352941176471	-Inf	1	-0.636363636363636	1	33
BNC1	3	21	1	3	976.14	1952.28	15	1	0.481025641025641	-1.33333333333333	1	-0.125	4	24
BNC2	6	24	1	1	876.15	1752.3	15	1	0.395161290322581	-3	1	-0.3	2	30
BNIP1	0	4	0	0	155.76	311.52	15	1	1	NA	1	NA	0	4
BNIP2	0	11	1	2	306.9	613.8	15	1	0.214285714285714	-Inf	1	-0.333333333333333	3	11
BNIP3	4	14	1	4	225.39	450.78	15	1	1	0.125	1	0.0222222222222222	5	18
BNIP3L	10	7	2	3	236.94	473.88	15	1	0.62406015037594	0.533333333333333	1	0.188235294117647	5	17
BOC	16	56	5	17	1140.15	2280.3	15	1	1	-0.0294117647058822	1	-0.00505050505050506	22	72
BOD1	0	3	0	2	113.19	226.38	15	1	1	NA	1	0	2	3
BOD1L1	121	82	15	7	2935.68	5871.36	15	1	0.49782273091813	-0.452184179456907	1	-0.0857590685176891	22	203
BOK	2	6	1	1	193.38	386.76	15	1	1	-2	1	-0.25	2	8
BOLA3	2	3	0	0	49.5	99	15	1	1	NA	1	NA	0	5
BOLL	4	12	0	1	291.06	582.12	15	1	1	1	1	0.25	1	16
BOP1	1	1	2	1	144.87	289.74	15	1	1	-1	1	-0.166666666666667	3	2
BORA	12	23	2	4	619.74	1239.48	15	1	1	0.0416666666666666	1	0.00952380952380955	6	35
BORCS5	4	7	0	0	81.84	163.68	15	1	1	NA	1	NA	0	11
BORCS6	0	2	0	2	96.03	192.06	15	1	1	NA	1	0	2	2
BORCS8	0	4	0	8	108.57	217.14	15	1	1	NA	1	0	8	4
BORL1-BORL4	10	16	4	2	243.21	486.42	15	1	0.364942528735632	-2.2	1	-0.282051282051282	6	26
BPGM	1	9	0	1	257.4	514.8	15	1	1	1	1	0.1	1	10
BPHL	8	17	4	1	287.1	574.2	15	1	0.128205128205128	-7.5	1	-0.48	5	25
BPIFB2	16	22	4	7	421.41	842.82	15	1	1	0.214285714285714	1	0.0574162679425837	11	38
BPIFB3	20	17	2	8	455.4	910.8	15	1	0.0786145101202849	0.7875	0.931184629197094	0.340540540540541	10	37
BPIFB4	7	19	7	6	419.76	839.52	15	1	0.157431248561917	-2.16666666666667	1	-0.269230769230769	13	26
BPIFB6	21	15	7	3	452.1	904.2	15	1	0.71719202695111	-0.666666666666667	1	-0.116666666666667	10	36
BPIFCB	13	19	1	1	447.15	894.3	15	1	1	-0.461538461538461	1	-0.09375	2	32
BPIL3	36	26	15	11	538.23	1076.46	15	1	1	0.0151515151515151	1	0.00372208436724575	26	62
BPNT1	8	13	1	2	304.92	609.84	15	1	1	0.1875	1	0.0476190476190476	3	21
BPTF	40	64	12	5	2974.29	5948.58	15	1	0.0173308352737289	-2.84	0.67478445727067	-0.321266968325792	17	104
BRAF	0	17	0	1	748.44	1496.88	15	1	1	NA	1	0	1	17
BRAP	3	18	2	6	534.27	1068.54	15	1	0.596816976127321	-1	1	-0.107142857142857	8	21
BRAT1	22	36	5	7	832.59	1665.18	15	1	1	-0.168831168831169	1	-0.0373563218390805	12	58
BRCA1	152	102	20	26	1821.6	3643.2	15	1	0.0512439555489593	0.483805668016194	0.843251957917679	0.163642588154742	46	254
BRCA2	202	119	46	24	3354.12	6708.24	15	1	0.683950757073989	-0.129125412541254	1	-0.027859368046284	70	321
BRCC3	0	15	0	5	176.55	353.1	15	1	1	NA	1	0	5	15
BRD1	3	30	4	0	1370.49	2740.98	15	1	0.000529941706412294	-Inf	0.182754182754183	-0.909090909090909	4	33
BRD3	3	21	5	14	710.49	1420.98	15	1	0.431945405853517	-1.5	1	-0.138157894736842	19	24
BRD7	6	25	4	5	571.23	1142.46	15	1	0.190337343394619	-2.33333333333333	1	-0.25089605734767	9	31
BRD8	18	44	3	3	1194.6	2389.2	15	1	0.363478844465456	-1.44444444444444	1	-0.209677419354839	6	62
BRDT	52	30	2	4	928.62	1857.24	15	1	0.200324214196061	0.711538461538462	1	0.300813008130081	6	82
BRE	19	16	11	4	522.39	1044.78	15	1	0.345094000516938	-1.31578947368421	1	-0.19047619047619	15	35
BRF1	6	16	1	2	501.6	1003.2	15	1	1	-0.333333333333333	1	-0.0606060606060606	3	22
BRF2	8	22	7	5	378.51	757.02	15	1	0.0778717643990959	-2.85	0.927455919491027	-0.316666666666667	12	30
BRI3BP	0	5	0	0	172.26	344.52	15	1	1	NA	1	NA	0	5
BRINP1	12	20	2	6	770.88	1541.76	15	1	0.688654598871317	0.444444444444444	1	0.125	8	32
BRINP2	4	17	5	11	717.09	1434.18	15	1	0.458030079832082	-0.931818181818182	1	-0.12202380952381	16	21
BRINP3	19	13	3	0	434.94	869.88	15	1	0.278991596638655	-Inf	1	-0.40625	3	32
BRIX1	5	5	1	0	343.53	687.06	15	1	1	-Inf	1	-0.5	1	10
BRMS1L	2	5	0	0	273.24	546.48	15	1	1	NA	1	NA	0	7
BRPF1	5	27	2	16	997.26	1994.52	15	1	1	0.325	1	0.0451388888888889	18	32
BRPF3	10	37	3	11	1096.92	2193.84	15	1	1	-0.00909090909090904	1	-0.00151975683890576	14	47
BRS3	4	9	2	2	384.12	768.24	15	1	0.584033613445378	-1.25	1	-0.192307692307692	4	13
BRSK2	3	13	3	8	753.39	1506.78	15	1	0.661835748792271	-0.625	1	-0.0852272727272727	11	16
BRWD3	2	42	3	10	1518	3036	15	1	0.0724373827650889	-5.3	0.911545360143491	-0.185314685314685	13	44
BSDC1	9	16	2	4	424.71	849.42	15	1	1	0.111111111111111	1	0.0266666666666667	6	25
BSG	4	21	0	1	356.07	712.14	15	1	1	1	1	0.16	1	25
BSND	1	5	1	2	80.52	161.04	15	1	1	-1.5	1	-0.166666666666667	3	6
BSPRY	3	15	2	2	299.97	599.94	15	1	0.209842788790157	-4	1	-0.333333333333333	4	18
BST1	16	10	1	1	332.31	664.62	15	1	1	0.375	1	0.115384615384615	2	26
BSX	0	2	0	1	104.61	209.22	15	1	1	NA	1	0	1	2
BTAF1	3	49	1	5	1821.93	3643.86	15	1	0.361903976241544	-2.26666666666667	1	-0.108974358974359	6	52
BTBD1	0	13	0	3	345.84	691.68	15	1	1	NA	1	0	3	13
BTBD10	1	17	0	3	470.25	940.5	15	1	1	1	1	0.0555555555555556	3	18
BTBD11	5	15	4	8	772.2	1544.4	15	1	0.695986994096004	-0.5	1	-0.0833333333333333	12	20
BTBD17	2	6	4	10	341.55	683.1	15	1	1	-0.2	1	-0.0357142857142857	14	8
BTBD18	1	0	1	0	79.2	158.4	15	1	1	NA	1	0	1	1
BTBD19	1	4	0	2	69.63	139.26	15	1	1	1	1	0.2	2	5
BTBD2	3	9	1	1	408.87	817.74	15	1	0.505494505494505	-2	1	-0.25	2	12
BTBD6	0	16	1	4	425.7	851.4	15	1	0.238095238095238	-Inf	1	-0.2	5	16
BTBD7	4	33	2	2	1104.18	2208.36	15	1	0.0951910733682236	-7.25	0.960983694935281	-0.391891891891892	4	37
BTBD9	1	18	1	0	438.57	877.14	15	1	0.1	-Inf	0.971353639774823	-0.947368421052632	1	19
BTC	2	1	2	3	83.16	166.32	15	1	1	0.666666666666667	1	0.266666666666667	5	3
BTD	13	33	10	6	515.79	1031.58	15	1	0.0192043542844623	-3.23076923076923	0.683149554847669	-0.342391304347826	16	46
BTF3	0	3	0	0	140.58	281.16	15	1	1	NA	1	NA	0	3
BTF3L4	0	4	0	0	157.41	314.82	15	1	1	NA	1	NA	0	4
BTG1	1	3	0	1	149.82	299.64	15	1	1	1	1	0.25	1	4
BTG2	1	2	1	7	112.53	225.06	15	1	0.490909090909091	0.714285714285714	1	0.208333333333333	8	3
BTG4	3	13	1	2	225.72	451.44	15	1	0.530443756449948	-1.16666666666667	1	-0.145833333333333	3	16
BTK	3	19	4	11	613.47	1226.94	15	1	0.408148067422261	-1.3030303030303	1	-0.13030303030303	15	22
BTLA	12	7	3	3	265.32	530.64	15	1	0.653162055335968	0.416666666666667	1	0.131578947368421	6	19
BTN1	3	29	2	7	438.57	877.14	15	1	0.299416331508758	-1.76190476190476	1	-0.128472222222222	9	32
BTN1A1	27	23	2	4	478.83	957.66	15	1	0.414060135203309	0.574074074074074	1	0.206666666666667	6	50
BTN3A2-BTN3A3-LOC107049000-LOC107055478-LOC426827	28	11	3	2	371.58	743.16	15	1	0.623349920074254	0.410714285714286	1	0.117948717948718	5	39
BUB1	42	32	5	13	1060.62	2121.24	15	1	0.0359737538658924	0.706959706959707	0.788199921465956	0.28978978978979	18	74
BUB1B	41	29	8	5	1149.39	2298.78	15	1	1	-0.131707317073171	1	-0.0296703296703297	13	70
BUB3	0	12	0	3	323.73	647.46	15	1	1	NA	1	0	3	12
BUD13-LOC770165	14	26	11	14	520.08	1040.16	15	1	0.601201186466706	-0.459183673469388	1	-0.09	25	40
BUD31	0	3	0	3	133.65	267.3	15	1	1	NA	1	0	3	3
BVES	0	7	2	4	356.4	712.8	15	1	0.192307692307692	-Inf	1	-0.333333333333333	6	7
BYSL	2	7	3	2	288.09	576.18	15	1	0.265734265734266	-4.25	1	-0.377777777777778	5	9
BZFP1-LOC112533547	13	22	8	7	382.14	764.28	15	1	0.355732863367637	-0.934065934065934	1	-0.161904761904762	15	35
BZW1	1	15	1	5	414.48	828.96	15	1	0.480519480519481	-2	1	-0.104166666666667	6	16
BZW2	0	8	0	3	415.8	831.6	15	1	1	NA	1	0	3	8
C10H15orf40	1	3	0	0	121.11	242.22	15	1	1	NA	1	NA	0	4
C10H15ORF58	15	14	1	3	594	1188	15	1	0.601173020527859	0.688888888888889	1	0.267241379310345	4	29
C10H15ORF59	0	2	0	3	85.47	170.94	15	1	1	NA	1	0	3	2
C10orf10	11	13	3	2	330.66	661.32	15	1	0.651340996168582	-0.772727272727273	1	-0.141666666666667	5	24
C10orf128	1	0	2	0	103.29	206.58	15	1	1	NA	1	0	2	1
C11H16orf70	0	12	1	1	410.52	821.04	15	1	0.142857142857143	-Inf	1	-0.5	2	12
C11H16ORF87	1	3	0	1	131.67	263.34	15	1	1	1	1	0.25	1	4
C11H19orf12-LOC100858381-LOC415756	4	7	0	3	140.58	281.16	15	1	0.505494505494506	1	1	0.363636363636364	3	11
C11orf24	45	23	9	0	469.26	938.52	15	1	0.0508294654367341	-Inf	0.841579763815338	-0.338235294117647	9	68
C11ORF52	2	0	1	2	117.81	235.62	15	1	0.4	1	1	0.666666666666667	3	2
C11orf63	47	28	13	5	767.25	1534.5	15	1	0.586156634968497	-0.548936170212766	1	-0.0955555555555555	18	75
C11orf97	1	2	2	0	84.15	168.3	15	1	0.4	-Inf	1	-0.666666666666667	2	3
C12H3orf14	3	3	0	0	130.68	261.36	15	1	1	NA	1	NA	0	6
C12H3orf18	2	1	1	1	155.43	310.86	15	1	1	0.5	1	0.166666666666667	2	3
C12H3ORF67	32	23	5	2	793.32	1586.64	15	1	0.691125074114041	-0.796875	1	-0.132467532467533	7	55
C12orf74-PLEKHG7	37	28	3	2	748.44	1496.88	15	1	1	-0.135135135135135	1	-0.0307692307692308	5	65
C12orf75	1	2	0	0	58.08	116.16	15	1	1	NA	1	NA	0	3
C13H5orf15	7	13	4	0	271.59	543.18	15	1	0.031055900621118	-Inf	0.774976578716492	-0.65	4	20
C14H16orf45	0	2	0	0	167.97	335.94	15	1	1	NA	1	NA	0	2
C14H16ORF52	0	7	0	0	166.32	332.64	15	1	1	NA	1	NA	0	7
C14H16orf62	8	34	4	1	948.75	1897.5	15	1	0.0118107695286449	-16	0.596226042284133	-0.60952380952381	5	42
C14H7orf50	6	5	0	0	163.35	326.7	15	1	1	NA	1	NA	0	11
C14orf132	1	3	0	0	111.54	223.08	15	1	1	NA	1	NA	0	4
C14ORF166B	8	12	0	0	312.84	625.68	15	1	1	NA	1	NA	0	20
C14orf180	4	6	3	0	135.63	271.26	15	1	0.192307692307693	-Inf	1	-0.6	3	10
C14ORF39	12	14	3	1	583.11	1166.22	15	1	0.597701149425287	-2.5	1	-0.288461538461538	4	26
C15H12orf49	4	9	2	1	127.71	255.42	15	1	0.517857142857143	-3.5	1	-0.358974358974359	3	13
C15H12ORF65	2	5	3	1	158.4	316.8	15	1	0.242424242424243	-6.5	1	-0.464285714285714	4	7
C15orf39-MUC1	60	57	22	17	905.85	1811.7	15	1	0.71148647092392	-0.229411764705882	1	-0.0512820512820513	39	117
C16orf72	0	2	0	0	206.91	413.82	15	1	1	NA	1	NA	0	2
C17H9orf16	0	1	1	1	60.72	121.44	15	1	1	-Inf	1	-0.5	2	1
C17H9orf78	0	11	1	2	259.71	519.42	15	1	0.214285714285714	-Inf	1	-0.333333333333333	3	11
C17ORF80	9	10	4	0	148.17	296.34	15	1	0.10446075663467	-Inf	0.983379501385042	-0.526315789473684	4	19
C18H17orf58	9	21	2	0	380.16	760.32	15	1	0.110887096774194	-Inf	0.98538656216834	-0.7	2	30
C18H17orf62	3	8	0	1	189.09	378.18	15	1	1	1	1	0.272727272727273	1	11
C18H17orf75	6	14	1	3	358.05	716.1	15	1	1	0.222222222222222	1	0.05	4	20
C18orf63	36	30	8	4	640.53	1281.06	15	1	0.535891622312187	-0.666666666666667	1	-0.121212121212121	12	66
C19H17ORF64	8	12	3	1	178.2	356.4	15	1	0.300207039337474	-3.5	1	-0.35	4	20
C19H17orf78	30	10	3	3	259.38	518.76	15	1	0.329854884566468	0.666666666666667	1	0.25	6	40
C19orf24	0	2	1	0	66.99	133.98	15	1	0.333333333333333	-Inf	1	-1	1	2
C19orf35	19	22	1	0	438.57	877.14	15	1	0.476190476190476	-Inf	1	-0.536585365853659	1	41
C19orf45	25	24	4	1	438.57	877.14	15	1	0.358104796506572	-2.84	1	-0.289795918367347	5	49
C19orf70	5	2	2	0	101.31	202.62	15	1	1	-Inf	1	-0.285714285714286	2	7
C1D	10	6	4	0	166.32	332.64	15	1	0.267492260061919	-Inf	1	-0.375	4	16
C1GALT1	6	15	1	4	363.33	726.66	15	1	1	0.375	1	0.0857142857142857	5	21
C1GALT1C1	8	17	1	2	307.89	615.78	15	1	1	-0.0625	1	-0.0133333333333333	3	25
C1H11ORF54	2	16	2	6	313.83	627.66	15	1	0.563344481605351	-1.66666666666667	1	-0.138888888888889	8	18
C1H11ORF70	8	10	3	2	264.66	529.32	15	1	0.64040536122916	-0.875	1	-0.155555555555556	5	18
C1H11ORF87	2	4	1	1	172.92	345.84	15	1	1	-1	1	-0.166666666666667	2	6
C1H12ORF45	7	6	2	1	162.36	324.72	15	1	1	-0.714285714285714	1	-0.128205128205128	3	13
C1H12ORF57	0	1	0	2	112.86	225.72	15	1	1	NA	1	0	2	1
C1H12ORF66	0	9	0	3	392.7	785.4	15	1	1	NA	1	0	3	9
C1H12ORF73	2	1	0	2	50.82	101.64	15	1	0.4	1	1	0.666666666666667	2	3
C1H21ORF33	1	4	1	0	191.07	382.14	15	1	0.333333333333333	-Inf	1	-0.8	1	5
C1H21ORF59	4	21	3	2	274.56	549.12	15	1	0.0679339817270851	-6.875	0.887960242513107	-0.44	5	25
C1H21ORF62	0	6	2	1	223.74	447.48	15	1	0.0833333333333333	-Inf	0.949431371776132	-0.666666666666667	3	6
C1H21ORF91	0	4	0	0	105.6	211.2	15	1	1	NA	1	NA	0	4
C1H22orf23	6	11	5	2	183.15	366.3	15	1	0.181922196796339	-3.58333333333333	1	-0.361344537815126	7	17
C1H2ORF40	0	3	0	2	138.27	276.54	15	1	1	NA	1	0	2	3
C1H2ORF49	1	9	2	1	239.58	479.16	15	1	0.108391608391608	-17	0.985224113668503	-0.566666666666667	3	10
C1H3ORF30	16	6	1	1	145.86	291.72	15	1	0.507246376811594	0.625	1	0.227272727272727	2	22
C1H3ORF38	8	10	1	1	287.43	574.86	15	1	1	-0.25	1	-0.0555555555555556	2	18
C1HXORF36	6	12	5	3	427.68	855.36	15	1	0.218306636155606	-2.33333333333333	1	-0.291666666666667	8	18
C1HXORF59	71	58	14	5	2074.71	4149.42	15	1	0.14323873173895	-1.28732394366197	1	-0.186454508363933	19	129
C1orf158	15	10	3	1	215.82	431.64	15	1	1	-1	1	-0.15	4	25
C1orf167	94	78	14	9	1577.73	3155.46	15	1	0.658324743183563	-0.290780141843972	1	-0.0621840242669364	23	172
C1orf186	4	9	1	2	98.01	196.02	15	1	1	-0.125	1	-0.0256410256410256	3	13
C1orf210	17	22	5	3	351.12	702.24	15	1	0.445537305447275	-1.15686274509804	1	-0.189102564102564	8	39
C1orf228	22	25	7	4	427.02	854.04	15	1	0.504497926280741	-0.988636363636364	1	-0.168278529980658	11	47
C1QA	11	15	5	9	241.56	483.12	15	1	0.746211506278247	0.242424242424242	1	0.0659340659340659	14	26
C1QB	4	9	2	7	242.55	485.1	15	1	1	0.357142857142857	1	0.0854700854700855	9	13
C1QBP	0	7	1	1	198.66	397.32	15	1	0.222222222222222	-Inf	1	-0.5	2	7
C1QC	12	19	4	7	243.54	487.08	15	1	1	0.0952380952380952	1	0.0234604105571847	11	31
C1QL1	0	2	0	2	117.81	235.62	15	1	1	NA	1	0	2	2
C1QL2	0	3	0	0	93.06	186.12	15	1	1	NA	1	NA	0	3
C1QL3	0	1	0	1	79.2	158.4	15	1	1	NA	1	0	1	1
C1QL4	0	7	0	3	158.73	317.46	15	1	1	NA	1	0	3	7
C1QTNF1	2	7	2	5	240.9	481.8	15	1	1	-0.4	1	-0.0634920634920635	7	9
C1QTNF2	0	21	1	1	282.15	564.3	15	1	0.0869565217391305	-Inf	0.951277979139867	-0.5	2	21
C1QTNF3	1	11	0	0	286.11	572.22	15	1	1	NA	1	NA	0	12
C1QTNF4	5	13	2	4	364.32	728.64	15	1	1	-0.3	1	-0.0555555555555555	6	18
C1QTNF5	1	3	0	4	139.92	279.84	15	1	1	1	1	0.25	4	4
C1QTNF6	0	10	0	0	257.4	514.8	15	1	1	NA	1	NA	0	10
C1QTNF7	2	11	0	1	287.1	574.2	15	1	1	1	1	0.153846153846154	1	13
C1QTNF8	6	15	6	4	255.42	510.84	15	1	0.127134199649555	-2.75	1	-0.314285714285714	10	21
C1QTNF9	5	10	4	3	341.55	683.1	15	1	0.376160990712074	-1.66666666666667	1	-0.238095238095238	7	15
C1R	13	25	4	5	705.87	1411.74	15	1	0.703689683084196	-0.538461538461539	1	-0.10233918128655	9	38
C1S	17	23	5	4	684.09	1368.18	15	1	0.712556484439518	-0.691176470588235	1	-0.130555555555556	9	40
C20H20ORF112	1	18	2	14	524.04	1048.08	15	1	0.581970970206264	-1.57142857142857	1	-0.0723684210526316	16	19
C20H20ORF195	26	17	6	3	484.77	969.54	15	1	1	-0.307692307692308	1	-0.062015503875969	9	43
C20H20orf204	2	0	0	1	23.76	47.52	15	1	0.333333333333333	1	1	1	1	2
C20H20ORF24	0	2	0	0	91.08	182.16	15	1	1	NA	1	NA	0	2
C20H20ORF85	7	2	1	0	130.68	261.36	15	1	1	-Inf	1	-0.222222222222222	1	9
C20H20orf96	30	33	7	5	356.4	712.8	15	1	0.543746393985328	-0.54	1	-0.107142857142857	12	63
C20orf27	0	3	1	2	80.19	160.38	15	1	1	-Inf	1	-0.333333333333333	3	3
C21H1orf159	0	3	1	3	199.98	399.96	15	1	1	-Inf	1	-0.25	4	3
C21H1orf174	5	4	1	0	204.6	409.2	15	1	1	-Inf	1	-0.444444444444444	1	9
C21H1orf50	1	11	1	0	132.66	265.32	15	1	0.153846153846154	-Inf	1	-0.916666666666667	1	12
C21orf140	10	11	3	3	251.46	502.92	15	1	1	-0.1	1	-0.0238095238095238	6	21
C22H2ORF42	4	12	2	7	371.25	742.5	15	1	1	0.142857142857143	1	0.0277777777777778	9	16
C22H8ORF4	1	5	0	2	105.93	211.86	15	1	1	1	1	0.166666666666667	2	6
C22orf39	2	3	0	1	47.52	95.04	15	1	1	1	1	0.4	1	5
C23H1ORF109	12	5	1	1	120.78	241.56	15	1	1	0.583333333333333	1	0.205882352941177	2	17
C23H1orf216	6	5	2	1	163.68	327.36	15	1	1	-0.666666666666667	1	-0.121212121212121	3	11
C23H1ORF94	15	18	5	2	374.22	748.44	15	1	0.407484407484408	-2	1	-0.25974025974026	7	33
C24H11orf1	11	7	3	1	164.34	328.68	15	1	1	-0.909090909090909	1	-0.138888888888889	4	18
C24H11orf34	10	6	2	1	179.19	358.38	15	1	1	-0.2	1	-0.0416666666666666	3	16
C24H11orf57	6	7	2	4	283.14	566.28	15	1	1	0.416666666666667	1	0.128205128205128	6	13
C25H1ORF43	0	11	1	1	223.08	446.16	15	1	0.153846153846154	-Inf	1	-0.5	2	11
C26H1orf116	26	19	5	8	500.94	1001.88	15	1	0.344312025978808	0.543269230769231	1	0.193162393162393	13	45
C26H1orf74	8	12	2	1	133.65	267.3	15	1	0.55957086391869	-2	1	-0.266666666666667	3	20
C26H6orf106	0	5	0	4	241.56	483.12	15	1	1	NA	1	0	4	5
C26H6ORF125	0	1	1	0	73.92	147.84	15	1	1	-Inf	1	-1	1	1
C28H19ORF44	41	38	11	12	635.58	1271.16	15	1	0.81455829943303	0.150406504065041	1	0.0407264722069345	23	79
C2CD2	12	21	5	2	604.89	1209.78	15	1	0.113434183171025	-3.375	0.993578077557528	-0.350649350649351	7	33
C2CD2L	12	24	1	6	592.68	1185.36	15	1	0.411828731737977	0.666666666666667	1	0.19047619047619	7	36
C2CD3	157	175	56	42	2206.38	4412.76	15	1	0.107229282835981	-0.48619957537155	0.983875031494079	-0.0985370051635112	98	332
C2CD4A	4	21	1	0	429.66	859.32	15	1	0.192307692307692	-Inf	1	-0.84	1	25
C2CD4C	2	25	1	5	301.62	603.24	15	1	0.463892961876833	-1.5	1	-0.0925925925925926	6	27
C2CD5	2	20	1	1	994.95	1989.9	15	1	0.239130434782609	-9	1	-0.409090909090909	2	22
C2H18ORF21	20	14	2	4	327.03	654.06	15	1	0.381031841558157	0.65	1	0.254901960784314	6	34
C2H18ORF8	4	20	1	5	636.9	1273.8	15	1	1	0	1	0	6	24
C2H1orf35	7	5	4	5	193.71	387.42	15	1	0.66992140985949	0.428571428571429	1	0.138888888888889	9	12
C2H6orf52	4	4	0	0	256.41	512.82	15	1	1	NA	1	NA	0	8
C2H6ORF62	0	1	0	1	227.7	455.4	15	1	1	NA	1	0	1	1
C2H7orf31	23	17	4	2	394.02	788.04	15	1	1	-0.478260869565217	1	-0.0916666666666667	6	40
C2H7ORF57	7	8	0	3	147.51	295.02	15	1	0.245098039215686	1	1	0.466666666666667	3	15
C2H8ORF22	4	4	0	0	85.14	170.28	15	1	1	NA	1	NA	0	8
C2H8ORF34	13	12	1	0	383.13	766.26	15	1	1	-Inf	1	-0.48	1	25
C2H8ORF37	3	9	2	1	210.87	421.74	15	1	0.241758241758242	-5	1	-0.416666666666667	3	12
C2H8ORF46	9	9	3	3	164.67	329.34	15	1	1	0	1	0	6	18
C2H8ORF76	30	20	6	4	356.73	713.46	15	1	1	0	1	0	10	50
C2orf71	47	53	19	8	1267.86	2535.72	15	1	0.0495006163188788	-1.6781914893617	0.837400931738441	-0.233703703703704	27	100
C2orf72	1	5	0	0	100.98	201.96	15	1	1	NA	1	NA	0	6
C2orf88	1	5	0	0	87.12	174.24	15	1	1	NA	1	NA	0	6
C3AR1	20	21	5	3	463.32	926.64	15	1	0.701939162602201	-0.75	1	-0.13719512195122	8	41
C3H1ORF115	0	1	1	0	74.91	149.82	15	1	1	-Inf	1	-1	1	1
C3H1ORF131	6	4	1	0	155.76	311.52	15	1	1	-Inf	1	-0.4	1	10
C3H1ORF198	1	4	1	3	217.8	435.6	15	1	1	-0.333333333333333	1	-0.05	4	5
C3H1orf95	0	2	0	0	82.17	164.34	15	1	1	NA	1	NA	0	2
C3H2ORF3-GCFC2-LOC112530730	31	24	7	0	782.76	1565.52	15	1	0.0367652490294394	-Inf	0.788199921465956	-0.436363636363636	7	55
C3H2ORF70	7	3	0	2	125.73	251.46	15	1	0.151515151515152	1	1	0.7	2	10
C3H6orf120	3	7	2	3	170.28	340.56	15	1	1	-0.555555555555556	1	-0.1	5	10
C3H6ORF203	7	13	2	3	223.74	447.48	15	1	1	-0.238095238095238	1	-0.05	5	20
C3H8ORF80	41	43	8	8	751.41	1502.82	15	1	1	-0.0487804878048781	1	-0.0119047619047619	16	84
C3orf33	6	16	2	5	214.83	429.66	15	1	1	-0.0666666666666667	1	-0.012987012987013	7	22
C3orf70	1	8	3	3	170.61	341.22	15	1	0.235164835164835	-7	1	-0.388888888888889	6	9
C4A	57	77	9	12	1657.26	3314.52	15	1	1	-0.013157894736842	1	-0.00319829424307033	21	134
C4BPA	96	128	25	30	2129.16	4258.32	15	1	0.762640729802378	-0.111111111111111	1	-0.025974025974026	55	224
C4H20ORF194	17	39	8	8	1116.06	2232.12	15	1	0.232706619545243	-1.29411764705882	1	-0.196428571428571	16	56
C4H2orf81	23	18	8	2	267.96	535.92	15	1	0.280051296930677	-2.1304347826087	1	-0.239024390243902	10	41
C4H4orf17	27	21	6	3	333.63	667.26	15	1	0.719675111966718	-0.555555555555556	1	-0.104166666666667	9	48
C4H4ORF32	0	6	0	0	86.46	172.92	15	1	1	NA	1	NA	0	6
C4H4orf33	2	5	0	0	83.16	166.32	15	1	1	NA	1	NA	0	7
C4H4ORF47	15	12	4	4	370.26	740.52	15	1	1	0.2	1	0.0555555555555556	8	27
C4H4ORF50	117	56	7	4	2012.34	4024.68	15	1	0.750801382422698	0.162393162393162	1	0.0399369416710458	11	173
C4HCXorf57	23	29	2	3	702.9	1405.8	15	1	1	0.159420289855073	1	0.0423076923076923	5	52
C4HXorf56	0	9	0	0	168.63	337.26	15	1	1	NA	1	NA	0	9
C4ORF19	18	10	5	6	325.71	651.42	15	1	0.306885900290337	0.537037037037037	1	0.188311688311688	11	28
C5	38	51	4	16	1658.91	3317.82	15	1	0.0763019039393167	0.664473684210526	0.919736921581953	0.226966292134831	20	89
C5H11orf16	29	20	10	7	397.98	795.96	15	1	1	0.0147783251231527	1	0.00360144057623046	17	49
C5H11orf58	0	5	0	2	137.28	274.56	15	1	1	NA	1	0	2	5
C5H11orf74	20	10	2	1	254.43	508.86	15	1	1	0	1	0	3	30
C5H11ORF9	8	25	3	11	1024.32	2048.64	15	1	1	0.147727272727273	1	0.0281385281385282	14	33
C5H14orf1	1	3	0	0	73.26	146.52	15	1	1	NA	1	NA	0	4
C5H14ORF105	25	14	5	3	280.17	560.34	15	1	1	0.0666666666666667	1	0.0160256410256411	8	39
C5H14orf159	15	25	7	2	611.82	1223.64	15	1	0.0596365416572437	-4.83333333333333	0.86933944179098	-0.402777777777778	9	40
C5H14orf166	1	21	0	4	224.07	448.14	15	1	1	1	1	0.0454545454545455	4	22
C5H14ORF169	8	20	3	8	465.96	931.92	15	1	1	0.0625	1	0.012987012987013	11	28
C5H14orf37	34	48	8	4	739.53	1479.06	15	1	0.126390964333375	-1.82352941176471	1	-0.252032520325203	12	82
C5H14orf4	1	22	1	7	448.47	896.94	15	1	0.455913978494624	-2.14285714285714	1	-0.0815217391304348	8	23
C5H14orf79	20	8	2	3	289.08	578.16	15	1	0.30408787541713	0.733333333333333	1	0.314285714285714	5	28
C5H15orf41	0	5	0	1	156.75	313.5	15	1	1	NA	1	0	1	5
C5H15orf52	13	20	5	3	629.64	1259.28	15	1	0.267398631968593	-1.56410256410256	1	-0.231060606060606	8	33
C5H15orf57	3	12	0	3	176.22	352.44	15	1	1	1	1	0.2	3	15
C5H15ORF62	3	6	0	3	175.23	350.46	15	1	0.509090909090909	1	1	0.333333333333333	3	9
C5NT1AL	10	16	4	5	361.35	722.7	15	1	1	-0.28	1	-0.0598290598290598	9	26
C6	23	37	3	7	918.06	1836.12	15	1	0.733976244388534	0.31055900621118	1	0.0833333333333334	10	60
C6H10orf53	4	5	0	1	92.07	184.14	15	1	1	1	1	0.444444444444444	1	9
C6H10orf54	2	6	0	1	229.35	458.7	15	1	1	1	1	0.25	1	8
C6H10ORF71	51	38	12	6	1414.71	2829.42	15	1	0.601471382556449	-0.490196078431373	1	-0.0936329588014981	18	89
C6H10ORF88	9	9	7	0	355.08	710.16	15	1	0.0266694403994175	-Inf	0.761210061313465	-0.5	7	18
C6H10ORF90	38	23	6	7	726.66	1453.32	15	1	0.355617046829368	0.481203007518797	1	0.16141235813367	13	61
C6orf132	31	54	9	4	704.55	1409.1	15	1	0.0344543118725545	-2.91935483870968	0.788199921465956	-0.327601809954751	13	85
C6orf58	14	17	4	3	382.14	764.28	15	1	0.686732186732187	-0.619047619047619	1	-0.119815668202765	7	31
C7	27	32	2	1	813.12	1626.24	15	1	0.595134849286092	-1.37037037037037	1	-0.209039548022599	3	59
C7H2ORF47	1	6	2	2	189.42	378.84	15	1	0.490909090909091	-5	1	-0.357142857142857	4	7
C7H2ORF69	12	6	2	3	297.99	595.98	15	1	0.342833368004993	0.666666666666667	1	0.266666666666667	5	18
C7H2ORF76	1	6	1	2	125.73	251.46	15	1	1	-2	1	-0.19047619047619	3	7
C7orf49	2	1	1	0	22.44	44.88	15	1	1	-Inf	1	-0.333333333333333	1	3
C8A	18	33	1	4	594	1188	15	1	0.652163873861987	0.541666666666667	1	0.152941176470588	5	51
C8B	20	31	7	11	1151.37	2302.74	15	1	1	0.0136363636363637	1	0.00326797385620914	18	51
C8G	6	5	2	0	137.28	274.56	15	1	0.487179487179487	-Inf	1	-0.454545454545455	2	11
C8H14ORF80	17	15	10	5	414.81	829.62	15	1	0.529332255222602	-0.764705882352941	1	-0.135416666666667	15	32
C8H1ORF112	5	24	5	5	795.96	1591.92	15	1	0.0871434089001252	-3.8	0.951277979139867	-0.327586206896552	10	29
C8H1orf123	1	4	1	2	157.41	314.82	15	1	1	-1	1	-0.133333333333333	3	5
C8H1ORF146	6	3	1	2	175.23	350.46	15	1	0.522727272727273	0.75	1	0.333333333333333	3	9
C8H1orf168	42	23	13	7	591.03	1182.06	15	1	1	-0.0170068027210883	1	-0.00384615384615383	20	65
C8H1ORF21	0	2	0	2	120.78	241.56	15	1	1	NA	1	0	2	2
C8H1orf27	10	11	1	2	419.76	839.52	15	1	1	0.45	1	0.142857142857143	3	21
C8H1orf52	2	2	2	0	98.34	196.68	15	1	0.466666666666667	-Inf	1	-0.5	2	4
C8orf59	4	3	0	0	61.38	122.76	15	1	1	NA	1	NA	0	7
C9H21orf2	2	7	0	2	227.04	454.08	15	1	1	1	1	0.222222222222222	2	9
C9H2orf54	14	16	9	6	400.95	801.9	15	1	0.53021377872484	-0.714285714285714	1	-0.133333333333333	15	30
C9H2ORF82	3	9	0	3	121.77	243.54	15	1	1	1	1	0.25	3	12
C9H3orf58	2	7	3	1	284.46	568.92	15	1	0.216783216783217	-9.5	1	-0.527777777777778	4	9
C9orf116	4	3	2	0	47.19	94.38	15	1	0.5	-Inf	1	-0.428571428571429	2	7
C9ORF58	0	1	1	2	114.84	229.68	15	1	1	-Inf	1	-0.333333333333333	3	1
C9orf69	0	5	0	3	138.6	277.2	15	1	1	NA	1	0	3	5
C9orf84	114	52	13	9	1508.1	3016.2	15	1	0.467418185817523	0.341130604288499	1	0.0958378970427163	22	166
C9orf85	6	7	2	0	133.98	267.96	15	1	0.466666666666667	-Inf	1	-0.538461538461538	2	13
CA10	0	7	0	1	205.92	411.84	15	1	1	NA	1	0	1	7
CA12	6	8	2	2	338.58	677.16	15	1	1	-0.333333333333333	1	-0.0714285714285715	4	14
CA13	2	9	0	0	194.7	389.4	15	1	1	NA	1	NA	0	11
CA15L	9	9	5	8	255.42	510.84	15	1	0.716841341638179	0.375	1	0.115384615384615	13	18
CA2	3	12	1	0	258.39	516.78	15	1	0.25	-Inf	1	-0.8	1	15
CA3A	3	10	2	1	260.37	520.74	15	1	0.214285714285714	-5.66666666666667	1	-0.435897435897436	3	13
CA3B	1	8	1	1	263.34	526.68	15	1	0.345454545454545	-7	1	-0.388888888888889	2	9
CA4	12	14	3	4	313.83	627.66	15	1	1	0.125	1	0.032967032967033	7	26
CA5A	1	18	0	3	288.09	576.18	15	1	1	1	1	0.0526315789473684	3	19
CA6	17	29	6	6	513.81	1027.62	15	1	0.512575017508568	-0.705882352941176	1	-0.130434782608696	12	46
CA7	2	7	0	0	262.35	524.7	15	1	1	NA	1	NA	0	9
CA8	0	6	1	1	251.13	502.26	15	1	0.25	-Inf	1	-0.5	2	6
CA9	20	16	2	6	342.87	685.74	15	1	0.240444904086424	0.733333333333333	1	0.305555555555556	8	36
CAAP1	8	8	0	2	285.45	570.9	15	1	0.477124183006536	1	1	0.5	2	16
CAB39	0	9	0	0	338.58	677.16	15	1	1	NA	1	NA	0	9
CAB39L	0	9	0	3	331.65	663.3	15	1	1	NA	1	0	3	9
CABIN1	23	84	4	13	2030.82	4061.64	15	1	1	-0.123745819397993	1	-0.0203408466190214	17	107
CABLES2	12	19	5	1	468.93	937.86	15	1	0.0752310752310753	-6.91666666666667	0.916285648878989	-0.446236559139785	6	31
CABYR	48	22	4	1	464.97	929.94	15	1	1	-0.833333333333333	1	-0.114285714285714	5	70
CACFD1	1	3	1	2	151.8	303.6	15	1	1	-0.5	1	-0.0833333333333333	3	4
CACNA1B	5	64	8	37	2109.36	4218.72	15	1	0.129745796295217	-1.76756756756757	1	-0.105314009661836	45	69
CACNA1C	1	16	5	13	933.24	1866.48	15	1	0.17741935483871	-5.15384615384615	1	-0.218954248366013	18	17
CACNA1D	6	58	6	10	2113.65	4227.3	15	1	0.0115573162410668	-4.8	0.593603434168836	-0.28125	16	64
CACNA1E	6	61	20	55	1894.53	3789.06	15	1	0.00849223363210952	-2.6969696969697	0.54233354502865	-0.177114427860697	75	67
CACNA1G	24	73	11	40	2292.18	4584.36	15	1	0.838944946046386	0.163541666666667	1	0.0317364059025672	51	97
CACNA1H	20	84	9	28	2262.15	4524.3	15	1	0.489114024033714	-0.35	1	-0.0509355509355509	37	104
CACNA1I	25	63	8	25	2221.56	4443.12	15	1	0.819196250050017	0.1936	1	0.0416666666666667	33	88
CACNA1S	20	90	12	36	1761.87	3523.74	15	1	0.389937757021795	-0.5	1	-0.0681818181818182	48	110
CACNA2D1	10	21	2	1	835.89	1671.78	15	1	0.279411764705882	-3.2	1	-0.344086021505376	3	31
CACNA2D2	5	32	2	19	872.52	1745.04	15	1	1	0.326315789473684	1	0.0398970398970399	21	37
CACNA2D4	6	35	4	6	814.44	1628.88	15	1	0.0904444394080707	-2.88888888888889	0.953786405978059	-0.253658536585366	10	41
CACNG1	1	10	0	1	224.73	449.46	15	1	1	1	1	0.0909090909090909	1	11
CACNG2	1	2	0	3	231.99	463.98	15	1	1	1	1	0.333333333333333	3	3
CACNG3	1	7	1	4	256.41	512.82	15	1	1	-0.75	1	-0.075	5	8
CACNG4	1	5	0	0	275.55	551.1	15	1	1	NA	1	NA	0	6
CACNG5	0	21	0	4	277.2	554.4	15	1	1	NA	1	0	4	21
CACTIN	6	24	2	6	688.38	1376.76	15	1	1	-0.333333333333333	1	-0.05	8	30
CACUL1	0	6	0	0	245.19	490.38	15	1	1	NA	1	NA	0	6
CACYBP	2	9	0	3	219.78	439.56	15	1	1	1	1	0.181818181818182	3	11
CADM1	2	2	1	2	427.68	855.36	15	1	1	0.5	1	0.166666666666667	3	4
CADM3	23	11	5	3	381.48	762.96	15	1	1	0.202898550724638	1	0.0514705882352942	8	34
CADNL	57	32	5	1	997.92	1995.84	15	1	0.661098237659901	-1.80701754385965	1	-0.192883895131086	6	89
CADPS	0	23	0	4	493.35	986.7	15	1	1	NA	1	0	4	23
CADPS2	13	51	2	5	1119.69	2239.38	15	1	0.633784537203754	-0.569230769230769	1	-0.0825892857142857	7	64
CALCB	1	3	0	0	137.61	275.22	15	1	1	NA	1	NA	0	4
CALCOCO2	21	15	1	2	442.53	885.06	15	1	0.570303096618886	0.642857142857143	1	0.25	3	36
CALCR	0	20	1	1	465.3	930.6	15	1	0.0909090909090909	-Inf	0.953786405978059	-0.5	2	20
CALCRL	0	11	0	1	419.76	839.52	15	1	1	NA	1	0	1	11
CALD1	5	9	1	2	396.99	793.98	15	1	1	0.1	1	0.0238095238095238	3	14
CALHM1	3	18	2	2	258.39	516.78	15	1	0.166403162055336	-5	1	-0.357142857142857	4	21
CALHM2	0	21	0	1	316.8	633.6	15	1	1	NA	1	0	1	21
CALHM3	13	17	6	1	326.7	653.4	15	1	0.0896805896805896	-6.84615384615385	0.953786405978059	-0.423809523809524	7	30
CALML3	0	3	0	2	147.51	295.02	15	1	1	NA	1	0	2	3
CALML4	0	9	0	1	152.46	304.92	15	1	1	NA	1	0	1	9
CALN1	9	3	2	2	249.48	498.96	15	1	0.546703296703297	0.666666666666667	1	0.25	4	12
CAMK1G	4	33	1	5	472.23	944.46	15	1	0.547166106723679	-0.65	1	-0.0585585585585585	6	37
CAMK2A	1	8	14	17	455.73	911.46	15	1	0.116568938550363	-5.58823529411765	1	-0.340501792114695	31	9
CAMK2D	5	10	1	1	469.26	938.52	15	1	1	-1	1	-0.166666666666667	2	15
CAMK2G	0	10	0	3	512.49	1024.98	15	1	1	NA	1	0	3	10
CAMK4	3	3	1	0	178.2	356.4	15	1	1	-Inf	1	-0.5	1	6
CAMK4L	3	13	1	4	306.9	613.8	15	1	1	-0.0833333333333333	1	-0.0125	5	16
CAMKK1	11	30	5	6	508.53	1017.06	15	1	0.28090926778619	-1.27272727272727	1	-0.186252771618625	11	41
CAMKK2	7	19	2	13	542.52	1085.04	15	1	0.444704086401587	0.582417582417582	1	0.135897435897436	15	26
CAMLG	5	16	3	3	255.75	511.5	15	1	0.319104084321476	-2.2	1	-0.261904761904762	6	21
CAMSAP1	7	76	8	9	1578.06	3156.12	15	1	0.000436952435445557	-8.65079365079365	0.164755839006111	-0.386250885896527	17	83
CAMSAP2	23	53	4	6	1383.03	2766.06	15	1	0.718189259676003	-0.536231884057971	1	-0.0973684210526316	10	76
CAMTA1	17	52	1	0	1635.81	3271.62	15	1	0.257142857142857	-Inf	1	-0.753623188405797	1	69
CAND1	1	29	1	7	1218.03	2436.06	15	1	0.38122332859175	-3.14285714285714	1	-0.0916666666666667	8	30
CAND2	12	63	8	15	1212.42	2424.84	15	1	0.0741042285624616	-1.8	0.913861472365723	-0.187826086956522	23	75
CANT1	2	12	3	6	393.69	787.38	15	1	0.342833368004993	-2	1	-0.19047619047619	9	14
CANX	4	19	3	4	599.94	1199.88	15	1	0.305797229590333	-2.5625	1	-0.254658385093168	7	23
CAP1	5	22	0	1	437.91	875.82	15	1	1	1	1	0.185185185185185	1	27
CAP2	3	21	1	3	474.21	948.42	15	1	0.481025641025641	-1.33333333333333	1	-0.125	4	24
CAPG	0	2	3	1	144.54	289.08	15	1	0.4	-Inf	1	-0.75	4	2
CAPN10	5	24	4	6	665.28	1330.56	15	1	0.197042002644719	-2.2	1	-0.227586206896552	10	29
CAPN11	5	24	1	8	696.3	1392.6	15	1	1	0.4	1	0.0613026819923372	9	29
CAPN13	21	26	4	2	598.95	1197.9	15	1	0.404233391469796	-1.47619047619048	1	-0.219858156028369	6	47
CAPN15	5	38	3	24	1025.31	2050.62	15	1	1	0.05	1	0.00516795865633075	27	43
CAPN2	6	28	1	7	684.09	1368.18	15	1	1	0.333333333333333	1	0.0514705882352941	8	34
CAPN3	5	34	3	4	797.94	1595.88	15	1	0.0890168796898927	-4.1	0.953357353910386	-0.3003663003663	7	39
CAPN5	5	30	2	6	779.13	1558.26	15	1	0.597032210102037	-1	1	-0.107142857142857	8	35
CAPN6	11	21	0	2	637.56	1275.12	15	1	1	1	1	0.34375	2	32
CAPN7	2	33	1	9	770.88	1541.76	15	1	0.53875968992248	-0.833333333333333	1	-0.0428571428571429	10	35
CAPN8	9	26	6	6	666.6	1333.2	15	1	0.157895605641779	-1.88888888888889	1	-0.242857142857143	12	35
CAPN9	7	31	8	7	687.06	1374.12	15	1	0.0179368970911255	-4.06122448979592	0.677255339142531	-0.349122807017544	15	38
CAPRIN2	10	30	3	4	1154.67	2309.34	15	1	0.376899571116917	-1.25	1	-0.178571428571429	7	40
CAPS2	30	10	6	3	589.05	1178.1	15	1	0.683069797553973	0.333333333333333	1	0.0833333333333334	9	40
CAPSL	0	9	0	1	206.91	413.82	15	1	1	NA	1	0	1	9
CAPZA1	0	9	0	0	271.26	542.52	15	1	1	NA	1	NA	0	9
CAPZA2	0	6	1	2	271.26	542.52	15	1	0.333333333333333	-Inf	1	-0.333333333333333	3	6
CAPZA3	15	5	1	1	274.23	548.46	15	1	0.48051948051948	0.666666666666667	1	0.25	2	20
CAPZB	0	9	0	1	274.23	548.46	15	1	1	NA	1	0	1	9
CARD10	14	40	6	18	1000.56	2001.12	15	1	1	0.0476190476190477	1	0.00925925925925924	24	54
CARD11	2	20	2	4	1123.65	2247.3	15	1	0.191452991452991	-4	1	-0.242424242424242	6	22
CARD19	1	3	1	0	178.86	357.72	15	1	0.4	-Inf	1	-0.75	1	4
CARD9	17	24	8	1	662.97	1325.94	15	1	0.0232154217451454	-10.2941176470588	0.735459686256967	-0.474254742547425	9	41
CARF	26	20	1	0	687.06	1374.12	15	1	1	-Inf	1	-0.434782608695652	1	46
CARHSP1	8	6	1	1	214.5	429	15	1	1	0.25	1	0.0714285714285714	2	14
CARMIL1	18	49	3	5	1609.41	3218.82	15	1	0.678520100853985	-0.633333333333333	1	-0.10634328358209	8	67
CARNMT1	6	11	1	1	307.23	614.46	15	1	1	-0.833333333333333	1	-0.147058823529412	2	17
CARS	10	41	10	6	1238.82	2477.64	15	1	0.00335336616032318	-5.83333333333333	0.408839692475765	-0.428921568627451	16	51
CARS2	17	18	2	8	500.61	1001.22	15	1	0.153562885837418	0.735294117647059	1	0.285714285714286	10	35
CARTPT	7	0	0	0	32.67	65.34	15	1	1	NA	1	NA	0	7
CASC1	26	27	3	1	707.85	1415.7	15	1	0.611483253588517	-2.11538461538462	1	-0.259433962264151	4	53
CASC3	12	34	3	10	484.11	968.22	15	1	1	0.15	1	0.0301003344481605	13	46
CASC4	5	5	2	1	377.52	755.04	15	1	1	-1	1	-0.166666666666667	3	10
CASD1	7	31	2	7	791.01	1582.02	15	1	1	-0.26530612244898	1	-0.0380116959064327	9	38
CASK	4	21	0	9	891	1782	15	1	0.55364843884768	1	1	0.16	9	25
CASKIN1	4	27	3	24	904.2	1808.4	15	1	1	0.15625	1	0.017921146953405	27	31
CASKIN2	21	54	18	21	1281.39	2562.78	15	1	0.0629405039327732	-1.20408163265306	0.878646123461792	-0.181538461538462	39	75
CASP1	18	22	3	3	357.39	714.78	15	1	1	-0.222222222222222	1	-0.05	6	40
CASP10	22	15	3	4	533.61	1067.22	15	1	0.443038526986343	0.488636363636364	1	0.166023166023166	7	37
CASP18	16	14	1	1	461.34	922.68	15	1	1	0.125	1	0.0333333333333333	2	30
CASP2	8	15	4	6	422.73	845.46	15	1	1	-0.25	1	-0.0521739130434783	10	23
CASP6	8	11	2	5	300.96	601.92	15	1	0.66798418972332	0.45	1	0.135338345864662	7	19
CASP7	0	10	0	0	306.9	613.8	15	1	1	NA	1	NA	0	10
CASP8	6	14	2	1	478.17	956.34	15	1	0.268774703557312	-3.66666666666667	1	-0.366666666666667	3	20
CASP8AP2	106	99	33	18	2283.27	4566.54	15	1	0.116391595022048	-0.712264150943396	1	-0.129985652797704	51	205
CASP9	18	21	3	7	366.3	732.6	15	1	0.482260829877819	0.5	1	0.161538461538462	10	39
CASQ2	2	16	3	6	391.71	783.42	15	1	0.294983277591973	-3	1	-0.222222222222222	9	18
CASR	3	37	2	7	1038.51	2077.02	15	1	0.223593044988578	-2.52380952380952	1	-0.147222222222222	9	40
CAST	30	27	11	5	597.96	1195.92	15	1	0.392964972051423	-0.98	1	-0.161184210526316	16	57
CASZ1	3	48	4	19	1874.07	3748.14	15	1	0.193643286350213	-2.36842105263158	1	-0.115089514066496	23	51
CAT	0	14	1	2	501.93	1003.86	15	1	0.176470588235294	-Inf	1	-0.333333333333333	3	14
CATH3	1	11	5	5	148.5	297	15	1	0.0557275541795665	-10	0.846060006968071	-0.416666666666667	10	12
CATIP	3	6	1	2	127.05	254.1	15	1	1	0	1	0	3	9
CAV1	0	5	0	3	112.86	225.72	15	1	1	NA	1	0	3	5
CAV2	1	6	2	1	130.02	260.04	15	1	0.183333333333333	-11	1	-0.523809523809524	3	7
CAV3	1	4	1	2	150.48	300.96	15	1	1	-1	1	-0.133333333333333	3	5
CBARP	1	0	1	2	71.28	142.56	15	1	1	1	1	0.666666666666667	3	1
CBFA2T2	2	23	2	8	557.7	1115.4	15	1	0.560733384262796	-1.875	1	-0.12	10	25
CBFA2T3	0	6	2	11	255.09	510.18	15	1	1	-Inf	1	-0.153846153846154	13	6
CBL	8	48	3	10	861.3	1722.6	15	1	0.42218928094532	-0.8	1	-0.0879120879120879	13	56
CBLL1	1	23	1	5	375.87	751.74	15	1	0.365517241379311	-3.6	1	-0.125	6	24
CBLN1	0	3	0	1	88.77	177.54	15	1	1	NA	1	0	1	3
CBLN2	0	5	0	0	150.81	301.62	15	1	1	NA	1	NA	0	5
CBLN4	0	3	0	0	118.14	236.28	15	1	1	NA	1	NA	0	3
CBR1	3	10	0	1	238.59	477.18	15	1	1	1	1	0.230769230769231	1	13
CBR4	3	4	3	1	235.62	471.24	15	1	0.545454545454546	-3	1	-0.321428571428571	4	7
CBS	2	23	1	8	561.33	1122.66	15	1	1	-0.4375	1	-0.0311111111111111	9	25
CBWD1	9	18	3	0	365.31	730.62	15	1	0.0541871921182267	-Inf	0.846060006968071	-0.666666666666667	3	27
CBX3	0	8	0	1	173.25	346.5	15	1	1	NA	1	0	1	8
CBX4	4	18	4	9	461.67	923.34	15	1	0.432722632990905	-1	1	-0.125874125874126	13	22
CBX6	2	5	0	7	269.28	538.56	15	1	0.461538461538462	1	1	0.285714285714286	7	7
CBX7	0	1	0	3	193.38	386.76	15	1	1	NA	1	0	3	1
CBX8	1	4	1	7	309.87	619.74	15	1	1	0.428571428571429	1	0.075	8	5
CBY1	0	7	0	1	124.74	249.48	15	1	1	NA	1	0	1	7
CC2D1B-LOC101748080	21	28	7	3	873.18	1746.36	15	1	0.168483445573724	-2.11111111111111	1	-0.271428571428571	10	49
CC2D2A	33	60	8	9	1516.35	3032.7	15	1	0.418382446141976	-0.616161616161616	1	-0.115749525616698	17	93
CCAH221-CCL26-CCLI7-CCLI8	12	4	7	3	117.81	235.62	15	1	1	0.222222222222222	1	0.05	10	16
CCBL1	18	30	6	15	772.2	1544.4	15	1	0.586932480670838	0.333333333333333	1	0.0892857142857143	21	48
CCDC102A	2	18	2	2	462.66	925.32	15	1	0.114906832298137	-8	1	-0.4	4	20
CCDC102B	24	3	4	0	226.71	453.42	15	1	1	-Inf	1	-0.111111111111111	4	27
CCDC107	7	8	3	4	256.08	512.16	15	1	1	0.142857142857143	1	0.0380952380952381	7	15
CCDC110	32	19	9	1	622.71	1245.42	15	1	0.144048938233978	-4.34375	1	-0.272549019607843	10	51
CCDC113	19	10	3	3	358.05	716.1	15	1	0.648481973434535	0.473684210526316	1	0.155172413793103	6	29
CCDC117	4	3	0	0	340.56	681.12	15	1	1	NA	1	NA	0	7
CCDC12	3	9	3	3	154.77	309.54	15	1	0.344053005817712	-2	1	-0.25	6	12
CCDC122	14	9	5	0	258.39	516.78	15	1	0.143956043956044	-Inf	1	-0.391304347826087	5	23
CCDC124	4	10	1	2	154.11	308.22	15	1	1	-0.25	1	-0.0476190476190476	3	14
CCDC125	23	7	3	2	178.2	356.4	15	1	0.585530693215703	0.543478260869565	1	0.166666666666667	5	30
CCDC126	3	7	1	2	138.6	277.2	15	1	1	-0.166666666666667	1	-0.0333333333333333	3	10
CCDC127	3	9	0	1	262.35	524.7	15	1	1	1	1	0.25	1	12
CCDC129	70	28	4	1	757.68	1515.36	15	1	1	-0.6	1	-0.0857142857142857	5	98
CCDC13	20	21	6	5	708.84	1417.68	15	1	1	-0.26	1	-0.0576496674057649	11	41
CCDC137	8	6	6	2	141.9	283.8	15	1	0.649398004815962	-1.25	1	-0.178571428571429	8	14
CCDC138	12	2	1	0	95.04	190.08	15	1	1	-Inf	1	-0.142857142857143	1	14
CCDC14	46	36	11	5	915.75	1831.5	15	1	0.415168335626605	-0.721739130434783	1	-0.126524390243902	16	82
CCDC146	47	26	8	7	959.31	1918.62	15	1	0.559292721256205	0.367781155015198	1	0.110502283105023	15	73
CCDC148	31	21	4	2	611.16	1222.32	15	1	1	-0.354838709677419	1	-0.0705128205128205	6	52
CCDC149	17	33	3	4	553.41	1106.82	15	1	0.686744073536526	-0.455882352941176	1	-0.0885714285714285	7	50
CCDC15	14	21	1	1	412.5	825	15	1	1	-0.5	1	-0.1	2	35
CCDC152Z	1	1	0	1	245.52	491.04	15	1	1	1	1	0.5	1	2
CCDC153	10	9	1	2	170.28	340.56	15	1	1	0.55	1	0.192982456140351	3	19
CCDC166	15	11	1	1	305.91	611.82	15	1	1	0.266666666666667	1	0.0769230769230769	2	26
CCDC167	1	4	1	0	85.8	171.6	15	1	0.333333333333333	-Inf	1	-0.8	1	5
CCDC169	9	5	2	0	207.9	415.8	15	1	1	-Inf	1	-0.357142857142857	2	14
CCDC17	18	15	13	7	218.79	437.58	15	1	0.568857653285473	-0.547619047619048	1	-0.104545454545455	20	33
CCDC170	34	28	7	5	824.01	1648.02	15	1	1	-0.152941176470588	1	-0.0349462365591399	12	62
CCDC171	7	4	2	1	1147.08	2294.16	15	1	1	-0.142857142857143	1	-0.0303030303030303	3	11
CCDC173	8	4	2	0	287.43	574.86	15	1	1	-Inf	1	-0.333333333333333	2	12
CCDC173L	16	7	6	2	311.52	623.04	15	1	1	-0.3125	1	-0.0543478260869565	8	23
CCDC174	24	22	7	4	644.49	1288.98	15	1	0.737506061183374	-0.604166666666667	1	-0.114624505928854	11	46
CCDC175-LOC112532521	39	22	11	2	743.16	1486.32	15	1	0.200455736285073	-2.1025641025641	1	-0.206809583858764	13	61
CCDC177	4	23	5	6	532.62	1065.24	15	1	0.0875189955760215	-3.79166666666667	0.951277979139867	-0.306397306397306	11	27
CCDC178	36	17	5	2	753.72	1507.44	15	1	1	-0.180555555555556	1	-0.0350404312668464	7	53
CCDC180-LOC112529956	78	65	14	5	1500.84	3001.68	15	1	0.142057135535386	-1.33333333333333	1	-0.191387559808612	19	143
CCDC181	15	15	2	2	520.74	1041.48	15	1	1	0	1	0	4	30
CCDC183	22	38	6	4	515.13	1030.26	15	1	0.183252239211715	-1.59090909090909	1	-0.233333333333333	10	60
CCDC186	23	36	2	4	907.83	1815.66	15	1	1	0.217391304347826	1	0.056497175141243	6	59
CCDC191	36	23	14	2	866.58	1733.16	15	1	0.0712629583423512	-3.47222222222222	0.908058284769907	-0.264830508474576	16	59
CCDC27	16	12	2	1	352.77	705.54	15	1	1	-0.5	1	-0.0952380952380952	3	28
CCDC28A	0	3	0	2	155.1	310.2	15	1	1	NA	1	0	2	3
CCDC28B	4	5	1	2	97.02	194.04	15	1	1	0.375	1	0.111111111111111	3	9
CCDC3	0	10	0	1	148.83	297.66	15	1	1	NA	1	0	1	10
CCDC30	51	37	13	5	1072.17	2144.34	15	1	0.301251165505916	-0.886274509803922	1	-0.142676767676768	18	88
CCDC33-LOC107052135	28	21	18	5	436.59	873.18	15	1	0.11525350648212	-1.7	1	-0.211180124223603	23	49
CCDC39	22	29	5	4	947.43	1894.86	15	1	0.718243482066214	-0.647727272727273	1	-0.124183006535948	9	51
CCDC40	26	35	8	6	937.53	1875.06	15	1	0.381205495144215	-0.794871794871795	1	-0.14519906323185	14	61
CCDC42	24	11	2	3	294.03	588.06	15	1	0.322348664453928	0.694444444444444	1	0.285714285714286	5	35
CCDC43	2	5	0	1	149.49	298.98	15	1	1	1	1	0.285714285714286	1	7
CCDC47	0	17	1	1	478.17	956.34	15	1	0.105263157894737	-Inf	0.983379501385042	-0.5	2	17
CCDC50	16	12	3	2	515.46	1030.92	15	1	1	-0.125	1	-0.0285714285714286	5	28
CCDC51	10	16	4	3	415.8	831.6	15	1	0.422054246581499	-1.13333333333333	1	-0.186813186813187	7	26
CCDC57	32	17	2	1	496.65	993.3	15	1	1	-0.0625	1	-0.0136054421768708	3	49
CCDC58	1	5	0	1	141.24	282.48	15	1	1	1	1	0.166666666666667	1	6
CCDC59	2	4	0	0	160.05	320.1	15	1	1	NA	1	NA	0	6
CCDC6	0	11	1	0	370.26	740.52	15	1	0.0833333333333334	-Inf	0.949431371776132	-1	1	11
CCDC60	8	5	1	1	134.64	269.28	15	1	1	0.375	1	0.115384615384615	2	13
CCDC63	21	23	8	3	547.47	1094.94	15	1	0.184772744906875	-1.92063492063492	1	-0.25	11	44
CCDC65	14	16	2	7	313.5	627	15	1	0.26173209754554	0.673469387755102	1	0.244444444444444	9	30
CCDC66	43	24	6	2	925.98	1851.96	15	1	0.706129890828737	-0.674418604651163	1	-0.108208955223881	8	67
CCDC69	9	9	4	5	263.01	526.02	15	1	1	0.2	1	0.0555555555555556	9	18
CCDC71	20	26	3	10	387.42	774.84	15	1	0.216268331435411	0.61	1	0.204013377926421	13	46
CCDC73	42	35	12	7	1016.73	2033.46	15	1	0.608759079163249	-0.428571428571429	1	-0.0861244019138756	19	77
CCDC77	10	12	2	1	422.07	844.14	15	1	0.593043478260869	-1.4	1	-0.212121212121212	3	22
CCDC80	13	39	10	7	912.78	1825.56	15	1	0.0168503246307519	-3.28571428571429	0.674707602339182	-0.338235294117647	17	52
CCDC82	20	20	2	1	464.31	928.62	15	1	1	-1	1	-0.166666666666667	3	40
CCDC83	23	16	0	1	463.98	927.96	15	1	0.425	1	1	0.58974358974359	1	39
CCDC84	7	8	0	2	170.61	341.22	15	1	0.485294117647059	1	1	0.466666666666667	2	15
CCDC85A	11	19	0	1	406.89	813.78	15	1	1	1	1	0.366666666666667	1	30
CCDC85C	4	14	2	2	419.43	838.86	15	1	0.291866028708134	-2.5	1	-0.277777777777778	4	18
CCDC88A	20	61	3	0	2020.59	4041.18	15	1	0.0185865412870996	-Inf	0.681883140836754	-0.753086419753086	3	81
CCDC88C	31	42	11	9	2005.74	4011.48	15	1	0.447425142516899	-0.655913978494624	1	-0.125342465753425	20	73
CCDC91	16	3	0	0	189.09	378.18	15	1	1	NA	1	NA	0	19
CCDC92	2	13	0	1	312.84	625.68	15	1	1	1	1	0.133333333333333	1	15
CCDC93	7	20	0	4	597.96	1195.92	15	1	0.54972191323693	1	1	0.259259259259259	4	27
CCDC96	27	4	0	2	246.18	492.36	15	1	0.0284090909090909	1	0.761210061313465	0.870967741935484	2	31
CCKAR	6	15	0	1	424.71	849.42	15	1	1	1	1	0.285714285714286	1	21
CCKBR	5	18	2	7	363	726	15	1	1	-0.0285714285714285	1	-0.00483091787439613	9	23
CCL1	5	3	2	1	65.01	130.02	15	1	1	-0.2	1	-0.0416666666666666	3	8
CCL17	8	4	2	1	94.05	188.1	15	1	1	0	1	0	3	12
CCL19	13	8	2	1	225.06	450.12	15	1	1	-0.230769230769231	1	-0.0476190476190476	3	21
CCL20	2	2	0	0	99.99	199.98	15	1	1	NA	1	NA	0	4
CCL4	8	8	0	1	180.18	360.36	15	1	1	1	1	0.5	1	16
CCL5	2	3	1	1	90.09	180.18	15	1	1	-0.5	1	-0.1	2	5
CCLI5	0	4	3	0	90.75	181.5	15	1	0.0285714285714286	-Inf	0.761210061313465	-1	3	4
CCLL4	7	4	0	0	95.04	190.08	15	1	1	NA	1	NA	0	11
CCM2	1	8	3	2	191.07	382.14	15	1	0.0949050949050949	-11	0.960983694935281	-0.488888888888889	5	9
CCM2L	0	1	0	5	159.39	318.78	15	1	1	NA	1	0	5	1
CCNA1	13	13	2	3	403.92	807.84	15	1	1	0.333333333333333	1	0.1	5	26
CCNB2	18	24	1	7	440.55	881.1	15	1	0.134303422197921	0.80952380952381	1	0.303571428571429	8	42
CCNB3	4	10	1	1	287.43	574.86	15	1	1	-1.5	1	-0.214285714285714	2	14
CCNC	0	5	0	0	270.6	541.2	15	1	1	NA	1	NA	0	5
CCND1	0	1	0	1	152.46	304.92	15	1	1	NA	1	0	1	1
CCND2	0	2	0	0	66.66	133.32	15	1	1	NA	1	NA	0	2
CCND3	1	6	0	1	249.48	498.96	15	1	1	1	1	0.142857142857143	1	7
CCNE1	3	8	0	3	403.92	807.84	15	1	1	1	1	0.272727272727273	3	11
CCNE2	2	19	0	4	401.94	803.88	15	1	1	1	1	0.0952380952380952	4	21
CCNF	3	25	3	8	684.42	1368.84	15	1	0.323487574261568	-2.125	1	-0.165584415584416	11	28
CCNG1	3	12	1	2	293.04	586.08	15	1	1	-1	1	-0.133333333333333	3	15
CCNG2	0	7	1	0	300.96	601.92	15	1	0.125	-Inf	1	-1	1	7
CCNI	2	9	2	1	381.15	762.3	15	1	0.175824175824176	-8	1	-0.484848484848485	3	11
CCNI2	9	17	2	5	364.32	728.64	15	1	1	0.244444444444444	1	0.0604395604395604	7	26
CCNJ	1	5	1	1	357.39	714.78	15	1	0.464285714285714	-4	1	-0.333333333333333	2	6
CCNJL	21	19	3	7	392.04	784.08	15	1	0.29377425533639	0.612244897959184	1	0.225	10	40
CCNK	1	14	0	0	434.61	869.22	15	1	1	NA	1	NA	0	15
CCNL1	0	18	0	4	421.74	843.48	15	1	1	NA	1	0	4	18
CCNL2	4	20	1	6	469.26	938.52	15	1	1	0.166666666666667	1	0.0238095238095238	7	24
CCNT2	7	10	3	3	669.57	1339.14	15	1	1	-0.428571428571429	1	-0.0882352941176471	6	17
CCNY	6	8	0	3	363.33	726.66	15	1	0.514705882352941	1	1	0.428571428571429	3	14
CCNYL1	0	3	0	0	285.78	571.56	15	1	1	NA	1	NA	0	3
CCP110	26	31	1	2	1004.85	2009.7	15	1	1	0.403846153846154	1	0.12280701754386	3	57
CCPG1	11	23	6	3	799.92	1599.84	15	1	0.122069711077682	-3.18181818181818	1	-0.343137254901961	9	34
CCR4	7	16	0	0	355.41	710.82	15	1	1	NA	1	NA	0	23
CCR5	2	6	1	4	290.73	581.46	15	1	1	0.25	1	0.05	5	8
CCR6	9	9	1	3	361.35	722.7	15	1	0.593984962406015	0.666666666666667	1	0.25	4	18
CCR7	1	11	1	6	351.12	702.24	15	1	1	-0.833333333333333	1	-0.0595238095238095	7	12
CCR8L	5	11	2	6	348.48	696.96	15	1	1	0.266666666666667	1	0.0625	8	16
CCR9	17	19	6	3	384.12	768.24	15	1	0.459095073956106	-1.23529411764706	1	-0.194444444444444	9	36
CCSAP	3	4	1	2	161.04	322.08	15	1	1	0.333333333333333	1	0.0952380952380952	3	7
CCSER1	17	27	8	8	507.87	1015.74	15	1	0.55582087784833	-0.588235294117647	1	-0.113636363636364	16	44
CCSER2	22	26	0	1	539.88	1079.76	15	1	1	1	1	0.458333333333333	1	48
CCT2	2	12	2	5	529.65	1059.3	15	1	0.574269005847953	-1.4	1	-0.142857142857143	7	14
CCT3-LOC101751456	3	22	1	0	545.16	1090.32	15	1	0.153846153846154	-Inf	1	-0.88	1	25
CCT4-FAM161A	33	47	8	11	1248.06	2496.12	15	1	1	-0.0358126721763086	1	-0.00855263157894737	19	80
CCT5	0	19	4	5	536.58	1073.16	15	1	0.00615384615384615	-Inf	0.467685236262114	-0.444444444444444	9	19
CCT6A	2	21	2	9	503.25	1006.5	15	1	0.579933586337761	-1.33333333333333	1	-0.0948616600790514	11	23
CCT7	5	37	3	12	568.92	1137.84	15	1	0.421764817991233	-0.85	1	-0.080952380952381	15	42
CCT8	2	21	2	2	549.12	1098.24	15	1	0.0917948717948718	-9.5	0.953786405978059	-0.41304347826087	4	23
CCZ1	1	15	0	1	472.23	944.46	15	1	1	1	1	0.0625	1	16
CD101	60	45	24	15	820.38	1640.76	15	1	0.705636038609552	-0.2	1	-0.043956043956044	39	105
CD109	24	43	9	6	1360.59	2721.18	15	1	0.143466721770931	-1.6875	1	-0.241791044776119	15	67
CD14	28	24	7	4	447.81	895.62	15	1	0.740943993458063	-0.5	1	-0.0979020979020979	11	52
CD151	0	7	0	2	246.84	493.68	15	1	1	NA	1	0	2	7
CD163	44	32	3	8	1023.66	2047.32	15	1	0.102557703616149	0.727272727272727	0.981633870854417	0.30622009569378	11	76
CD164	11	9	0	3	176.55	353.1	15	1	0.217391304347826	1	1	0.55	3	20
CD164L2	2	0	0	2	47.52	95.04	15	1	0.333333333333333	1	1	1	2	2
CD180	25	34	6	6	654.39	1308.78	15	1	0.752572755069582	-0.36	1	-0.076271186440678	12	59
CD1B	31	16	6	2	316.8	633.6	15	1	1	-0.548387096774194	1	-0.0904255319148937	8	47
CD1C	12	21	3	3	287.76	575.52	15	1	0.658026685890463	-0.75	1	-0.136363636363636	6	33
CD2	31	10	0	2	304.92	609.84	15	1	0.0730897009966778	1	0.913861472365723	0.75609756097561	2	41
CD200	31	35	7	2	569.58	1139.16	15	1	0.152925366373344	-2.95161290322581	1	-0.308080808080808	9	66
CD200R1-CD200R1L	26	14	8	3	555.06	1110.12	15	1	0.731166137868195	-0.435897435897436	1	-0.0772727272727273	11	40
CD244	37	20	14	4	316.8	633.6	15	1	0.392418093982524	-0.891891891891892	1	-0.128654970760234	18	57
CD247	3	7	0	3	164.34	328.68	15	1	0.527972027972028	1	1	0.3	3	10
CD274	27	19	1	2	418.77	837.54	15	1	0.569148936170213	0.648148148148148	1	0.253623188405797	3	46
CD276	2	29	2	9	293.7	587.4	15	1	0.277137496649692	-2.22222222222222	1	-0.117302052785924	11	31
CD28	0	5	0	1	220.77	441.54	15	1	1	NA	1	0	1	5
CD2AP	7	12	0	1	499.95	999.9	15	1	1	1	1	0.368421052631579	1	19
CD300LF	11	10	0	2	134.97	269.94	15	1	0.478260869565217	1	1	0.523809523809524	2	21
CD300LG	53	16	28	7	418.77	837.54	15	1	0.80585326004197	-0.207547169811321	1	-0.0318840579710146	35	69
CD320	0	5	1	0	74.91	149.82	15	1	0.166666666666667	-Inf	1	-1	1	5
CD34	15	17	5	1	361.35	722.7	15	1	0.183924183924184	-4.66666666666667	1	-0.364583333333333	6	32
CD36	3	22	1	1	467.28	934.56	15	1	0.279202279202279	-6.33333333333333	1	-0.38	2	25
CD38	7	8	3	2	295.02	590.04	15	1	1	-0.714285714285714	1	-0.133333333333333	5	15
CD3D	20	9	0	0	169.29	338.58	15	1	1	NA	1	NA	0	29
CD3E	4	9	2	2	171.27	342.54	15	1	0.584033613445378	-1.25	1	-0.192307692307692	4	13
CD4	58	16	5	6	464.97	929.94	15	1	0.0299852705205763	0.770114942528736	0.771992783106328	0.329238329238329	11	74
CD40LG	6	14	0	3	270.27	540.54	15	1	0.539243365330322	1	1	0.3	3	20
CD44	19	14	2	5	561.99	1123.98	15	1	0.225779625779626	0.705263157894737	1	0.29004329004329	7	33
CD47	6	7	1	3	293.7	587.4	15	1	0.602941176470588	0.611111111111111	1	0.211538461538462	4	13
CD5-CD6	21	21	14	7	513.48	1026.96	15	1	0.284213955794989	-1	1	-0.166666666666667	21	42
CD7	55	14	2	1	544.5	1089	15	1	0.509389671361502	0.490909090909091	1	0.130434782608696	3	69
CD72	5	5	2	2	174.24	348.48	15	1	1	0	1	0	4	10
CD74	9	7	1	2	200.64	401.28	15	1	0.582043343653251	0.611111111111111	1	0.229166666666667	3	16
CD79B	5	14	0	1	224.73	449.46	15	1	1	1	1	0.263157894736842	1	19
CD80	9	14	1	3	310.86	621.72	15	1	1	0.481481481481482	1	0.141304347826087	4	23
CD81	8	10	0	5	212.85	425.7	15	1	0.122113584356147	1	1	0.444444444444444	5	18
CD82	11	9	1	1	260.37	520.74	15	1	1	0.181818181818182	1	0.05	2	20
CD83	5	10	0	0	212.85	425.7	15	1	1	NA	1	NA	0	15
CD86	9	7	4	1	282.15	564.3	15	1	0.606467148262814	-2.11111111111111	1	-0.2375	5	16
CD8A-LOC100857817-LOC100857839-LOC100858172-LOC101752184-LOC107049163-LOC107049196-LOC107049200-LOC107053306-LOC107053324-LOC107056303-LOC112529934-LOC422924-LOC771798-LOC771804-LOC771880-LOC777408-TCD8AL1-TCD8AL4	23	9	6	3	234.63	469.26	15	1	1	0.217391304347826	1	0.0520833333333334	9	32
CD8B	15	3	4	5	202.95	405.9	15	1	0.0721070234113712	0.84	0.910388883446916	0.388888888888889	9	18
CD9	2	9	0	1	205.92	411.84	15	1	1	1	1	0.181818181818182	1	11
CD99	5	8	0	2	161.37	322.74	15	1	0.523809523809524	1	1	0.384615384615385	2	13
CD99L2	11	24	2	6	231.66	463.32	15	1	1	0.272727272727273	1	0.0642857142857143	8	35
CDA	3	1	1	0	56.43	112.86	15	1	1	-Inf	1	-0.25	1	4
CDADC1	6	20	0	1	464.64	929.28	15	1	1	1	1	0.230769230769231	1	26
CDAN1	22	47	2	3	1280.07	2560.14	15	1	0.656882427478607	-0.424242424242424	1	-0.0811594202898551	5	69
CDC123	0	13	2	0	319.44	638.88	15	1	0.00952380952380953	-Inf	0.573230339530418	-1	2	13
CDC14A	8	18	4	6	588.39	1176.78	15	1	0.700445250402719	-0.5	1	-0.0923076923076923	10	26
CDC14B	8	17	3	4	408.54	817.08	15	1	0.667485774792505	-0.59375	1	-0.108571428571429	7	25
CDC16	3	28	3	4	621.72	1243.44	15	1	0.0631213820068309	-6	0.878646123461792	-0.331797235023041	7	31
CDC20	10	27	3	7	435.27	870.54	15	1	1	-0.157142857142857	1	-0.0297297297297297	10	37
CDC20B	9	12	5	1	322.74	645.48	15	1	0.164734299516908	-5.66666666666667	1	-0.404761904761905	6	21
CDC23	0	17	1	1	514.8	1029.6	15	1	0.105263157894737	-Inf	0.983379501385042	-0.5	2	17
CDC25A	11	38	2	8	506.55	1013.1	15	1	1	0.136363636363636	1	0.0244897959183673	10	49
CDC27	1	26	0	8	817.74	1635.48	15	1	1	1	1	0.037037037037037	8	27
CDC34	0	11	0	3	172.26	344.52	15	1	1	NA	1	0	3	11
CDC37L1	4	11	1	0	280.17	560.34	15	1	0.3125	-Inf	1	-0.733333333333333	1	15
CDC40	1	17	0	2	548.79	1097.58	15	1	1	1	1	0.0555555555555556	2	18
CDC42	0	3	0	0	190.08	380.16	15	1	1	NA	1	NA	0	3
CDC42BPA	6	41	3	8	1305.15	2610.3	15	1	0.350347752965937	-1.5625	1	-0.145067698259188	11	47
CDC42BPB	3	52	1	11	1645.05	3290.1	15	1	0.555037313432836	-0.575757575757576	1	-0.0287878787878788	12	55
CDC42EP1	6	14	2	6	411.84	823.68	15	1	1	0.222222222222222	1	0.05	8	20
CDC42EP3	0	8	1	0	251.46	502.92	15	1	0.111111111111111	-Inf	0.98538656216834	-1	1	8
CDC42EP4	3	5	2	10	262.02	524.04	15	1	0.347265221878225	0.666666666666667	1	0.208333333333333	12	8
CDC42SE1	0	2	0	1	65.67	131.34	15	1	1	NA	1	0	1	2
CDC42SE2	3	4	0	0	91.08	182.16	15	1	1	NA	1	NA	0	7
CDC45	1	20	0	5	547.47	1094.94	15	1	1	1	1	0.0476190476190476	5	21
CDC5L	1	30	1	2	781.11	1562.22	15	1	0.171122994652407	-14	1	-0.301075268817204	3	31
CDC7	11	15	1	2	552.42	1104.84	15	1	1	0.318181818181818	1	0.0897435897435898	3	26
CDC73	0	10	1	1	297.33	594.66	15	1	0.166666666666667	-Inf	1	-0.5	2	10
CDCA2	106	56	12	7	1039.5	2079	15	1	0.805552284120081	0.0943396226415094	1	0.0227420402859	19	162
CDCA3	5	7	1	2	86.79	173.58	15	1	1	0.3	1	0.0833333333333334	3	12
CDCA4	10	11	2	3	342.54	685.08	15	1	1	0.266666666666667	1	0.0761904761904761	5	21
CDCA4L	2	8	0	2	281.16	562.32	15	1	1	1	1	0.2	2	10
CDCA7	6	13	0	3	400.95	801.9	15	1	0.532467532467532	1	1	0.315789473684211	3	19
CDCA7L	14	20	2	1	421.74	843.48	15	1	0.567567567567568	-1.85714285714286	1	-0.254901960784314	3	34
CDCA9	11	10	0	4	283.8	567.6	15	1	0.105217391304348	1	0.983379501385042	0.523809523809524	4	21
CDCP1	17	27	7	9	804.54	1609.08	15	1	0.771319393885786	-0.235294117647059	1	-0.0511363636363636	16	44
CDCP2	19	44	10	12	485.76	971.52	15	1	0.203958497245889	-0.929824561403509	1	-0.152958152958153	22	63
CDH11	5	29	0	3	785.07	1570.14	15	1	1	1	1	0.147058823529412	3	34
CDH12	4	13	0	0	499.62	999.24	15	1	1	NA	1	NA	0	17
CDH13	5	13	4	0	435.6	871.2	15	1	0.0172248803827751	-Inf	0.67478445727067	-0.722222222222222	4	18
CDH18	21	29	0	0	674.85	1349.7	15	1	1	NA	1	NA	0	50
CDH19	18	22	5	6	768.9	1537.8	15	1	1	-0.0185185185185186	1	-0.00454545454545452	11	40
CDH2	6	31	2	5	876.15	1752.3	15	1	0.59336886655751	-1.06666666666667	1	-0.123552123552124	7	37
CDH20	7	37	2	7	812.46	1624.92	15	1	0.640064814992724	-0.510204081632653	1	-0.0631313131313131	9	44
CDH22	7	41	3	6	747.78	1495.56	15	1	0.184419256970224	-1.92857142857143	1	-0.1875	9	48
CDH23	36	112	25	66	3310.23	6620.46	15	1	0.647377723306164	-0.178451178451178	1	-0.0314820314820315	91	148
CDH4	4	27	3	5	737.22	1474.44	15	1	0.136767090327462	-3.05	1	-0.245967741935484	8	31
CDH5	3	27	1	1	764.28	1528.56	15	1	0.237903225806452	-8	1	-0.4	2	30
CDH6	4	19	1	2	783.09	1566.18	15	1	0.488461538461538	-1.375	1	-0.159420289855072	3	23
CDH7	3	23	3	1	733.26	1466.52	15	1	0.0180623973727422	-22	0.677255339142531	-0.634615384615385	4	26
CDH8	5	22	2	1	750.42	1500.84	15	1	0.127586206896552	-7.8	1	-0.481481481481481	3	27
CDHR1	12	35	4	3	794.64	1589.28	15	1	0.177075803712874	-2.88888888888889	1	-0.316109422492401	7	47
CDHR2	84	32	10	26	1135.86	2271.72	15	1	2.97858781849255e-06	0.853479853479853	0.00898788874230128	0.446360153256705	36	116
CDHR3	39	31	5	5	765.93	1531.86	15	1	0.747454934339349	0.205128205128205	1	0.0571428571428572	10	70
CDK1	0	16	0	1	300.96	601.92	15	1	1	NA	1	0	1	16
CDK11A	0	31	1	5	733.59	1467.18	15	1	0.162162162162162	-Inf	1	-0.166666666666667	6	31
CDK12	16	49	10	13	1307.46	2614.92	15	1	0.112591983209466	-1.35576923076923	0.99134365547716	-0.188628762541806	23	65
CDK13	20	43	3	11	1237.83	2475.66	15	1	0.534693607062344	0.413636363636364	1	0.103174603174603	14	63
CDK14	5	8	1	1	244.53	489.06	15	1	1	-0.6	1	-0.115384615384615	2	13
CDK15	15	10	3	3	269.28	538.56	15	1	0.675830287621166	0.333333333333333	1	0.1	6	25
CDK17	0	19	0	3	518.76	1037.52	15	1	1	NA	1	0	3	19
CDK18	8	17	9	9	506.88	1013.76	15	1	0.344284705049833	-1.125	1	-0.18	18	25
CDK19	1	9	0	3	455.73	911.46	15	1	1	1	1	0.1	3	10
CDK2AP1	0	2	0	1	112.2	224.4	15	1	1	NA	1	0	1	2
CDK3	2	9	3	5	306.57	613.14	15	1	0.602683178534572	-1.7	1	-0.193181818181818	8	11
CDK5	0	1	0	2	106.26	212.52	15	1	1	NA	1	0	2	1
CDK5RAP1	30	42	7	17	915.42	1830.84	15	1	0.337526436771637	0.423529411764706	1	0.125	24	72
CDK5RAP2	45	60	10	6	1903.77	3807.54	15	1	0.180732135217879	-1.22222222222222	1	-0.196428571428571	16	105
CDK5RAP3	14	17	3	5	290.07	580.14	15	1	1	0.271428571428571	1	0.0766129032258064	8	31
CDK6	3	1	0	0	122.76	245.52	15	1	1	NA	1	NA	0	4
CDK7	2	20	0	4	320.76	641.52	15	1	1	1	1	0.0909090909090909	4	22
CDK8	0	5	0	2	365.64	731.28	15	1	1	NA	1	0	2	5
CDKAL1	20	20	8	8	552.42	1104.84	15	1	1	0	1	0	16	40
CDKL1	5	11	2	7	349.47	698.94	15	1	1	0.371428571428571	1	0.0902777777777778	9	16
CDKL2	9	22	5	6	514.8	1029.6	15	1	0.458815314975173	-1.03703703703704	1	-0.164222873900293	11	31
CDKL5	5	33	3	5	941.49	1882.98	15	1	0.12941341624663	-2.96	1	-0.243421052631579	8	38
CDKN2B	2	2	0	0	71.28	142.56	15	1	1	NA	1	NA	0	4
CDKN2C	0	2	0	0	153.78	307.56	15	1	1	NA	1	NA	0	2
CDKN3	6	11	2	5	181.17	362.34	15	1	1	0.266666666666667	1	0.0672268907563026	7	17
CDO1	1	4	1	1	190.74	381.48	15	1	1	-3	1	-0.3	2	5
CDON	41	59	6	1	1245.42	2490.84	15	1	0.041929511816721	-7.63414634146342	0.805874534439208	-0.447142857142857	7	100
CDPF1	5	3	0	1	123.09	246.18	15	1	0.444444444444444	1	1	0.625	1	8
CDR2	4	17	0	3	450.12	900.24	15	1	1	1	1	0.19047619047619	3	21
CDR2L	1	18	1	4	459.36	918.72	15	1	0.380434782608696	-3.5	1	-0.147368421052632	5	19
CDRT1	61	33	14	15	1038.18	2076.36	15	1	0.129789463210666	0.495081967213115	1	0.166177549523111	29	94
CDT1	9	10	8	5	346.83	693.66	15	1	0.490528929083845	-0.777777777777778	1	-0.1417004048583	13	19
CDV3	2	3	0	2	173.91	347.82	15	1	1	1	1	0.4	2	5
CDX2	1	6	0	3	208.89	417.78	15	1	1	1	1	0.142857142857143	3	7
CDX4	0	5	0	0	258.39	516.78	15	1	1	NA	1	NA	0	5
CDYL	3	7	0	1	346.5	693	15	1	1	1	1	0.3	1	10
CDYL2	0	7	0	0	495	990	15	1	1	NA	1	NA	0	7
CEBPA	0	6	1	0	219.78	439.56	15	1	0.142857142857143	-Inf	1	-1	1	6
CEBPB	1	2	1	0	179.19	358.38	15	1	1	-Inf	1	-0.666666666666667	1	3
CEBPG	2	6	0	0	149.49	298.98	15	1	1	NA	1	NA	0	8
CECR1	1	4	0	0	175.23	350.46	15	1	1	NA	1	NA	0	5
CECR2	30	64	9	9	1419	2838	15	1	0.178395103155894	-1.13333333333333	1	-0.180851063829787	18	94
CECR5L	4	12	3	1	400.62	801.24	15	1	0.101135190918473	-8	0.975691437149951	-0.5	4	16
CEL	11	30	0	3	551.43	1102.86	15	1	0.561461794019933	1	1	0.268292682926829	3	41
CELA3B	1	2	0	5	130.02	260.04	15	1	0.375	1	1	0.333333333333333	5	3
CELF1	0	10	0	4	481.14	962.28	15	1	1	NA	1	0	4	10
CELF5	3	10	0	1	451.77	903.54	15	1	1	1	1	0.230769230769231	1	13
CELF6	3	7	2	10	289.08	578.16	15	1	0.62406015037594	0.533333333333333	1	0.133333333333333	12	10
CELSR1	9	50	3	11	1562.55	3125.1	15	1	0.689028922938526	-0.515151515151515	1	-0.0617433414043583	14	59
CEMIP	11	51	6	9	1347.39	2694.78	15	1	0.0840800309988628	-2.09090909090909	0.949431371776132	-0.22258064516129	15	62
CEND1	0	2	0	1	129.69	259.38	15	1	1	NA	1	0	1	2
CENPC	84	33	4	3	914.76	1829.52	15	1	0.412950441872061	0.476190476190476	1	0.146520146520147	7	117
CENPE	72	92	15	8	2101.11	4202.22	15	1	0.0735581983152868	-1.39583333333333	0.913861472365723	-0.213149522799576	23	164
CENPF	140	97	22	16	2634.39	5268.78	15	1	1	0.0473214285714286	1	0.0117699311570064	38	237
CENPI	47	34	6	7	700.92	1401.84	15	1	0.549399494268406	0.379939209726444	1	0.118708452041785	13	81
CENPJ	41	61	10	14	1237.5	2475	15	1	1	-0.0627177700348431	1	-0.0147058823529412	24	102
CENPK	34	11	0	0	261.69	523.38	15	1	1	NA	1	NA	0	45
CENPL	14	14	2	3	311.19	622.38	15	1	1	0.333333333333333	1	0.1	5	28
CENPM	4	7	0	1	135.63	271.26	15	1	1	1	1	0.363636363636364	1	11
CENPN	8	7	0	1	325.71	651.42	15	1	1	1	1	0.533333333333333	1	15
CENPO	33	17	5	3	295.02	590.04	15	1	1	0.141414141414141	1	0.035	8	50
CENPP	10	10	0	0	125.73	251.46	15	1	1	NA	1	NA	0	20
CENPQ	18	12	1	0	227.7	455.4	15	1	1	-Inf	1	-0.4	1	30
CENPS	2	4	1	3	129.69	259.38	15	1	1	0.333333333333333	1	0.0833333333333333	4	6
CENPT	49	28	5	3	658.35	1316.7	15	1	1	0.0476190476190477	1	0.0113636363636364	8	77
CENPV	2	9	0	3	186.78	373.56	15	1	1	1	1	0.181818181818182	3	11
CENPW	1	1	0	0	53.79	107.58	15	1	1	NA	1	NA	0	2
CENPX	0	3	0	0	40.92	81.84	15	1	1	NA	1	NA	0	3
CEP104	18	37	9	6	941.49	1882.98	15	1	0.0743506185470704	-2.08333333333333	0.913861472365723	-0.272727272727273	15	55
CEP112	22	31	11	5	941.49	1882.98	15	1	0.0859971966248086	-2.1	0.951277979139867	-0.272405660377358	16	53
CEP120	11	28	5	4	985.38	1970.76	15	1	0.137701011069874	-2.18181818181818	1	-0.273504273504274	9	39
CEP126	57	24	12	8	833.58	1667.16	15	1	0.424907845891177	0.368421052631579	1	0.103703703703704	20	81
CEP128	36	26	6	1	1089	2178	15	1	0.233056049096531	-3.33333333333333	1	-0.276497695852534	7	62
CEP135	21	37	7	6	1139.49	2278.98	15	1	0.34707806389357	-1.05555555555556	1	-0.176392572944297	13	58
CEP152	57	31	8	2	2171.73	4343.46	15	1	0.487465393705907	-1.17543859649123	1	-0.152272727272727	10	88
CEP164	88	61	19	14	1922.58	3845.16	15	1	1	0.0592532467532467	1	0.0148464510880618	33	149
CEP170	20	42	7	8	1579.05	3158.1	15	1	0.368901292138145	-0.8375	1	-0.144086021505376	15	62
CEP170B	26	81	4	11	1480.05	2960.1	15	1	1	-0.132867132867133	1	-0.0236760124610592	15	107
CEP19	3	6	1	2	162.36	324.72	15	1	1	0	1	0	3	9
CEP192	100	99	15	14	2489.52	4979.04	15	1	1	-0.0607142857142857	1	-0.0147288164962746	29	199
CEP250	79	73	15	11	2428.47	4856.94	15	1	0.673090478901405	-0.260069044879171	1	-0.0571862348178137	26	152
CEP295	95	94	23	8	1885.62	3771.24	15	1	0.0187085076743907	-1.84473684210526	0.683149554847669	-0.239289981225465	31	189
CEP350	85	118	18	10	3184.5	6369	15	1	0.0410178865205665	-1.49882352941176	0.798931947804628	-0.224137931034483	28	203
CEP350L	176	100	55	29	2791.8	5583.6	15	1	0.796574416112968	-0.0775862068965518	1	-0.017080745341615	84	276
CEP41	10	17	4	6	356.4	712.8	15	1	1	-0.133333333333333	1	-0.0296296296296297	10	27
CEP44	9	10	1	2	381.15	762.3	15	1	1	0.444444444444444	1	0.140350877192982	3	19
CEP55	13	13	4	1	413.49	826.98	15	1	0.344456803856137	-3	1	-0.3	5	26
CEP57	13	15	3	2	483.12	966.24	15	1	0.656183638386085	-0.730769230769231	1	-0.135714285714286	5	28
CEP57L1	13	13	7	4	451.44	902.88	15	1	0.49505456513243	-0.75	1	-0.136363636363636	11	26
CEP63	20	19	2	1	712.8	1425.6	15	1	1	-0.9	1	-0.153846153846154	3	39
CEP68	42	39	17	12	692.67	1385.34	15	1	0.664929480410838	-0.31547619047619	1	-0.0676883780332056	29	81
CEP70	9	26	3	2	579.15	1158.3	15	1	0.148648648648649	-3.33333333333333	1	-0.342857142857143	5	35
CEP76	9	28	5	6	656.37	1312.74	15	1	0.25794337315345	-1.59259259259259	1	-0.211302211302211	11	37
CEP78	27	34	1	0	734.91	1469.82	15	1	0.451612903225806	-Inf	1	-0.557377049180328	1	61
CEP83	11	32	4	7	709.83	1419.66	15	1	0.475105549058737	-0.662337662337662	1	-0.107822410147992	11	43
CEP85	13	31	10	6	776.16	1552.32	15	1	0.0342304927491805	-2.97435897435897	0.788199921465956	-0.329545454545455	16	44
CEP85L	13	26	4	8	738.21	1476.42	15	1	1	0	1	0	12	39
CEP95	33	22	8	2	865.92	1731.84	15	1	0.300978592098808	-1.66666666666667	1	-0.2	10	55
CEP97	23	16	4	1	833.25	1666.5	15	1	0.633704355769018	-1.78260869565217	1	-0.21025641025641	5	39
CEPT1	8	26	2	6	431.64	863.28	15	1	1	-0.0833333333333333	1	-0.0147058823529412	8	34
CER1	10	11	0	0	271.26	542.52	15	1	1	NA	1	NA	0	21
CERK	2	14	4	4	492.69	985.38	15	1	0.128770542958186	-6	1	-0.375	8	16
CERKL	17	15	3	3	493.02	986.04	15	1	1	0.117647058823529	1	0.03125	6	32
CERS1	0	5	2	3	233.97	467.94	15	1	0.444444444444444	-Inf	1	-0.4	5	5
CERS2	1	16	0	1	372.24	744.48	15	1	1	1	1	0.0588235294117647	1	17
CERS3	23	28	11	4	769.23	1538.46	15	1	0.0784777006448976	-2.34782608695652	0.930584321290736	-0.282352941176471	15	51
CERS4	24	24	2	3	515.79	1031.58	15	1	1	0.333333333333333	1	0.1	5	48
CERS4L	11	12	3	1	351.45	702.9	15	1	0.595555555555556	-2.27272727272727	1	-0.271739130434783	4	23
CERS5	2	8	2	5	325.05	650.1	15	1	1	-0.6	1	-0.0857142857142857	7	10
CERS6	21	12	1	1	524.37	1048.74	15	1	1	0.428571428571429	1	0.136363636363636	2	33
CES1L1-CES1L2-LOC769704	18	19	1	0	522.72	1045.44	15	1	1	-Inf	1	-0.513513513513513	1	37
CETN1	1	7	0	2	169.29	338.58	15	1	1	1	1	0.125	2	8
CETN3	2	5	0	1	160.71	321.42	15	1	1	1	1	0.285714285714286	1	7
CFAP100	40	20	1	0	609.84	1219.68	15	1	1	-Inf	1	-0.333333333333333	1	60
CFAP161	9	13	1	1	253.77	507.54	15	1	1	-0.444444444444444	1	-0.0909090909090909	2	22
CFAP20	0	3	0	1	164.34	328.68	15	1	1	NA	1	0	1	3
CFAP206	26	24	3	2	615.78	1231.56	15	1	1	-0.384615384615385	1	-0.08	5	50
CFAP221	30	38	7	3	846.12	1692.24	15	1	0.178473559424662	-1.95555555555556	1	-0.258823529411765	10	68
CFAP36	9	12	1	0	368.61	737.22	15	1	0.454545454545454	-Inf	1	-0.571428571428571	1	21
CFAP43	81	68	10	6	1662.87	3325.74	15	1	0.604563966725607	-0.39917695473251	1	-0.0813758389261745	16	149
CFAP44	68	71	14	6	1818.63	3637.26	15	1	0.0958773180878469	-1.43627450980392	0.965170333044464	-0.210791366906475	20	139
CFAP52	16	20	5	2	548.13	1096.26	15	1	0.240444904086424	-2.125	1	-0.26984126984127	7	36
CFAP54	138	100	18	10	3193.08	6386.16	15	1	0.550928486911378	-0.304347826086957	1	-0.0630252100840336	28	238
CFAP57	38	35	4	3	1071.18	2142.36	15	1	1	-0.228070175438597	1	-0.050880626223092	7	73
CFAP58	27	25	4	2	958.32	1916.64	15	1	0.675163466126723	-0.851851851851852	1	-0.147435897435897	6	52
CFAP61	48	37	12	10	1326.93	2653.86	15	1	1	0.075	1	0.0192513368983958	22	85
CFAP65	60	66	26	18	1751.64	3503.28	15	1	0.221937928343109	-0.588888888888889	1	-0.114718614718615	44	126
CFAP69	16	34	5	7	1275.12	2550.24	15	1	0.519564989788338	-0.517857142857143	1	-0.0966666666666667	12	50
CFAP73	28	11	6	5	283.14	566.28	15	1	0.297191474712566	0.528571428571429	1	0.172494172494173	11	39
CFAP74	74	72	19	7	1581.03	3162.06	15	1	0.053087674127013	-1.64092664092664	0.846060006968071	-0.223919915700738	26	146
CFAP77	14	9	1	3	214.83	429.66	15	1	0.294017094017094	0.785714285714286	1	0.358695652173913	4	23
CFAP99	13	19	4	4	653.4	1306.8	15	1	0.702471702471702	-0.461538461538461	1	-0.09375	8	32
CFC1	4	10	0	2	180.51	361.02	15	1	1	1	1	0.285714285714286	2	14
CFD	7	4	3	3	158.07	316.14	15	1	0.643665158371041	0.428571428571429	1	0.136363636363636	6	11
CFDP1	5	12	1	2	277.86	555.72	15	1	1	-0.2	1	-0.0392156862745098	3	17
CFH	69	30	3	12	959.97	1919.94	15	1	0.000349600700012661	0.891304347826087	0.161908753078878	0.496969696969697	15	99
CFI	25	20	5	3	512.82	1025.64	15	1	1	-0.333333333333333	1	-0.0694444444444444	8	45
CFL2	1	2	0	0	164.34	328.68	15	1	1	NA	1	NA	0	3
CFLAR	13	9	0	3	485.1	970.2	15	1	0.0956521739130434	1	0.963707628656456	0.590909090909091	3	22
CFTR	20	62	3	6	1467.18	2934.36	15	1	0.68706391171258	-0.55	1	-0.0894308943089431	9	82
CG-16	1	14	1	3	133.65	267.3	15	1	0.385964912280702	-3.66666666666667	1	-0.183333333333333	4	15
CGA	1	5	0	2	119.79	239.58	15	1	1	1	1	0.166666666666667	2	6
CGGBP1	0	9	0	3	166.32	332.64	15	1	1	NA	1	0	3	9
CGN	26	40	6	2	946.77	1893.54	15	1	0.0696777039155584	-3.61538461538461	0.898514835748707	-0.356060606060606	8	66
CGNL1	22	45	11	7	1303.17	2606.34	15	1	0.0543247896250989	-2.21428571428571	0.846060006968071	-0.282752902155887	18	67
CGNRHRL	4	14	8	11	349.14	698.28	15	1	0.295295931558445	-1.54545454545455	1	-0.198830409356725	19	18
CGRRF1	5	12	3	0	331.32	662.64	15	1	0.0491228070175438	-Inf	0.836265558112488	-0.705882352941176	3	17
CGTL	2	22	3	6	463.98	927.96	15	1	0.110956618464961	-4.5	0.98538656216834	-0.25	9	24
CH25H	7	12	0	4	272.25	544.5	15	1	0.272727272727273	1	1	0.368421052631579	4	19
CHAC1	2	5	0	5	142.56	285.12	15	1	0.46969696969697	1	1	0.285714285714286	5	7
CHAC2	0	3	0	1	166.98	333.96	15	1	1	NA	1	0	1	3
CHAD	3	20	4	5	343.53	687.06	15	1	0.0763526425372922	-4.33333333333333	0.919736921581953	-0.314009661835749	9	23
CHADL	30	45	13	12	687.72	1375.44	15	1	0.353626146161767	-0.625	1	-0.12	25	75
CHAF1A	29	77	7	18	900.24	1800.48	15	1	1	-0.0325670498084292	1	-0.00641509433962267	25	106
CHAF1B	8	19	3	1	561.33	1122.66	15	1	0.115366279993644	-6.125	1	-0.453703703703704	4	27
CHAMP1	18	26	10	9	854.7	1709.4	15	1	0.42053897636992	-0.604938271604938	1	-0.117224880382775	19	44
CHAT	10	16	3	0	629.64	1259.28	15	1	0.0782703886152162	-Inf	0.929846053726043	-0.615384615384615	3	26
CHCHD1	6	5	2	0	123.75	247.5	15	1	0.487179487179487	-Inf	1	-0.454545454545455	2	11
CHCHD10	0	2	0	2	54.78	109.56	15	1	1	NA	1	0	2	2
CHCHD2	0	3	0	2	97.02	194.04	15	1	1	NA	1	0	2	3
CHCHD3	7	19	2	2	383.13	766.26	15	1	0.563218390804598	-1.71428571428571	1	-0.230769230769231	4	26
CHCHD4	0	3	1	0	130.35	260.7	15	1	0.25	-Inf	1	-1	1	3
CHCHD6	14	9	1	4	289.08	578.16	15	1	0.152777777777778	0.839285714285714	1	0.408695652173913	5	23
CHCHD7	1	1	0	0	84.15	168.3	15	1	1	NA	1	NA	0	2
CHD1L	21	46	11	14	1386.66	2773.32	15	1	0.326225198640997	-0.72108843537415	1	-0.126567164179104	25	67
CHD1Z-CHDB1	13	45	14	34	1518.66	3037.32	15	1	0.504008197541254	-0.425339366515837	1	-0.0675287356321839	48	58
CHD2	7	54	2	4	1847.34	3694.68	15	1	0.181183104329469	-2.85714285714286	1	-0.218579234972678	6	61
CHD4	2	60	2	11	1858.23	3716.46	15	1	0.136529680365297	-4.45454545454545	1	-0.121588089330025	13	62
CHD5	8	106	4	21	1932.15	3864.3	15	1	0.228436400726491	-1.52380952380952	1	-0.0898245614035088	25	114
CHD7	7	47	8	14	2989.8	5979.6	15	1	0.0283093654308312	-2.83673469387755	0.761210061313465	-0.234006734006734	22	54
CHD9	9	105	6	17	2862.09	5724.18	15	1	0.0209113374972436	-3.11764705882353	0.712432502205107	-0.181922196796339	23	114
CHDH	7	20	1	2	604.89	1209.78	15	1	1	-0.428571428571429	1	-0.0740740740740741	3	27
CHEK2	7	18	0	0	520.74	1041.48	15	1	1	NA	1	NA	0	25
CHERP	2	33	1	6	875.82	1751.64	15	1	0.429878048780488	-1.75	1	-0.0857142857142857	7	35
CHFR	7	7	0	3	642.84	1285.68	15	1	0.227941176470588	1	1	0.5	3	14
CHGA	16	12	6	4	445.17	890.34	15	1	1	-0.125	1	-0.0285714285714286	10	28
CHGB	33	35	22	12	657.03	1314.06	15	1	0.143715451148834	-0.944444444444444	1	-0.161764705882353	34	68
CHIA-CHIA-M31-LOC768786	20	37	11	10	804.87	1609.74	15	1	0.197793794305696	-1.035	1	-0.172932330827068	21	57
CHIC1	1	1	0	0	125.07	250.14	15	1	1	NA	1	NA	0	2
CHIC2	0	3	2	2	125.07	250.14	15	1	0.428571428571429	-Inf	1	-0.5	4	3
CHID1	9	19	1	1	313.83	627.66	15	1	1	-1.11111111111111	1	-0.178571428571429	2	28
CHKA	1	16	1	2	379.83	759.66	15	1	0.28421052631579	-7	1	-0.274509803921569	3	17
CHL1	8	59	3	6	1197.9	2395.8	15	1	0.117137905791483	-2.6875	1	-0.213930348258706	9	67
CHM	16	20	3	3	642.51	1285.02	15	1	1	-0.25	1	-0.0555555555555556	6	36
CHMP1A	0	14	0	4	170.28	340.56	15	1	1	NA	1	0	4	14
CHMP1B	0	11	0	3	192.72	385.44	15	1	1	NA	1	0	3	11
CHMP2B	0	7	0	0	202.29	404.58	15	1	1	NA	1	NA	0	7
CHMP3	3	12	0	1	207.24	414.48	15	1	1	1	1	0.2	1	15
CHMP4B	0	9	0	0	161.04	322.08	15	1	1	NA	1	NA	0	9
CHMP5	0	7	0	2	195.03	390.06	15	1	1	NA	1	0	2	7
CHMP6	3	7	1	0	171.93	343.86	15	1	0.363636363636364	-Inf	1	-0.7	1	10
CHMP7	0	8	3	2	368.28	736.56	15	1	0.034965034965035	-Inf	0.788199921465956	-0.6	5	8
CHN1	1	10	0	3	455.4	910.8	15	1	1	1	1	0.0909090909090909	3	11
CHORDC1	0	9	0	2	307.56	615.12	15	1	1	NA	1	0	2	9
CHP1	1	2	0	1	175.56	351.12	15	1	1	1	1	0.333333333333333	1	3
CHPF	10	12	7	11	647.46	1294.92	15	1	0.754699415767269	0.236363636363636	1	0.0656565656565656	18	22
CHPF2	2	40	3	8	733.59	1467.18	15	1	0.0544962251954482	-6.5	0.846060006968071	-0.225108225108225	11	42
CHRAC1	7	7	2	0	232.65	465.3	15	1	0.475	-Inf	1	-0.5	2	14
CHRD	2	9	4	8	380.16	760.32	15	1	0.64040536122916	-1.25	1	-0.151515151515151	12	11
CHRDL1	1	7	1	3	452.43	904.86	15	1	1	-1.33333333333333	1	-0.125	4	8
CHRDL2	3	9	3	3	394.68	789.36	15	1	0.344053005817712	-2	1	-0.25	6	12
CHRM2	6	15	0	2	462.33	924.66	15	1	1	1	1	0.285714285714286	2	21
CHRM3	5	20	0	3	623.7	1247.4	15	1	1	1	1	0.2	3	25
CHRM4	1	16	2	7	501.6	1003.2	15	1	0.267692307692308	-3.57142857142857	1	-0.163398692810457	9	17
CHRM5	0	13	0	1	523.71	1047.42	15	1	1	NA	1	0	1	13
CHRNA1	0	27	3	3	452.43	904.86	15	1	0.00366568914956012	-Inf	0.425431423415295	-0.5	6	27
CHRNA10	2	6	3	5	252.45	504.9	15	1	1	-0.8	1	-0.125	8	8
CHRNA3	9	10	0	2	477.18	954.36	15	1	0.485714285714286	1	1	0.473684210526316	2	19
CHRNA4	3	34	2	9	618.75	1237.5	15	1	0.321153253160654	-1.51851851851852	1	-0.100737100737101	11	37
CHRNA5	1	18	0	1	429.33	858.66	15	1	1	1	1	0.0526315789473684	1	19
CHRNA6	9	27	2	4	490.05	980.1	15	1	0.643710017907707	-0.5	1	-0.0833333333333333	6	36
CHRNA7	4	24	0	3	479.82	959.64	15	1	1	1	1	0.142857142857143	3	28
CHRNA7L	9	21	4	6	561.33	1122.66	15	1	0.700379371681679	-0.555555555555556	1	-0.1	10	30
CHRNA9	7	21	3	6	482.13	964.26	15	1	0.678776630454966	-0.5	1	-0.0833333333333333	9	28
CHRNB2	1	3	1	8	332.64	665.28	15	1	1	0.625	1	0.138888888888889	9	4
CHRNB3	7	30	3	8	450.12	900.24	15	1	0.67535035403409	-0.607142857142857	1	-0.0835380835380835	11	37
CHRNB4	6	12	1	2	485.1	970.2	15	1	1	0	1	0	3	18
CHRND	6	16	3	13	446.49	892.98	15	1	0.705984922303708	0.384615384615385	1	0.0852272727272727	16	22
CHRNG	3	11	1	9	409.86	819.72	15	1	0.614624505928854	0.592592592592593	1	0.114285714285714	10	14
CHST1	1	10	2	10	393.36	786.72	15	1	1	-1	1	-0.0757575757575757	12	11
CHST10	4	12	4	1	358.38	716.76	15	1	0.0474716202270382	-11	0.828231827900648	-0.55	5	16
CHST11	0	12	0	2	289.08	578.16	15	1	1	NA	1	0	2	12
CHST12	4	19	2	2	415.8	831.6	15	1	0.204273504273504	-3.75	1	-0.326086956521739	4	23
CHST13	1	16	2	4	301.29	602.58	15	1	0.15527950310559	-7	1	-0.274509803921569	6	17
CHST15	6	7	2	0	542.19	1084.38	15	1	0.466666666666667	-Inf	1	-0.538461538461538	2	13
CHST2	1	10	1	1	346.17	692.34	15	1	0.294871794871795	-9	1	-0.409090909090909	2	11
CHST3	7	11	3	5	452.1	904.2	15	1	1	0.0571428571428572	1	0.0138888888888889	8	18
CHST6	5	22	0	1	390.06	780.12	15	1	1	1	1	0.185185185185185	1	27
CHST7	1	6	1	3	199.65	399.3	15	1	1	-1	1	-0.107142857142857	4	7
CHST8	3	19	2	1	387.75	775.5	15	1	0.091304347826087	-11.6666666666667	0.953786405978059	-0.53030303030303	3	22
CHST9	6	19	0	2	334.62	669.24	15	1	1	1	1	0.24	2	25
CHSY1	3	24	1	8	525.69	1051.38	15	1	1	0	1	0	9	27
CHSY3	12	18	2	0	516.78	1033.56	15	1	0.183467741935484	-Inf	1	-0.6	2	30
CHTF18	19	44	15	19	932.91	1865.82	15	1	0.187221826087785	-0.828254847645429	1	-0.139589169000934	34	63
CHTOP	0	7	1	4	214.17	428.34	15	1	0.416666666666667	-Inf	1	-0.2	5	7
CHUK	8	30	1	0	738.54	1477.08	15	1	0.230769230769231	-Inf	1	-0.789473684210526	1	38
CIAPIN1	9	14	2	0	305.91	611.82	15	1	0.183333333333333	-Inf	1	-0.608695652173913	2	23
CIB1	2	8	2	1	160.71	321.42	15	1	0.202797202797203	-7	1	-0.466666666666667	3	10
CIB2	7	10	0	3	240.24	480.48	15	1	0.521052631578947	1	1	0.411764705882353	3	17
CIB3	3	9	0	1	186.12	372.24	15	1	1	1	1	0.25	1	12
CIDEA	2	5	0	3	216.81	433.62	15	1	1	1	1	0.285714285714286	3	7
CIDEC	1	1	0	0	38.61	77.22	15	1	1	NA	1	NA	0	2
CIITA	39	28	5	5	1221.99	2443.98	15	1	0.736683550991731	0.282051282051282	1	0.082089552238806	10	67
CILP	10	67	16	23	1083.39	2166.78	15	1	0.00170253597193461	-3.66086956521739	0.302200135018392	-0.28038628038628	39	77
CINP	4	9	3	1	207.57	415.14	15	1	0.25	-5.75	1	-0.442307692307692	4	13
CIPC	10	20	1	1	370.26	740.52	15	1	1	-1	1	-0.166666666666667	2	30
CIR1	5	11	2	3	436.59	873.18	15	1	1	-0.466666666666667	1	-0.0875	5	16
CIRBP	0	2	0	1	170.28	340.56	15	1	1	NA	1	0	1	2
CISD1	1	3	0	0	97.68	195.36	15	1	1	NA	1	NA	0	4
CISD2	0	3	0	2	99.99	199.98	15	1	1	NA	1	0	2	3
CISH	1	5	0	4	256.41	512.82	15	1	1	1	1	0.166666666666667	4	6
CITED2	0	2	0	0	167.31	334.62	15	1	1	NA	1	NA	0	2
CITED4	2	10	0	2	202.95	405.9	15	1	1	1	1	0.166666666666667	2	12
CIZ1	10	18	4	6	702.24	1404.48	15	1	1	-0.2	1	-0.0428571428571429	10	28
CKAP2	46	25	7	4	692.01	1384.02	15	1	1	0.0489130434782609	1	0.0115236875800256	11	71
CKAP4	6	16	2	5	439.56	879.12	15	1	1	-0.0666666666666667	1	-0.012987012987013	7	22
CKAP5	11	86	2	9	2042.04	4084.08	15	1	0.619217939744103	-0.737373737373737	1	-0.0684161199625117	11	97
CKLF	1	4	3	4	116.16	232.32	15	1	0.575757575757576	-2	1	-0.228571428571429	7	5
CKMT1A	0	16	2	3	351.78	703.56	15	1	0.0476190476190476	-Inf	0.828231827900648	-0.4	5	16
CKMT2	3	19	1	0	397.98	795.96	15	1	0.173913043478261	-Inf	1	-0.863636363636364	1	22
CKS2	0	3	0	0	63.36	126.72	15	1	1	NA	1	NA	0	3
CLASP1	0	38	2	3	1443.09	2886.18	15	1	0.0110741971207087	-Inf	0.58625245283752	-0.4	5	38
CLASP2	19	41	0	3	1337.82	2675.64	15	1	0.547379819193674	1	1	0.316666666666667	3	60
CLCA1	89	65	10	10	1656.6	3313.2	15	1	0.632341328272325	0.269662921348315	1	0.0779220779220779	20	154
CLCC1	23	25	2	7	509.52	1019.04	15	1	0.272802746837445	0.68944099378882	1	0.256944444444444	9	48
CLCN1	15	26	11	3	1001.88	2003.76	15	1	0.0117540631067028	-5.35555555555556	0.596226042284133	-0.4198606271777	14	41
CLCN2	5	14	0	9	446.82	893.64	15	1	0.143956043956044	1	1	0.263157894736842	9	19
CLCN3	1	19	0	8	758.01	1516.02	15	1	1	1	1	0.05	8	20
CLCN4	4	25	7	2	791.01	1582.02	15	1	0.000738229490851084	-20.875	0.233065034151711	-0.639846743295019	9	29
CLCN5	1	17	1	2	800.58	1601.16	15	1	0.271428571428571	-7.5	1	-0.277777777777778	3	18
CLCN6	4	37	0	7	832.92	1665.84	15	1	1	1	1	0.0975609756097561	7	41
CLCNKB	5	4	3	2	138.93	277.86	15	1	1	-0.2	1	-0.0444444444444444	5	9
CLDN1	1	14	0	2	168.3	336.6	15	1	1	1	1	0.0666666666666667	2	15
CLDN10	2	4	1	0	167.64	335.28	15	1	0.428571428571428	-Inf	1	-0.666666666666667	1	6
CLDN11	0	10	2	6	205.92	411.84	15	1	0.183006535947712	-Inf	1	-0.25	8	10
CLDN12	2	17	3	3	243.54	487.08	15	1	0.0698475437605872	-7.5	0.898784491674081	-0.394736842105263	6	19
CLDN14	1	7	1	5	232.65	465.3	15	1	1	-0.4	1	-0.0416666666666667	6	8
CLDN15	10	7	0	0	217.8	435.6	15	1	1	NA	1	NA	0	17
CLDN16	0	9	1	1	245.52	491.04	15	1	0.181818181818182	-Inf	1	-0.5	2	9
CLDN16L	11	10	4	1	217.8	435.6	15	1	0.3561872909699	-2.63636363636364	1	-0.276190476190476	5	21
CLDN18	1	12	0	5	257.4	514.8	15	1	1	1	1	0.0769230769230769	5	13
CLDN19	1	8	2	1	150.48	300.96	15	1	0.127272727272727	-15	1	-0.555555555555556	3	9
CLDN2	2	4	4	4	229.68	459.36	15	1	0.627039627039627	-1	1	-0.166666666666667	8	6
CLDN25	5	13	0	1	228.69	457.38	15	1	1	1	1	0.277777777777778	1	18
CLDN3	0	10	0	2	199.98	399.96	15	1	1	NA	1	0	2	10
CLDN34	7	9	2	2	212.85	425.7	15	1	1	-0.285714285714286	1	-0.0625	4	16
CLDN4	0	12	0	3	166.32	332.64	15	1	1	NA	1	0	3	12
CLDN5	0	10	0	3	209.22	418.44	15	1	1	NA	1	0	3	10
CLDN8	4	8	2	1	222.75	445.5	15	1	0.525274725274725	-3	1	-0.333333333333333	3	12
CLDN9	0	11	0	1	186.78	373.56	15	1	1	NA	1	0	1	11
CLDND1	1	21	3	5	249.48	498.96	15	1	0.0475095785440613	-11.6	0.828231827900648	-0.329545454545455	8	22
CLEC16A	10	31	1	5	1004.52	2009.04	15	1	1	0.38	1	0.0772357723577236	6	41
CLEC18B	1	14	4	6	214.83	429.66	15	1	0.120553359683794	-8.33333333333333	1	-0.333333333333333	10	15
CLEC19A	0	9	0	0	178.53	357.06	15	1	1	NA	1	NA	0	9
CLEC3A	4	4	1	1	192.06	384.12	15	1	1	0	1	0	2	8
CLEC3B	0	7	1	1	196.68	393.36	15	1	0.222222222222222	-Inf	1	-0.5	2	7
CLEC5A	5	2	2	0	93.72	187.44	15	1	1	-Inf	1	-0.285714285714286	2	7
CLGN	11	14	0	3	631.62	1263.24	15	1	0.257936507936508	1	1	0.44	3	25
CLIC2	2	2	1	3	226.71	453.42	15	1	1	0.666666666666667	1	0.25	4	4
CLIC5	2	7	1	1	249.48	498.96	15	1	0.490909090909091	-2.5	1	-0.277777777777778	2	9
CLINT1	4	15	1	2	629.97	1259.94	15	1	1	-0.875	1	-0.12280701754386	3	19
CLIP1	56	72	9	13	2240.37	4480.74	15	1	1	0.10989010989011	1	0.0284090909090909	22	128
CLIP2	7	43	5	24	1029.6	2059.2	15	1	0.750996039813751	-0.279761904761905	1	-0.0324137931034483	29	50
CLIP4	13	24	2	3	677.49	1354.98	15	1	1	-0.230769230769231	1	-0.0486486486486487	5	37
CLK1	2	17	1	7	463.98	927.96	15	1	1	-0.214285714285714	1	-0.0197368421052632	8	19
CLK2	3	14	1	0	499.95	999.9	15	1	0.222222222222222	-Inf	1	-0.823529411764706	1	17
CLK3	16	26	1	8	482.79	965.58	15	1	0.241231172072125	0.796875	1	0.26984126984127	9	42
CLMN	30	31	5	2	856.35	1712.7	15	1	0.429056639877535	-1.58333333333333	1	-0.22248243559719	7	61
CLMP	6	16	1	5	371.58	743.16	15	1	1	0.466666666666667	1	0.106060606060606	6	22
CLN5	4	11	1	6	328.02	656.04	15	1	1	0.541666666666667	1	0.123809523809524	7	15
CLN6	1	15	0	4	287.43	574.86	15	1	1	1	1	0.0625	4	16
CLN8	8	11	1	0	283.14	566.28	15	1	0.45	-Inf	1	-0.578947368421053	1	19
CLNK	36	18	0	5	523.05	1046.1	15	1	0.00672121566335476	1	0.480030018086935	0.666666666666667	5	54
CLNS1A	0	12	0	1	197.34	394.68	15	1	1	NA	1	0	1	12
CLOCK	10	14	4	1	894.96	1789.92	15	1	0.168582375478927	-4.6	1	-0.383333333333333	5	24
CLP1	0	10	0	10	376.2	752.4	15	1	1	NA	1	0	10	10
CLPS	4	1	2	3	70.95	141.9	15	1	0.523809523809524	0.833333333333333	1	0.4	5	5
CLPTM1L	2	22	1	6	522.72	1045.44	15	1	0.54972191323693	-0.833333333333333	1	-0.0595238095238095	7	24
CLPX	0	23	2	6	601.59	1203.18	15	1	0.0602150537634409	-Inf	0.870851370851371	-0.25	8	23
CLRN1	4	9	2	6	230.67	461.34	15	1	1	0.25	1	0.0576923076923077	8	13
CLRN2	4	9	0	1	230.67	461.34	15	1	1	1	1	0.307692307692308	1	13
CLRN3	21	16	3	5	225.72	451.44	15	1	0.44270401559114	0.542857142857143	1	0.192567567567568	8	37
CLSPN	46	59	13	16	1298.88	2597.76	15	1	1	-0.0421195652173914	1	-0.0101806239737274	29	105
CLSTN1	3	30	0	7	990.99	1981.98	15	1	1	1	1	0.0909090909090909	7	33
CLSTN2	15	30	6	5	892.98	1785.96	15	1	0.297669444048583	-1.4	1	-0.212121212121212	11	45
CLSTN3	28	39	5	4	1197.24	2394.48	15	1	0.490043810420652	-0.741071428571429	1	-0.137645107794362	9	67
CLTA	2	3	0	1	141.24	282.48	15	1	1	1	1	0.4	1	5
CLTB	0	5	1	6	148.17	296.34	15	1	1	-Inf	1	-0.142857142857143	7	5
CLTC	0	63	0	11	1645.38	3290.76	15	1	1	NA	1	0	11	63
CLTCL1	0	46	2	18	1642.08	3284.16	15	1	0.0885780885780886	-Inf	0.953024314709457	-0.1	20	46
CLUH	22	51	4	18	1525.59	3051.18	15	1	0.413543116594348	0.484848484848485	1	0.119551681195517	22	73
CLUL1	15	7	11	1	308.88	617.76	15	1	0.210249950925865	-4.13333333333333	1	-0.234848484848485	12	22
CLVS1	0	3	1	1	151.47	302.94	15	1	0.4	-Inf	1	-0.5	2	3
CLYBL	1	1	1	1	218.79	437.58	15	1	1	0	1	0	2	2
CMAS	3	8	2	2	357.72	715.44	15	1	0.56043956043956	-1.66666666666667	1	-0.227272727272727	4	11
CMBL	2	10	1	1	225.06	450.12	15	1	0.395604395604396	-4	1	-0.333333333333333	2	12
CMBLL	1	7	1	1	240.57	481.14	15	1	0.377777777777778	-6	1	-0.375	2	8
CMC1	0	1	0	5	98.67	197.34	15	1	1	NA	1	0	5	1
CMIP	1	20	0	6	704.22	1408.44	15	1	1	1	1	0.0476190476190476	6	21
CMPK1	0	10	0	2	170.28	340.56	15	1	1	NA	1	0	2	10
CMPK2	12	13	0	1	251.46	502.92	15	1	1	1	1	0.48	1	25
CMTM3	2	7	0	0	131.67	263.34	15	1	1	NA	1	NA	0	9
CMTM4	0	4	0	0	176.88	353.76	15	1	1	NA	1	NA	0	4
CMTM6	12	3	0	0	171.93	343.86	15	1	1	NA	1	NA	0	15
CMTM8	1	2	3	0	123.75	247.5	15	1	0.4	-Inf	1	-0.666666666666667	3	3
CMTR1	7	32	3	13	840.51	1681.02	15	1	1	-0.054945054945055	1	-0.00801282051282051	16	39
CMTR2	0	1	0	3	480.48	960.96	15	1	1	NA	1	0	3	1
CMYA5	290	157	39	17	4428.6	8857.2	15	1	0.552289406736864	-0.241987829614605	1	-0.0476589964844998	56	447
CNBP	0	3	0	2	170.28	340.56	15	1	1	NA	1	0	2	3
CNDP1	8	27	6	4	489.06	978.12	15	1	0.0488146444202211	-4.0625	0.833370237838852	-0.371428571428571	10	35
CNDP2	6	23	3	1	471.24	942.48	15	1	0.0523460410557185	-10.5	0.843251957917679	-0.543103448275862	4	29
CNEP1R1	1	3	0	0	116.49	232.98	15	1	1	NA	1	NA	0	4
CNGA1	2	17	3	6	638.55	1277.1	15	1	0.29010989010989	-3.25	1	-0.228070175438596	9	19
CNGA2	12	27	14	9	641.19	1282.38	15	1	0.0325154024854922	-2.5	0.784275503573749	-0.301003344481605	23	39
CNGA3	3	35	2	9	724.68	1449.36	15	1	0.310966477247698	-1.59259259259259	1	-0.102870813397129	11	38
CNGB1	30	45	12	18	1145.1	2290.2	15	1	1	0	1	0	30	75
CNGB3	12	20	3	1	721.05	1442.1	15	1	0.28698752228164	-4	1	-0.375	4	32
CNIH1	0	3	0	0	137.61	275.22	15	1	1	NA	1	NA	0	3
CNIH3	0	4	0	0	132.66	265.32	15	1	1	NA	1	NA	0	4
CNIH4	1	4	0	1	93.72	187.44	15	1	1	1	1	0.2	1	5
CNKSR1	7	19	4	8	311.85	623.7	15	1	0.714373694040644	-0.357142857142857	1	-0.0641025641025641	12	26
CNKSR2	8	35	3	5	986.04	1972.08	15	1	0.346397282317182	-1.625	1	-0.188953488372093	8	43
CNKSR2L	8	20	2	3	977.46	1954.92	15	1	0.626900259547645	-0.666666666666667	1	-0.114285714285714	5	28
CNKSR3	6	22	1	3	503.58	1007.16	15	1	1	-0.222222222222222	1	-0.0357142857142857	4	28
CNMD	3	16	4	6	326.7	653.4	15	1	0.192903548225887	-2.55555555555556	1	-0.242105263157895	10	19
CNN2	8	4	1	6	240.57	481.14	15	1	0.0572755417956656	0.916666666666667	0.851374124967591	0.523809523809524	7	12
CNN3	0	6	0	2	309.87	619.74	15	1	1	NA	1	0	2	6
CNOT10	0	27	2	7	703.56	1407.12	15	1	0.0571428571428572	-Inf	0.850449180905408	-0.222222222222222	9	27
CNOT11	0	7	0	5	340.23	680.46	15	1	1	NA	1	0	5	7
CNOT2	0	6	0	1	515.79	1031.58	15	1	1	NA	1	0	1	6
CNOT4	6	12	1	3	812.79	1625.58	15	1	1	0.333333333333333	1	0.0833333333333333	4	18
CNOT6	0	5	0	4	552.42	1104.84	15	1	1	NA	1	0	4	5
CNOT6L	0	6	0	1	544.5	1089	15	1	1	NA	1	0	1	6
CNOT7	0	10	0	2	283.14	566.28	15	1	1	NA	1	0	2	10
CNOT8	0	14	1	2	289.08	578.16	15	1	0.176470588235294	-Inf	1	-0.333333333333333	3	14
CNOT9	0	16	0	3	255.75	511.5	15	1	1	NA	1	0	3	16
CNP	9	19	1	6	399.96	799.92	15	1	0.644457894392462	0.648148148148148	1	0.178571428571429	7	28
CNP1	3	3	3	1	124.74	249.48	15	1	0.571428571428571	-2	1	-0.25	4	6
CNPPD1	12	19	5	10	413.49	826.98	15	1	1	0.208333333333333	1	0.0537634408602151	15	31
CNR1	1	15	0	3	513.81	1027.62	15	1	1	1	1	0.0625	3	16
CNRIP1	0	5	1	3	161.37	322.74	15	1	0.444444444444444	-Inf	1	-0.25	4	5
CNST	15	27	4	4	714.78	1429.56	15	1	0.458820331186573	-0.8	1	-0.142857142857143	8	42
CNTF	3	15	2	3	141.24	282.48	15	1	0.290677286100627	-2.33333333333333	1	-0.233333333333333	5	18
CNTFR	6	13	0	3	402.93	805.86	15	1	0.532467532467532	1	1	0.315789473684211	3	19
CNTLN	31	28	6	0	812.13	1624.26	15	1	0.0327065451734939	-Inf	0.784275503573749	-0.474576271186441	6	59
CNTN1	4	27	3	3	998.91	1997.82	15	1	0.06794695765284	-5.75	0.887960242513107	-0.370967741935484	6	31
CNTN2	11	52	2	13	1015.74	2031.48	15	1	1	0.272727272727273	1	0.0412698412698413	15	63
CNTN3	6	41	5	11	892.98	1785.96	15	1	0.128070499903457	-2.10606060606061	1	-0.184840425531915	16	47
CNTN4	8	47	3	9	1019.7	2039.4	15	1	0.400311018633517	-0.958333333333333	1	-0.104545454545455	12	55
CNTN5	12	9	2	0	269.61	539.22	15	1	0.50197628458498	-Inf	1	-0.428571428571429	2	21
CNTN6	24	27	7	3	1038.18	2076.36	15	1	0.300551924750747	-1.625	1	-0.229411764705882	10	51
CNTNAP1	5	37	2	32	1055.01	2110.02	15	1	0.450099977614016	0.5375	1	0.0602240896358543	34	42
CNTNAP2	6	7	0	0	314.82	629.64	15	1	1	NA	1	NA	0	13
CNTNAP5	23	47	3	8	1282.38	2564.76	15	1	1	0.233695652173913	1	0.0558441558441559	11	70
CNTRL	76	86	21	16	2311.65	4623.3	15	1	0.36230790512099	-0.485197368421053	1	-0.0984317650984318	37	162
COA5	1	1	0	1	41.58	83.16	15	1	1	1	1	0.5	1	2
COA6	1	1	0	0	31.68	63.36	15	1	1	NA	1	NA	0	2
COA7	2	12	2	1	229.68	459.36	15	1	0.120588235294118	-11	1	-0.523809523809524	3	14
COBLL1	47	38	5	4	1149.06	2298.12	15	1	1	-0.0106382978723405	1	-0.00261437908496731	9	85
COCH	4	11	2	1	526.68	1053.36	15	1	0.245098039215686	-4.5	1	-0.4	3	15
COG1	14	36	17	13	784.41	1568.82	15	1	0.0172383541152788	-2.36263736263736	0.67478445727067	-0.286666666666667	30	50
COG3	3	38	6	1	763.29	1526.58	15	1	4.49822320183529e-05	-75	0.04042271543353	-0.78397212543554	7	41
COG5	6	26	7	4	713.13	1426.26	15	1	0.00913975021752889	-6.58333333333333	0.5628407404366	-0.448863636363636	11	32
COG6	1	14	2	3	637.23	1274.46	15	1	0.140350877192982	-8.33333333333333	1	-0.333333333333333	5	15
COG7	3	30	6	6	753.06	1506.12	15	1	0.00617953374916685	-9	0.467685236262114	-0.409090909090909	12	33
COG8	0	6	0	5	184.14	368.28	15	1	1	NA	1	0	5	6
COIL	19	19	2	0	546.81	1093.62	15	1	0.488461538461539	-Inf	1	-0.5	2	38
COL10A1	3	23	0	5	671.22	1342.44	15	1	1	1	1	0.115384615384615	5	26
COL11A1	9	57	9	3	1852.29	3704.58	15	1	4.01362488242888e-05	-18	0.04042271543353	-0.613636363636364	12	66
COL12A1	16	99	5	7	3051.51	6103.02	15	1	0.0279665523788365	-3.41964285714286	0.761210061313465	-0.277536231884058	12	115
COL13A1	13	32	8	7	719.73	1439.46	15	1	0.119776578050329	-1.81318681318681	1	-0.244444444444444	15	45
COL14A1	18	67	12	7	1750.32	3500.64	15	1	0.000600151388960099	-5.38095238095238	0.201217424020789	-0.419814241486068	19	85
COL15A1	47	17	8	7	1334.52	2669.04	15	1	0.210180107119128	0.586626139817629	1	0.201041666666667	15	64
COL16A1	6	22	6	17	537.24	1074.48	15	1	0.749033630178879	-0.294117647058824	1	-0.046583850931677	23	28
COL17A1	27	62	10	13	1480.05	2960.1	15	1	0.319630050306051	-0.766381766381766	1	-0.131411822178798	23	89
COL18A1	16	37	17	20	1059.63	2119.26	15	1	0.182015635509894	-0.965625	1	-0.157572667006629	37	53
COL19A1	24	13	2	0	393.36	786.72	15	1	0.543859649122807	-Inf	1	-0.351351351351351	2	37
COL1A1	16	2	1	4	273.57	547.14	15	1	0.0077565455139826	0.96875	0.525963507605449	0.688888888888889	5	18
COL1A2	2	33	0	13	1331.55	2663.1	15	1	1	1	1	0.0571428571428571	13	35
COL20A1	29	76	18	24	1453.32	2906.64	15	1	0.0813583028065454	-0.96551724137931	0.94404191396991	-0.152380952380952	42	105
COL21A1	7	35	1	5	912.78	1825.56	15	1	1	0	1	0	6	42
COL22A1	37	82	15	12	1710.06	3420.12	15	1	0.024961308085512	-1.77027027027027	0.761210061313465	-0.244631185807656	27	119
COL23A1	2	1	0	0	43.89	87.78	15	1	1	NA	1	NA	0	3
COL24A1	62	42	4	6	1651.32	3302.64	15	1	0.3174710530595	0.548387096774194	1	0.196153846153846	10	104
COL26A1	15	18	7	9	557.37	1114.74	15	1	1	0.0666666666666667	1	0.0170454545454545	16	33
COL28A1	34	32	7	8	1246.41	2492.82	15	1	0.781267851671708	0.176470588235294	1	0.0484848484848485	15	66
COL2A1L	61	82	35	28	1469.49	2938.98	15	1	0.09701953254428	-0.680327868852459	0.971353639774823	-0.128982128982129	63	143
COL3A1	15	54	0	4	1440.45	2880.9	15	1	0.574763650395524	1	1	0.217391304347826	4	69
COL4A1	18	50	5	15	1753.95	3507.9	15	1	1	0.0740740740740741	1	0.0147058823529412	20	68
COL4A2	27	66	10	17	1650.99	3301.98	15	1	0.480575283426299	-0.437908496732026	1	-0.080047789725209	27	93
COL4A3	45	54	17	14	1626.24	3252.48	15	1	0.413135302011684	-0.457142857142857	1	-0.093841642228739	31	99
COL4A3BP	0	19	0	2	587.07	1174.14	15	1	1	NA	1	0	2	19
COL4A4	40	69	11	9	1653.63	3307.26	15	1	0.141146331341305	-1.10833333333333	1	-0.18302752293578	20	109
COL4A5	11	59	1	6	1642.41	3284.82	15	1	1	0.106060606060606	1	0.0142857142857143	7	70
COL4A6	25	68	7	14	1682.01	3364.02	15	1	0.594836376244829	-0.36	1	-0.0645161290322581	21	93
COL5A1	8	81	1	20	1758.24	3516.48	15	1	1	0.49375	1	0.0422685928303906	21	89
COL5A2	7	59	0	7	1448.04	2896.08	15	1	1	1	1	0.106060606060606	7	66
COL6A1	5	47	9	18	930.6	1861.2	15	1	0.0132982330499161	-3.7	0.618176018064783	-0.237179487179487	27	52
COL6A2	8	26	0	5	902.88	1805.76	15	1	0.562801668064826	1	1	0.235294117647059	5	34
COL6A3	35	151	7	11	3132.36	6264.72	15	1	0.0631848274236883	-1.74545454545455	0.878646123461792	-0.200716845878136	18	186
COL6A6	154	100	37	23	2468.73	4937.46	15	1	1	-0.0446075663466967	1	-0.0103674540682415	60	254
COL8A1	0	28	4	9	601.92	1203.84	15	1	0.00706033376123233	-Inf	0.495282212683078	-0.307692307692308	13	28
COL8A2	3	48	3	14	627	1254	15	1	0.160099850398358	-2.42857142857143	1	-0.117647058823529	17	51
COL9A1	8	38	7	4	910.8	1821.6	15	1	0.00432813028864697	-7.3125	0.454265500730165	-0.462450592885375	11	46
COL9A2	3	20	3	11	324.39	648.78	15	1	0.653385002649709	-0.818181818181818	1	-0.0838509316770186	14	23
COL9A3	3	21	1	7	663.3	1326.6	15	1	1	0	1	0	8	24
COLCA2	1	10	0	2	150.81	301.62	15	1	1	1	1	0.0909090909090909	2	11
COLEC10	5	12	1	3	301.95	603.9	15	1	1	0.2	1	0.0441176470588235	4	17
COLEC11	2	12	0	1	269.28	538.56	15	1	1	1	1	0.142857142857143	1	14
COLEC12	3	22	3	6	785.07	1570.14	15	1	0.305846365242426	-2.66666666666667	1	-0.213333333333333	9	25
COLGALT2	8	18	2	3	584.43	1168.86	15	1	1	-0.5	1	-0.0923076923076923	5	26
COLQ	3	18	5	3	448.47	896.94	15	1	0.0187619476974799	-9	0.683149554847669	-0.482142857142857	8	21
COMMD1	3	6	4	2	151.14	302.28	15	1	0.314685314685315	-3	1	-0.333333333333333	6	9
COMMD10	2	3	0	1	118.14	236.28	15	1	1	1	1	0.4	1	5
COMMD2	2	3	0	1	150.15	300.3	15	1	1	1	1	0.4	1	5
COMMD4	0	9	1	5	138.27	276.54	15	1	0.4	-Inf	1	-0.166666666666667	6	9
COMMD5	1	2	1	0	181.83	363.66	15	1	1	-Inf	1	-0.666666666666667	1	3
COMMD6	7	12	3	3	188.43	376.86	15	1	0.653162055335968	-0.714285714285714	1	-0.131578947368421	6	19
COMMD7	0	6	1	1	171.27	342.54	15	1	0.25	-Inf	1	-0.5	2	6
COMMD8	4	5	1	0	108.9	217.8	15	1	1	-Inf	1	-0.555555555555556	1	9
COMMD9	1	3	1	3	150.15	300.3	15	1	1	0	1	0	4	4
COMT	7	8	2	2	281.16	562.32	15	1	1	-0.142857142857143	1	-0.0333333333333333	4	15
COMTD1	2	9	2	1	232.32	464.64	15	1	0.175824175824176	-8	1	-0.484848484848485	3	11
COPA	3	40	3	9	1180.08	2360.16	15	1	0.110280125596441	-3.44444444444444	0.98538656216834	-0.180232558139535	12	43
COPB1	17	79	13	15	1093.29	2186.58	15	1	0.00463339695423297	-3.02745098039216	0.458402469160589	-0.287202380952381	28	96
COPB2	2	43	1	15	903.87	1807.74	15	1	1	-0.433333333333333	1	-0.0180555555555556	16	45
COPE	1	16	3	2	264.33	528.66	15	1	0.0239234449760766	-23	0.748072489277835	-0.541176470588235	5	17
COPG2	1	41	2	13	851.07	1702.14	15	1	0.166267942583732	-5.30769230769231	1	-0.10952380952381	15	42
COPRS	10	7	2	1	181.17	362.34	15	1	1	-0.4	1	-0.0784313725490196	3	17
COPS2	0	10	0	0	439.56	879.12	15	1	1	NA	1	NA	0	10
COPS4	0	15	0	3	402.93	805.86	15	1	1	NA	1	0	3	15
COPS5	0	8	2	1	273.24	546.48	15	1	0.0545454545454546	-Inf	0.846060006968071	-0.666666666666667	3	8
COPS7A	0	7	0	0	207.57	415.14	15	1	1	NA	1	NA	0	7
COPS7B	3	8	1	2	288.09	576.18	15	1	1	-0.333333333333333	1	-0.0606060606060606	3	11
COPS8	2	5	0	0	205.92	411.84	15	1	1	NA	1	NA	0	7
COQ10A	4	8	1	2	121.77	243.54	15	1	1	0	1	0	3	12
COQ2	15	16	3	3	463.98	927.96	15	1	1	-0.0666666666666667	1	-0.0161290322580645	6	31
COQ3	14	13	2	1	322.41	644.82	15	1	1	-0.857142857142857	1	-0.148148148148148	3	27
COQ6	3	18	2	5	430.32	860.64	15	1	0.573717948717949	-1.4	1	-0.142857142857143	7	21
COQ7	1	2	0	0	132.66	265.32	15	1	1	NA	1	NA	0	3
COQ8A	5	20	1	3	643.5	1287	15	1	1	-0.333333333333333	1	-0.05	4	25
COQ9	4	8	2	0	281.49	562.98	15	1	0.164835164835165	-Inf	1	-0.666666666666667	2	12
COR8	13	10	3	5	319.77	639.54	15	1	0.433147942157953	0.538461538461538	1	0.190217391304348	8	23
CORIN	31	51	11	8	1399.53	2799.06	15	1	0.12712569561558	-1.26209677419355	1	-0.200898587933248	19	82
CORO1C	8	23	6	14	802.56	1605.12	15	1	0.758211255682925	-0.232142857142857	1	-0.0419354838709677	20	31
CORO2A	14	25	2	1	517.77	1035.54	15	1	0.547038327526132	-2.57142857142857	1	-0.307692307692308	3	39
CORO2B	1	12	1	12	403.26	806.52	15	1	1	0	1	0	13	13
CORO6	1	3	0	2	219.78	439.56	15	1	1	1	1	0.25	2	4
COTL1	2	3	4	1	165.33	330.66	15	1	0.523809523809524	-5	1	-0.4	5	5
COX10	5	8	0	2	209.88	419.76	15	1	0.523809523809524	1	1	0.384615384615385	2	13
COX11	5	2	0	1	169.62	339.24	15	1	0.375	1	1	0.714285714285714	1	7
COX17	1	2	0	0	41.25	82.5	15	1	1	NA	1	NA	0	3
COX18	9	16	3	2	288.09	576.18	15	1	0.364405709233295	-1.66666666666667	1	-0.24	5	25
COX20	0	4	1	1	116.16	232.32	15	1	0.333333333333333	-Inf	1	-0.5	2	4
COX4I1	4	20	0	1	170.28	340.56	15	1	1	1	1	0.166666666666667	1	24
COX5A	0	2	0	2	116.49	232.98	15	1	1	NA	1	0	2	2
COX7A2L	1	0	0	1	92.07	184.14	15	1	1	1	1	1	1	1
COX7B	3	6	0	0	78.21	156.42	15	1	1	NA	1	NA	0	9
CP	22	30	5	4	1069.2	2138.4	15	1	0.491560532614933	-0.704545454545455	1	-0.132478632478633	9	52
CPA1	6	13	4	1	309.54	619.08	15	1	0.122200263504611	-7.66666666666667	1	-0.48421052631579	5	19
CPA2	7	16	0	5	382.14	764.28	15	1	0.289529914529915	1	1	0.304347826086957	5	23
CPA5	9	17	5	11	379.17	758.34	15	1	1	0.141414141414141	1	0.0336538461538461	16	26
CPA6	3	13	2	1	396.33	792.66	15	1	0.154798761609907	-7.66666666666667	1	-0.479166666666667	3	16
CPAMD8	9	63	4	9	1842.06	3684.12	15	1	0.107031238161787	-2.11111111111111	0.983875031494079	-0.182692307692308	13	72
CPB1	8	13	0	1	413.82	827.64	15	1	1	1	1	0.380952380952381	1	21
CPB2	2	11	3	2	417.78	835.56	15	1	0.0987394957983193	-7.25	0.971353639774823	-0.446153846153846	5	13
CPD	15	73	4	15	1185.69	2371.38	15	1	0.741931638040275	-0.297777777777778	1	-0.0400717703349282	19	88
CPE	6	13	1	2	431.64	863.28	15	1	1	-0.0833333333333333	1	-0.0175438596491228	3	19
CPEB1	4	24	1	7	555.72	1111.44	15	1	1	0.142857142857143	1	0.0178571428571428	8	28
CPEB2	0	6	1	4	447.81	895.62	15	1	0.454545454545455	-Inf	1	-0.2	5	6
CPEB3	0	10	0	2	657.36	1314.72	15	1	1	NA	1	0	2	10
CPEB4	0	8	0	2	691.02	1382.04	15	1	1	NA	1	0	2	8
CPED1	28	12	4	0	512.16	1024.32	15	1	0.561550191158813	-Inf	1	-0.3	4	40
CPLX2	0	2	0	4	127.05	254.1	15	1	1	NA	1	0	4	2
CPLX3	0	2	0	1	70.95	141.9	15	1	1	NA	1	0	1	2
CPLX4	0	6	0	1	159.39	318.78	15	1	1	NA	1	0	1	6
CPM	23	23	4	7	406.56	813.12	15	1	0.511576527333873	0.428571428571429	1	0.136363636363636	11	46
CPN1	5	23	0	2	449.46	898.92	15	1	1	1	1	0.178571428571429	2	28
CPNE1	9	22	7	5	487.08	974.16	15	1	0.0920419882144286	-2.42222222222222	0.953786405978059	-0.293010752688172	12	31
CPNE2	0	18	2	3	538.56	1077.12	15	1	0.0395256916996048	-Inf	0.794548741720226	-0.4	5	18
CPNE3	8	16	0	2	528.66	1057.32	15	1	1	1	1	0.333333333333333	2	24
CPNE7	3	9	3	9	322.08	644.16	15	1	1	0	1	0	12	12
CPNE8	1	13	0	1	527.01	1054.02	15	1	1	1	1	0.0714285714285714	1	14
CPNE9	1	8	6	12	379.83	759.66	15	1	0.363210702341137	-3	1	-0.222222222222222	18	9
CPO	11	16	0	0	448.47	896.94	15	1	1	NA	1	NA	0	27
CPOX	2	12	0	2	272.91	545.82	15	1	1	1	1	0.142857142857143	2	14
CPPED1	8	10	3	1	309.87	619.74	15	1	0.586466165413534	-2.75	1	-0.305555555555556	4	18
CPQ	3	4	3	2	223.41	446.82	15	1	1	-1	1	-0.171428571428571	5	7
CPS1	29	53	6	5	1584.66	3169.32	15	1	0.320433782338481	-1.19310344827586	1	-0.19179600886918	11	82
CPSF2	1	23	0	1	775.17	1550.34	15	1	1	1	1	0.0416666666666667	1	24
CPSF3	0	28	0	5	619.08	1238.16	15	1	1	NA	1	0	5	28
CPSF4	0	4	0	1	189.09	378.18	15	1	1	NA	1	0	1	4
CPSF4L	12	5	3	2	143.22	286.44	15	1	1	0.375	1	0.105882352941177	5	17
CPSF6	4	10	0	3	543.18	1086.36	15	1	0.541176470588235	1	1	0.285714285714286	3	14
CPSF7	3	6	0	1	153.45	306.9	15	1	1	1	1	0.333333333333333	1	9
CPT2	11	22	5	7	639.54	1279.08	15	1	0.728383240831239	-0.428571428571429	1	-0.0833333333333334	12	33
CPTP	1	7	0	2	177.54	355.08	15	1	1	1	1	0.125	2	8
CPXM2	14	37	4	4	848.76	1697.52	15	1	0.231498069031013	-1.64285714285714	1	-0.225490196078431	8	51
CPZ	14	35	6	2	643.5	1287	15	1	0.0174341381888552	-6.5	0.676623948358463	-0.464285714285714	8	49
CR1L	78	48	11	10	832.26	1664.52	15	1	0.472496875244867	0.323076923076923	1	0.0952380952380952	21	126
CRABP2	1	3	0	0	136.62	273.24	15	1	1	NA	1	NA	0	4
CRACR2B	23	27	14	4	700.92	1401.84	15	1	0.0275366483148011	-3.10869565217391	0.761210061313465	-0.317777777777778	18	50
CRAMP1	12	51	2	14	1345.41	2690.82	15	1	0.722845642771406	0.392857142857143	1	0.0654761904761905	16	63
CRAT	3	34	1	8	611.82	1223.64	15	1	1	-0.416666666666667	1	-0.03003003003003	9	37
CRB1	36	50	7	3	1295.25	2590.5	15	1	0.106079371427101	-2.24074074074074	0.983805342817882	-0.281395348837209	10	86
CRB2	52	74	13	19	1461.24	2922.48	15	1	1	0.0263157894736842	1	0.00644841269841268	32	126
CRBN	2	14	0	3	430.65	861.3	15	1	1	1	1	0.125	3	16
CRCBL	46	35	15	7	885.72	1771.44	15	1	0.463849620168686	-0.630434782608696	1	-0.113916947250281	22	81
CRCP	0	3	0	0	147.18	294.36	15	1	1	NA	1	NA	0	3
CREB1	0	5	1	0	316.8	633.6	15	1	0.166666666666667	-Inf	1	-1	1	5
CREB3	12	15	5	5	353.43	706.86	15	1	1	-0.25	1	-0.0555555555555556	10	27
CREB3L1	2	11	1	3	470.25	940.5	15	1	1	-0.833333333333333	1	-0.0961538461538461	4	13
CREB3L2	1	16	3	4	495.66	991.32	15	1	0.0592885375494071	-11	0.865311545612266	-0.369747899159664	7	17
CREB3L3	6	12	4	13	236.94	473.88	15	1	0.711194256244312	0.384615384615385	1	0.0980392156862745	17	18
CREB5	1	1	0	0	93.72	187.44	15	1	1	NA	1	NA	0	2
CREBL2	3	2	0	0	131.67	263.34	15	1	1	NA	1	NA	0	5
CREBRF	0	23	2	8	630.63	1261.26	15	1	0.0852272727272728	-Inf	0.950356516076024	-0.2	10	23
CREG1	0	6	0	0	137.61	275.22	15	1	1	NA	1	NA	0	6
CREG2	12	11	3	4	217.8	435.6	15	1	1	0.3125	1	0.093167701863354	7	23
CRELD2	4	8	1	0	308.88	617.76	15	1	0.384615384615385	-Inf	1	-0.666666666666667	1	12
CREM	4	10	0	1	381.15	762.3	15	1	1	1	1	0.285714285714286	1	14
CRH	1	0	2	0	178.2	356.4	15	1	1	NA	1	0	2	1
CRHBP	4	15	0	1	292.05	584.1	15	1	1	1	1	0.210526315789474	1	19
CRHR1	0	20	1	1	416.79	833.58	15	1	0.0909090909090909	-Inf	0.953786405978059	-0.5	2	20
CRHR2	0	6	0	3	347.49	694.98	15	1	1	NA	1	0	3	6
CRIM1	2	34	1	2	876.15	1752.3	15	1	0.218732902943429	-7.5	1	-0.277777777777778	3	36
CRIP1	0	3	0	1	64.02	128.04	15	1	1	NA	1	0	1	3
CRIP2	0	4	0	3	183.15	366.3	15	1	1	NA	1	0	3	4
CRIPT	0	3	0	1	100.98	201.96	15	1	1	NA	1	0	1	3
CRISP2	4	8	0	0	256.41	512.82	15	1	1	NA	1	NA	0	12
CRISPLD1	6	18	0	0	484.44	968.88	15	1	1	NA	1	NA	0	24
CRISPLD2	3	23	2	4	498.96	997.92	15	1	0.227911965676148	-2.83333333333333	1	-0.217948717948718	6	26
CRK	1	2	0	1	256.41	512.82	15	1	1	1	1	0.333333333333333	1	3
CRLF2	10	17	0	1	374.22	748.44	15	1	1	1	1	0.37037037037037	1	27
CRLF3	2	13	1	3	405.57	811.14	15	1	0.530443756449949	-1.16666666666667	1	-0.116666666666667	4	15
CRMP1	1	15	1	1	554.4	1108.8	15	1	0.215686274509804	-14	1	-0.4375	2	16
CRNKL1	31	33	6	7	842.49	1684.98	15	1	1	0.0875576036866359	1	0.0228365384615384	13	64
CROCC	7	9	8	9	344.52	689.04	15	1	1	-0.142857142857143	1	-0.0330882352941176	17	16
CROT	19	25	2	4	615.45	1230.9	15	1	1	0.342105263157895	1	0.0984848484848485	6	44
CRP	4	5	1	1	166.98	333.96	15	1	1	-0.25	1	-0.0555555555555556	2	9
CRTAC1	11	41	11	19	599.28	1198.56	15	1	0.194974824833688	-1.15789473684211	1	-0.155128205128205	30	52
CRTAM	27	27	11	7	470.58	941.16	15	1	0.586474738079126	-0.571428571428571	1	-0.111111111111111	18	54
CRTAP	6	14	1	0	370.26	740.52	15	1	0.333333333333333	-Inf	1	-0.7	1	20
CRY1	0	18	2	1	607.86	1215.72	15	1	0.0142857142857143	-Inf	0.629301355578728	-0.666666666666667	3	18
CRY2	3	19	3	3	516.12	1032.24	15	1	0.0913043478260869	-5.33333333333333	0.953786405978059	-0.363636363636364	6	22
CRY4	15	26	7	9	524.7	1049.4	15	1	0.763438882166565	-0.348148148148148	1	-0.0716463414634146	16	41
CRYAA	1	4	3	1	172.26	344.52	15	1	0.206349206349207	-11	1	-0.55	4	5
CRYAB	3	8	0	2	173.25	346.5	15	1	1	1	1	0.272727272727273	2	11
CRYBA1	1	5	1	1	213.84	427.68	15	1	0.464285714285714	-4	1	-0.333333333333333	2	6
CRYBA2	2	0	2	1	137.94	275.88	15	1	1	1	1	0.333333333333333	3	2
CRYBA4	1	5	3	5	106.92	213.84	15	1	0.580419580419581	-2	1	-0.208333333333333	8	6
CRYBB1	10	10	9	9	208.56	417.12	15	1	1	0	1	0	18	20
CRYBB2	0	4	0	5	155.76	311.52	15	1	1	NA	1	0	5	4
CRYBB3	3	4	1	3	174.24	348.48	15	1	1	0.555555555555556	1	0.178571428571429	4	7
CRYBG3	136	94	28	11	2514.27	5028.54	15	1	0.157224268122375	-0.759358288770053	1	-0.126644370122631	39	230
CRYGN	9	12	6	2	302.28	604.56	15	1	0.214759287023155	-3	1	-0.321428571428571	8	21
CRYGS	2	5	2	2	162.03	324.06	15	1	0.575757575757576	-1.5	1	-0.214285714285714	4	7
CRYL1	3	5	2	3	312.51	625.02	15	1	1	-0.111111111111111	1	-0.025	5	8
CRYM	2	12	0	0	254.76	509.52	15	1	1	NA	1	NA	0	14
CRYZ	6	9	3	2	328.68	657.36	15	1	0.61687306501548	-1.25	1	-0.2	5	15
CRYZL1	2	7	3	4	297.99	595.98	15	1	0.596153846153846	-1.625	1	-0.206349206349206	7	9
CS	1	11	1	3	338.91	677.82	15	1	0.45	-2.66666666666667	1	-0.166666666666667	4	12
CSDC2	0	2	0	0	87.12	174.24	15	1	1	NA	1	NA	0	2
CSDE1	1	23	0	0	873.84	1747.68	15	1	1	NA	1	NA	0	24
CSE1L	7	43	1	7	1579.05	3158.1	15	1	1	0.122448979591837	1	0.015	8	50
CSF1	17	20	4	6	495	990	15	1	1	0.215686274509804	1	0.0594594594594595	10	37
CSF1R	42	47	10	13	979.11	1958.22	15	1	0.817306999246251	0.139194139194139	1	0.0371275036638984	23	89
CSF2	22	10	2	2	139.59	279.18	15	1	0.587675070028011	0.545454545454545	1	0.1875	4	32
CSF2RA	38	7	2	1	396.99	793.98	15	1	0.428769657724329	0.631578947368421	1	0.177777777777778	3	45
CSF2RB	33	22	8	6	620.4	1240.8	15	1	1	0.111111111111111	1	0.0285714285714286	14	55
CSF3	0	3	0	4	80.19	160.38	15	1	1	NA	1	0	4	3
CSF3R	19	28	14	17	653.4	1306.8	15	1	0.815308257446129	-0.213622291021672	1	-0.0473575840768703	31	47
CSGALNACT1	4	32	2	5	501.93	1003.86	15	1	0.247638709321845	-2.2	1	-0.174603174603175	7	36
CSGALNACT2	1	19	0	3	536.58	1073.16	15	1	1	1	1	0.05	3	20
CSK	0	3	0	0	112.53	225.06	15	1	1	NA	1	NA	0	3
CSMD1	21	55	3	3	1663.53	3327.06	15	1	0.351530360483741	-1.61904761904762	1	-0.223684210526316	6	76
CSMD2	11	147	9	31	3226.74	6453.48	15	1	0.00719913639413225	-2.87976539589443	0.496534721583864	-0.155379746835443	40	158
CSMD3	10	73	4	9	1799.16	3598.32	15	1	0.0935018218140583	-2.24444444444444	0.958791526417971	-0.187210379981464	13	83
CSNK1A1	0	5	0	0	308.88	617.76	15	1	1	NA	1	NA	0	5
CSNK1D	1	10	0	0	401.94	803.88	15	1	1	NA	1	NA	0	11
CSNK1E	0	20	0	7	412.83	825.66	15	1	1	NA	1	0	7	20
CSNK1G1	0	16	0	8	460.35	920.7	15	1	1	NA	1	0	8	16
CSNK2A1	0	11	0	5	388.08	776.16	15	1	1	NA	1	0	5	11
CSNK2A2	0	5	1	1	301.95	603.9	15	1	0.285714285714286	-Inf	1	-0.5	2	5
CSPG4	62	81	44	33	2022.9	4045.8	15	1	0.0657182834174339	-0.741935483870968	0.884435842948953	-0.137862137862138	77	143
CSPG5	1	1	1	0	8.58	17.16	15	1	1	-Inf	1	-0.5	1	2
CSPP1	38	41	11	3	1188.33	2376.66	15	1	0.0441036404287247	-2.95614035087719	0.822543273817637	-0.304701627486438	14	79
CSRNP1	13	34	6	4	565.29	1130.58	15	1	0.068482760126965	-2.92307692307692	0.888803134120932	-0.323404255319149	10	47
CSRNP2	8	11	5	11	492.69	985.38	15	1	0.726683754896745	0.375	1	0.108552631578947	16	19
CSRNP3	11	19	2	2	745.47	1490.94	15	1	0.627177850612386	-0.727272727272727	1	-0.133333333333333	4	30
CSRP1	1	7	0	5	191.07	382.14	15	1	1	1	1	0.125	5	8
CSRP2	0	12	0	6	193.05	386.1	15	1	1	NA	1	0	6	12
CSRP3	5	11	1	0	221.1	442.2	15	1	0.352941176470588	-Inf	1	-0.6875	1	16
CST3	9	4	0	2	135.3	270.6	15	1	0.142857142857143	1	1	0.692307692307692	2	13
CST7	5	8	0	4	146.52	293.04	15	1	0.260504201680672	1	1	0.384615384615385	4	13
CSTA-CSTB	9	1	0	1	61.05	122.1	15	1	0.181818181818182	1	1	0.9	1	10
CSTF1	0	16	0	0	458.37	916.74	15	1	1	NA	1	NA	0	16
CSTF2	0	22	0	9	526.02	1052.04	15	1	1	NA	1	0	9	22
CSTF3	0	16	1	3	701.91	1403.82	15	1	0.2	-Inf	1	-0.25	4	16
CTBP1	2	6	1	0	397.65	795.3	15	1	0.333333333333333	-Inf	1	-0.75	1	8
CTBP2	18	53	17	26	962.61	1925.22	15	1	0.143109522462743	-0.925213675213675	1	-0.141827710448739	43	71
CTBPL	1	6	0	0	436.59	873.18	15	1	1	NA	1	NA	0	7
CTC1	58	47	10	11	1224.3	2448.6	15	1	0.633079341039291	0.263322884012539	1	0.0761904761904763	21	105
CTCF	2	24	1	2	734.58	1469.16	15	1	0.288451012588944	-5	1	-0.256410256410256	3	26
CTDP1	9	31	4	3	790.68	1581.36	15	1	0.0804659942991659	-3.59259259259259	0.937475435512484	-0.346428571428571	7	40
CTDSPL	7	5	1	0	316.14	632.28	15	1	1	-Inf	1	-0.416666666666667	1	12
CTDSPL2	0	10	0	1	464.31	928.62	15	1	1	NA	1	0	1	10
CTGF	2	10	1	0	307.23	614.46	15	1	0.230769230769231	-Inf	1	-0.833333333333333	1	12
CTGFL	4	7	3	4	304.59	609.18	15	1	1	-0.3125	1	-0.0649350649350649	7	11
CTH	2	14	3	5	383.46	766.92	15	1	0.288537549407114	-3.2	1	-0.25	8	16
CTHRC1	1	12	0	1	198.66	397.32	15	1	1	1	1	0.0769230769230769	1	13
CTIF	10	8	3	5	459.69	919.38	15	1	0.672768878718535	0.52	1	0.180555555555556	8	18
CTLA4	3	4	0	0	203.94	407.88	15	1	1	NA	1	NA	0	7
CTNNA2	1	10	0	0	634.59	1269.18	15	1	1	NA	1	NA	0	11
CTNNA3	25	35	9	2	1020.36	2040.72	15	1	0.0206083248255709	-5.3	0.70665477455864	-0.401515151515152	11	60
CTNNAL1	4	19	3	3	746.79	1493.58	15	1	0.131476569407604	-3.75	1	-0.326086956521739	6	23
CTNNB1	0	21	3	5	774.18	1548.36	15	1	0.0153256704980843	-Inf	0.644532553699922	-0.375	8	21
CTNNBL1	5	29	1	5	594	1188	15	1	1	-0.16	1	-0.0196078431372549	6	34
CTNND1	5	50	1	12	900.9	1801.8	15	1	1	0.166666666666667	1	0.013986013986014	13	55
CTNND2	7	12	8	8	1135.2	2270.4	15	1	0.506019340560135	-0.714285714285714	1	-0.131578947368421	16	19
CTNS	3	13	5	2	379.17	758.34	15	1	0.02573045028288	-9.83333333333333	0.761210061313465	-0.526785714285714	7	16
CTPS1	2	21	2	5	561.33	1122.66	15	1	0.224521072796935	-3.2	1	-0.198757763975155	7	23
CTPS2	2	17	1	4	581.13	1162.26	15	1	0.521245059288538	-1.125	1	-0.0947368421052632	5	19
CTR9	2	46	3	6	1144.77	2289.54	15	1	0.0241039992777828	-10.5	0.749833173409377	-0.291666666666667	9	48
CTRC	1	0	1	1	13.86	27.72	15	1	1	1	1	0.5	2	1
CTRL	15	8	0	2	250.47	500.94	15	1	0.15	1	1	0.652173913043478	2	23
CTSA	30	13	0	2	757.68	1515.36	15	1	0.106060606060606	1	0.983805342817882	0.697674418604651	2	43
CTSB	0	7	1	6	331.65	663.3	15	1	1	-Inf	1	-0.142857142857143	7	7
CTSC	5	19	0	3	413.16	826.32	15	1	1	1	1	0.208333333333333	3	24
CTSD	0	28	1	10	357.06	714.12	15	1	0.282051282051282	-Inf	1	-0.0909090909090909	11	28
CTSE	16	15	7	6	386.43	772.86	15	1	1	-0.09375	1	-0.0223325062034739	13	31
CTSEAL	2	20	1	9	401.94	803.88	15	1	1	-0.111111111111111	1	-0.00909090909090909	10	22
CTSG	7	13	1	0	241.23	482.46	15	1	0.380952380952381	-Inf	1	-0.65	1	20
CTSH	0	17	2	5	264.66	529.32	15	1	0.0760869565217393	-Inf	0.919736921581953	-0.285714285714286	7	17
CTSK	5	22	0	3	329.67	659.34	15	1	1	1	1	0.185185185185185	3	27
CTSO	12	8	1	0	235.29	470.58	15	1	1	-Inf	1	-0.4	1	20
CTSS	8	26	2	1	326.04	652.08	15	1	0.171814671814672	-5.5	1	-0.431372549019608	3	34
CTSV	14	25	2	1	396.66	793.32	15	1	0.547038327526132	-2.57142857142857	1	-0.307692307692308	3	39
CTSZ	0	13	0	1	266.31	532.62	15	1	1	NA	1	0	1	13
CTTN	1	17	0	1	511.83	1023.66	15	1	1	1	1	0.0555555555555556	1	18
CTTNBP2	14	27	2	4	1142.79	2285.58	15	1	1	0.0357142857142857	1	0.00813008130081305	6	41
CTTNBP2NL	4	15	3	2	631.62	1263.24	15	1	0.126482213438735	-4.625	1	-0.389473684210526	5	19
CTU2	4	7	0	5	147.84	295.68	15	1	0.244505494505495	1	1	0.363636363636364	5	11
CTXN3	2	2	1	0	97.02	194.04	15	1	1	-Inf	1	-0.5	1	4
CUBN	72	121	29	24	3655.74	7311.48	15	1	0.0273483423085991	-1.0306712962963	0.761210061313465	-0.174112816502102	53	193
CUEDC1	3	16	2	7	329.01	658.02	15	1	1	-0.523809523809524	1	-0.064327485380117	9	19
CUEDC2	5	15	0	5	282.15	564.3	15	1	0.544042913608131	1	1	0.25	5	20
CUL1	0	19	0	3	752.4	1504.8	15	1	1	NA	1	0	3	19
CUL2	0	19	1	0	704.88	1409.76	15	1	0.05	-Inf	0.838566235774774	-1	1	19
CUL3	1	20	0	3	744.48	1488.96	15	1	1	1	1	0.0476190476190476	3	21
CUL4A	0	17	1	2	644.16	1288.32	15	1	0.15	-Inf	1	-0.333333333333333	3	17
CUL4B	3	32	0	2	804.21	1608.42	15	1	1	1	1	0.0857142857142857	2	35
CUL5	0	14	0	6	773.19	1546.38	15	1	1	NA	1	0	6	14
CUL9	11	27	9	9	818.07	1636.14	15	1	0.145996180090386	-1.45454545454545	1	-0.210526315789474	18	38
CUTA	1	6	1	1	140.58	281.16	15	1	0.416666666666667	-5	1	-0.357142857142857	2	7
CUX1	6	10	3	4	231.66	463.32	15	1	1	-0.25	1	-0.0535714285714285	7	16
CUX2	12	23	17	19	1074.81	2149.62	15	1	0.336590620144821	-0.714912280701754	1	-0.129365079365079	36	35
CUZD1	25	38	11	9	593.01	1186.02	15	1	0.301771803242197	-0.857777777777778	1	-0.153174603174603	20	63
CWC15	0	14	0	1	228.69	457.38	15	1	1	NA	1	0	1	14
CWC22	10	25	3	0	856.02	1712.04	15	1	0.0339023233760076	-Inf	0.787252650978106	-0.714285714285714	3	35
CWC25	9	31	2	5	416.13	832.26	15	1	0.659322605746764	-0.377777777777778	1	-0.0607142857142857	7	40
CWC27	6	13	0	0	330.66	661.32	15	1	1	NA	1	NA	0	19
CWF19L1	7	16	1	0	442.53	885.06	15	1	0.333333333333333	-Inf	1	-0.695652173913043	1	23
CWF19L2	7	16	3	3	400.95	801.9	15	1	0.632815460401667	-1.28571428571429	1	-0.195652173913043	6	23
CWH43	12	25	6	2	717.42	1434.84	15	1	0.0447177087771768	-5.25	0.822543273817637	-0.425675675675676	8	37
CX3CL1	54	17	9	6	579.15	1158.3	15	1	0.213752487173568	0.527777777777778	1	0.16056338028169	15	71
CX3CR1	15	22	0	1	351.45	702.9	15	1	1	1	1	0.405405405405405	1	37
CXADR	4	6	1	1	310.2	620.4	15	1	1	-0.5	1	-0.1	2	10
CXCL13	2	2	2	0	84.48	168.96	15	1	0.466666666666667	-Inf	1	-0.5	2	4
CXCL13L2	2	1	0	1	45.87	91.74	15	1	1	1	1	0.666666666666667	1	3
CXCL13L3	4	5	1	1	104.94	209.88	15	1	1	-0.25	1	-0.0555555555555556	2	9
CXCL14	0	4	0	0	76.89	153.78	15	1	1	NA	1	NA	0	4
CXCR1	5	5	2	8	334.95	669.9	15	1	0.34984520123839	0.75	1	0.3	10	10
CXCR4	1	15	0	4	350.46	700.92	15	1	1	1	1	0.0625	4	16
CXCR5	4	19	1	0	368.28	736.56	15	1	0.208333333333333	-Inf	1	-0.826086956521739	1	23
CXorf21	6	19	2	0	289.08	578.16	15	1	0.0797720797720798	-Inf	0.936566440349175	-0.76	2	25
CXorf23	12	29	1	10	713.79	1427.58	15	1	0.252984160985781	0.758333333333333	1	0.201773835920177	11	41
CXorf40B	0	9	0	0	154.44	308.88	15	1	1	NA	1	NA	0	9
CXorf65	1	1	1	0	98.34	196.68	15	1	1	-Inf	1	-0.5	1	2
CYB561	0	6	1	5	162.69	325.38	15	1	1	-Inf	1	-0.166666666666667	6	6
CYB561A3	6	6	0	2	141.57	283.14	15	1	0.472527472527472	1	1	0.5	2	12
CYB561D2	0	2	0	2	50.49	100.98	15	1	1	NA	1	0	2	2
CYB5A	0	1	0	2	110.88	221.76	15	1	1	NA	1	0	2	1
CYB5B	1	3	2	2	99.99	199.98	15	1	1	-2	1	-0.25	4	4
CYB5D2	5	8	2	3	132.33	264.66	15	1	1	-0.0666666666666667	1	-0.0153846153846154	5	13
CYB5R2	5	10	1	1	267.63	535.26	15	1	1	-1	1	-0.166666666666667	2	15
CYB5R3	5	15	0	0	285.45	570.9	15	1	1	NA	1	NA	0	20
CYBB	4	17	1	5	565.29	1130.58	15	1	1	0.15	1	0.0238095238095238	6	21
CYBRD1	12	15	1	2	260.7	521.4	15	1	1	0.375	1	0.111111111111111	3	27
CYCS	0	7	0	5	104.94	209.88	15	1	1	NA	1	0	5	7
CYFIP1	0	38	0	7	1241.46	2482.92	15	1	1	NA	1	0	7	38
CYFIP2	0	33	0	4	1241.46	2482.92	15	1	1	NA	1	0	4	33
CYGB	0	8	0	2	172.26	344.52	15	1	1	NA	1	0	2	8
CYLD	2	29	2	10	945.45	1890.9	15	1	0.307957215784782	-1.9	1	-0.102150537634409	12	31
CYP11A1	7	13	4	12	458.04	916.08	15	1	0.718205413422321	0.380952380952381	1	0.1	16	20
CYP19A1	5	14	1	2	498.96	997.92	15	1	1	-0.4	1	-0.0701754385964912	3	19
CYP1A1	17	23	7	14	468.6	937.2	15	1	0.585899158359046	0.323529411764706	1	0.0916666666666667	21	40
CYP1A2	21	25	13	13	474.54	949.08	15	1	0.807841175285814	-0.19047619047619	1	-0.0434782608695652	26	46
CYP1B1	3	10	0	3	386.76	773.52	15	1	1	1	1	0.230769230769231	3	13
CYP1C1	21	44	7	6	509.85	1019.7	15	1	0.204766164076941	-1.44444444444444	1	-0.215384615384615	13	65
CYP20A1	6	23	2	0	441.54	883.08	15	1	0.0602150537634409	-Inf	0.870851370851371	-0.793103448275862	2	29
CYP21A1	2	9	1	2	86.79	173.58	15	1	1	-1.25	1	-0.151515151515151	3	11
CYP24A1	4	14	1	1	363	726	15	1	0.447368421052632	-2.5	1	-0.277777777777778	2	18
CYP26A1	6	17	1	3	478.83	957.66	15	1	1	0.0555555555555556	1	0.0108695652173913	4	23
CYP26B1	8	8	1	8	372.9	745.8	15	1	0.0875071892705491	0.875	0.951277979139867	0.388888888888889	9	16
CYP26C1	12	28	0	2	445.17	890.34	15	1	1	1	1	0.3	2	40
CYP27C1	1	13	5	3	548.13	1096.26	15	1	0.0108828220283328	-20.6666666666667	0.585928868752023	-0.553571428571429	8	14
CYP2AB1	12	16	3	4	485.1	970.2	15	1	1	0	1	0	7	28
CYP2AB2	24	16	0	4	483.12	966.24	15	1	0.0356903448225059	1	0.788199921465956	0.6	4	40
CYP2AB3	12	21	4	3	486.09	972.18	15	1	0.407246255543469	-1.33333333333333	1	-0.207792207792208	7	33
CYP2AB4	9	15	2	1	486.09	972.18	15	1	0.548717948717949	-2.33333333333333	1	-0.291666666666667	3	24
CYP2AB5	7	14	3	6	441.54	883.08	15	1	1	0	1	0	9	21
CYP2AC1-CYP2AC2	26	22	3	0	892.65	1785.3	15	1	0.249411764705882	-Inf	1	-0.458333333333333	3	48
CYP2AC7	5	38	2	5	911.13	1822.26	15	1	0.250140242119891	-2.04	1	-0.169435215946844	7	43
CYP2C23a-CYP2C23b	23	23	0	4	490.05	980.1	15	1	0.114654798089449	1	1	0.5	4	46
CYP2C45-RP11-400G3.5	13	13	0	3	490.05	980.1	15	1	0.231527093596059	1	1	0.5	3	26
CYP2D6	13	26	4	6	498.96	997.92	15	1	0.721485579668643	-0.333333333333333	1	-0.0666666666666667	10	39
CYP2J19	6	12	6	8	485.76	971.52	15	1	0.717831406877207	-0.5	1	-0.0952380952380952	14	18
CYP2J21-CYP2J22-CYP2J23	28	31	1	12	487.08	974.16	15	1	0.0107482280237143	0.907738095238095	0.585928868752023	0.397653194263364	13	59
CYP2R1	0	16	3	3	422.73	845.46	15	1	0.012987012987013	-Inf	0.61231737012987	-0.5	6	16
CYP2U1	8	21	2	4	475.2	950.4	15	1	1	-0.3125	1	-0.0574712643678161	6	29
CYP2W2	12	20	2	0	488.07	976.14	15	1	0.162210338680927	-Inf	1	-0.625	2	32
CYP39A1	18	9	0	1	489.06	978.12	15	1	0.357142857142857	1	1	0.666666666666667	1	27
CYP3A4	3	24	2	8	500.28	1000.56	15	1	0.597381950323127	-1	1	-0.0888888888888889	10	27
CYP3A5	6	22	0	9	505.89	1011.78	15	1	0.302464228934817	1	1	0.214285714285714	9	28
CYP46A1	6	21	3	2	487.41	974.82	15	1	0.120550611790879	-4.25	1	-0.377777777777778	5	27
CYP4A22	5	17	3	6	443.85	887.7	15	1	0.659505433387525	-0.7	1	-0.106060606060606	9	22
CYP4V2	42	36	5	2	1039.17	2078.34	15	1	0.452657833630073	-1.14285714285714	1	-0.175824175824176	7	78
CYP51A1	44	41	7	8	1253.34	2506.68	15	1	0.784089966387083	0.184659090909091	1	0.0509803921568628	15	85
CYP7A1	11	17	0	2	507.87	1015.74	15	1	0.519540229885057	1	1	0.392857142857143	2	28
CYP8B1	36	52	20	21	874.17	1748.34	15	1	0.448241335938787	-0.375661375661376	1	-0.0787139689578714	41	88
CYR61	3	16	2	2	343.2	686.4	15	1	0.193675889328063	-4.33333333333333	1	-0.342105263157895	4	19
CYSLTR1	0	6	1	2	342.54	685.08	15	1	0.333333333333333	-Inf	1	-0.333333333333333	3	6
CYSLTR2	8	10	2	4	307.89	615.78	15	1	1	0.375	1	0.111111111111111	6	18
CYTH4	4	13	0	4	454.41	908.82	15	1	0.545530492898914	1	1	0.235294117647059	4	17
CYTIP	10	17	1	4	322.08	644.16	15	1	0.636749165739711	0.575	1	0.17037037037037	5	27
CYTL1	6	7	2	0	129.69	259.38	15	1	0.466666666666667	-Inf	1	-0.538461538461538	2	13
CYYR1	8	3	0	0	128.7	257.4	15	1	1	NA	1	NA	0	11
CZH18ORF25	3	12	2	3	324.06	648.12	15	1	0.559791021671827	-1.66666666666667	1	-0.2	5	15
CZH18ORF32	6	11	1	3	99.99	199.98	15	1	1	0.388888888888889	1	0.102941176470588	4	17
CZH5ORF34	28	12	4	0	586.74	1173.48	15	1	0.561550191158813	-Inf	1	-0.3	4	40
CZH5ORF42	133	81	11	6	2322.54	4645.08	15	1	1	-0.116541353383459	1	-0.025563496426608	17	214
CZH9orf24	13	16	1	1	262.02	524.04	15	1	1	-0.230769230769231	1	-0.0517241379310345	2	29
CZH9ORF3	25	27	4	1	692.67	1385.34	15	1	0.352472089314195	-3.32	1	-0.319230769230769	5	52
CZH9orf64	7	13	1	1	304.59	609.18	15	1	1	-0.857142857142857	1	-0.15	2	20
CZH9orf72	4	15	0	3	477.18	954.36	15	1	1	1	1	0.210526315789474	3	19
D2HGDH	11	29	5	10	528	1056	15	1	0.7436555656616	-0.318181818181818	1	-0.0583333333333333	15	40
DAAM1	5	38	3	10	972.84	1945.68	15	1	0.370333949474587	-1.28	1	-0.114490161001789	13	43
DAAM2	15	40	4	4	1122	2244	15	1	0.228605301787786	-1.66666666666667	1	-0.227272727272727	8	55
DAB2	42	49	4	3	1182.72	2365.44	15	1	0.702943272342139	-0.555555555555556	1	-0.10989010989011	7	91
DAB2IP	4	25	5	12	1093.29	2186.58	15	1	0.257597842813131	-1.60416666666667	1	-0.156186612576065	17	29
DACH1	2	9	0	1	323.73	647.46	15	1	1	1	1	0.181818181818182	1	11
DACH2	1	9	0	1	421.74	843.48	15	1	1	1	1	0.1	1	10
DACT1	9	44	2	5	709.5	1419	15	1	0.601710979181833	-0.955555555555555	1	-0.115902964959569	7	53
DACT2	20	24	2	5	785.07	1570.14	15	1	0.684072481906731	0.52	1	0.168831168831169	7	44
DAD1	1	6	0	2	116.16	232.32	15	1	1	1	1	0.142857142857143	2	7
DAGLA	0	30	2	9	998.91	1997.82	15	1	0.0670731707317073	-Inf	0.884435842948953	-0.181818181818182	11	30
DAGLB	8	21	1	0	665.61	1331.22	15	1	0.3	-Inf	1	-0.724137931034483	1	29
DALRD3	21	36	2	8	412.83	825.66	15	1	0.474288597451611	0.571428571428571	1	0.168421052631579	10	57
DAO	10	8	1	8	341.88	683.76	15	1	0.041671067300358	0.9	0.802184660789985	0.444444444444444	9	18
DAP	16	6	0	2	174.24	348.48	15	1	0.101449275362319	1	0.975691437149951	0.727272727272727	2	22
DAP3	10	12	1	0	369.6	739.2	15	1	0.478260869565217	-Inf	1	-0.545454545454545	1	22
DAPK1	5	52	4	4	1310.1	2620.2	15	1	0.00988683823618043	-9.4	0.5818356433428	-0.412280701754386	8	57
DAPK2	6	21	2	11	493.02	986.04	15	1	1	0.363636363636364	1	0.0683760683760684	13	27
DAPP1	0	10	2	3	255.42	510.84	15	1	0.0952380952380952	-Inf	0.960983694935281	-0.4	5	10
DARS	1	13	1	1	480.48	960.96	15	1	0.241666666666667	-12	1	-0.428571428571429	2	14
DARS2	14	13	6	5	627.33	1254.66	15	1	1	-0.114285714285714	1	-0.0269360269360269	11	27
DAW1	5	12	3	4	398.64	797.28	15	1	0.646626447541779	-0.8	1	-0.134453781512605	7	17
DAZAP1	0	14	0	1	388.41	776.82	15	1	1	NA	1	0	1	14
DAZAP2	0	2	0	2	73.26	146.52	15	1	1	NA	1	0	2	2
DAZL	3	11	0	5	287.1	574.2	15	1	0.530443756449948	1	1	0.214285714285714	5	14
DBF4	13	21	1	2	686.73	1373.46	15	1	1	0.192307692307692	1	0.0490196078431372	3	34
DBF4B	38	20	15	7	741.51	1483.02	15	1	1	-0.12781954887218	1	-0.0266457680250783	22	58
DBH	7	29	6	18	625.02	1250.04	15	1	0.751070352568341	-0.380952380952381	1	-0.0555555555555556	24	36
DBI	0	5	0	0	45.21	90.42	15	1	1	NA	1	NA	0	5
DBN1	0	5	0	3	141.24	282.48	15	1	1	NA	1	0	3	5
DBNDD2	1	2	1	2	167.97	335.94	15	1	1	0	1	0	3	3
DBNL	2	10	5	15	347.49	694.98	15	1	0.683319785516671	-0.666666666666667	1	-0.0833333333333333	20	12
DBR1	6	17	2	3	537.24	1074.48	15	1	0.605616605616606	-0.888888888888889	1	-0.139130434782609	5	23
DBT	2	16	3	5	472.23	944.46	15	1	0.280510793554272	-3.8	1	-0.263888888888889	8	18
DBX1	0	7	0	0	183.81	367.62	15	1	1	NA	1	NA	0	7
DBX2	3	11	0	3	292.71	585.42	15	1	1	1	1	0.214285714285714	3	14
DCAF1	26	45	5	5	1706.43	3412.86	15	1	0.494790731797111	-0.730769230769231	1	-0.133802816901408	10	71
DCAF10	4	13	0	3	415.8	831.6	15	1	1	1	1	0.235294117647059	3	17
DCAF12	1	18	0	1	403.92	807.84	15	1	1	1	1	0.0526315789473684	1	19
DCAF13	3	14	4	5	452.76	905.52	15	1	0.18809364548495	-2.73333333333333	1	-0.26797385620915	9	17
DCAF17	6	6	2	3	504.9	1009.8	15	1	1	0.333333333333333	1	0.1	5	12
DCAF4	13	16	0	1	507.87	1015.74	15	1	1	1	1	0.448275862068966	1	29
DCAF5	9	45	3	8	899.58	1799.16	15	1	0.411804350596058	-0.875	1	-0.106060606060606	11	54
DCAF6	8	25	1	4	837.21	1674.42	15	1	1	0.21875	1	0.0424242424242424	5	33
DCAF7	0	8	0	1	319.44	638.88	15	1	1	NA	1	0	1	8
DCAF8	0	12	6	7	389.73	779.46	15	1	0.0149068322981366	-Inf	0.642329698273754	-0.461538461538462	13	12
DCAKD	9	7	5	6	227.7	455.4	15	1	0.703567101897967	0.351851851851852	1	0.107954545454545	11	16
DCBLD1	6	24	2	4	681.12	1362.24	15	1	0.59634293600138	-1	1	-0.133333333333333	6	30
DCBLD2	4	30	2	8	680.46	1360.92	15	1	0.605816758397587	-0.875	1	-0.0823529411764706	10	34
DCDC2	9	14	5	3	316.14	632.28	15	1	0.412476414122688	-1.59259259259259	1	-0.233695652173913	8	23
DCDC2B	11	7	6	2	247.5	495	15	1	0.667285209070106	-0.909090909090909	1	-0.138888888888889	8	18
DCHS2	76	76	8	2	2002.11	4004.22	15	1	0.100885486585189	-3	0.975691437149951	-0.3	10	152
DCK	3	10	0	0	237.27	474.54	15	1	1	NA	1	NA	0	13
DCLK1	2	24	0	2	784.08	1568.16	15	1	1	1	1	0.0769230769230769	2	26
DCLK2	4	16	2	0	697.29	1394.58	15	1	0.064935064935065	-Inf	0.884435842948953	-0.8	2	20
DCLK3	36	26	4	2	804.54	1609.08	15	1	1	-0.444444444444444	1	-0.086021505376344	6	62
DCLRE1A	51	43	4	0	971.85	1943.7	15	1	0.128579456742002	-Inf	1	-0.457446808510638	4	94
DCLRE1B	16	21	1	1	413.49	826.98	15	1	1	-0.3125	1	-0.0675675675675675	2	37
DCLRE1C	9	18	7	3	449.79	899.58	15	1	0.0666659057027441	-3.66666666666667	0.884435842948953	-0.366666666666667	10	27
DCN	3	14	3	1	403.92	807.84	15	1	0.0526315789473685	-13	0.843251957917679	-0.573529411764706	4	17
DCP1A	10	18	2	3	582.12	1164.24	15	1	1	-0.2	1	-0.0428571428571429	5	28
DCP1B	11	12	7	5	612.81	1225.62	15	1	0.724671857619577	-0.527272727272727	1	-0.105072463768116	12	23
DCP2	6	14	1	2	395.34	790.68	15	1	1	-0.166666666666667	1	-0.0333333333333333	3	20
DCSTAMP	12	16	2	2	468.27	936.54	15	1	1	-0.333333333333333	1	-0.0714285714285715	4	28
DCT	14	18	7	3	576.84	1153.68	15	1	0.277157252767009	-2	1	-0.2625	10	32
DCTD	1	4	0	0	178.53	357.06	15	1	1	NA	1	NA	0	5
DCTN1	3	33	3	14	989.67	1979.34	15	1	0.37188471905453	-1.35714285714286	1	-0.0931372549019608	17	36
DCTN3	3	5	1	2	182.16	364.32	15	1	1	0.166666666666667	1	0.0416666666666667	3	8
DCTN4	2	22	3	4	409.86	819.72	15	1	0.0619206525769372	-7.25	0.876180863544705	-0.345238095238095	7	24
DCTN5	2	4	0	0	174.24	348.48	15	1	1	NA	1	NA	0	6
DCUN1D1-DCUN1D2	0	8	0	1	256.41	512.82	15	1	1	NA	1	0	1	8
DCUN1D3	3	11	0	0	303.93	607.86	15	1	1	NA	1	NA	0	14
DCUN1D4	0	3	0	1	291.72	583.44	15	1	1	NA	1	0	1	3
DCUN1D5	1	8	0	1	237.6	475.2	15	1	1	1	1	0.111111111111111	1	9
DCX	0	10	0	0	239.58	479.16	15	1	1	NA	1	NA	0	10
DCXR	1	3	0	0	143.22	286.44	15	1	1	NA	1	NA	0	4
DD1CR	10	40	3	0	439.89	879.78	15	1	0.0122086570477248	-Inf	0.608919382504288	-0.8	3	50
DDA1	0	3	0	0	100.98	201.96	15	1	1	NA	1	NA	0	3
DDAH1	1	8	1	0	188.76	377.52	15	1	0.2	-Inf	1	-0.888888888888889	1	9
DDB1	2	43	1	16	1110.78	2221.56	15	1	1	-0.34375	1	-0.0143790849673203	17	45
DDB2	11	22	4	4	600.93	1201.86	15	1	0.43375150427933	-1	1	-0.166666666666667	8	33
DDEFL1	37	43	6	8	927.63	1855.26	15	1	1	0.128378378378378	1	0.0339285714285715	14	80
DDHD1	11	21	2	8	604.89	1209.78	15	1	0.465815261329873	0.522727272727273	1	0.14375	10	32
DDHD2	13	17	7	10	653.73	1307.46	15	1	1	0.0846153846153846	1	0.0215686274509804	17	30
DDI2	28	28	8	8	930.6	1861.2	15	1	1	0	1	0	16	56
DDIAS	88	42	58	28	963.27	1926.54	15	1	1	0.0113636363636364	1	0.00250447227191419	86	130
DDIT3	16	13	7	5	169.29	338.58	15	1	1	-0.1375	1	-0.0316091954022989	12	29
DDO	13	9	8	5	338.25	676.5	15	1	1	-0.107692307692308	1	-0.0244755244755245	13	22
DDOST	0	19	1	7	339.9	679.8	15	1	0.296296296296296	-Inf	1	-0.125	8	19
DDR1	4	24	0	6	862.29	1724.58	15	1	1	1	1	0.142857142857143	6	28
DDRGK1	7	6	1	2	275.55	551.1	15	1	1	0.571428571428571	1	0.205128205128205	3	13
DDTNFR23	27	8	2	4	393.03	786.06	15	1	0.0500094742713484	0.851851851851852	0.838566235774774	0.438095238095238	6	35
DDX10	14	28	3	3	595.65	1191.3	15	1	0.651286654814826	-1	1	-0.166666666666667	6	42
DDX11	13	34	10	9	873.51	1747.02	15	1	0.0857446765540009	-1.90598290598291	0.950356516076024	-0.249720044792833	19	47
DDX17	0	15	2	5	536.91	1073.82	15	1	0.0909090909090909	-Inf	0.953786405978059	-0.285714285714286	7	15
DDX18	6	33	11	6	629.97	1259.94	15	1	0.000450450926860122	-9.08333333333333	0.164755839006111	-0.493212669683258	17	39
DDX19B	4	30	0	2	475.53	951.06	15	1	1	1	1	0.117647058823529	2	34
DDX20	25	25	5	3	744.81	1489.62	15	1	0.707263062307165	-0.666666666666667	1	-0.125	8	50
DDX21	15	33	1	6	657.36	1314.72	15	1	0.659529815356674	0.633333333333333	1	0.169642857142857	7	48
DDX23	1	24	0	12	545.16	1090.32	15	1	1	1	1	0.04	12	25
DDX24	26	34	5	3	718.74	1437.48	15	1	0.453807142209393	-1.17948717948718	1	-0.191666666666667	8	60
DDX27	11	27	3	4	713.13	1426.26	15	1	0.659276543082556	-0.840909090909091	1	-0.139097744360902	7	38
DDX28	11	21	4	1	281.16	562.32	15	1	0.13619501854796	-6.63636363636364	1	-0.45625	5	32
DDX31	22	32	5	9	683.1	1366.2	15	1	1	0.191919191919192	1	0.0502645502645502	14	54
DDX3X	3	19	0	5	631.62	1263.24	15	1	1	1	1	0.136363636363636	5	22
DDX4	6	18	4	5	684.75	1369.5	15	1	0.399858817489518	-1.4	1	-0.194444444444444	9	24
DDX41	0	33	0	14	558.69	1117.38	15	1	1	NA	1	0	14	33
DDX42	4	32	5	13	927.63	1855.26	15	1	0.141607810094362	-2.07692307692308	1	-0.166666666666667	18	36
DDX43	16	22	5	1	641.19	1282.38	15	1	0.0882891923731402	-5.875	0.952323996375159	-0.412280701754386	6	38
DDX47	7	13	4	0	420.42	840.84	15	1	0.031055900621118	-Inf	0.774976578716492	-0.65	4	20
DDX49	4	26	3	7	409.86	819.72	15	1	0.337544975315873	-1.78571428571429	1	-0.166666666666667	10	30
DDX5	0	9	2	3	587.4	1174.8	15	1	0.10989010989011	-Inf	0.98538656216834	-0.4	5	9
DDX51	20	30	5	3	595.98	1191.96	15	1	0.27181596510493	-1.5	1	-0.225	8	50
DDX54	18	30	6	10	767.25	1534.5	15	1	1	0	1	0	16	48
DDX55	10	18	4	0	569.91	1139.82	15	1	0.0278364849833148	-Inf	0.761210061313465	-0.642857142857143	4	28
DDX59	10	18	5	2	619.74	1239.48	15	1	0.112219905658694	-3.5	0.990055515037369	-0.357142857142857	7	28
DDX6	0	5	0	2	471.24	942.48	15	1	1	NA	1	0	2	5
DDX60	85	69	7	12	1832.82	3665.64	15	1	0.149441470488699	0.526470588235294	1	0.183526999316473	19	154
DEAF1	0	17	0	3	481.14	962.28	15	1	1	NA	1	0	3	17
DECR2	15	14	4	5	245.52	491.04	15	1	1	0.253333333333333	1	0.0727969348659004	9	29
DEF6	5	20	1	10	586.74	1173.48	15	1	0.642800668654559	0.6	1	0.109090909090909	11	25
DEF8	0	2	0	3	143.55	287.1	15	1	1	NA	1	0	3	2
DEGS1	1	14	1	4	297.66	595.32	15	1	0.447368421052632	-2.5	1	-0.133333333333333	5	15
DEGS2	2	14	0	4	316.47	632.94	15	1	1	1	1	0.125	4	16
DEK	3	7	1	1	369.27	738.54	15	1	1	-1.33333333333333	1	-0.2	2	10
DELE	14	25	3	3	470.58	941.16	15	1	0.658124065384417	-0.785714285714286	1	-0.141025641025641	6	39
DENND1A	10	25	3	2	1077.45	2154.9	15	1	0.306543385490754	-2.75	1	-0.314285714285714	5	35
DENND1B	9	16	3	3	734.58	1469.16	15	1	0.652556564681148	-0.777777777777778	1	-0.14	6	25
DENND2A	7	29	4	7	1078.11	2156.22	15	1	0.255509419566968	-1.36734693877551	1	-0.169191919191919	11	36
DENND2C	39	41	1	3	1040.16	2080.32	15	1	0.617579882052406	0.64957264957265	1	0.2375	4	80
DENND2D	4	26	2	8	444.84	889.68	15	1	0.62873399715505	-0.625	1	-0.0666666666666667	10	30
DENND3	24	64	5	7	1230.57	2461.14	15	1	0.32190707966851	-0.904761904761905	1	-0.143939393939394	12	88
DENND4A	13	75	7	21	1800.81	3601.62	15	1	0.252360825937657	-0.923076923076923	1	-0.102272727272727	28	88
DENND5A	2	45	2	14	1251.03	2502.06	15	1	0.265014731434615	-2.21428571428571	1	-0.0824468085106383	16	47
DENND5B	4	43	3	16	1230.57	2461.14	15	1	0.401227813258485	-1.015625	1	-0.0727883538633819	19	47
DENND6A	1	15	0	4	537.24	1074.48	15	1	1	1	1	0.0625	4	16
DENND6B	3	19	3	3	521.73	1043.46	15	1	0.0913043478260869	-5.33333333333333	0.953786405978059	-0.363636363636364	6	22
DENR	0	2	0	4	168.96	337.92	15	1	1	NA	1	0	4	2
DEPDC1	23	46	11	8	804.87	1609.74	15	1	0.0650881438366828	-1.75	0.884435842948953	-0.245614035087719	19	69
DEPDC1B	22	28	2	2	624.36	1248.72	15	1	1	-0.272727272727273	1	-0.06	4	50
DEPDC6	4	12	2	2	369.27	738.54	15	1	0.54922600619195	-2	1	-0.25	4	16
DEPDC7	1	19	3	3	501.27	1002.54	15	1	0.0277591973244147	-18	0.761210061313465	-0.45	6	20
DEPTOR	3	12	4	3	395.01	790.02	15	1	0.144660615442349	-4.33333333333333	1	-0.371428571428571	7	15
DERA	3	6	0	1	105.6	211.2	15	1	1	1	1	0.333333333333333	1	9
DERL1	1	10	0	1	239.91	479.82	15	1	1	1	1	0.0909090909090909	1	11
DERL3	6	10	2	1	187.11	374.22	15	1	0.545923632610939	-2.33333333333333	1	-0.291666666666667	3	16
DES	0	8	1	2	349.14	698.28	15	1	0.272727272727273	-Inf	1	-0.333333333333333	3	8
DESI2	0	5	2	3	192.06	384.12	15	1	0.444444444444444	-Inf	1	-0.4	5	5
DET1	1	18	0	5	514.47	1028.94	15	1	1	1	1	0.0526315789473684	5	19
DEUP1	32	15	7	5	670.23	1340.46	15	1	0.51793475680139	0.34375	1	0.0975177304964538	12	47
DEXI	1	3	0	0	72.27	144.54	15	1	1	NA	1	NA	0	4
DFFA	7	9	1	1	276.87	553.74	15	1	1	-0.285714285714286	1	-0.0625	2	16
DFFB	3	13	1	0	250.14	500.28	15	1	0.235294117647059	-Inf	1	-0.8125	1	16
DFNA5	25	17	19	9	565.29	1130.58	15	1	0.614797480473816	-0.435555555555555	1	-0.0833333333333334	28	42
DFNB59	6	7	1	0	244.86	489.72	15	1	1	-Inf	1	-0.538461538461538	1	13
DGAT2	3	9	0	3	342.21	684.42	15	1	1	1	1	0.25	3	12
DGCR2	4	15	0	2	511.5	1023	15	1	1	1	1	0.210526315789474	2	19
DGCR6L	0	7	0	0	100.98	201.96	15	1	1	NA	1	NA	0	7
DGKD	4	27	0	4	1205.82	2411.64	15	1	1	1	1	0.129032258064516	4	31
DGKE	13	27	1	2	566.28	1132.56	15	1	1	-0.0384615384615385	1	-0.0083333333333333	3	40
DGKG	9	46	9	13	834.9	1669.8	15	1	0.0352230462485663	-2.53846153846154	0.788199921465956	-0.245454545454545	22	55
DGKI	3	42	3	1	984.72	1969.44	15	1	0.0041297740187657	-41	0.454065685553736	-0.683333333333333	4	45
DGKK	2	4	0	6	210.54	421.08	15	1	0.454545454545454	1	1	0.333333333333333	6	6
DGKQ	13	19	9	5	778.14	1556.28	15	1	0.202204473333231	-1.63076923076923	1	-0.236607142857143	14	32
DGKZ	14	37	6	10	1027.62	2055.24	15	1	0.534437700492288	-0.585714285714286	1	-0.100490196078431	16	51
DGUOK	9	12	0	2	475.2	950.4	15	1	0.50197628458498	1	1	0.428571428571429	2	21
DHCR24	0	11	2	0	435.6	871.2	15	1	0.0128205128205128	-Inf	0.61231737012987	-1	2	11
DHCR7	6	16	2	3	470.25	940.5	15	1	0.615904868078781	-0.777777777777778	1	-0.127272727272727	5	22
DHODH	8	26	3	2	362.01	724.02	15	1	0.125177809388336	-3.875	1	-0.364705882352941	5	34
DHRS11	5	19	4	9	494.01	988.02	15	1	0.690568039740323	-0.688888888888889	1	-0.0993589743589744	13	24
DHRS12	5	16	0	5	318.78	637.56	15	1	0.545074490726665	1	1	0.238095238095238	5	21
DHRS13	3	0	2	0	66.99	133.98	15	1	1	NA	1	0	2	3
DHRS3	0	3	0	1	288.09	576.18	15	1	1	NA	1	0	1	3
DHRS7	1	12	0	2	288.75	577.5	15	1	1	1	1	0.0769230769230769	2	13
DHRS7B	5	17	1	5	321.75	643.5	15	1	1	0.32	1	0.0606060606060606	6	22
DHRS7C	5	12	0	0	266.31	532.62	15	1	1	NA	1	NA	0	17
DHRSX	4	5	0	0	308.88	617.76	15	1	1	NA	1	NA	0	9
DHTKD1	13	44	5	6	892.98	1785.96	15	1	0.144212688978402	-1.82051282051282	1	-0.226475279106858	11	57
DHX15	0	27	0	3	731.94	1463.88	15	1	1	NA	1	0	3	27
DHX29	19	37	3	5	1421.31	2842.62	15	1	1	-0.168421052631579	1	-0.0357142857142857	8	56
DHX30	0	46	1	15	1152.03	2304.06	15	1	0.258064516129032	-Inf	1	-0.0625	16	46
DHX32	19	14	9	5	742.5	1485	15	1	0.753166569738902	-0.326315789473684	1	-0.0670995670995671	14	33
DHX33	2	31	4	12	741.18	1482.36	15	1	0.0796000176203693	-4.16666666666667	0.936566440349175	-0.189393939393939	16	33
DHX34	18	33	15	14	596.97	1193.94	15	1	0.1653097940647	-0.964285714285714	1	-0.164300202839757	29	51
DHX35	6	23	5	6	696.3	1392.6	15	1	0.137288923048685	-2.19444444444444	1	-0.247648902821317	11	29
DHX36	2	49	1	17	851.4	1702.8	15	1	1	-0.441176470588235	1	-0.0163398692810457	18	51
DHX37	21	40	0	0	759.66	1519.32	15	1	1	NA	1	NA	0	61
DHX38	5	40	0	3	1115.73	2231.46	15	1	1	1	1	0.111111111111111	3	45
DHX40	3	24	2	4	633.27	1266.54	15	1	0.216174537364749	-3	1	-0.222222222222222	6	27
DHX57	17	60	10	11	1353	2706	15	1	0.0281623312046309	-2.20855614973262	0.761210061313465	-0.255411255411255	21	77
DHX58	19	18	5	7	389.73	779.46	15	1	0.741643326683333	0.323308270676692	1	0.0968468468468468	12	37
DHX8	1	42	2	9	1181.07	2362.14	15	1	0.101999677471375	-8.33333333333333	0.977868234376093	-0.158562367864693	11	43
DIABLO	5	13	1	3	235.29	470.58	15	1	1	0.133333333333333	1	0.0277777777777778	4	18
DIAPH2	6	6	1	1	381.15	762.3	15	1	1	0	1	0	2	12
DIAPH3	8	17	1	1	624.36	1248.72	15	1	1	-1.125	1	-0.18	2	25
DICER1	7	40	2	0	1935.78	3871.56	15	1	0.0306122448979592	-Inf	0.773114333163925	-0.851063829787234	2	47
DIEXF	27	37	6	9	765.27	1530.54	15	1	1	0.0864197530864198	1	0.021875	15	64
DIMT1	2	13	0	2	324.06	648.12	15	1	1	1	1	0.133333333333333	2	15
DIO1	4	14	1	5	197.01	394.02	15	1	1	0.3	1	0.0555555555555556	6	18
DIO3	0	5	1	0	119.13	238.26	15	1	0.166666666666667	-Inf	1	-1	1	5
DIP2A	25	28	6	4	1432.2	2864.4	15	1	0.509181400291504	-0.68	1	-0.128301886792453	10	53
DIP2B	13	52	6	20	1595.55	3191.1	15	1	0.778953296701551	-0.2	1	-0.0307692307692308	26	65
DIP2C	9	43	2	1	1681.02	3362.04	15	1	0.0985324947589098	-8.55555555555556	0.971353639774823	-0.493589743589744	3	52
DIRAS1	0	3	0	2	190.41	380.82	15	1	1	NA	1	0	2	3
DIRAS2	0	5	0	0	198	396	15	1	1	NA	1	NA	0	5
DIRC2	2	10	1	1	417.78	835.56	15	1	0.395604395604396	-4	1	-0.333333333333333	2	12
DIS3	8	16	2	1	533.61	1067.22	15	1	0.535042735042735	-3	1	-0.333333333333333	3	24
DIS3L	17	48	12	6	1009.47	2018.94	15	1	0.00224630169438034	-4.64705882352941	0.334726684582354	-0.405128205128205	18	65
DIS3L2	35	44	7	20	1205.16	2410.32	15	1	0.113154702973468	0.56	0.991849865569908	0.183778715424285	27	79
DISC1	31	31	11	2	685.74	1371.48	15	1	0.0307683446451306	-4.5	0.773695666389012	-0.346153846153846	13	62
DISP1	22	38	7	9	1362.24	2724.48	15	1	0.772883510471974	-0.343434343434343	1	-0.0708333333333334	16	60
DISP2	26	57	5	14	1445.07	2890.14	15	1	0.786435441990812	0.217032967032967	1	0.0500951173113507	19	83
DISP3	2	45	1	6	1280.73	2561.46	15	1	0.346274794388002	-2.75	1	-0.100303951367781	7	47
DIXDC1	7	30	2	3	683.1	1366.2	15	1	0.288070081394857	-1.85714285714286	1	-0.210810810810811	5	37
DKC1	6	28	0	6	485.1	970.2	15	1	0.565041501883607	1	1	0.176470588235294	6	34
DKK1	1	3	0	1	81.51	163.02	15	1	1	1	1	0.25	1	4
DKK3	9	12	2	4	284.13	568.26	15	1	1	0.333333333333333	1	0.0952380952380952	6	21
DLAT	6	32	4	4	546.48	1092.96	15	1	0.0548263544391686	-4.33333333333333	0.846060006968071	-0.342105263157895	8	38
DLC1	27	57	4	7	1440.78	2881.56	15	1	0.745201067031836	-0.206349206349206	1	-0.0422077922077922	11	84
DLD	2	11	0	2	499.62	999.24	15	1	1	1	1	0.153846153846154	2	13
DLEC1	75	64	22	9	1652.31	3304.62	15	1	0.108495314740097	-1.08592592592593	0.985224113668503	-0.170109074031098	31	139
DLEU7	11	9	3	1	219.78	439.56	15	1	0.614624505928854	-1.45454545454545	1	-0.2	4	20
DLG1	0	21	3	4	804.54	1609.08	15	1	0.0106837606837607	-Inf	0.585928868752023	-0.428571428571429	7	21
DLG2	8	12	1	1	473.55	947.1	15	1	1	-0.5	1	-0.1	2	20
DLG2-DLG3	0	9	0	0	344.52	689.04	15	1	1	NA	1	NA	0	9
DLG3	3	20	8	23	697.29	1394.58	15	1	0.318741451124501	-1.31884057971015	1	-0.127629733520337	31	23
DLG5	20	53	4	3	1818.3	3636.6	15	1	0.188814387082209	-2.53333333333333	1	-0.297455968688845	7	73
DLGAP1L	3	11	0	1	461.34	922.68	15	1	1	1	1	0.214285714285714	1	14
DLGAP2	1	22	2	4	656.37	1312.74	15	1	0.0998905309250137	-10	0.971353639774823	-0.289855072463768	6	23
DLGAP3	8	24	8	13	900.57	1801.14	15	1	0.367598922543439	-0.846153846153846	1	-0.130952380952381	21	32
DLGAP4	12	33	2	0	999.57	1999.14	15	1	0.0841813135985199	-Inf	0.949431371776132	-0.733333333333333	2	45
DLGAP5	29	39	13	4	767.58	1535.16	15	1	0.0154684223908782	-3.37068965517241	0.648277285617707	-0.338235294117647	17	68
DLK1	10	10	1	3	357.06	714.12	15	1	0.596273291925466	0.666666666666667	1	0.25	4	20
DLK2	8	24	5	7	393.03	786.06	15	1	0.29515374311133	-1.14285714285714	1	-0.166666666666667	12	32
DLL1	1	18	1	4	583.77	1167.54	15	1	0.380434782608696	-3.5	1	-0.147368421052632	5	19
DLL4	2	20	0	2	652.41	1304.82	15	1	1	1	1	0.0909090909090909	2	22
DLST	1	10	1	7	433.62	867.24	15	1	1	-0.428571428571429	1	-0.0340909090909091	8	11
DLX3	0	4	0	4	121.11	242.22	15	1	1	NA	1	0	4	4
DLX4	0	3	1	1	74.91	149.82	15	1	0.4	-Inf	1	-0.5	2	3
DLX5	0	4	0	1	168.3	336.6	15	1	1	NA	1	0	1	4
DMAP1	1	15	1	2	460.35	920.7	15	1	0.298245614035088	-6.5	1	-0.270833333333333	3	16
DMBT1	7	5	1	2	254.43	508.86	15	1	0.569230769230769	0.642857142857143	1	0.25	3	12
DMBT1L-DMBT1L3	57	42	19	12	860.97	1721.94	15	1	0.835239251442075	-0.166666666666667	1	-0.0371456500488758	31	99
DMBX1	2	13	2	7	359.37	718.74	15	1	0.614624505928854	-0.857142857142857	1	-0.0888888888888889	9	15
DMC1	0	17	1	4	339.57	679.14	15	1	0.227272727272727	-Inf	1	-0.2	5	17
DMD	28	55	10	8	1622.61	3245.22	15	1	0.108644017837016	-1.45535714285714	0.985224113668503	-0.218206157965194	18	83
DMGDH	12	20	3	5	865.26	1730.52	15	1	1	0	1	0	8	32
DMP1	17	28	5	4	378.18	756.36	15	1	0.460580010787869	-1.05882352941176	1	-0.177777777777778	9	45
DMRT1	3	6	0	3	225.06	450.12	15	1	0.509090909090909	1	1	0.333333333333333	3	9
DMRT2	9	12	1	3	379.83	759.66	15	1	0.626482213438735	0.555555555555556	1	0.178571428571429	4	21
DMRTA2	0	5	0	1	223.41	446.82	15	1	1	NA	1	0	1	5
DMRTB1	7	20	0	1	290.73	581.46	15	1	1	1	1	0.259259259259259	1	27
DMTF1	5	25	4	2	760.32	1520.64	15	1	0.0244954286700017	-9	0.758102112940823	-0.5	6	30
DMXL1	47	110	10	12	2997.39	5994.78	15	1	0.150707247734876	-0.950354609929078	1	-0.155182397220614	22	157
DMXL2	16	102	10	23	3013.56	6027.12	15	1	0.0355876817821406	-1.77173913043478	0.788199921465956	-0.16743708269132	33	118
DNA2	26	55	9	12	1638.78	3277.56	15	1	0.440419706040502	-0.586538461538461	1	-0.107583774250441	21	81
DNAAF2	19	15	9	3	406.23	812.46	15	1	0.315110913522711	-1.36842105263158	1	-0.191176470588235	12	34
DNAAF5	16	28	5	0	763.29	1526.58	15	1	0.0106713360644905	-Inf	0.585928868752023	-0.636363636363636	5	44
DNAH1	97	159	29	31	4366.56	8733.12	15	1	0.145337153824302	-0.533422015297639	1	-0.104427083333333	60	256
DNAH10	90	148	16	21	4517.37	9034.74	15	1	0.587219573460424	-0.252910052910053	1	-0.0542811719282308	37	238
DNAH12	67	144	10	19	3872.22	7744.44	15	1	0.832645681310324	-0.131186174391202	1	-0.0272920411831999	29	211
DNAH14	20	14	4	0	335.61	671.22	15	1	0.275865339023234	-Inf	1	-0.411764705882353	4	34
DNAH17	65	203	19	82	4335.87	8671.74	15	1	0.329744519037353	0.276360225140713	1	0.0544185015516477	101	268
DNAH3	67	126	9	7	4031.28	8062.56	15	1	0.106123824055417	-1.41791044776119	0.983805342817882	-0.215349740932642	16	193
DNAH5	79	125	21	27	4525.62	9051.24	15	1	0.517635575774722	-0.230661040787623	1	-0.0502450980392157	48	204
DNAH5L	83	144	22	21	4550.04	9100.08	15	1	0.0879557766959479	-0.817555938037866	0.951277979139867	-0.14598914045692	43	227
DNAH7	64	146	16	23	3963.3	7926.6	15	1	0.197327009466547	-0.58695652173913	1	-0.105494505494505	39	210
DNAH8	60	130	7	16	4564.23	9128.46	15	1	1	0.0520833333333334	1	0.011441647597254	23	190
DNAH9	63	158	15	22	3582.81	7165.62	15	1	0.175146846877062	-0.70995670995671	1	-0.120337532102238	37	221
DNAI1	17	32	1	3	725.67	1451.34	15	1	1	0.372549019607843	1	0.0969387755102041	4	49
DNAI2	33	20	6	12	628.32	1256.64	15	1	0.0536985059023395	0.696969696969697	0.846060006968071	0.289308176100629	18	53
DNAJA1	3	24	0	2	347.16	694.32	15	1	1	1	1	0.111111111111111	2	27
DNAJA2	1	11	0	4	382.14	764.28	15	1	1	1	1	0.0833333333333333	4	12
DNAJA4	3	13	1	2	351.45	702.9	15	1	0.530443756449948	-1.16666666666667	1	-0.145833333333333	3	16
DNAJB11	0	10	0	1	279.51	559.02	15	1	1	NA	1	0	1	10
DNAJB13	13	11	1	7	252.45	504.9	15	1	0.052677048572488	0.879120879120879	0.843251957917679	0.416666666666667	8	24
DNAJB14	4	14	1	1	363	726	15	1	0.447368421052632	-2.5	1	-0.277777777777778	2	18
DNAJB2	0	5	1	2	176.22	352.44	15	1	0.375	-Inf	1	-0.333333333333333	3	5
DNAJB4	0	9	0	0	336.6	673.2	15	1	1	NA	1	NA	0	9
DNAJB5	1	8	1	5	342.87	685.74	15	1	1	-0.6	1	-0.0555555555555556	6	9
DNAJB6	3	10	2	3	321.75	643.5	15	1	0.582749766573296	-1.22222222222222	1	-0.169230769230769	5	13
DNAJB8	18	12	2	2	221.76	443.52	15	1	1	0.333333333333333	1	0.1	4	30
DNAJB9	1	13	0	2	213.84	427.68	15	1	1	1	1	0.0714285714285714	2	14
DNAJC1	15	21	8	4	535.92	1071.84	15	1	0.18678745767183	-1.8	1	-0.25	12	36
DNAJC10	5	23	0	1	789.03	1578.06	15	1	1	1	1	0.178571428571429	1	28
DNAJC11	1	19	4	1	530.64	1061.28	15	1	0.00190099755317147	-75	0.318681117594161	-0.75	5	20
DNAJC12	2	9	2	1	195.69	391.38	15	1	0.175824175824176	-8	1	-0.484848484848485	3	11
DNAJC13	7	70	6	18	2218.59	4437.18	15	1	0.0742479454990201	-2.33333333333333	0.913861472365723	-0.159090909090909	24	77
DNAJC15	4	6	0	1	113.85	227.7	15	1	1	1	1	0.4	1	10
DNAJC16	5	33	5	11	693	1386	15	1	0.140502503461329	-2	1	-0.180921052631579	16	38
DNAJC17	3	9	2	0	282.48	564.96	15	1	0.10989010989011	-Inf	0.98538656216834	-0.75	2	12
DNAJC18	7	19	0	2	342.54	685.08	15	1	1	1	1	0.269230769230769	2	26
DNAJC19	0	3	1	0	114.84	229.68	15	1	0.25	-Inf	1	-1	1	3
DNAJC2	3	14	1	1	594.66	1189.32	15	1	0.385964912280702	-3.66666666666667	1	-0.323529411764706	2	17
DNAJC21	14	18	2	1	505.89	1011.78	15	1	0.581970970206264	-1.57142857142857	1	-0.229166666666667	3	32
DNAJC22	1	0	0	1	32.01	64.02	15	1	1	1	1	1	1	1
DNAJC24	3	5	0	5	145.53	291.06	15	1	0.230769230769231	1	1	0.375	5	8
DNAJC25	3	3	1	0	297.99	595.98	15	1	1	-Inf	1	-0.5	1	6
DNAJC27	4	8	1	9	237.93	475.86	15	1	0.323308270676692	0.777777777777778	1	0.233333333333333	10	12
DNAJC28	3	20	6	3	355.41	710.82	15	1	0.00563589173155359	-12.3333333333333	0.467685236262114	-0.536231884057971	9	23
DNAJC3	4	21	1	4	472.89	945.78	15	1	1	-0.3125	1	-0.04	5	25
DNAJC30	1	5	0	0	93.72	187.44	15	1	1	NA	1	NA	0	6
DNAJC5	0	16	0	3	197.01	394.02	15	1	1	NA	1	0	3	16
DNAJC5B	4	6	3	2	228.69	457.38	15	1	0.608391608391608	-1.25	1	-0.2	5	10
DNAJC6	7	20	2	7	919.38	1838.76	15	1	1	0.183673469387755	1	0.037037037037037	9	27
DNAJC7	0	19	1	3	464.64	929.28	15	1	0.173913043478261	-Inf	1	-0.25	4	19
DNAJC8	0	4	0	0	228.03	456.06	15	1	1	NA	1	NA	0	4
DNAJC9	4	3	1	3	259.71	519.42	15	1	0.545454545454546	0.75	1	0.321428571428571	4	7
DNAL1	2	4	0	3	179.19	358.38	15	1	0.5	1	1	0.333333333333333	3	6
DNAL4	0	9	0	2	105.93	211.86	15	1	1	NA	1	0	2	9
DNALI1	5	10	1	2	192.06	384.12	15	1	1	0	1	0	3	15
DNASE1L3	3	7	1	7	304.92	609.84	15	1	0.588235294117647	0.666666666666667	1	0.175	8	10
DNASE2B	8	11	2	1	357.39	714.78	15	1	0.571428571428572	-1.75	1	-0.245614035087719	3	19
DND1	16	15	1	4	321.75	643.5	15	1	0.341991341991342	0.765625	1	0.316129032258064	5	31
DNER	8	24	4	8	638.55	1277.1	15	1	0.707418858211993	-0.5	1	-0.0833333333333333	12	32
DNLZ	2	5	1	1	104.94	209.88	15	1	1	-1.5	1	-0.214285714285714	2	7
DNM1	2	18	1	9	882.42	1764.84	15	1	1	0	1	0	10	20
DNM1L	2	15	0	3	628.32	1256.64	15	1	1	1	1	0.117647058823529	3	17
DNMBP	19	30	7	2	740.19	1480.38	15	1	0.0639420424353881	-4.52631578947368	0.884435842948953	-0.390022675736961	9	49
DNMT3A	2	2	0	10	494.34	988.68	15	1	0.0659340659340659	1	0.884435842948953	0.5	10	4
DNMT3B	5	28	3	11	673.2	1346.4	15	1	0.679483906084032	-0.527272727272727	1	-0.0627705627705628	14	33
DNPEP	0	12	2	6	346.83	693.66	15	1	0.147368421052632	-Inf	1	-0.25	8	12
DNTT	14	12	0	0	334.62	669.24	15	1	1	NA	1	NA	0	26
DNTTIP1	1	8	0	0	165.33	330.66	15	1	1	NA	1	NA	0	9
DNTTIP2	55	34	10	5	773.85	1547.7	15	1	0.781393785497522	-0.236363636363636	1	-0.048689138576779	15	89
DOC2B	0	10	0	7	354.75	709.5	15	1	1	NA	1	0	7	10
DOCK1	18	61	6	11	992.64	1985.28	15	1	0.354629601599665	-0.848484848484848	1	-0.125093075204765	17	79
DOCK10	15	57	13	16	2151.93	4303.86	15	1	0.0255528468883931	-2.0875	0.761210061313465	-0.239942528735632	29	72
DOCK11	14	60	4	7	1931.82	3863.64	15	1	0.234688219554735	-1.44897959183673	1	-0.174447174447174	11	74
DOCK2	11	43	3	4	1602.81	3205.62	15	1	0.335471261678355	-1.93181818181818	1	-0.224867724867725	7	54
DOCK2L	19	52	7	24	1586.64	3173.28	15	1	0.806123994994387	0.201754385964912	1	0.0417991821899137	31	71
DOCK4	9	57	3	8	2002.77	4005.54	15	1	0.362740125289494	-1.375	1	-0.136363636363636	11	66
DOCK5	5	65	2	14	1791.9	3583.8	15	1	0.609570569414483	-0.857142857142857	1	-0.0535714285714286	16	70
DOCK7	2	45	1	8	1496.88	2993.76	15	1	0.41504329004329	-1.8125	1	-0.0685579196217494	9	47
DOCK8	12	81	2	8	2095.17	4190.34	15	1	0.622793535480703	-0.6875	1	-0.0709677419354839	10	93
DOCK9	17	73	3	10	2288.55	4577.1	15	1	0.713476419472067	-0.288235294117647	1	-0.0418803418803419	13	90
DOHH	4	5	3	2	188.43	376.86	15	1	1	-0.875	1	-0.155555555555556	5	9
DOK1	5	29	1	4	449.13	898.26	15	1	1	-0.45	1	-0.0529411764705882	5	34
DOK2	12	19	7	12	414.15	828.3	15	1	1	0.0763888888888888	1	0.0186757215619694	19	31
DOK4	5	14	1	3	345.18	690.36	15	1	1	0.0666666666666667	1	0.0131578947368421	4	19
DOK5	2	13	2	1	311.85	623.7	15	1	0.107843137254902	-12	0.983875031494079	-0.533333333333333	3	15
DOK7	4	15	1	0	577.5	1155	15	1	0.25	-Inf	1	-0.789473684210526	1	19
DOLK	7	19	4	6	518.76	1037.52	15	1	0.453936654379957	-0.80952380952381	1	-0.130769230769231	10	26
DOLPP1	1	6	2	3	280.5	561	15	1	0.522727272727273	-3	1	-0.257142857142857	5	7
DONSON	18	29	5	5	548.79	1097.58	15	1	0.503591344107729	-0.611111111111111	1	-0.117021276595745	10	47
DOPEY1	20	87	8	14	2424.51	4849.02	15	1	0.0878756293286993	-1.48571428571429	0.951277979139867	-0.176720475785896	22	107
DOT1L	11	39	0	5	1554.3	3108.6	15	1	0.570749183401792	1	1	0.22	5	50
DPAGT1	1	13	2	0	400.29	800.58	15	1	0.025	-Inf	0.761210061313465	-0.928571428571429	2	14
DPCD	2	5	2	2	180.84	361.68	15	1	0.575757575757576	-1.5	1	-0.214285714285714	4	7
DPEP1	12	1	1	6	178.2	356.4	15	1	0.00118679050567595	0.986111111111111	0.254094564439392	0.78021978021978	7	13
DPEP2	9	14	1	2	420.75	841.5	15	1	1	0.222222222222222	1	0.0579710144927537	3	23
DPF3	4	9	2	3	404.58	809.16	15	1	1	-0.5	1	-0.0923076923076923	5	13
DPH1	3	8	4	4	237.93	475.86	15	1	0.376518218623482	-1.66666666666667	1	-0.227272727272727	8	11
DPH2	13	29	10	14	356.07	712.14	15	1	0.428116379701099	-0.593406593406593	1	-0.107142857142857	24	42
DPH3	0	1	0	1	27.06	54.12	15	1	1	NA	1	0	1	1
DPH5	4	11	0	2	283.14	566.28	15	1	1	1	1	0.266666666666667	2	15
DPH6	10	16	2	0	395.67	791.34	15	1	0.174603174603175	-Inf	1	-0.615384615384615	2	26
DPH7	16	27	3	7	462.99	925.98	15	1	1	0.276785714285714	1	0.072093023255814	10	43
DPM1	2	5	1	0	198.66	397.32	15	1	0.375	-Inf	1	-0.714285714285714	1	7
DPP10	12	18	2	1	621.72	1243.44	15	1	0.561217008797654	-2	1	-0.266666666666667	3	30
DPP4	8	17	1	1	749.43	1498.86	15	1	1	-1.125	1	-0.18	2	25
DPP6	13	28	3	4	901.89	1803.78	15	1	0.671799204531601	-0.615384615384615	1	-0.111498257839721	7	41
DPP7	6	8	0	2	305.91	611.82	15	1	0.5	1	1	0.428571428571429	2	14
DPP8	2	35	1	9	874.17	1748.34	15	1	0.520814061054579	-0.944444444444444	1	-0.0459459459459459	10	37
DPP9	3	29	4	12	925.98	1851.96	15	1	0.20137806436023	-2.22222222222222	1	-0.15625	16	32
DPT	2	9	1	0	198	396	15	1	0.25	-Inf	1	-0.818181818181818	1	11
DPY19L1	15	19	2	1	706.2	1412.4	15	1	0.584298584298584	-1.53333333333333	1	-0.225490196078431	3	34
DPY19L3	10	34	4	2	967.56	1935.12	15	1	0.0444099378881987	-5.8	0.822543273817637	-0.439393939393939	6	44
DPY19L4	5	19	0	3	658.02	1316.04	15	1	1	1	1	0.208333333333333	3	24
DPYD	26	26	10	7	924.66	1849.32	15	1	0.585202089590009	-0.428571428571429	1	-0.0882352941176471	17	52
DPYS	18	18	1	3	607.53	1215.06	15	1	0.607068607068607	0.666666666666667	1	0.25	4	36
DPYSL2	3	19	4	12	700.59	1401.18	15	1	0.42501324854266	-1.11111111111111	1	-0.113636363636364	16	22
DPYSL4	17	33	7	10	556.38	1112.76	15	1	0.770360943093428	-0.358823529411765	1	-0.0717647058823529	17	50
DR1	0	4	0	1	160.05	320.1	15	1	1	NA	1	0	1	4
DRAM1	11	7	2	1	269.28	538.56	15	1	1	-0.272727272727273	1	-0.0555555555555555	3	18
DRAM2	5	14	3	3	264.33	528.66	15	1	0.344189723320158	-1.8	1	-0.236842105263158	6	19
DRAXIN	8	16	3	5	346.5	693	15	1	1	-0.2	1	-0.0416666666666667	8	24
DRC1	49	41	5	11	708.18	1416.36	15	1	0.107648059100826	0.619666048237477	0.983875031494079	0.231944444444444	16	90
DRC3	22	27	10	4	544.83	1089.66	15	1	0.128862485066295	-2.06818181818182	1	-0.26530612244898	14	49
DRC7	29	32	6	2	791.01	1582.02	15	1	0.259455232200203	-2.31034482758621	1	-0.274590163934426	8	61
DRCC1	22	17	2	1	417.78	835.56	15	1	1	-0.545454545454545	1	-0.102564102564103	3	39
DRD1	0	12	0	2	447.48	894.96	15	1	1	NA	1	0	2	12
DRD2	3	12	1	4	442.53	885.06	15	1	1	0	1	0	5	15
DRD3	9	21	4	1	486.42	972.84	15	1	0.0524193548387097	-8.33333333333333	0.843251957917679	-0.5	5	30
DRD4	2	8	2	1	366.96	733.92	15	1	0.202797202797203	-7	1	-0.466666666666667	3	10
DRD5	8	32	1	3	483.12	966.24	15	1	1	-0.333333333333333	1	-0.05	4	40
DRG2	0	25	0	6	340.23	680.46	15	1	1	NA	1	0	6	25
DRGX	1	10	2	1	217.14	434.28	15	1	0.0934065934065933	-19	0.958791526417971	-0.575757575757576	3	11
DROSHA	0	11	0	0	476.19	952.38	15	1	1	NA	1	NA	0	11
DRP2	7	29	9	24	895.29	1790.58	15	1	0.570186780615891	-0.553571428571429	1	-0.0782828282828283	33	36
DSC1	10	28	2	3	865.59	1731.18	15	1	0.607749029189755	-0.866666666666667	1	-0.136842105263158	5	38
DSCAM	6	62	3	6	1832.16	3664.32	15	1	0.0657962899519017	-4.16666666666667	0.884435842948953	-0.245098039215686	9	68
DSCAML1	5	25	1	32	1689.6	3379.2	15	1	0.094252585096816	0.84375	0.960983694935281	0.136363636363636	33	30
DSCR3	0	12	0	2	276.21	552.42	15	1	1	NA	1	0	2	12
DSE	5	38	2	6	950.4	1900.8	15	1	0.300404439296533	-1.53333333333333	1	-0.133720930232558	8	43
DSG2	55	60	6	8	1170.18	2340.36	15	1	0.78319108296375	0.181818181818182	1	0.0496894409937889	14	115
DSG4	12	43	1	2	1119.03	2238.06	15	1	0.540121856365051	-0.791666666666667	1	-0.115151515151515	3	55
DSP	6	97	3	13	2787.51	5575.02	15	1	0.101405099835037	-2.73076923076923	0.975691437149951	-0.129247572815534	16	103
DST	260	306	43	49	10073.25	20146.5	15	1	0.910532371784364	-0.0328100470957613	1	-0.00802734675065297	92	566
DSTN	8	4	0	0	195.03	390.06	15	1	1	NA	1	NA	0	12
DSTYK	3	29	1	11	839.19	1678.38	15	1	1	0.121212121212121	1	0.0104166666666667	12	32
DTD1	1	6	0	2	140.25	280.5	15	1	1	1	1	0.142857142857143	2	7
DTD2	3	5	0	1	166.32	332.64	15	1	1	1	1	0.375	1	8
DTHD1	50	33	5	1	772.53	1545.06	15	1	0.400588700199902	-2.3	1	-0.230923694779116	6	83
DTL	26	45	7	8	701.58	1403.16	15	1	0.562241290042957	-0.514423076923077	1	-0.100469483568075	15	71
DTNA	1	17	0	4	815.76	1631.52	15	1	1	1	1	0.0555555555555556	4	18
DTNB	2	2	2	5	130.68	261.36	15	1	0.575757575757576	0.6	1	0.214285714285714	7	4
DTNBP1	16	11	0	0	251.13	502.26	15	1	1	NA	1	NA	0	27
DTWD1	5	6	0	0	220.77	441.54	15	1	1	NA	1	NA	0	11
DTWD2	3	7	0	0	223.41	446.82	15	1	1	NA	1	NA	0	10
DTX1	0	3	4	7	383.79	767.58	15	1	0.505494505494506	-Inf	1	-0.363636363636364	11	3
DTX2	11	16	5	19	530.97	1061.94	15	1	0.145298268733902	0.617224880382775	1	0.199074074074074	24	27
DTX3L	45	24	9	10	732.6	1465.2	15	1	0.188390455257615	0.52	1	0.178489702517163	19	69
DTX4	1	27	3	5	476.52	953.04	15	1	0.0278074866310161	-15.2	0.761210061313465	-0.339285714285714	8	28
DTYMK	3	8	1	4	132	264	15	1	1	0.333333333333333	1	0.0727272727272727	5	11
DUOX2	39	55	6	9	1502.82	3005.64	15	1	1	0.0598290598290598	1	0.0148936170212766	15	94
DUOXA1L	16	16	3	5	319.77	639.54	15	1	0.698355698355698	0.4	1	0.125	8	32
DUOXA2	6	18	2	4	319.11	638.22	15	1	0.645198938992042	-0.5	1	-0.0833333333333333	6	24
DUPD1	3	13	1	1	215.82	431.64	15	1	0.405228758169935	-3.33333333333333	1	-0.3125	2	16
DUS1L	7	11	3	1	507.87	1015.74	15	1	0.293233082706767	-3.71428571428571	1	-0.361111111111111	4	18
DUS2	5	16	0	0	476.85	953.7	15	1	1	NA	1	NA	0	21
DUS4L	2	10	3	4	313.83	627.66	15	1	0.304695562435501	-2.75	1	-0.261904761904762	7	12
DUSP1	0	17	0	2	314.16	628.32	15	1	1	NA	1	0	2	17
DUSP10	4	12	2	5	475.2	950.4	15	1	1	-0.2	1	-0.0357142857142857	7	16
DUSP11RC1I	18	22	3	2	659.34	1318.68	15	1	0.652108148988467	-0.833333333333333	1	-0.15	5	40
DUSP12	5	7	1	1	246.51	493.02	15	1	1	-0.4	1	-0.0833333333333333	2	12
DUSP13	8	12	7	1	220.77	441.54	15	1	0.0376811594202899	-9.5	0.789311843512415	-0.475	8	20
DUSP13L	3	6	2	3	188.1	376.2	15	1	1	-0.333333333333333	1	-0.0666666666666667	5	9
DUSP14	0	2	1	1	197.01	394.02	15	1	1	-Inf	1	-0.5	2	2
DUSP15	0	9	1	1	212.85	425.7	15	1	0.181818181818182	-Inf	1	-0.5	2	9
DUSP16	13	22	2	0	547.47	1094.94	15	1	0.157657657657658	-Inf	1	-0.628571428571429	2	35
DUSP19	1	9	0	2	179.52	359.04	15	1	1	1	1	0.1	2	10
DUSP26	1	8	0	2	192.72	385.44	15	1	1	1	1	0.111111111111111	2	9
DUSP27	22	40	10	12	1150.38	2300.76	15	1	0.450333238932038	-0.515151515151515	1	-0.0997067448680352	22	62
DUSP28	6	6	2	4	152.46	304.92	15	1	0.638009049773756	0.5	1	0.166666666666667	6	12
DUSP3	1	2	0	0	138.93	277.86	15	1	1	NA	1	NA	0	3
DUSP5	2	13	0	2	262.35	524.7	15	1	1	1	1	0.133333333333333	2	15
DUSP7	0	2	0	3	262.35	524.7	15	1	1	NA	1	0	3	2
DUSP8	3	24	2	4	470.58	941.16	15	1	0.216174537364749	-3	1	-0.222222222222222	6	27
DUT	3	5	1	0	132.33	264.66	15	1	0.444444444444444	-Inf	1	-0.625	1	8
DVL1	2	15	0	1	655.05	1310.1	15	1	1	1	1	0.117647058823529	1	17
DVL3	0	15	1	9	575.52	1151.04	15	1	0.4	-Inf	1	-0.1	10	15
DYDC1	1	5	1	1	137.61	275.22	15	1	0.464285714285714	-4	1	-0.333333333333333	2	6
DYM	6	49	7	3	544.83	1089.66	15	1	0.000221589777709363	-18.0555555555556	0.111675492225535	-0.590909090909091	10	55
DYNC1H1	3	148	3	17	4471.17	8942.34	15	1	0.0219793726091385	-7.70588235294118	0.721018759249189	-0.130132450331126	20	151
DYNC1I1	2	12	0	2	473.22	946.44	15	1	1	1	1	0.142857142857143	2	14
DYNC1I2	0	13	1	0	602.25	1204.5	15	1	0.0714285714285714	-Inf	0.908058284769907	-1	1	13
DYNC1LI1	1	9	0	3	463.65	927.3	15	1	1	1	1	0.1	3	10
DYNC1LI2	4	10	0	0	371.58	743.16	15	1	1	NA	1	NA	0	14
DYNC2H1	72	125	19	14	4235.88	8471.76	15	1	0.0331767771149952	-1.35615079365079	0.784275503573749	-0.210275342255038	33	197
DYNLRB2	3	1	1	1	96.03	192.06	15	1	1	0.666666666666667	1	0.25	2	4
DYNLT1	0	5	0	1	112.86	225.72	15	1	1	NA	1	0	1	5
DYNLT3	0	2	0	0	108.57	217.14	15	1	1	NA	1	NA	0	2
DYRK1A	1	10	3	4	785.73	1571.46	15	1	0.245098039215686	-6.5	1	-0.337662337662338	7	11
DYRK2	1	15	2	6	528.66	1057.32	15	1	0.24901185770751	-4	1	-0.1875	8	16
DYRK3	2	22	2	3	557.04	1114.08	15	1	0.126520988589954	-6.33333333333333	1	-0.316666666666667	5	24
DYSF	18	65	15	36	1870.77	3741.54	15	1	0.409035686393164	-0.50462962962963	1	-0.0772501771793055	51	83
DYX1C1	22	19	10	9	424.71	849.42	15	1	1	0.0404040404040404	1	0.0102695763799744	19	41
DZANK1	22	30	7	8	769.23	1538.46	15	1	0.776061108998878	-0.193181818181818	1	-0.0435897435897436	15	52
DZIP1	25	29	10	4	808.5	1617	15	1	0.134907859322885	-1.9	1	-0.251322751322751	14	54
DZIP1L	20	22	7	6	467.28	934.56	15	1	0.758481402699905	-0.283333333333333	1	-0.0622710622710623	13	42
E2F1	9	13	5	11	309.21	618.42	15	1	0.735177223942519	0.343434343434343	1	0.0965909090909091	16	22
E2F2	2	3	2	3	120.45	240.9	15	1	1	0	1	0	5	5
E2F3	1	7	0	1	389.4	778.8	15	1	1	1	1	0.125	1	8
E2F4	6	24	0	4	345.51	691.02	15	1	1	1	1	0.2	4	30
E2F5	4	10	1	3	347.49	694.98	15	1	1	0.166666666666667	1	0.0357142857142857	4	14
E2F7	16	40	2	7	894.96	1789.92	15	1	1	0.285714285714286	1	0.0634920634920635	9	56
E2F8	53	42	3	4	880.77	1761.54	15	1	0.69808434754937	0.405660377358491	1	0.129323308270677	7	95
E4F1	2	33	1	6	660	1320	15	1	0.429878048780488	-1.75	1	-0.0857142857142857	7	35
EAAT5L	8	27	3	10	540.54	1081.08	15	1	1	-0.0125	1	-0.00219780219780222	13	35
EAF1	0	5	0	1	223.41	446.82	15	1	1	NA	1	0	1	5
EAF2	1	5	2	1	228.36	456.72	15	1	0.226190476190476	-9	1	-0.5	3	6
EAPP	8	11	3	5	285.12	570.24	15	1	1	0.175	1	0.0460526315789473	8	19
EBF2	0	4	0	4	134.64	269.28	15	1	1	NA	1	0	4	4
EBNA1BP2	11	9	0	0	302.28	604.56	15	1	1	NA	1	NA	0	20
ECD	20	29	12	2	574.53	1149.06	15	1	0.00516471975318936	-7.7	0.463165107753452	-0.448979591836735	14	49
ECE1-ECE2	2	2	0	0	111.87	223.74	15	1	1	NA	1	NA	0	4
ECEL1	1	13	1	7	541.86	1083.72	15	1	1	-0.857142857142857	1	-0.0535714285714286	8	14
ECHDC1	7	14	4	3	301.29	602.58	15	1	0.380899293942772	-1.66666666666667	1	-0.238095238095238	7	21
ECHDC2	1	11	0	0	260.7	521.4	15	1	1	NA	1	NA	0	12
ECHDC3	4	13	1	1	265.65	531.3	15	1	0.467836257309941	-2.25	1	-0.264705882352941	2	17
ECHS1	5	29	1	1	256.08	512.16	15	1	0.30952380952381	-4.8	1	-0.352941176470588	2	34
ECI2	8	14	4	6	389.07	778.14	15	1	1	-0.166666666666667	1	-0.0363636363636364	10	22
ECM2	20	30	3	4	703.89	1407.78	15	1	1	-0.125	1	-0.0285714285714285	7	50
ECSCR	7	8	4	3	242.55	485.1	15	1	1	-0.523809523809524	1	-0.104761904761905	7	15
ECT2	10	44	4	7	872.52	1745.04	15	1	0.231880287652815	-1.51428571428571	1	-0.178451178451178	11	54
EDA	1	8	1	2	260.37	520.74	15	1	0.454545454545454	-3	1	-0.222222222222222	3	9
EDA2R	16	27	6	6	502.92	1005.84	15	1	0.512085247595653	-0.6875	1	-0.127906976744186	12	43
EDAR	1	17	0	5	462.99	925.98	15	1	1	1	1	0.0555555555555556	5	18
EDBETA	4	5	0	1	99	198	15	1	1	1	1	0.444444444444444	1	9
EDC3	1	27	0	9	501.93	1003.86	15	1	1	1	1	0.0357142857142857	9	28
EDC4	11	49	4	10	1362.9	2725.8	15	1	0.462968343778519	-0.781818181818182	1	-0.102380952380952	14	60
EDCH5	5	5	2	6	112.86	225.72	15	1	0.366515837104072	0.666666666666667	1	0.25	8	10
EDEM1	1	19	0	5	477.51	955.02	15	1	1	1	1	0.05	5	20
EDEM2	2	25	2	8	527.34	1054.68	15	1	0.291392232568703	-2.125	1	-0.125925925925926	10	27
EDEM3	4	27	1	4	870.54	1741.08	15	1	0.549298128342246	-0.6875	1	-0.0709677419354839	5	31
EDF1	0	5	0	0	104.61	209.22	15	1	1	NA	1	NA	0	5
EDGH	14	15	5	8	295.02	590.04	15	1	0.739344419163459	0.330357142857143	1	0.0981432360742706	13	29
EDIL3	2	16	1	1	321.42	642.84	15	1	0.284210526315789	-7	1	-0.388888888888889	2	18
EDKM	3	3	0	1	91.08	182.16	15	1	1	1	1	0.5	1	6
EDMTF1-EDMTF2-EDMTF3-LOC110231148	8	3	3	2	156.75	313.5	15	1	1	0.4375	1	0.127272727272727	5	11
EDMTFH	2	7	0	1	94.05	188.1	15	1	1	1	1	0.222222222222222	1	9
EDN1	13	9	0	0	201.96	403.92	15	1	1	NA	1	NA	0	22
EDN2	4	10	1	2	178.2	356.4	15	1	1	-0.25	1	-0.0476190476190476	3	14
EDNRA	1	14	0	1	417.78	835.56	15	1	1	1	1	0.0666666666666667	1	15
EDNRB	2	19	0	1	373.56	747.12	15	1	1	1	1	0.0952380952380952	1	21
EDNRB2	23	16	14	12	615.78	1231.56	15	1	0.799432247299071	0.188405797101449	1	0.0512820512820513	26	39
EDPE	14	12	2	5	297.33	594.66	15	1	0.39832136717565	0.657142857142857	1	0.252747252747253	7	26
EDQCM	5	5	1	2	174.24	348.48	15	1	1	0.5	1	0.166666666666667	3	10
EDQM3	1	5	0	1	86.13	172.26	15	1	1	1	1	0.166666666666667	1	6
EDQREP	2	10	2	7	306.24	612.48	15	1	1	-0.428571428571429	1	-0.0555555555555556	9	12
EDRF1	12	59	6	7	1206.15	2412.3	15	1	0.028406709907054	-3.21428571428571	0.761210061313465	-0.292524377031419	13	71
EDWM	6	16	4	4	219.78	439.56	15	1	0.384123322953908	-1.66666666666667	1	-0.227272727272727	8	22
EDYM1	4	13	2	1	149.49	298.98	15	1	0.201754385964912	-5.5	1	-0.431372549019608	3	17
EDYM2	8	19	5	5	319.77	639.54	15	1	0.27485854396474	-1.375	1	-0.203703703703704	10	27
EED	0	15	0	6	430.32	860.64	15	1	1	NA	1	0	6	15
EEF1A1	0	16	0	3	458.37	916.74	15	1	1	NA	1	0	3	16
EEF1A2	0	10	0	9	400.95	801.9	15	1	1	NA	1	0	9	10
EEF1AKMT1	4	12	0	4	211.86	423.72	15	1	0.537667698658411	1	1	0.25	4	16
EEF1B2	0	12	0	1	216.48	432.96	15	1	1	NA	1	0	1	12
EEF1E1	2	2	0	0	157.41	314.82	15	1	1	NA	1	NA	0	4
EEF2K	2	20	1	0	718.74	1437.48	15	1	0.130434782608696	-Inf	1	-0.909090909090909	1	22
EEF2KMT	10	23	4	3	332.97	665.94	15	1	0.214152232728084	-2.06666666666667	1	-0.268398268398268	7	33
EEFSEC	10	22	1	4	548.79	1097.58	15	1	1	0.45	1	0.1125	5	32
EEPD1	12	41	2	8	571.56	1143.12	15	1	1	0.145833333333333	1	0.0264150943396226	10	53
EFCAB1	3	5	1	2	187.77	375.54	15	1	1	0.166666666666667	1	0.0416666666666667	3	8
EFCAB10	3	3	2	1	94.71	189.42	15	1	1	-1	1	-0.166666666666667	3	6
EFCAB11	9	7	0	0	93.06	186.12	15	1	1	NA	1	NA	0	16
EFCAB14	10	10	7	3	433.95	867.9	15	1	0.440413126769948	-1.33333333333333	1	-0.2	10	20
EFCAB2	4	4	0	1	168.3	336.6	15	1	1	1	1	0.5	1	8
EFCAB5	52	32	12	5	1231.89	2463.78	15	1	0.588770676881427	-0.476923076923077	1	-0.0868347338935574	17	84
EFCAB7	23	23	5	4	624.69	1249.38	15	1	1	-0.25	1	-0.0555555555555556	9	46
EFCC1	16	23	7	8	500.61	1001.22	15	1	0.764846077924839	-0.2578125	1	-0.0564102564102564	15	39
EFEMP1	1	17	0	1	447.48	894.96	15	1	1	1	1	0.0555555555555556	1	18
EFHB	22	20	6	0	690.69	1381.38	15	1	0.0338589083399014	-Inf	0.787252650978106	-0.476190476190476	6	42
EFHC1	15	24	5	2	636.57	1273.14	15	1	0.212733266224105	-3	1	-0.32967032967033	7	39
EFHC2	28	25	4	5	822.69	1645.38	15	1	0.727962711598517	0.285714285714286	1	0.0838574423480084	9	53
EFHD1	0	9	0	0	137.94	275.88	15	1	1	NA	1	NA	0	9
EFHD2	1	3	0	5	105.27	210.54	15	1	0.444444444444444	1	1	0.25	5	4
EFL1	18	37	7	1	1087.68	2175.36	15	1	0.00499579165294305	-13.3888888888889	0.460299276725364	-0.547727272727273	8	55
EFNA2	1	2	1	3	162.69	325.38	15	1	1	0.333333333333333	1	0.0833333333333333	4	3
EFNA5	3	9	2	0	214.5	429	15	1	0.10989010989011	-Inf	0.98538656216834	-0.75	2	12
EFNB1	1	3	1	5	250.47	500.94	15	1	1	0.4	1	0.0833333333333333	6	4
EFNB2	0	5	0	1	328.02	656.04	15	1	1	NA	1	0	1	5
EFR3A	1	21	2	2	837.87	1675.74	15	1	0.0523076923076923	-20	0.843251957917679	-0.454545454545455	4	22
EFR3B	1	32	4	11	817.74	1635.48	15	1	0.0280604378661733	-10.6363636363636	0.761210061313465	-0.236363636363636	15	33
EFTUD2	0	40	1	12	961.62	1923.24	15	1	0.245283018867925	-Inf	1	-0.0769230769230769	13	40
EGF	48	44	12	9	1228.92	2457.84	15	1	0.809672890168213	-0.222222222222222	1	-0.0496894409937888	21	92
EGFL6	9	19	1	0	357.39	714.78	15	1	0.344827586206897	-Inf	1	-0.678571428571429	1	28
EGFL7	5	12	3	5	273.24	546.48	15	1	1	-0.44	1	-0.0808823529411765	8	17
EGFLAM	26	56	5	1	921.36	1842.72	15	1	0.0192297607292745	-9.76923076923077	0.683149554847669	-0.516260162601626	6	82
EGLN1	0	2	0	1	217.8	435.6	15	1	1	NA	1	0	1	2
EGLN3	0	9	0	2	198.33	396.66	15	1	1	NA	1	0	2	9
EGR1	2	20	1	1	495.33	990.66	15	1	0.239130434782609	-9	1	-0.409090909090909	2	22
EGR4	1	5	1	2	134.97	269.94	15	1	1	-1.5	1	-0.166666666666667	3	6
EHBP1	27	26	8	15	1254.99	2509.98	15	1	0.219864103164066	0.48641975308642	1	0.161607875307629	23	53
EHD3	1	10	1	2	530.64	1061.28	15	1	0.395604395604396	-4	1	-0.242424242424242	3	11
EHF	0	7	0	0	286.11	572.22	15	1	1	NA	1	NA	0	7
EHHADH	14	26	5	3	718.08	1436.16	15	1	0.235824407683461	-2.0952380952381	1	-0.275	8	40
EHMT1	14	37	4	5	1317.69	2635.38	15	1	0.431227462699734	-1.11428571428571	1	-0.169934640522876	9	51
EIF1-EIF1B	0	2	0	0	69.63	139.26	15	1	1	NA	1	NA	0	2
EIF1AY	0	8	0	1	138.27	276.54	15	1	1	NA	1	0	1	8
EIF2A	9	19	1	4	682.11	1364.22	15	1	1	0.472222222222222	1	0.121428571428571	5	28
EIF2AK1	18	22	2	1	616.11	1232.22	15	1	0.589984604164979	-1.44444444444444	1	-0.216666666666667	3	40
EIF2AK2	53	22	4	6	536.91	1073.82	15	1	0.0741448987931823	0.723270440251572	0.913861472365723	0.306666666666667	10	75
EIF2AK3	8	44	5	8	997.26	1994.52	15	1	0.113974554513045	-2.4375	0.996993733693869	-0.230769230769231	13	52
EIF2B1	1	16	0	4	262.02	524.04	15	1	1	1	1	0.0588235294117647	4	17
EIF2B2	1	16	0	3	309.54	619.08	15	1	1	1	1	0.0588235294117647	3	17
EIF2B3	2	15	1	2	424.71	849.42	15	1	0.403508771929824	-2.75	1	-0.215686274509804	3	17
EIF2B5	4	34	6	12	694.32	1388.64	15	1	0.0602171699952281	-3.25	0.870851370851371	-0.228070175438596	18	38
EIF2D	19	21	11	6	594	1188	15	1	0.262064888398023	-1.02631578947368	1	-0.172058823529412	17	40
EIF2S1	1	11	0	1	312.84	625.68	15	1	1	1	1	0.0833333333333333	1	12
EIF2S2	0	5	0	2	326.7	653.4	15	1	1	NA	1	0	2	5
EIF2S3	0	12	0	0	451.11	902.22	15	1	1	NA	1	NA	0	12
EIF3A	5	71	2	7	1354.98	2709.96	15	1	0.158450496803455	-3.05714285714286	1	-0.156432748538012	9	76
EIF3B	1	21	0	5	685.41	1370.82	15	1	1	1	1	0.0454545454545455	5	22
EIF3D	9	76	8	15	1040.16	2080.32	15	1	0.00898472057231858	-3.5037037037037	0.558997821174666	-0.241943734015345	23	85
EIF3E	0	15	0	2	411.84	823.68	15	1	1	NA	1	0	2	15
EIF3F	6	6	1	3	275.22	550.44	15	1	0.584615384615385	0.666666666666667	1	0.25	4	12
EIF3H	1	12	1	2	272.25	544.5	15	1	0.35	-5	1	-0.256410256410256	3	13
EIF3I	0	12	0	6	311.19	622.38	15	1	1	NA	1	0	6	12
EIF3J	3	1	0	2	306.9	613.8	15	1	0.4	1	1	0.75	2	4
EIF3L	0	35	0	8	548.46	1096.92	15	1	1	NA	1	0	8	35
EIF3M	2	21	0	4	357.39	714.78	15	1	1	1	1	0.0869565217391304	4	23
EIF4A2	0	7	0	2	403.92	807.84	15	1	1	NA	1	0	2	7
EIF4A3	0	21	0	5	349.8	699.6	15	1	1	NA	1	0	5	21
EIF4B	2	8	2	0	168.63	337.26	15	1	0.0909090909090909	-Inf	0.953786405978059	-0.8	2	10
EIF4E	0	6	0	0	209.88	419.76	15	1	1	NA	1	NA	0	6
EIF4E1B	0	4	1	4	103.29	206.58	15	1	1	-Inf	1	-0.2	5	4
EIF4E2	0	3	0	1	234.63	469.26	15	1	1	NA	1	0	1	3
EIF4EBP1	0	4	0	1	66.99	133.98	15	1	1	NA	1	0	1	4
EIF4G1	8	38	5	12	1162.92	2325.84	15	1	0.311420465150557	-0.979166666666667	1	-0.120204603580563	17	46
EIF4G2	7	15	4	8	994.29	1988.58	15	1	1	-0.0714285714285714	1	-0.0151515151515151	12	22
EIF4G3	15	39	7	10	1683.33	3366.66	15	1	0.370103045873352	-0.82	1	-0.133986928104575	17	54
EIF4H	0	2	0	0	212.19	424.38	15	1	1	NA	1	NA	0	2
EIF5	0	7	0	2	426.69	853.38	15	1	1	NA	1	0	2	7
EIF5A2-LOC107050352-RPL22L1	0	15	0	3	197.01	394.02	15	1	1	NA	1	0	3	15
EIF5B	12	46	3	9	1163.25	2326.5	15	1	0.711332007513455	-0.277777777777778	1	-0.0431034482758621	12	58
EIF6	0	6	0	3	212.52	425.04	15	1	1	NA	1	0	3	6
ELAC2	8	32	3	4	794.97	1589.94	15	1	0.329634804856535	-2	1	-0.228571428571429	7	40
ELAVL1	0	4	0	1	323.73	647.46	15	1	1	NA	1	0	1	4
ELAVL2	2	15	2	0	407.88	815.76	15	1	0.0350877192982456	-Inf	0.788199921465956	-0.882352941176471	2	17
ELAVL4	9	10	5	8	431.31	862.62	15	1	0.724885621705276	0.305555555555556	1	0.0890688259109311	13	19
ELF1	3	25	2	4	615.78	1231.56	15	1	0.205300155252717	-3.16666666666667	1	-0.226190476190476	6	28
ELF2	3	18	1	7	589.05	1178.1	15	1	1	0.142857142857143	1	0.0178571428571428	8	21
ELF3	0	4	1	4	158.73	317.46	15	1	1	-Inf	1	-0.2	5	4
ELF5	5	9	0	1	322.74	645.48	15	1	1	1	1	0.357142857142857	1	14
ELFN1	1	34	1	6	783.09	1566.18	15	1	0.308943089430894	-4.66666666666667	1	-0.114285714285714	7	35
ELFN2	0	23	3	9	771.54	1543.08	15	1	0.0336134453781512	-Inf	0.784747167725891	-0.25	12	23
ELK3	4	17	0	4	403.92	807.84	15	1	1	1	1	0.19047619047619	4	21
ELK4	0	13	2	3	442.86	885.72	15	1	0.0653594771241829	-Inf	0.884435842948953	-0.4	5	13
ELL	2	22	3	5	560.67	1121.34	15	1	0.085372636262514	-5.6	0.950356516076024	-0.291666666666667	8	24
ELL2	33	29	3	7	447.81	895.62	15	1	0.307004709834407	0.623376623376623	1	0.232258064516129	10	62
ELMO1	4	9	1	0	293.04	586.08	15	1	0.357142857142857	-Inf	1	-0.692307692307692	1	13
ELMO2	0	26	1	2	721.38	1442.76	15	1	0.103448275862069	-Inf	0.983165897366278	-0.333333333333333	3	26
ELMO3	9	21	2	9	695.64	1391.28	15	1	0.694336366513908	0.481481481481482	1	0.118181818181818	11	30
ELMOD1	1	11	0	3	323.73	647.46	15	1	1	1	1	0.0833333333333333	3	12
ELMOD2	1	3	2	1	294.69	589.38	15	1	0.485714285714286	-5	1	-0.416666666666667	3	4
ELMSAN1	15	38	2	8	1103.85	2207.7	15	1	0.715217457150501	0.366666666666667	1	0.0830188679245283	10	53
ELOVL1	3	15	0	3	308.88	617.76	15	1	1	1	1	0.166666666666667	3	18
ELOVL2	6	8	2	2	294.03	588.06	15	1	1	-0.333333333333333	1	-0.0714285714285715	4	14
ELOVL3	7	9	3	4	256.41	512.82	15	1	1	0.0357142857142857	1	0.00892857142857145	7	16
ELOVL4	0	4	1	0	262.68	525.36	15	1	0.2	-Inf	1	-1	1	4
ELOVL5	0	7	0	1	293.04	586.08	15	1	1	NA	1	0	1	7
ELOVL6	0	7	0	0	213.84	427.68	15	1	1	NA	1	NA	0	7
ELOVL7	0	12	0	0	277.2	554.4	15	1	1	NA	1	NA	0	12
ELP2	19	27	8	4	773.19	1546.38	15	1	0.193126797508498	-1.84210526315789	1	-0.253623188405797	12	46
ELP3	7	31	4	8	590.7	1181.4	15	1	0.423952269002855	-1.21428571428571	1	-0.149122807017544	12	38
ELP4	8	10	1	3	315.48	630.96	15	1	0.616131237183869	0.583333333333333	1	0.194444444444444	4	18
EMB	16	15	0	1	357.72	715.44	15	1	1	1	1	0.516129032258065	1	31
EMC1	12	38	6	11	949.74	1899.48	15	1	0.363739685740326	-0.727272727272727	1	-0.112941176470588	17	50
EMC2	2	5	0	2	295.02	590.04	15	1	1	1	1	0.285714285714286	2	7
EMC3	0	9	0	3	247.5	495	15	1	1	NA	1	0	3	9
EMC7	3	8	0	0	170.94	341.88	15	1	1	NA	1	NA	0	11
EMC8	0	20	0	1	132.66	265.32	15	1	1	NA	1	0	1	20
EME1	10	15	1	2	378.84	757.68	15	1	1	0.25	1	0.0666666666666667	3	25
EMG1	3	8	1	1	184.8	369.6	15	1	1	-1.66666666666667	1	-0.227272727272727	2	11
EMID1	1	12	2	7	518.76	1037.52	15	1	0.544155844155844	-2.42857142857143	1	-0.145299145299145	9	13
EMILIN2	10	33	4	9	1069.2	2138.4	15	1	0.716597897358025	-0.466666666666667	1	-0.075134168157424	13	43
EMILIN3	8	41	4	9	718.08	1436.16	15	1	0.255917849829628	-1.27777777777778	1	-0.144427001569859	13	49
EML1	4	17	0	5	858.33	1716.66	15	1	0.555183946488294	1	1	0.19047619047619	5	21
EML4	7	39	2	5	925.65	1851.3	15	1	0.587840933242024	-1.22857142857143	1	-0.133540372670807	7	46
EML5	3	45	4	15	1844.04	3688.08	15	1	0.0937257194923123	-3	0.958791526417971	-0.148026315789474	19	48
EML6	3	56	0	8	1893.87	3787.74	15	1	1	1	1	0.0508474576271186	8	59
EMP1	5	11	0	0	160.38	320.76	15	1	1	NA	1	NA	0	16
EMP2	2	3	0	0	166.32	332.64	15	1	1	NA	1	NA	0	5
EMSY	6	40	3	6	1188.33	2376.66	15	1	0.154347255376844	-2.33333333333333	1	-0.202898550724638	9	46
EMX1-EMX2	2	0	0	3	125.07	250.14	15	1	0.1	1	0.971353639774823	1	3	2
ENAH	3	12	0	2	697.95	1395.9	15	1	1	1	1	0.2	2	15
ENC1	0	23	0	6	584.1	1168.2	15	1	1	NA	1	0	6	23
ENDOD1	16	27	6	9	488.07	976.14	15	1	1	-0.125	1	-0.0279069767441861	15	43
ENDOG	6	16	9	9	287.76	575.52	15	1	0.194199761496758	-1.66666666666667	1	-0.227272727272727	18	22
ENDOU	5	10	2	5	306.24	612.48	15	1	1	0.2	1	0.0476190476190476	7	15
ENDOV	9	10	3	3	250.8	501.6	15	1	1	-0.111111111111111	1	-0.0263157894736842	6	19
ENG	16	11	5	11	383.79	767.58	15	1	0.115910362128981	0.6875	1	0.280092592592593	16	27
ENGASE	17	30	10	17	672.87	1345.74	15	1	1	-0.0380622837370241	1	-0.00866824271079586	27	47
ENKUR	3	8	2	0	229.02	458.04	15	1	0.128205128205128	-Inf	1	-0.727272727272727	2	11
ENO1	2	18	0	4	430.65	861.3	15	1	1	1	1	0.1	4	20
ENO2	1	19	0	1	430.65	861.3	15	1	1	1	1	0.05	1	20
ENO4	22	23	7	3	618.09	1236.18	15	1	0.30316626486367	-1.43939393939394	1	-0.211111111111111	10	45
ENOPH1	0	10	0	2	173.25	346.5	15	1	1	NA	1	0	2	10
ENOX1	2	20	0	4	448.14	896.28	15	1	1	1	1	0.0909090909090909	4	22
ENOX2	2	10	1	2	654.06	1308.12	15	1	0.516483516483516	-1.5	1	-0.166666666666667	3	12
ENPEP	25	43	4	8	939.51	1879.02	15	1	1	0.14	1	0.0343137254901961	12	68
ENPP1	12	21	0	2	838.53	1677.06	15	1	0.536134453781513	1	1	0.363636363636364	2	33
ENPP2	1	20	2	2	852.39	1704.78	15	1	0.0565217391304347	-19	0.846060006968071	-0.452380952380952	4	21
ENPP3	21	32	5	6	878.13	1756.26	15	1	0.746269637601768	-0.26984126984127	1	-0.0583190394511149	11	53
ENPP4	17	26	0	1	447.48	894.96	15	1	1	1	1	0.395348837209302	1	43
ENPP7	8	16	0	8	418.44	836.88	15	1	0.0814519456566176	1	0.94404191396991	0.333333333333333	8	24
ENSA	0	8	2	6	99.66	199.32	15	1	0.466666666666667	-Inf	1	-0.25	8	8
ENTPD1	9	31	2	2	495.99	991.98	15	1	0.256462199173487	-2.44444444444444	1	-0.275	4	40
ENTPD2	6	13	0	1	455.4	910.8	15	1	1	1	1	0.315789473684211	1	19
ENTPD2L	15	18	11	4	492.03	984.06	15	1	0.117946738329065	-2.3	1	-0.278787878787879	15	33
ENTPD3	10	30	4	6	506.88	1013.76	15	1	0.436128348148111	-1	1	-0.15	10	40
ENTPD4	6	37	1	16	602.91	1205.82	15	1	0.661028010580442	0.614583333333333	1	0.0807113543091655	17	43
ENTPD5	5	13	1	0	439.56	879.12	15	1	0.315789473684211	-Inf	1	-0.722222222222222	1	18
ENTPD6	4	9	4	4	438.57	877.14	15	1	0.645820433436533	-1.25	1	-0.192307692307692	8	13
ENTPD8	23	31	4	2	486.09	972.18	15	1	0.394339150037572	-1.69565217391304	1	-0.240740740740741	6	54
ENTPD8-ENTPD8L	17	24	3	5	431.64	863.28	15	1	1	0.152941176470588	1	0.0396341463414634	8	41
EOGT	7	14	6	8	522.72	1045.44	15	1	0.724055714078445	-0.5	1	-0.0952380952380952	14	21
EP300	9	79	1	20	2393.49	4786.98	15	1	0.683396252869072	0.561111111111111	1	0.0546536796536797	21	88
EP400	11	69	7	12	1887.93	3775.86	15	1	0.0410407209726764	-2.65909090909091	0.798931947804628	-0.230921052631579	19	80
EPAS1	10	26	5	3	868.23	1736.46	15	1	0.0986849165193495	-3.33333333333333	0.971353639774823	-0.347222222222222	8	36
EPB41	23	41	15	14	1116.39	2232.78	15	1	0.176324399939246	-0.909937888198758	1	-0.157866379310345	29	64
EPB41L1	77	62	4	1	1712.37	3424.74	15	1	0.386094876055919	-2.22077922077922	1	-0.246043165467626	5	139
EPB41L2	19	37	4	7	1001.88	2003.76	15	1	1	-0.112781954887218	1	-0.0243506493506493	11	56
EPB41L3	13	43	5	7	1349.37	2698.74	15	1	0.277818920075963	-1.36263736263736	1	-0.18452380952381	12	56
EPB41L4A	11	23	4	3	688.05	1376.1	15	1	0.39021499034336	-1.78787878787879	1	-0.247899159663865	7	34
EPB41L5	13	22	4	1	684.75	1369.5	15	1	0.143732295048085	-5.76923076923077	1	-0.428571428571429	5	35
EPC2	8	11	3	6	829.62	1659.24	15	1	1	0.3125	1	0.087719298245614	9	19
EPCAM	16	14	8	7	282.81	565.62	15	1	1	0	1	0	15	30
EPDR1	1	3	0	0	132	264	15	1	1	NA	1	NA	0	4
EPFIP1L	1	15	0	7	512.16	1024.32	15	1	1	1	1	0.0625	7	16
EPG5	57	111	8	5	2524.5	5049	15	1	0.0688839612901165	-2.11578947368421	0.893049852601188	-0.276098901098901	13	168
EPGN	0	3	0	1	150.48	300.96	15	1	1	NA	1	0	1	3
EPHA1	7	41	4	7	962.28	1924.56	15	1	0.190874717806762	-2.3469387755102	1	-0.21780303030303	11	48
EPHA10	17	52	5	17	1004.19	2008.38	15	1	1	0.100346020761246	1	0.0191040843214756	22	69
EPHA2	0	9	1	6	301.62	603.24	15	1	0.4375	-Inf	1	-0.142857142857143	7	9
EPHA4	7	12	1	3	1249.05	2498.1	15	1	1	0.428571428571429	1	0.118421052631579	4	19
EPHA5	6	19	3	3	589.71	1179.42	15	1	0.320441516214597	-2.16666666666667	1	-0.26	6	25
EPHA6	1	9	0	0	294.03	588.06	15	1	1	NA	1	NA	0	10
EPHA7	2	21	0	4	986.04	1972.08	15	1	1	1	1	0.0869565217391304	4	23
EPHA8	7	38	5	12	988.68	1977.36	15	1	0.28270223522721	-1.26190476190476	1	-0.138562091503268	17	45
EPHB1	2	26	3	14	902.55	1805.1	15	1	0.350435724230392	-1.78571428571429	1	-0.105042016806723	17	28
EPHB2	0	25	3	15	955.35	1910.7	15	1	0.0661210598816952	-Inf	0.884435842948953	-0.166666666666667	18	25
EPHB3	3	27	2	20	885.06	1770.12	15	1	1	0.1	1	0.00909090909090909	22	30
EPHB6	23	31	9	7	1093.29	2186.58	15	1	0.398633547069833	-0.732919254658385	1	-0.136574074074074	16	54
EPHX1	9	15	4	1	460.35	920.7	15	1	0.143951833607006	-5.66666666666667	1	-0.425	5	24
EPHX1L	10	18	9	6	474.87	949.74	15	1	0.198200366698862	-1.7	1	-0.242857142857143	15	28
EPHX4	0	8	0	0	284.13	568.26	15	1	1	NA	1	NA	0	8
EPM2A	4	14	4	5	282.48	564.96	15	1	0.374788689571298	-1.8	1	-0.222222222222222	9	18
EPN3	6	15	5	7	537.24	1074.48	15	1	0.471281728862616	-0.785714285714286	1	-0.130952380952381	12	21
EPPKL	20	46	15	16	945.78	1891.56	15	1	0.112729771001681	-1.15625	0.99134365547716	-0.180840664711632	31	66
EPRS	21	51	3	4	1647.03	3294.06	15	1	0.428757873622941	-0.821428571428571	1	-0.136904761904762	7	72
EPS15	7	22	3	3	907.83	1815.66	15	1	0.32197072377338	-2.14285714285714	1	-0.258620689655172	6	29
EPS15L1	8	39	7	14	1201.2	2402.4	15	1	0.204209561896297	-1.4375	1	-0.163120567375887	21	47
EPS8	6	23	2	7	820.71	1641.42	15	1	1	-0.0952380952380953	1	-0.0153256704980843	9	29
EPS8L2	8	24	2	4	729.63	1459.26	15	1	0.644000882390975	-0.5	1	-0.0833333333333333	6	32
EPSTI1	6	8	1	0	215.82	431.64	15	1	0.466666666666667	-Inf	1	-0.571428571428571	1	14
EPT1L	2	14	1	2	366.3	732.6	15	1	0.422084623323013	-2.5	1	-0.208333333333333	3	16
ERAL1	23	19	6	3	429	858	15	1	0.714462972547838	-0.652173913043478	1	-0.119047619047619	9	42
ERAP1	30	50	6	8	920.7	1841.4	15	1	0.769645827402912	-0.25	1	-0.0535714285714285	14	80
ERBB4	3	17	0	2	518.76	1037.52	15	1	1	1	1	0.15	2	20
ERC1	2	12	2	0	404.58	809.16	15	1	0.05	-Inf	0.838566235774774	-0.857142857142857	2	14
ERC2	1	7	1	1	231.66	463.32	15	1	0.377777777777778	-6	1	-0.375	2	8
ERCC3	2	25	2	6	739.2	1478.4	15	1	0.217914438502674	-3.16666666666667	1	-0.175925925925926	8	27
ERCC4	41	45	1	1	897.27	1794.54	15	1	1	-0.0975609756097562	1	-0.0232558139534884	2	86
ERCC5	42	32	4	4	1079.1	2158.2	15	1	0.725398993958166	0.238095238095238	1	0.0675675675675675	8	74
ERCC6	36	46	8	7	1421.31	2842.62	15	1	0.57835505414193	-0.46031746031746	1	-0.0943089430894309	15	82
ERCC6L	52	47	9	10	1181.4	2362.8	15	1	0.803392078509299	0.186538461538462	1	0.0515683147262095	19	99
ERCC6L2	70	63	9	2	1606.77	3213.54	15	1	0.111608257163396	-3.05	0.988343113691994	-0.291866028708134	11	133
EREG	2	4	0	2	152.46	304.92	15	1	1	1	1	0.333333333333333	2	6
ERG	2	12	0	2	476.52	953.04	15	1	1	1	1	0.142857142857143	2	14
ERGIC1	5	8	0	1	332.97	665.94	15	1	1	1	1	0.384615384615385	1	13
ERGIC2	2	16	0	3	374.22	748.44	15	1	1	1	1	0.111111111111111	3	18
ERGIC3	1	13	1	3	360.36	720.72	15	1	0.405228758169935	-3.33333333333333	1	-0.178571428571429	4	14
ERH	0	4	0	0	102.96	205.92	15	1	1	NA	1	NA	0	4
ERI2	34	31	2	0	662.64	1325.28	15	1	0.495251017639077	-Inf	1	-0.476923076923077	2	65
ERICH1	13	10	3	2	320.43	640.86	15	1	1	-0.153846153846154	1	-0.0347826086956522	5	23
ERICH3	63	33	17	7	1126.95	2253.9	15	1	0.809310622009641	-0.272108843537415	1	-0.0520833333333334	24	96
ERICH5	12	9	6	4	188.1	376.2	15	1	1	-0.125	1	-0.0285714285714286	10	21
ERICH6B	39	16	10	8	603.9	1207.8	15	1	0.257360514010045	0.487179487179487	1	0.153535353535354	18	55
ERLEC1	0	9	0	1	439.56	879.12	15	1	1	NA	1	0	1	9
ERLIN1	5	18	0	1	343.86	687.72	15	1	1	1	1	0.217391304347826	1	23
ERLIN2	1	10	5	3	278.19	556.38	15	1	0.0407636738906088	-15.6666666666667	0.798931947804628	-0.534090909090909	8	11
ERMARD	22	23	8	6	577.17	1154.34	15	1	0.761068496728027	-0.393939393939394	1	-0.0825396825396825	14	45
ERMN	12	14	3	6	242.55	485.1	15	1	0.700273030640105	0.416666666666667	1	0.128205128205128	9	26
ERMP1	5	26	3	2	793.65	1587.3	15	1	0.0614973262032085	-6.8	0.875321612349914	-0.438709677419355	5	31
ERN1	9	39	1	2	943.47	1886.94	15	1	0.488115246098439	-1.16666666666667	1	-0.145833333333333	3	48
ERN2	11	31	5	21	901.89	1803.78	15	1	0.56988883119175	0.329004329004329	1	0.0695970695970696	26	42
ERO1A	2	35	1	9	423.72	847.44	15	1	0.520814061054579	-0.944444444444444	1	-0.0459459459459459	10	37
ERO1B	0	13	0	2	429.66	859.32	15	1	1	NA	1	0	2	13
ERP29	0	15	1	2	211.86	423.72	15	1	0.166666666666667	-Inf	1	-0.333333333333333	3	15
ERP44	2	7	1	7	402.93	805.86	15	1	1	0.5	1	0.0972222222222222	8	9
ERRFI1	10	18	0	0	457.38	914.76	15	1	1	NA	1	NA	0	28
ES1ML1	6	13	0	2	223.74	447.48	15	1	1	1	1	0.315789473684211	2	19
ES1ML2	4	12	2	0	247.17	494.34	15	1	0.0980392156862745	-Inf	0.971353639774823	-0.75	2	16
ESAM	3	7	1	2	154.44	308.88	15	1	1	-0.166666666666667	1	-0.0333333333333333	3	10
ESCO1	30	40	7	13	1151.37	2302.74	15	1	0.611961706674994	0.282051282051282	1	0.0785714285714286	20	70
ESCO2	47	51	6	19	498.63	997.26	15	1	0.0412180351829556	0.657334826427772	0.798931947804628	0.239591836734694	25	98
ESD	2	14	0	3	280.17	560.34	15	1	1	1	1	0.125	3	16
ESF1	31	26	4	2	804.21	1608.42	15	1	0.684432179127746	-0.67741935483871	1	-0.12280701754386	6	57
ESM1	1	6	1	0	167.97	335.94	15	1	0.25	-Inf	1	-0.857142857142857	1	7
ESPL1	172	173	14	8	1752.96	3505.92	15	1	0.272373466534382	-0.760174418604651	1	-0.137812911725955	22	345
ESPN	21	69	4	4	885.39	1770.78	15	1	0.197099385428415	-2.28571428571429	1	-0.266666666666667	8	90
ESR1	2	14	0	2	574.2	1148.4	15	1	1	1	1	0.125	2	16
ESR2	4	27	2	5	562.32	1124.64	15	1	0.302469934048881	-1.7	1	-0.15668202764977	7	31
ESRP1	2	24	5	12	597.96	1195.92	15	1	0.0934121571193548	-4	0.958791526417971	-0.217194570135747	17	26
ESRP2	1	20	1	1	727.98	1455.96	15	1	0.1699604743083	-19	1	-0.452380952380952	2	21
ESRRB	0	11	1	7	429.66	859.32	15	1	0.421052631578947	-Inf	1	-0.125	8	11
ESYT2	8	19	3	5	827.31	1654.62	15	1	0.685467512922855	-0.425	1	-0.0787037037037037	8	27
ESYT3	20	25	3	9	781.44	1562.88	15	1	0.324804631162255	0.583333333333333	1	0.194444444444444	12	45
ETAA1	42	24	12	4	873.18	1746.36	15	1	0.558597705573474	-0.714285714285714	1	-0.113636363636364	16	66
ETF1	0	3	0	3	401.61	803.22	15	1	1	NA	1	0	3	3
ETFA	0	16	0	1	318.78	637.56	15	1	1	NA	1	0	1	16
ETFBKMT	3	15	2	9	269.28	538.56	15	1	1	-0.111111111111111	1	-0.0151515151515152	11	18
ETFDH	5	25	0	2	602.58	1205.16	15	1	1	1	1	0.166666666666667	2	30
ETNK1	2	3	1	2	318.45	636.9	15	1	1	0.25	1	0.0666666666666667	3	5
ETNK2	3	7	1	9	259.71	519.42	15	1	0.582043343653251	0.740740740740741	1	0.2	10	10
ETNPPL	12	18	0	2	499.62	999.24	15	1	0.516129032258065	1	1	0.4	2	30
ETS1	0	14	2	5	410.52	821.04	15	1	0.1	-Inf	0.971353639774823	-0.285714285714286	7	14
ETS2	1	28	1	2	475.2	950.4	15	1	0.181451612903226	-13	1	-0.298850574712644	3	29
ETV3	5	21	7	17	428.34	856.68	15	1	0.514437086549419	-0.729411764705882	1	-0.0993589743589744	24	26
ETV3L	0	3	0	2	75.9	151.8	15	1	1	NA	1	0	2	3
ETV4	2	10	3	6	298.65	597.3	15	1	0.610791685095091	-1.5	1	-0.166666666666667	9	12
ETV5	2	21	1	9	387.75	775.5	15	1	1	-0.166666666666667	1	-0.0130434782608696	10	23
ETV6	6	9	0	1	289.74	579.48	15	1	1	1	1	0.4	1	15
EVA1A	10	21	4	2	498.96	997.92	15	1	0.173456544780074	-3.2	1	-0.344086021505376	6	31
EVA1B	3	3	1	3	113.52	227.04	15	1	0.571428571428572	0.666666666666667	1	0.25	4	6
EVA1C	7	17	7	3	281.82	563.64	15	1	0.053842653453332	-4.66666666666667	0.846060006968071	-0.408333333333333	10	24
EVA1CL	3	9	1	8	371.25	742.5	15	1	0.603007518796992	0.625	1	0.138888888888889	9	12
EVC	26	35	5	3	947.1	1894.2	15	1	0.452389686696096	-1.24358974358974	1	-0.198770491803279	8	61
EVC2	56	42	20	0	1186.02	2372.04	15	1	6.47517646361028e-05	-Inf	0.0456978181178775	-0.428571428571429	20	98
EVI5	5	22	1	2	838.53	1677.06	15	1	0.501477832512315	-1.2	1	-0.148148148148148	3	27
EVI5L	0	9	0	4	255.42	510.84	15	1	1	NA	1	0	4	9
EVL	4	11	1	1	399.63	799.26	15	1	0.514705882352941	-1.75	1	-0.233333333333333	2	15
EVPL	22	87	14	27	2002.77	4005.54	15	1	0.0878756299998623	-1.05050505050505	0.951277979139867	-0.139628552248825	41	109
EVX1	1	4	0	1	374.88	749.76	15	1	1	1	1	0.2	1	5
EVX2	7	1	0	1	257.4	514.8	15	1	0.222222222222222	1	1	0.875	1	8
EXD2	18	23	1	10	611.16	1222.32	15	1	0.0400053367301356	0.872222222222222	0.796805964245439	0.348115299334812	11	41
EXD3	26	22	5	1	763.95	1527.9	15	1	0.224116739100091	-3.23076923076923	1	-0.291666666666667	6	48
EXFABP	23	10	0	2	478.5	957	15	1	0.110924369747899	1	0.98538656216834	0.696969696969697	2	33
EXO1	28	23	6	3	801.9	1603.8	15	1	0.718603324362426	-0.642857142857143	1	-0.117647058823529	9	51
EXOC1L	1	4	0	1	130.35	260.7	15	1	1	1	1	0.2	1	5
EXOC3	4	28	1	4	738.54	1477.08	15	1	0.538019302725185	-0.75	1	-0.075	5	32
EXOC3L	25	16	7	3	649.44	1298.88	15	1	0.725115088856672	-0.493333333333333	1	-0.0902439024390244	10	41
EXOC3L1	10	29	5	12	714.78	1429.56	15	1	0.754571331409526	-0.208333333333333	1	-0.0377073906485672	17	39
EXOC3L4	27	32	5	4	697.95	1395.9	15	1	0.724906363516591	-0.481481481481481	1	-0.0979284369114878	9	59
EXOC4	19	33	5	13	946.44	1892.88	15	1	0.575165775600419	0.331983805668016	1	0.0876068376068376	18	52
EXOC5	0	11	0	0	663.3	1326.6	15	1	1	NA	1	NA	0	11
EXOC6	4	21	1	1	831.6	1663.2	15	1	0.341880341880342	-4.25	1	-0.34	2	25
EXOC6B	4	16	1	1	556.38	1112.76	15	1	0.411255411255411	-3	1	-0.3	2	20
EXOC7	0	33	3	11	707.85	1415.7	15	1	0.0224483502929386	-Inf	0.724469486726656	-0.214285714285714	14	33
EXOC8	3	24	1	4	531.96	1063.92	15	1	0.511957730812013	-1	1	-0.0888888888888889	5	27
EXOG	3	11	3	1	360.36	720.72	15	1	0.0833333333333333	-10	0.949431371776132	-0.535714285714286	4	14
EXOSC1	0	10	0	1	120.78	241.56	15	1	1	NA	1	0	1	10
EXOSC10	12	30	4	6	846.45	1692.9	15	1	0.474972889769697	-0.666666666666667	1	-0.114285714285714	10	42
EXOSC2	2	9	0	2	237.27	474.54	15	1	1	1	1	0.181818181818182	2	11
EXOSC3	1	4	0	2	154.44	308.88	15	1	1	1	1	0.2	2	5
EXOSC6	2	2	1	2	33.33	66.66	15	1	1	0.5	1	0.166666666666667	3	4
EXOSC7	12	11	4	0	344.52	689.04	15	1	0.122507122507122	-Inf	1	-0.478260869565217	4	23
EXOSC8	5	10	2	1	268.62	537.24	15	1	0.528186274509804	-3	1	-0.333333333333333	3	15
EXOSC9	15	16	3	3	424.38	848.76	15	1	1	-0.0666666666666667	1	-0.0161290322580645	6	31
EXPH5	76	79	17	11	1951.62	3903.24	15	1	0.306703341842732	-0.606459330143541	1	-0.116820276497696	28	155
EXT1	0	6	1	0	430.65	861.3	15	1	0.142857142857143	-Inf	1	-1	1	6
EXT2	1	30	4	4	694.98	1389.96	15	1	0.00386621439253019	-29	0.444430549693708	-0.467741935483871	8	31
EXTL1	14	12	10	12	502.26	1004.52	15	1	0.77248182124475	0.285714285714286	1	0.0839160839160839	22	26
EXTL2	6	13	1	3	328.68	657.36	15	1	1	0.277777777777778	1	0.0657894736842105	4	19
EXTL3	1	20	2	15	910.8	1821.6	15	1	0.576813655761024	-1.66666666666667	1	-0.0700280112044818	17	21
EYA4	1	18	1	1	619.74	1239.48	15	1	0.185714285714286	-17	1	-0.447368421052632	2	19
EYS	39	45	3	8	1102.86	2205.72	15	1	0.336144926595317	0.567307692307692	1	0.191558441558442	11	84
EZH1	2	30	1	8	737.55	1475.1	15	1	0.534709193245778	-0.875	1	-0.0486111111111111	9	32
EZR	4	23	1	1	576.18	1152.36	15	1	0.320197044334975	-4.75	1	-0.351851851851852	2	27
F10	6	18	0	3	448.14	896.28	15	1	1	1	1	0.25	3	24
F11	14	14	3	3	635.58	1271.16	15	1	1	0	1	0	6	28
F2	17	30	2	2	603.9	1207.8	15	1	0.622889155662265	-0.764705882352941	1	-0.138297872340426	4	47
F2R	17	11	1	0	406.23	812.46	15	1	1	-Inf	1	-0.392857142857143	1	28
F2RL1	20	16	0	3	370.92	741.84	15	1	0.106029106029106	1	0.983805342817882	0.555555555555556	3	36
F2RL3	10	16	7	3	385.11	770.22	15	1	0.139367615452154	-2.73333333333333	1	-0.315384615384615	10	26
F3	7	10	0	2	267.3	534.6	15	1	0.508771929824561	1	1	0.411764705882353	2	17
F5	62	82	11	14	2117.61	4235.22	15	1	1	-0.0391705069124424	1	-0.00944444444444442	25	144
F7	9	14	2	2	422.73	845.46	15	1	1	-0.555555555555556	1	-0.108695652173913	4	23
F8	89	101	26	30	2174.7	4349.4	15	1	1	0.0164794007490636	1	0.00413533834586466	56	190
F8A3	0	3	0	1	26.73	53.46	15	1	1	NA	1	0	1	3
F9	14	26	0	2	463.32	926.64	15	1	0.544715447154472	1	1	0.35	2	40
FAAH	11	22	3	5	561.66	1123.32	15	1	1	-0.2	1	-0.0416666666666667	8	33
FAAH2	3	18	2	8	411.84	823.68	15	1	1	-0.5	1	-0.0571428571428572	10	21
FAAHL	10	22	5	3	565.62	1131.24	15	1	0.1255747292899	-2.66666666666667	1	-0.3125	8	32
FAAP100	14	23	10	13	731.94	1463.88	15	1	0.787744143001392	-0.263736263736264	1	-0.0564042303172738	23	37
FAAP24	6	12	2	0	213.84	427.68	15	1	0.147368421052632	-Inf	1	-0.666666666666667	2	18
FABP1	6	3	0	0	126.72	253.44	15	1	1	NA	1	NA	0	9
FABP2	4	5	3	0	131.67	263.34	15	1	0.204545454545455	-Inf	1	-0.555555555555556	3	9
FABP3	0	1	1	0	51.48	102.96	15	1	1	-Inf	1	-1	1	1
FABP6	0	3	1	0	127.71	255.42	15	1	0.25	-Inf	1	-1	1	3
FABP7	1	1	0	0	109.23	218.46	15	1	1	NA	1	NA	0	2
FADD	6	6	0	0	194.04	388.08	15	1	1	NA	1	NA	0	12
FADS1	2	12	0	0	405.24	810.48	15	1	1	NA	1	NA	0	14
FADS1L1	4	16	3	1	444.51	889.02	15	1	0.0592885375494071	-11	0.865311545612266	-0.55	4	20
FADS1L2	9	20	4	3	466.29	932.58	15	1	0.224998682268606	-1.96296296296296	1	-0.261083743842364	7	29
FADS2	6	16	0	2	485.43	970.86	15	1	1	1	1	0.272727272727273	2	22
FADS6	7	15	3	7	312.51	625.02	15	1	1	0.0816326530612245	1	0.0181818181818182	10	22
FAF1	2	26	1	5	667.26	1334.52	15	1	0.452540106951872	-1.6	1	-0.0952380952380952	6	28
FAF2	0	17	0	2	396.99	793.98	15	1	1	NA	1	0	2	17
FAH	6	16	2	3	415.8	831.6	15	1	0.615904868078781	-0.777777777777778	1	-0.127272727272727	5	22
FAHD1	4	7	0	0	221.76	443.52	15	1	1	NA	1	NA	0	11
FAIM2	1	8	0	2	303.93	607.86	15	1	1	1	1	0.111111111111111	2	9
FAM102B-LOC429054	4	10	2	0	306.9	613.8	15	1	0.125	-Inf	1	-0.714285714285714	2	14
FAM103A1	2	2	0	0	116.82	233.64	15	1	1	NA	1	NA	0	4
FAM105A	9	12	2	1	367.29	734.58	15	1	0.576086956521739	-1.66666666666667	1	-0.238095238095238	3	21
FAM105B	5	12	0	2	310.2	620.4	15	1	1	1	1	0.294117647058824	2	17
FAM107A	6	12	5	2	213.84	427.68	15	1	0.17745995423341	-4	1	-0.380952380952381	7	18
FAM109A	4	6	6	11	252.45	504.9	15	1	1	0.181818181818182	1	0.0470588235294118	17	10
FAM109B	3	6	3	8	242.55	485.1	15	1	1	0.25	1	0.0606060606060606	11	9
FAM110A	6	4	9	11	300.96	601.92	15	1	0.699850074962519	0.454545454545455	1	0.15	20	10
FAM110B	1	6	1	6	367.29	734.58	15	1	1	0	1	0	7	7
FAM110C	9	13	3	4	284.13	568.26	15	1	1	-0.0833333333333333	1	-0.0194805194805194	7	22
FAM114A1	6	13	3	3	557.37	1114.74	15	1	0.6300395256917	-1.16666666666667	1	-0.184210526315789	6	19
FAM114A2	12	14	2	2	495.99	991.98	15	1	1	-0.166666666666667	1	-0.0384615384615384	4	26
FAM117A	13	32	7	12	385.77	771.54	15	1	0.56484246622983	-0.435897435897436	1	-0.0795321637426901	19	45
FAM117B	2	20	0	2	342.54	685.08	15	1	1	1	1	0.0909090909090909	2	22
FAM120A	5	5	1	2	1065.9	2131.8	15	1	1	0.5	1	0.166666666666667	3	10
FAM120B	20	23	3	4	681.12	1362.24	15	1	1	0.1375	1	0.0365448504983389	7	43
FAM122A	1	13	0	2	273.24	546.48	15	1	1	1	1	0.0714285714285714	2	14
FAM122B	1	5	0	0	221.76	443.52	15	1	1	NA	1	NA	0	6
FAM124A	10	16	1	2	520.08	1040.16	15	1	1	0.2	1	0.0512820512820513	3	26
FAM124B	27	24	10	11	441.54	883.08	15	1	0.796867625904452	0.191919191919192	1	0.0532212885154062	21	51
FAM126A	3	13	0	0	510.84	1021.68	15	1	1	NA	1	NA	0	16
FAM126B	4	8	1	3	582.12	1164.24	15	1	1	0.333333333333333	1	0.0833333333333333	4	12
FAM129A	44	39	9	8	1101.54	2203.08	15	1	1	0.00284090909090906	1	0.000708717221828525	17	83
FAM129B	9	17	3	11	573.87	1147.74	15	1	0.484369352926005	0.484848484848485	1	0.131868131868132	14	26
FAM131A	0	9	2	11	251.46	502.92	15	1	0.493506493506494	-Inf	1	-0.153846153846154	13	9
FAM133B	2	5	3	0	213.84	427.68	15	1	0.166666666666667	-Inf	1	-0.714285714285714	3	7
FAM134B	3	10	0	2	359.37	718.74	15	1	1	1	1	0.230769230769231	2	13
FAM134C	13	20	4	7	411.18	822.36	15	1	1	0.120879120879121	1	0.0303030303030303	11	33
FAM135A	32	42	3	9	1527.24	3054.48	15	1	0.344957712876275	0.5625	1	0.182432432432432	12	74
FAM135B	27	42	8	5	1186.02	2372.04	15	1	0.22054782936764	-1.48888888888889	1	-0.224080267558528	13	69
FAM136A	0	1	0	1	23.43	46.86	15	1	1	NA	1	0	1	1
FAM13B	8	24	3	6	924.66	1849.32	15	1	0.680402293103343	-0.5	1	-0.0833333333333333	9	32
FAM13C	24	26	4	0	927.96	1855.92	15	1	0.112015456077609	-Inf	0.989770537962477	-0.52	4	50
FAM149B1	19	19	6	4	569.58	1139.16	15	1	0.726670383116118	-0.5	1	-0.1	10	38
FAM150B	0	2	0	0	151.47	302.94	15	1	1	NA	1	NA	0	2
FAM160A2	10	46	5	13	904.53	1809.06	15	1	0.500396662909513	-0.769230769230769	1	-0.0992063492063492	18	56
FAM160B1	6	29	1	6	745.14	1490.28	15	1	1	0.194444444444444	1	0.0285714285714286	7	35
FAM161B	11	15	4	1	501.93	1003.86	15	1	0.171919416635768	-4.45454545454545	1	-0.376923076923077	5	26
FAM162A	3	6	1	2	145.2	290.4	15	1	1	0	1	0	3	9
FAM162B	1	4	0	1	114.18	228.36	15	1	1	1	1	0.2	1	5
FAM163A	3	4	0	3	163.35	326.7	15	1	0.475	1	1	0.428571428571429	3	7
FAM163B	1	3	2	5	151.8	303.6	15	1	1	-0.2	1	-0.0357142857142857	7	4
FAM166A	21	27	4	7	316.8	633.6	15	1	0.744687541095735	0.26530612244898	1	0.0738636363636364	11	48
FAM167A	1	7	2	7	209.88	419.76	15	1	1	-1	1	-0.0972222222222222	9	8
FAM167B	3	7	1	1	107.58	215.16	15	1	1	-1.33333333333333	1	-0.2	2	10
FAM168A	4	6	6	6	234.96	469.92	15	1	0.691355084543939	-0.5	1	-0.1	12	10
FAM169A	16	15	1	3	543.18	1086.36	15	1	0.602597402597402	0.6875	1	0.266129032258065	4	31
FAM169B	3	5	1	1	288.09	576.18	15	1	1	-0.666666666666667	1	-0.125	2	8
FAM171A1	6	21	4	7	914.76	1829.52	15	1	0.431753980775598	-1	1	-0.141414141414141	11	27
FAM171B	17	36	2	1	752.4	1504.8	15	1	0.263203463203463	-3.23529411764706	1	-0.345911949685535	3	53
FAM172A	4	11	0	2	205.92	411.84	15	1	1	1	1	0.266666666666667	2	15
FAM172BP	25	17	2	1	362.34	724.68	15	1	1	-0.36	1	-0.0714285714285714	3	42
FAM173B	12	14	4	2	220.77	441.54	15	1	0.653936472623903	-1.33333333333333	1	-0.205128205128205	6	26
FAM174A	4	6	0	0	72.6	145.2	15	1	1	NA	1	NA	0	10
FAM174B	2	3	0	0	91.41	182.82	15	1	1	NA	1	NA	0	5
FAM175A	8	13	2	3	374.22	748.44	15	1	1	-0.0833333333333333	1	-0.0190476190476191	5	21
FAM175B	3	32	3	4	409.2	818.4	15	1	0.0477796844934201	-7	0.828593091717788	-0.342857142857143	7	35
FAM177A1	2	7	0	1	200.97	401.94	15	1	1	1	1	0.222222222222222	1	9
FAM179A	64	29	8	6	1255.32	2510.64	15	1	0.379337350179783	0.395833333333333	1	0.116743471582181	14	93
FAM179B	24	50	11	18	1398.54	2797.08	15	1	0.647038579746078	-0.273148148148148	1	-0.0549860205032618	29	74
FAM180A	5	8	0	1	164.34	328.68	15	1	1	1	1	0.384615384615385	1	13
FAM180B	13	12	0	2	195.03	390.06	15	1	0.481481481481482	1	1	0.52	2	25
FAM181A	7	15	2	7	287.1	574.2	15	1	0.689113656571218	0.387755102040816	1	0.095959595959596	9	22
FAM181B	3	9	1	8	157.08	314.16	15	1	0.603007518796992	0.625	1	0.138888888888889	9	12
FAM183A	2	4	0	1	127.71	255.42	15	1	1	1	1	0.333333333333333	1	6
FAM184A	2	17	0	1	648.78	1297.56	15	1	1	1	1	0.105263157894737	1	19
FAM184B	23	30	2	1	686.07	1372.14	15	1	0.580627705627706	-1.60869565217391	1	-0.232704402515723	3	53
FAM185A	3	5	1	1	216.15	432.3	15	1	1	-0.666666666666667	1	-0.125	2	8
FAM187A	5	15	3	2	246.51	493.02	15	1	0.283267457180501	-3.5	1	-0.35	5	20
FAM188A	4	6	2	1	412.5	825	15	1	0.559440559440559	-2	1	-0.266666666666667	3	10
FAM188B	24	17	7	4	806.85	1613.7	15	1	1	-0.239583333333333	1	-0.0509977827050998	11	41
FAM189A1	15	15	5	4	534.27	1068.54	15	1	1	-0.25	1	-0.0555555555555556	9	30
FAM189A2	13	16	3	0	449.79	899.58	15	1	0.225806451612903	-Inf	1	-0.551724137931034	3	29
FAM18B1	3	6	1	0	191.07	382.14	15	1	0.4	-Inf	1	-0.666666666666667	1	9
FAM192A	0	6	0	1	166.32	332.64	15	1	1	NA	1	0	1	6
FAM193A	8	45	7	6	1486.98	2973.96	15	1	0.00647087278009718	-5.5625	0.467685236262114	-0.387518142235123	13	53
FAM193B	17	30	7	21	814.77	1629.54	15	1	0.44345632191895	0.411764705882353	1	0.111702127659574	28	47
FAM194A	21	23	4	5	455.4	910.8	15	1	1	0.123809523809524	1	0.0328282828282829	9	44
FAM195A	0	2	1	0	70.29	140.58	15	1	0.333333333333333	-Inf	1	-1	1	2
FAM196A	9	12	5	7	452.43	904.86	15	1	1	0.0476190476190477	1	0.0119047619047619	12	21
FAM198A	19	24	11	12	442.2	884.4	15	1	0.800795227364218	-0.157894736842105	1	-0.0364004044489383	23	43
FAM198B	13	25	1	1	541.53	1083.06	15	1	1	-0.923076923076923	1	-0.157894736842105	2	38
FAM199X	0	11	1	2	318.12	636.24	15	1	0.214285714285714	-Inf	1	-0.333333333333333	3	11
FAM19A3	0	6	0	1	132.66	265.32	15	1	1	NA	1	0	1	6
FAM204A	9	7	2	2	241.56	483.12	15	1	1	0.222222222222222	1	0.0625	4	16
FAM206A	1	8	1	1	170.61	341.22	15	1	0.345454545454545	-7	1	-0.388888888888889	2	9
FAM207A	3	6	0	0	145.53	291.06	15	1	1	NA	1	NA	0	9
FAM208A	44	49	7	2	1634.82	3269.64	15	1	0.159910293796607	-2.89772727272727	1	-0.304659498207885	9	93
FAM20A	9	23	3	10	381.81	763.62	15	1	1	0.233333333333333	1	0.0504807692307692	13	32
FAM20C	1	7	0	2	351.12	702.24	15	1	1	1	1	0.125	2	8
FAM20CL	15	11	8	11	503.91	1007.82	15	1	0.372583797871365	0.466666666666667	1	0.15587044534413	19	26
FAM210A	9	18	3	3	273.24	546.48	15	1	0.643353726362625	-1	1	-0.166666666666667	6	27
FAM210B	3	8	0	0	136.62	273.24	15	1	1	NA	1	NA	0	11
FAM212B	12	20	1	1	315.81	631.62	15	1	1	-0.666666666666667	1	-0.125	2	32
FAM214A	42	62	8	7	979.11	1958.22	15	1	0.406605075871354	-0.687074829931973	1	-0.129487179487179	15	104
FAM214B	16	32	3	9	557.37	1114.74	15	1	0.735346656113346	0.333333333333333	1	0.0833333333333333	12	48
FAM217B	37	37	3	2	1018.71	2037.42	15	1	1	-0.5	1	-0.1	5	74
FAM219B	6	8	7	5	141.24	282.48	15	1	0.695097590523624	-0.866666666666667	1	-0.154761904761905	12	14
FAM221A	8	16	3	2	275.55	551.1	15	1	0.338638373121132	-2	1	-0.266666666666667	5	24
FAM222A	2	6	3	4	456.72	913.44	15	1	0.608391608391608	-1.25	1	-0.178571428571429	7	8
FAM222B	3	4	3	1	405.9	811.8	15	1	0.545454545454546	-3	1	-0.321428571428571	4	7
FAM228	17	15	2	2	279.18	558.36	15	1	1	0.117647058823529	1	0.03125	4	32
FAM229A	2	4	0	1	73.26	146.52	15	1	1	1	1	0.333333333333333	1	6
FAM234B	6	11	3	5	606.54	1213.08	15	1	1	-0.1	1	-0.0220588235294117	8	17
FAM240A	0	4	0	0	72.27	144.54	15	1	1	NA	1	NA	0	4
FAM26D	4	18	1	3	315.81	631.62	15	1	1	-0.5	1	-0.0681818181818182	4	22
FAM26E	9	11	2	1	306.9	613.8	15	1	0.590062111801242	-1.44444444444444	1	-0.216666666666667	3	20
FAM26F	13	15	2	1	306.9	613.8	15	1	0.599555061179088	-1.30769230769231	1	-0.202380952380952	3	28
FAM32A	0	2	0	2	86.46	172.92	15	1	1	NA	1	0	2	2
FAM35A	66	41	5	2	889.02	1778.04	15	1	0.708581710755375	-0.553030303030303	1	-0.0974632843791723	7	107
FAM3B	7	2	1	1	233.64	467.28	15	1	0.490909090909091	0.714285714285714	1	0.277777777777778	2	9
FAM3C	0	8	0	0	225.72	451.44	15	1	1	NA	1	NA	0	8
FAM3D	2	11	1	1	224.73	449.46	15	1	0.371428571428571	-4.5	1	-0.346153846153846	2	13
FAM43B	0	2	0	4	125.73	251.46	15	1	1	NA	1	0	4	2
FAM45A	2	10	1	1	336.6	673.2	15	1	0.395604395604396	-4	1	-0.333333333333333	2	12
FAM46A	0	10	1	7	386.76	773.52	15	1	0.444444444444444	-Inf	1	-0.125	8	10
FAM46B	0	11	1	4	336.6	673.2	15	1	0.3125	-Inf	1	-0.2	5	11
FAM46C	0	20	1	6	387.09	774.18	15	1	0.259259259259259	-Inf	1	-0.142857142857143	7	20
FAM46D	3	13	2	1	388.08	776.16	15	1	0.154798761609907	-7.66666666666667	1	-0.479166666666667	3	16
FAM49A	0	7	0	0	317.46	634.92	15	1	1	NA	1	NA	0	7
FAM49AL	1	8	0	2	151.8	303.6	15	1	1	1	1	0.111111111111111	2	9
FAM49B	0	4	0	4	321.75	643.5	15	1	1	NA	1	0	4	4
FAM53A	3	8	0	3	415.8	831.6	15	1	1	1	1	0.272727272727273	3	11
FAM53B	3	6	6	2	367.29	734.58	15	1	0.153434800493624	-5	1	-0.416666666666667	8	9
FAM57A	1	2	2	1	176.22	352.44	15	1	1	-3	1	-0.333333333333333	3	3
FAM63A	14	18	4	3	445.83	891.66	15	1	0.682479682479682	-0.714285714285714	1	-0.133928571428571	7	32
FAM63B	0	10	0	1	328.02	656.04	15	1	1	NA	1	0	1	10
FAM64A	16	10	2	0	297	594	15	1	0.523809523809524	-Inf	1	-0.384615384615385	2	26
FAM65A	8	30	13	11	1069.2	2138.4	15	1	0.0124574781545606	-3.43181818181818	0.61231737012987	-0.331140350877193	24	38
FAM65B	13	27	8	10	1015.74	2031.48	15	1	0.394552847046065	-0.661538461538462	1	-0.119444444444444	18	40
FAM65C	11	41	2	3	933.57	1867.14	15	1	0.319154805252124	-1.48484848484848	1	-0.188461538461538	5	52
FAM69A	6	11	0	2	404.91	809.82	15	1	1	1	1	0.352941176470588	2	17
FAM69B	6	15	5	5	406.89	813.78	15	1	0.42321643148649	-1.5	1	-0.214285714285714	10	21
FAM69C	5	8	3	4	410.52	821.04	15	1	1	-0.2	1	-0.0439560439560439	7	13
FAM71D	17	5	1	0	325.71	651.42	15	1	1	-Inf	1	-0.227272727272727	1	22
FAM72A	2	3	0	2	98.34	196.68	15	1	1	1	1	0.4	2	5
FAM76A	1	19	0	5	269.61	539.22	15	1	1	1	1	0.05	5	20
FAM76B	0	14	0	2	301.95	603.9	15	1	1	NA	1	0	2	14
FAM78A	8	9	5	7	340.56	681.12	15	1	1	0.196428571428571	1	0.053921568627451	12	17
FAM78B	0	8	0	4	172.59	345.18	15	1	1	NA	1	0	4	8
FAM81A	3	7	0	0	379.17	758.34	15	1	1	NA	1	NA	0	10
FAM83A	5	26	4	8	466.29	932.58	15	1	0.237131245430496	-1.6	1	-0.172043010752688	12	31
FAM83B	14	22	3	6	1103.52	2207.04	15	1	1	0.214285714285714	1	0.0555555555555556	9	36
FAM83C	13	23	1	6	587.07	1174.14	15	1	0.396350540467924	0.705128205128205	1	0.218253968253968	7	36
FAM83D	16	32	5	9	700.92	1401.84	15	1	1	-0.111111111111111	1	-0.0238095238095238	14	48
FAM83F	11	17	1	3	501.93	1003.86	15	1	1	0.484848484848485	1	0.142857142857143	4	28
FAM83G	11	32	4	19	725.01	1450.02	15	1	0.547475976095873	0.38755980861244	1	0.0819009100101112	23	43
FAM83H	11	32	1	4	1121.67	2243.34	15	1	1	0.272727272727273	1	0.0558139534883721	5	43
FAM84B	2	14	1	0	297.99	595.98	15	1	0.176470588235294	-Inf	1	-0.875	1	16
FAM89A	7	3	4	3	135.3	270.6	15	1	0.643665158371041	0.428571428571429	1	0.128571428571429	7	10
FAM91A1	6	42	1	7	694.65	1389.3	15	1	1	0	1	0	8	48
FAM96A	0	3	0	2	118.47	236.94	15	1	1	NA	1	0	2	3
FAM96B	1	5	0	0	113.85	227.7	15	1	1	NA	1	NA	0	6
FAM98A	1	17	1	2	498.3	996.6	15	1	0.271428571428571	-7.5	1	-0.277777777777778	3	18
FAM98B	6	10	0	1	328.68	657.36	15	1	1	1	1	0.375	1	16
FAN1	55	49	10	15	1024.65	2049.3	15	1	0.272806271328873	0.406060606060606	1	0.128846153846154	25	104
FANCA	41	59	15	21	1409.76	2819.52	15	1	1	-0.0278745644599303	1	-0.00666666666666671	36	100
FANCB	38	30	12	7	809.82	1619.64	15	1	0.610676333241086	-0.353383458646616	1	-0.0727554179566563	19	68
FANCC	12	14	1	1	436.92	873.84	15	1	1	-0.166666666666667	1	-0.0384615384615384	2	26
FANCD2	30	60	19	37	1414.71	2829.42	15	1	1	-0.027027027027027	1	-0.00595238095238099	56	90
FANCD2OS	3	5	0	0	47.85	95.7	15	1	1	NA	1	NA	0	8
FANCE	22	35	5	15	468.93	937.86	15	1	0.414417897566817	0.46969696969697	1	0.135964912280702	20	57
FANCF	22	13	2	0	222.42	444.84	15	1	0.531531531531532	-Inf	1	-0.371428571428571	2	35
FANCG	29	30	12	9	634.92	1269.84	15	1	0.615119684121859	-0.379310344827586	1	-0.0799031476997578	21	59
FANCI	14	41	5	8	1298.88	2597.76	15	1	0.492292412607377	-0.830357142857143	1	-0.13006993006993	13	55
FANCL	7	15	1	1	339.57	679.14	15	1	1	-1.14285714285714	1	-0.181818181818182	2	22
FANCM	122	93	20	20	1752.3	3504.6	15	1	0.489434500890818	0.237704918032787	1	0.0674418604651162	40	215
FAP	9	23	2	3	752.4	1504.8	15	1	0.622731975673152	-0.703703703703704	1	-0.11875	5	32
FAR1	0	20	1	3	510.84	1021.68	15	1	0.166666666666667	-Inf	1	-0.25	4	20
FARP1	0	14	2	5	575.19	1150.38	15	1	0.1	-Inf	0.971353639774823	-0.285714285714286	7	14
FARP2	14	52	5	4	1374.12	2748.24	15	1	0.0406452833434518	-3.64285714285714	0.798931947804628	-0.343434343434343	9	66
FARSB	2	23	1	4	564.96	1129.92	15	1	0.433497536945813	-1.875	1	-0.12	5	25
FAS	46	19	0	2	393.03	786.06	15	1	0.0949796472184531	1	0.960983694935281	0.707692307692308	2	65
FASLG	5	9	3	3	266.31	532.62	15	1	0.642414860681115	-0.8	1	-0.142857142857143	6	14
FASN	48	80	3	5	2487.87	4975.74	15	1	1	0	1	0	8	128
FASTKD1	36	32	2	3	800.91	1601.82	15	1	0.665825007619671	0.407407407407407	1	0.129411764705882	5	68
FASTKD2	21	24	2	3	616.77	1233.54	15	1	1	0.238095238095238	1	0.0666666666666667	5	45
FASTKD3	32	24	6	6	652.08	1304.16	15	1	0.753027207712836	0.25	1	0.0714285714285714	12	56
FAT1	51	163	9	16	4545.09	9090.18	15	1	0.222171953116461	-0.797794117647059	1	-0.121682242990654	25	214
FAT2	50	183	33	48	4156.02	8312.04	15	1	0.00118084674411578	-1.51625	0.254094564439392	-0.192815132729296	81	233
FAT4	32	141	15	19	2640.66	5281.32	15	1	0.00279920219105969	-2.47861842105263	0.371278796110885	-0.256205372322339	34	173
FAXC	2	9	0	0	320.43	640.86	15	1	1	NA	1	NA	0	11
FAXDC2	9	15	3	2	330.66	661.32	15	1	0.622079070354932	-1.5	1	-0.225	5	24
FBLIM1	6	14	5	7	299.31	598.62	15	1	0.702595972485222	-0.666666666666667	1	-0.116666666666667	12	20
FBLN1	16	28	3	0	908.49	1816.98	15	1	0.0597594819611471	-Inf	0.870044279682834	-0.636363636363636	3	44
FBLN2	6	32	4	7	759.33	1518.66	15	1	0.201106824680158	-2.04761904761905	1	-0.205741626794258	11	38
FBLN5	1	9	2	3	440.55	881.1	15	1	0.241758241758242	-5	1	-0.3	5	10
FBLN7	6	13	3	8	374.22	748.44	15	1	1	0.1875	1	0.0430622009569378	11	19
FBN3	13	96	9	27	2932.05	5864.1	15	1	0.0662029114349993	-1.46153846153846	0.884435842948953	-0.130733944954128	36	109
FBP1	5	8	0	0	287.1	574.2	15	1	1	NA	1	NA	0	13
FBP2	5	15	1	1	319.77	639.54	15	1	0.48051948051948	-2	1	-0.25	2	20
FBRSL1	1	16	0	4	952.38	1904.76	15	1	1	1	1	0.0588235294117647	4	17
FBXL14	0	6	0	6	326.04	652.08	15	1	1	NA	1	0	6	6
FBXL15	0	3	0	0	214.17	428.34	15	1	1	NA	1	NA	0	3
FBXL17	13	10	1	0	286.44	572.88	15	1	1	-Inf	1	-0.434782608695652	1	23
FBXL18	11	31	5	11	716.76	1433.52	15	1	0.748302567214473	-0.28099173553719	1	-0.0505952380952381	16	42
FBXL2	1	6	0	0	149.16	298.32	15	1	1	NA	1	NA	0	7
FBXL20	0	15	0	1	418.77	837.54	15	1	1	NA	1	0	1	15
FBXL21	5	16	1	1	427.68	855.36	15	1	0.462450592885375	-2.2	1	-0.261904761904762	2	21
FBXL3	0	15	2	2	429.66	859.32	15	1	0.0350877192982456	-Inf	0.788199921465956	-0.5	4	15
FBXL4	2	16	2	4	561.33	1122.66	15	1	0.251270468661773	-3	1	-0.222222222222222	6	18
FBXL5	6	12	3	1	696.63	1393.26	15	1	0.264251537935748	-5	1	-0.416666666666667	4	18
FBXL7	0	14	0	4	440.55	881.1	15	1	1	NA	1	0	4	14
FBXL8	10	18	4	2	375.54	751.08	15	1	0.202239713763956	-2.6	1	-0.309523809523809	6	28
FBXO15	12	18	4	2	482.46	964.92	15	1	0.373752433524729	-2	1	-0.266666666666667	6	30
FBXO16	14	22	6	4	512.49	1024.98	15	1	0.292207692661465	-1.35714285714286	1	-0.211111111111111	10	36
FBXO18	12	7	1	4	124.74	249.48	15	1	0.142080745341615	0.854166666666667	1	0.431578947368421	5	19
FBXO2	2	12	2	6	245.52	491.04	15	1	0.601913875598086	-1	1	-0.107142857142857	8	14
FBXO21	3	20	0	4	530.97	1061.94	15	1	1	1	1	0.130434782608696	4	23
FBXO22	0	14	1	2	311.85	623.7	15	1	0.176470588235294	-Inf	1	-0.333333333333333	3	14
FBXO25	3	9	1	1	357.39	714.78	15	1	0.505494505494505	-2	1	-0.25	2	12
FBXO28	0	10	1	1	265.98	531.96	15	1	0.166666666666667	-Inf	1	-0.5	2	10
FBXO3	0	21	0	2	411.84	823.68	15	1	1	NA	1	0	2	21
FBXO30	7	22	4	3	751.41	1502.82	15	1	0.166534893527303	-3.19047619047619	1	-0.330049261083744	7	29
FBXO31	6	20	3	4	440.22	880.44	15	1	0.35826844642195	-1.5	1	-0.197802197802198	7	26
FBXO32	0	14	0	3	314.49	628.98	15	1	1	NA	1	0	3	14
FBXO33	0	8	2	5	380.16	760.32	15	1	0.2	-Inf	1	-0.285714285714286	7	8
FBXO34	14	30	7	11	703.89	1407.78	15	1	0.768202398228835	-0.363636363636364	1	-0.0707070707070707	18	44
FBXO38	12	31	0	2	1181.07	2362.14	15	1	1	1	1	0.27906976744186	2	43
FBXO39	7	16	0	1	435.6	871.2	15	1	1	1	1	0.304347826086957	1	23
FBXO4	10	14	1	4	370.26	740.52	15	1	0.622079070354932	0.65	1	0.216666666666667	5	24
FBXO41	2	28	3	22	756.03	1512.06	15	1	0.649875343549039	-0.909090909090909	1	-0.0533333333333333	25	30
FBXO42	4	8	1	1	164.01	328.02	15	1	1	-1	1	-0.166666666666667	2	12
FBXO43	35	35	9	3	657.36	1314.72	15	1	0.129141434949004	-2	1	-0.25	12	70
FBXO45	0	6	1	3	178.53	357.06	15	1	0.4	-Inf	1	-0.25	4	6
FBXO47	2	9	1	1	441.21	882.42	15	1	0.423076923076923	-3.5	1	-0.318181818181818	2	11
FBXO48	5	10	3	3	153.45	306.9	15	1	0.631062951496388	-1	1	-0.166666666666667	6	15
FBXO5	26	13	3	3	416.79	833.58	15	1	0.650079925746403	0.5	1	0.166666666666667	6	39
FBXO6	6	11	2	4	252.45	504.9	15	1	1	0.0833333333333334	1	0.0196078431372549	6	17
FBXO7	3	12	2	2	484.44	968.88	15	1	0.27218782249742	-3	1	-0.3	4	15
FBXO8	0	5	0	0	316.8	633.6	15	1	1	NA	1	NA	0	5
FBXO9	2	10	0	2	430.65	861.3	15	1	1	1	1	0.166666666666667	2	12
FBXW11	0	23	0	5	509.85	1019.7	15	1	1	NA	1	0	5	23
FBXW2	3	16	0	1	450.45	900.9	15	1	1	1	1	0.157894736842105	1	19
FBXW4	1	12	1	2	292.05	584.1	15	1	0.35	-5	1	-0.256410256410256	3	13
FBXW5	4	29	0	2	517.77	1035.54	15	1	1	1	1	0.121212121212121	2	33
FBXW7	0	23	0	3	535.59	1071.18	15	1	1	NA	1	0	3	23
FBXW8	6	18	2	5	533.94	1067.88	15	1	1	-0.2	1	-0.0357142857142857	7	24
FCER2	19	19	6	6	300.96	601.92	15	1	1	0	1	0	12	38
FCF1	0	5	0	0	176.55	353.1	15	1	1	NA	1	NA	0	5
FCGBP	70	90	5	5	2420.88	4841.76	15	1	0.750972093962155	-0.285714285714286	1	-0.0625	10	160
FCGBPL	144	119	45	66	2450.58	4901.16	15	1	0.0129628342476953	0.43655303030303	0.61231737012987	0.142123111704861	111	263
FCHO2	5	15	1	0	483.12	966.24	15	1	0.285714285714286	-Inf	1	-0.75	1	20
FCN2-LOC112531347	14	8	2	0	210.54	421.08	15	1	0.536231884057971	-Inf	1	-0.363636363636364	2	22
FDFT1	6	9	8	2	268.29	536.58	15	1	0.0991519720016153	-5	0.971353639774823	-0.4	10	15
FDPS	1	19	0	0	303.93	607.86	15	1	1	NA	1	NA	0	20
FDX1	1	4	0	2	132.99	265.98	15	1	1	1	1	0.2	2	5
FDX1L	9	10	1	1	183.15	366.3	15	1	1	-0.111111111111111	1	-0.0263157894736842	2	19
FDXR	7	21	5	8	453.75	907.5	15	1	0.468559075245688	-0.875	1	-0.134615384615385	13	28
FEM1A	3	39	2	12	663.3	1326.6	15	1	0.589765580331618	-1.16666666666667	1	-0.0714285714285714	14	42
FEM1B	1	23	2	8	584.1	1168.2	15	1	0.200534759358289	-4.75	1	-0.158333333333333	10	24
FEM1C	0	16	0	3	601.92	1203.84	15	1	1	NA	1	0	3	16
FEN1	3	15	1	6	378.18	756.36	15	1	1	0.166666666666667	1	0.0238095238095238	7	18
FER	4	1	0	0	152.46	304.92	15	1	1	NA	1	NA	0	5
FER1L4	32	57	13	15	1461.9	2923.8	15	1	0.375547193870408	-0.54375	1	-0.104735152487962	28	89
FER1L6	45	64	17	14	1969.77	3939.54	15	1	0.220292587417285	-0.726984126984127	1	-0.135543060076946	31	109
FERD3L	1	5	0	3	76.56	153.12	15	1	1	1	1	0.166666666666667	3	6
FERMT1	7	21	0	6	635.58	1271.16	15	1	0.305779445967891	1	1	0.25	6	28
FERMT2	4	18	2	8	698.61	1397.22	15	1	1	-0.125	1	-0.0181818181818182	10	22
FETUB	18	17	8	3	435.6	871.2	15	1	0.302427782291651	-1.51851851851852	1	-0.212987012987013	11	35
FEV	1	0	0	4	168.96	337.92	15	1	0.2	1	1	1	4	1
FEZ1	11	19	3	0	300.96	601.92	15	1	0.0667155425219941	-Inf	0.884435842948953	-0.633333333333333	3	30
FEZ2	2	15	3	1	358.05	716.1	15	1	0.0275689223057644	-21.5	0.761210061313465	-0.632352941176471	4	17
FEZF1	3	13	0	0	357.06	714.12	15	1	1	NA	1	NA	0	16
FEZF2	1	7	1	3	284.46	568.92	15	1	1	-1.33333333333333	1	-0.125	4	8
FFAR4	5	13	0	2	337.26	674.52	15	1	1	1	1	0.277777777777778	2	18
FGA	16	25	0	2	755.37	1510.74	15	1	0.521594684385382	1	1	0.390243902439024	2	41
FGB	4	15	0	3	476.19	952.38	15	1	1	1	1	0.210526315789474	3	19
FGD4	11	26	3	4	893.97	1787.94	15	1	0.661590454504745	-0.772727272727273	1	-0.131274131274131	7	37
FGD5	70	67	4	7	1660.89	3321.78	15	1	0.532824375411348	0.453061224489796	1	0.147312541473125	11	137
FGD6	27	39	3	6	1420.65	2841.3	15	1	0.733411843381395	0.277777777777778	1	0.0757575757575758	9	66
FGF1	1	6	0	3	150.15	300.3	15	1	1	1	1	0.142857142857143	3	7
FGF12	6	2	4	1	275.88	551.76	15	1	1	-0.333333333333333	1	-0.05	5	8
FGF13	3	1	0	0	154.44	308.88	15	1	1	NA	1	NA	0	4
FGF14	1	6	0	1	219.78	439.56	15	1	1	1	1	0.142857142857143	1	7
FGF18	0	5	1	1	217.47	434.94	15	1	0.285714285714286	-Inf	1	-0.5	2	5
FGF19	0	5	0	2	136.95	273.9	15	1	1	NA	1	0	2	5
FGF2	0	3	0	0	110.22	220.44	15	1	1	NA	1	NA	0	3
FGF20	1	8	0	0	115.5	231	15	1	1	NA	1	NA	0	9
FGF22	0	3	0	2	85.14	170.28	15	1	1	NA	1	0	2	3
FGF3	2	5	1	1	127.05	254.1	15	1	1	-1.5	1	-0.214285714285714	2	7
FGF4	0	2	0	2	131.67	263.34	15	1	1	NA	1	0	2	2
FGF5	0	8	1	1	162.36	324.72	15	1	0.2	-Inf	1	-0.5	2	8
FGF7	1	3	0	0	176.22	352.44	15	1	1	NA	1	NA	0	4
FGF8	0	3	1	4	137.94	275.88	15	1	1	-Inf	1	-0.2	5	3
FGF9	0	1	1	0	190.08	380.16	15	1	1	-Inf	1	-1	1	1
FGFBP1	11	10	2	5	236.61	473.22	15	1	0.395531400966184	0.636363636363636	1	0.238095238095238	7	21
FGFBP2	4	9	0	2	206.91	413.82	15	1	1	1	1	0.307692307692308	2	13
FGFR1	1	6	1	12	706.86	1413.72	15	1	1	0.5	1	0.0659340659340659	13	7
FGFR1OP	17	14	1	0	378.18	756.36	15	1	1	-Inf	1	-0.451612903225806	1	31
FGFR2	1	26	2	9	832.59	1665.18	15	1	0.195590327169275	-4.77777777777778	1	-0.144781144781145	11	27
FGFR3	1	24	4	2	763.95	1527.9	15	1	0.00224235040697777	-47	0.334726684582354	-0.626666666666667	6	25
FGFR4	2	20	4	14	537.24	1074.48	15	1	0.381031841558157	-1.85714285714286	1	-0.131313131313131	18	22
FGFRL1	1	17	1	5	384.12	768.24	15	1	0.445652173913043	-2.4	1	-0.111111111111111	6	18
FGG	5	14	1	1	430.65	861.3	15	1	0.5	-1.8	1	-0.236842105263158	2	19
FGGY	7	19	2	1	546.48	1092.96	15	1	0.220032840722496	-4.42857142857143	1	-0.397435897435897	3	26
FGL1L	22	21	6	5	268.29	536.58	15	1	1	-0.145454545454546	1	-0.0338266384778012	11	43
FGL2	6	10	2	4	438.57	877.14	15	1	1	0.166666666666667	1	0.0416666666666667	6	16
FGR	0	3	0	6	158.73	317.46	15	1	1	NA	1	0	6	3
FH	0	16	0	2	462.33	924.66	15	1	1	NA	1	0	2	16
FHAD1-LOC112529958	66	60	22	17	1253.01	2506.02	15	1	0.715547093494983	-0.176470588235294	1	-0.0402930402930403	39	126
FHDC1	23	45	5	7	1036.86	2073.72	15	1	0.744247682140846	-0.397515527950311	1	-0.0784313725490196	12	68
FHL1	6	15	2	2	326.7	653.4	15	1	0.5699604743083	-1.5	1	-0.214285714285714	4	21
FHL2	1	11	2	2	277.2	554.4	15	1	0.135714285714286	-10	1	-0.416666666666667	4	12
FHL3	0	6	0	4	269.28	538.56	15	1	1	NA	1	0	4	6
FHL5	7	9	1	0	278.19	556.38	15	1	0.470588235294118	-Inf	1	-0.5625	1	16
FHOD3	6	25	0	5	1177.77	2355.54	15	1	0.563836898395722	1	1	0.193548387096774	5	31
FIBCD1	1	7	3	6	387.09	774.18	15	1	0.576470588235294	-2.5	1	-0.208333333333333	9	8
FICD	1	23	1	4	352.11	704.22	15	1	0.320197044334976	-4.75	1	-0.158333333333333	5	24
FIG4	7	26	1	3	878.13	1756.26	15	1	1	-0.238095238095238	1	-0.0378787878787879	4	33
FIGN	2	23	0	1	705.21	1410.42	15	1	1	1	1	0.08	1	25
FIGNL2	6	21	5	25	587.4	1174.8	15	1	0.740200280496741	0.3	1	0.0555555555555556	30	27
FILIP1	3	30	1	7	1200.87	2401.74	15	1	1	-0.428571428571429	1	-0.0340909090909091	8	33
FILIP1L	3	9	2	0	228.69	457.38	15	1	0.10989010989011	-Inf	0.98538656216834	-0.75	2	12
FIP1L1	1	14	3	0	517.11	1034.22	15	1	0.00490196078431373	-Inf	0.460299276725364	-0.933333333333333	3	15
FKBP10	6	10	2	5	416.79	833.58	15	1	1	0.333333333333333	1	0.0892857142857143	7	16
FKBP11	0	1	0	1	43.23	86.46	15	1	1	NA	1	0	1	1
FKBP14	5	5	1	8	239.91	479.82	15	1	0.140866873065016	0.875	1	0.388888888888889	9	10
FKBP15	40	62	8	18	1230.24	2460.48	15	1	0.500792979553573	0.311111111111111	1	0.0844645550527903	26	102
FKBP1B	0	5	0	3	99.66	199.32	15	1	1	NA	1	0	3	5
FKBP1C	0	2	0	1	79.86	159.72	15	1	1	NA	1	0	1	2
FKBP3	1	2	0	1	116.16	232.32	15	1	1	1	1	0.333333333333333	1	3
FKBP4	6	13	1	0	417.78	835.56	15	1	0.35	-Inf	1	-0.684210526315789	1	19
FKBP5	3	20	1	8	442.86	885.72	15	1	1	0.166666666666667	1	0.0193236714975845	9	23
FKBP6	4	11	2	1	263.01	526.02	15	1	0.245098039215686	-4.5	1	-0.4	3	15
FKBP7	0	4	0	1	203.28	406.56	15	1	1	NA	1	0	1	4
FKBP8	0	4	0	5	173.91	347.82	15	1	1	NA	1	0	5	4
FKBP9	2	23	1	3	525.03	1050.06	15	1	0.370552818828681	-2.83333333333333	1	-0.17	4	25
FLAD1	11	13	8	12	451.77	903.54	15	1	0.766180297343366	0.212121212121212	1	0.0583333333333333	20	24
FLCN	4	20	0	2	844.47	1688.94	15	1	1	1	1	0.166666666666667	2	24
FLII	3	22	6	22	722.04	1444.08	15	1	0.473988712305476	-1	1	-0.0942857142857143	28	25
FLNB	5	104	9	16	2595.45	5190.9	15	1	7.54465395884736e-05	-10.7	0.047928406991204	-0.314128440366972	25	109
FLOT1	2	14	0	3	158.4	316.8	15	1	1	1	1	0.125	3	16
FLOT2	3	14	1	7	408.54	817.08	15	1	1	0.333333333333333	1	0.0514705882352941	8	17
FLRT2	11	19	1	5	655.38	1310.76	15	1	0.639943074003795	0.654545454545455	1	0.2	6	30
FLRT3	3	13	1	10	641.52	1283.04	15	1	0.623931623931624	0.566666666666667	1	0.0965909090909091	11	16
FLT1	9	37	7	11	833.25	1666.5	15	1	0.122287502130863	-1.61616161616162	1	-0.193236714975845	18	46
FLT3	30	40	5	9	955.68	1911.36	15	1	0.769353872610847	0.259259259259259	1	0.0714285714285714	14	70
FLT4	5	51	3	12	1348.05	2696.1	15	1	0.352583378270923	-1.55	1	-0.110714285714286	15	56
FLVCR1	5	15	1	8	437.25	874.5	15	1	0.632815460401667	0.625	1	0.138888888888889	9	20
FLVCR2	13	15	3	3	423.06	846.12	15	1	1	-0.153846153846154	1	-0.0357142857142857	6	28
FMN1	26	47	3	2	1079.1	2158.2	15	1	0.354626028310239	-1.71153846153846	1	-0.243835616438356	5	73
FMNL1	1	34	6	8	859.65	1719.3	15	1	0.0012635187672298	-24.5	0.254177858674395	-0.4	14	35
FMO3	14	22	8	6	497.97	995.94	15	1	0.34347165059744	-1.0952380952381	1	-0.182539682539683	14	36
FMO5	8	1	8	4	133.32	266.64	15	1	0.338345864661654	0.75	1	0.222222222222222	12	9
FMOD	0	8	2	6	322.74	645.48	15	1	0.466666666666667	-Inf	1	-0.25	8	8
FN1	13	101	2	13	2435.4	4870.8	15	1	0.686445569394982	-0.195266272189349	1	-0.0192982456140351	15	114
FN3K	4	7	3	3	306.9	613.8	15	1	0.643665158371041	-0.75	1	-0.136363636363636	6	11
FN3KRP	0	9	3	0	281.82	563.64	15	1	0.00454545454545454	-Inf	0.458402469160589	-1	3	9
FNBP1	11	19	3	7	634.59	1269.18	15	1	1	0.25974025974026	1	0.0666666666666667	10	30
FNBP4	12	8	4	12	582.45	1164.9	15	1	0.0485478668290489	0.777777777777778	0.833370237838852	0.35	16	20
FNDC1	35	69	11	9	1596.87	3193.74	15	1	0.081402193433069	-1.40952380952381	0.94404191396991	-0.213461538461538	20	104
FNDC10	1	7	0	1	125.4	250.8	15	1	1	1	1	0.125	1	8
FNDC3A	11	30	6	4	1129.26	2258.52	15	1	0.0654215914793514	-3.09090909090909	0.884435842948953	-0.331707317073171	10	41
FNDC3AL	11	46	3	9	1180.08	2360.16	15	1	0.698059915904878	-0.393939393939394	1	-0.0570175438596491	12	57
FNDC3B	6	26	3	12	1134.54	2269.08	15	1	1	-0.0833333333333333	1	-0.0125	15	32
FNDC4	3	2	0	2	212.19	424.38	15	1	0.428571428571428	1	1	0.6	2	5
FNDC5	0	4	1	0	172.92	345.84	15	1	0.2	-Inf	1	-1	1	4
FNDC7	31	25	6	0	589.05	1178.1	15	1	0.0726755422031037	-Inf	0.911545360143491	-0.446428571428571	6	56
FNIP1	9	55	6	10	1105.83	2211.66	15	1	0.0662484366218668	-2.66666666666667	0.884435842948953	-0.234375	16	64
FNIP2	33	41	5	3	1128.6	2257.2	15	1	0.461806051426305	-1.07070707070707	1	-0.179054054054054	8	74
FNTA	1	15	3	2	338.25	676.5	15	1	0.0275689223057644	-21.5	0.761210061313465	-0.5375	5	16
FOCAD	60	61	7	7	1813.35	3626.7	15	1	1	-0.0166666666666666	1	-0.00413223140495866	14	121
FOLH1	12	21	1	1	720.72	1441.44	15	1	1	-0.75	1	-0.136363636363636	2	33
FOPNL	4	9	3	1	173.58	347.16	15	1	0.25	-5.75	1	-0.442307692307692	4	13
FOS	4	15	2	4	224.4	448.8	15	1	0.606053077357425	-0.875	1	-0.12280701754386	6	19
FOSL2	0	1	0	2	282.81	565.62	15	1	1	NA	1	0	2	1
FOXA1	0	12	0	1	227.04	454.08	15	1	1	NA	1	0	1	12
FOXA2	1	17	2	5	281.82	563.64	15	1	0.179565217391304	-5.8	1	-0.23015873015873	7	18
FOXB1	1	6	0	1	273.9	547.8	15	1	1	1	1	0.142857142857143	1	7
FOXB2	0	3	0	0	113.52	227.04	15	1	1	NA	1	NA	0	3
FOXD3	0	4	0	2	192.72	385.44	15	1	1	NA	1	0	2	4
FOXE3	4	19	1	6	300.63	601.26	15	1	1	0.208333333333333	1	0.031055900621118	7	23
FOXG1	2	8	1	0	340.89	681.78	15	1	0.272727272727273	-Inf	1	-0.8	1	10
FOXI1	4	14	0	3	372.24	744.48	15	1	1	1	1	0.222222222222222	3	18
FOXI2	4	1	0	1	80.19	160.38	15	1	0.333333333333333	1	1	0.8	1	5
FOXI3	1	5	1	1	216.15	432.3	15	1	0.464285714285714	-4	1	-0.333333333333333	2	6
FOXJ1	10	19	5	16	442.53	885.06	15	1	0.536817507889544	0.40625	1	0.106732348111658	21	29
FOXJ2	3	8	0	2	540.54	1081.08	15	1	1	1	1	0.272727272727273	2	11
FOXK1	2	12	3	9	553.41	1106.82	15	1	0.634782608695652	-1	1	-0.107142857142857	12	14
FOXK2	5	15	1	4	687.06	1374.12	15	1	1	0.25	1	0.05	5	20
FOXM1	13	22	3	6	776.16	1552.32	15	1	1	0.153846153846154	1	0.0380952380952381	9	35
FOXN1	9	23	4	6	646.14	1292.28	15	1	0.696635827421903	-0.703703703703704	1	-0.11875	10	32
FOXN2	0	13	2	2	433.62	867.24	15	1	0.0441176470588235	-Inf	0.822543273817637	-0.5	4	13
FOXN3	15	8	0	1	514.8	1029.6	15	1	0.375	1	1	0.652173913043478	1	23
FOXN4	4	15	7	6	482.13	964.26	15	1	0.0720994341538908	-3.375	0.910388883446916	-0.327935222672065	13	19
FOXO1	1	7	1	3	446.49	892.98	15	1	1	-1.33333333333333	1	-0.125	4	8
FOXO3	3	13	1	7	490.05	980.1	15	1	1	0.380952380952381	1	0.0625	8	16
FOXO4	8	16	2	2	425.7	851.4	15	1	0.601465201465202	-1	1	-0.166666666666667	4	24
FOXP1	9	2	1	2	636.57	1273.14	15	1	0.175824175824176	0.888888888888889	1	0.484848484848485	3	11
FOXP2	1	11	1	0	586.74	1173.48	15	1	0.153846153846154	-Inf	1	-0.916666666666667	1	12
FOXP4L	0	5	1	3	482.79	965.58	15	1	0.444444444444444	-Inf	1	-0.25	4	5
FPGT	16	20	5	4	562.32	1124.64	15	1	0.712934977824371	-0.5625	1	-0.111111111111111	9	36
FRA10AC1	7	11	3	2	315.81	631.62	15	1	0.617522066034652	-1.35714285714286	1	-0.211111111111111	5	18
FRAS1	83	186	26	28	3932.61	7865.22	15	1	0.0178688913624983	-1.08089500860585	0.677255339142531	-0.172931295607876	54	269
FREM1	77	76	6	4	1952.61	3905.22	15	1	0.746468910660783	-0.480519480519481	1	-0.0967320261437908	10	153
FREM2	46	143	13	10	3143.91	6287.82	15	1	0.00239832404356917	-3.04130434782609	0.340562014186822	-0.321831147918104	23	189
FREM3	44	60	9	7	1462.89	2925.78	15	1	0.418083354641923	-0.753246753246753	1	-0.139423076923077	16	104
FRG1	0	12	0	2	254.43	508.86	15	1	1	NA	1	0	2	12
FRK	14	18	1	4	525.69	1051.38	15	1	0.629040805511394	0.678571428571429	1	0.2375	5	32
FRMD1	4	12	2	3	603.9	1207.8	15	1	0.597523219814241	-1	1	-0.15	5	16
FRMD3	12	12	2	0	342.21	684.42	15	1	0.483076923076923	-Inf	1	-0.5	2	24
FRMD4A	0	27	2	3	1015.74	2031.48	15	1	0.0201612903225806	-Inf	0.697268693964321	-0.4	5	27
FRMD4B	8	34	6	11	1022.01	2044.02	15	1	0.197211675922138	-1.31818181818182	1	-0.162464985994398	17	42
FRMD5	1	11	4	9	498.63	997.26	15	1	0.321739130434783	-3.88888888888889	1	-0.224358974358974	13	12
FRMD6	1	8	3	11	586.74	1173.48	15	1	1	-1.18181818181818	1	-0.103174603174603	14	9
FRMD7	13	31	12	4	628.65	1257.3	15	1	0.00263588706028368	-6.15384615384615	0.353501742418045	-0.454545454545455	16	44
FRMPD1	53	59	10	8	1547.37	3094.74	15	1	0.614425017870065	-0.391509433962264	1	-0.0823412698412699	18	112
FRMPD2	69	63	16	14	2089.89	4179.78	15	1	1	-0.0434782608695652	1	-0.0106060606060606	30	132
FRMPD3	32	65	12	22	1685.97	3371.94	15	1	0.834800109561961	-0.107954545454545	1	-0.0230442692540934	34	97
FRMPD4	17	28	4	6	1625.58	3251.16	15	1	1	-0.0980392156862746	1	-0.0222222222222223	10	45
FRRS1	19	26	7	4	594.66	1189.32	15	1	0.312952559586661	-1.39473684210526	1	-0.214141414141414	11	45
FRRS1L	0	10	0	5	212.52	425.04	15	1	1	NA	1	0	5	10
FRS2	0	9	0	3	503.91	1007.82	15	1	1	NA	1	0	3	9
FRS3	8	11	4	6	489.39	978.78	15	1	1	0.0833333333333334	1	0.0210526315789473	10	19
FRY	7	100	1	27	2936.67	5873.34	15	1	1	0.470899470899471	1	0.0297062750333778	28	107
FRYL	8	97	3	6	3009.93	6019.86	15	1	0.0411829192352478	-5.0625	0.798931947804628	-0.257142857142857	9	105
FRZB	4	6	2	4	249.81	499.62	15	1	1	0.25	1	0.0666666666666667	6	10
FSBP	2	6	0	0	296.01	592.02	15	1	1	NA	1	NA	0	8
FSCN1	0	7	0	7	283.14	566.28	15	1	1	NA	1	0	7	7
FSCN2	0	3	2	5	307.89	615.78	15	1	1	-Inf	1	-0.285714285714286	7	3
FSD2	20	23	4	1	777.15	1554.3	15	1	0.347517730496454	-3.6	1	-0.334883720930233	5	43
FSHB	6	5	2	2	125.73	251.46	15	1	1	0.166666666666667	1	0.0454545454545454	4	11
FST	0	13	0	0	340.56	681.12	15	1	1	NA	1	NA	0	13
FSTL3	0	5	0	6	229.35	458.7	15	1	1	NA	1	0	6	5
FSTL4	11	25	10	6	590.04	1180.08	15	1	0.0378404168391289	-2.78787878787879	0.789311843512415	-0.319444444444444	16	36
FSTL5	9	18	3	1	629.97	1259.94	15	1	0.271762275544256	-5	1	-0.416666666666667	4	27
FTCD	7	30	3	5	536.58	1073.16	15	1	0.349175037744163	-1.57142857142857	1	-0.185810810810811	8	37
FTH1	0	6	0	0	144.54	289.08	15	1	1	NA	1	NA	0	6
FTL	5	6	1	1	215.82	431.64	15	1	1	-0.2	1	-0.0454545454545455	2	11
FTO	22	13	1	2	557.7	1115.4	15	1	0.550142247510669	0.704545454545455	1	0.295238095238095	3	35
FTSJ3	27	43	2	3	796.95	1593.9	15	1	1	-0.0617283950617284	1	-0.0142857142857143	5	70
FUBP1	0	17	0	1	598.95	1197.9	15	1	1	NA	1	0	1	17
FUBP3	1	14	1	1	519.75	1039.5	15	1	0.227941176470588	-13	1	-0.433333333333333	2	15
FUCA1	7	13	0	0	380.49	760.98	15	1	1	NA	1	NA	0	20
FUCA2	11	18	2	1	445.17	890.34	15	1	0.551814516129032	-2.27272727272727	1	-0.28735632183908	3	29
FUNDC1	0	10	0	3	145.2	290.4	15	1	1	NA	1	0	3	10
FUNDC2	0	7	2	0	137.28	274.56	15	1	0.0277777777777778	-Inf	0.761210061313465	-1	2	7
FUT10	9	18	1	1	471.24	942.48	15	1	1	-1	1	-0.166666666666667	2	27
FUT11	9	18	1	4	419.76	839.52	15	1	1	0.5	1	0.133333333333333	5	27
FUT4	4	12	3	2	264	528	15	1	0.280013759889921	-3.5	1	-0.35	5	16
FUT7	9	20	0	2	344.52	689.04	15	1	1	1	1	0.310344827586207	2	29
FUT8	2	4	1	1	276.54	553.08	15	1	1	-1	1	-0.166666666666667	2	6
FUT9	0	13	0	2	356.4	712.8	15	1	1	NA	1	0	2	13
FXN	6	4	0	0	121.77	243.54	15	1	1	NA	1	NA	0	10
FXR1	1	20	0	3	643.17	1286.34	15	1	1	1	1	0.0476190476190476	3	21
FXYD6	5	6	1	3	293.04	586.08	15	1	0.604395604395604	0.6	1	0.204545454545455	4	11
FYB	31	30	1	2	865.92	1731.84	15	1	1	0.516129032258065	1	0.174863387978142	3	61
FYCO1	47	45	14	8	1530.54	3061.08	15	1	0.3459443444884	-0.675531914893617	1	-0.125494071146245	22	92
FYN	0	11	4	8	529.65	1059.3	15	1	0.093167701863354	-Inf	0.958791526417971	-0.333333333333333	12	11
FYTTD1	5	10	4	0	304.26	608.52	15	1	0.0325077399380804	-Inf	0.784275503573749	-0.666666666666667	4	15
FYTTD1L	7	7	6	1	270.93	541.86	15	1	0.173581011351909	-5	1	-0.357142857142857	7	14
FZD1	2	32	0	6	532.95	1065.9	15	1	1	1	1	0.0588235294117647	6	34
FZD10	1	12	1	2	578.49	1156.98	15	1	0.35	-5	1	-0.256410256410256	3	13
FZD3	3	29	1	8	660.33	1320.66	15	1	1	-0.208333333333333	1	-0.0173611111111111	9	32
FZD4	0	14	0	1	438.57	877.14	15	1	1	NA	1	0	1	14
FZD5	2	20	0	2	500.28	1000.56	15	1	1	1	1	0.0909090909090909	2	22
FZD6	6	35	2	5	700.92	1401.84	15	1	0.329740296061317	-1.33333333333333	1	-0.139372822299652	7	41
FZD7	2	26	0	3	528.66	1057.32	15	1	1	1	1	0.0714285714285714	3	28
FZD8	1	26	0	1	558.03	1116.06	15	1	1	1	1	0.037037037037037	1	27
FZD9	6	38	0	0	528.33	1056.66	15	1	1	NA	1	NA	0	44
FZR1	0	18	0	8	489.06	978.12	15	1	1	NA	1	0	8	18
G0S2	0	6	0	1	99.99	199.98	15	1	1	NA	1	0	1	6
G2E3	17	23	0	1	736.56	1473.12	15	1	1	1	1	0.425	1	40
G3BP1	0	11	0	2	461.34	922.68	15	1	1	NA	1	0	2	11
G3BP2	0	18	0	7	444.18	888.36	15	1	1	NA	1	0	7	18
G6PC	10	20	6	11	346.17	692.34	15	1	1	-0.0909090909090908	1	-0.0196078431372549	17	30
G6PC2	5	13	1	1	352.44	704.88	15	1	0.521052631578947	-1.6	1	-0.222222222222222	2	18
GAA	13	32	14	22	711.48	1422.96	15	1	0.355607347209205	-0.566433566433566	1	-0.1	36	45
GAAGSD	23	52	6	11	887.37	1774.74	15	1	0.775186677407964	-0.233201581027668	1	-0.0462745098039216	17	75
GAB2	15	52	4	10	695.31	1390.62	15	1	0.729875493007019	-0.386666666666667	1	-0.0618336886993603	14	67
GAB3	5	20	1	8	515.79	1031.58	15	1	1	0.5	1	0.0888888888888889	9	25
GABARAPL1	0	3	0	0	83.49	166.98	15	1	1	NA	1	NA	0	3
GABBR2	4	12	0	3	348.48	696.96	15	1	1	1	1	0.25	3	16
GABPA	0	12	0	0	450.45	900.9	15	1	1	NA	1	NA	0	12
GABPB1	0	13	0	2	380.16	760.32	15	1	1	NA	1	0	2	13
GABPB2	14	24	0	2	402.27	804.54	15	1	0.533333333333333	1	1	0.368421052631579	2	38
GABRA1	1	18	1	2	468.27	936.54	15	1	0.25974025974026	-8	1	-0.280701754385965	3	19
GABRA2	0	14	0	0	375.87	751.74	15	1	1	NA	1	NA	0	14
GABRA3	1	13	0	4	456.39	912.78	15	1	1	1	1	0.0714285714285714	4	14
GABRA4	1	10	0	0	522.39	1044.78	15	1	1	NA	1	NA	0	11
GABRA6	2	8	1	3	358.05	716.1	15	1	1	-0.333333333333333	1	-0.05	4	10
GABRD	1	11	0	2	447.48	894.96	15	1	1	1	1	0.0833333333333333	2	12
GABRE	0	18	0	1	431.97	863.94	15	1	1	NA	1	0	1	18
GABRG1	3	7	2	0	728.64	1457.28	15	1	0.151515151515152	-Inf	1	-0.7	2	10
GABRP	12	23	2	3	419.1	838.2	15	1	1	-0.277777777777778	1	-0.0571428571428572	5	35
GABRR1	2	17	1	9	450.45	900.9	15	1	1	0.0555555555555556	1	0.00526315789473683	10	19
GABRR2	10	17	5	3	484.11	968.22	15	1	0.246359591465264	-1.83333333333333	1	-0.25462962962963	8	27
GABRR3	3	15	3	3	465.3	930.6	15	1	0.139112603643496	-4	1	-0.333333333333333	6	18
GAD1	2	19	0	3	583.77	1167.54	15	1	1	1	1	0.0952380952380952	3	21
GAD2	0	17	1	5	491.7	983.4	15	1	0.260869565217391	-Inf	1	-0.166666666666667	6	17
GADD45A	6	4	2	0	63.69	127.38	15	1	0.515151515151515	-Inf	1	-0.4	2	10
GADD45G	1	7	7	2	158.4	316.8	15	1	0.0152200740436035	-23.5	0.642329698273754	-0.652777777777778	9	8
GADL1	3	12	2	1	463.32	926.64	15	1	0.171568627450981	-7	1	-0.466666666666667	3	15
GAK	44	40	5	3	1089	2178	15	1	0.719087151500489	-0.515151515151515	1	-0.101190476190476	8	84
GAL	2	1	0	0	114.84	229.68	15	1	1	NA	1	NA	0	3
GAL3ST2	21	25	2	3	477.18	954.36	15	1	1	0.206349206349206	1	0.0565217391304347	5	46
GAL3ST4	27	22	6	7	648.45	1296.9	15	1	0.755748730496287	0.301587301587302	1	0.0894819466248037	13	49
GALC	2	14	1	1	622.71	1245.42	15	1	0.313725490196078	-6	1	-0.375	2	16
GALE	4	21	1	0	184.14	368.28	15	1	0.192307692307692	-Inf	1	-0.84	1	25
GALK1	9	25	8	3	376.86	753.72	15	1	0.0109215105184893	-6.40740740740741	0.585928868752023	-0.462566844919786	11	34
GALK2	5	8	2	1	439.23	878.46	15	1	0.55	-2.2	1	-0.282051282051282	3	13
GALM	6	14	3	6	328.02	656.04	15	1	1	-0.166666666666667	1	-0.0333333333333333	9	20
GALNT1	0	18	0	2	524.7	1049.4	15	1	1	NA	1	0	2	18
GALNT10	1	20	1	3	556.38	1112.76	15	1	0.3	-5.66666666666667	1	-0.202380952380952	4	21
GALNT11	3	26	0	6	602.91	1205.82	15	1	1	1	1	0.103448275862069	6	29
GALNT12	2	19	1	0	510.51	1021.02	15	1	0.136363636363636	-Inf	1	-0.904761904761905	1	21
GALNT13	7	34	3	7	532.95	1065.9	15	1	0.389318936411422	-1.08163265306122	1	-0.129268292682927	10	41
GALNT14	4	22	3	2	521.73	1043.46	15	1	0.0619206525769373	-7.25	0.876180863544705	-0.446153846153846	5	26
GALNT15	13	23	5	8	604.89	1209.78	15	1	1	-0.105769230769231	1	-0.0235042735042735	13	36
GALNT16	2	14	3	2	497.97	995.94	15	1	0.0629514963880289	-9.5	0.878646123461792	-0.475	5	16
GALNT2	1	15	2	1	523.71	1047.42	15	1	0.0505675954592363	-29	0.840481137782937	-0.604166666666667	3	16
GALNT3	9	20	1	0	626.67	1253.34	15	1	0.333333333333333	-Inf	1	-0.689655172413793	1	29
GALNT5	5	25	3	7	451.77	903.54	15	1	0.387841260906276	-1.14285714285714	1	-0.133333333333333	10	30
GALNT7	7	23	2	0	622.38	1244.76	15	1	0.0725806451612903	-Inf	0.911545360143491	-0.766666666666667	2	30
GALNT9	11	31	0	8	729.3	1458.6	15	1	0.173678303281384	1	1	0.261904761904762	8	42
GALNTL6	2	12	0	0	421.74	843.48	15	1	1	NA	1	NA	0	14
GALR1L	12	25	4	4	465.96	931.92	15	1	0.427031457362532	-1.08333333333333	1	-0.175675675675676	8	37
GALR2	3	8	4	6	303.93	607.86	15	1	0.659442724458204	-0.777777777777778	1	-0.127272727272727	10	11
GALR3	7	6	3	4	297.99	595.98	15	1	1	0.357142857142857	1	0.10989010989011	7	13
GALT	3	5	3	0	173.25	346.5	15	1	0.181818181818182	-Inf	1	-0.625	3	8
GAMT	0	3	1	1	154.44	308.88	15	1	0.4	-Inf	1	-0.5	2	3
GAN	0	24	0	1	592.02	1184.04	15	1	1	NA	1	0	1	24
GANC	15	17	3	3	783.75	1567.5	15	1	1	-0.133333333333333	1	-0.03125	6	32
GAP43	3	5	4	5	273.9	547.8	15	1	1	-0.333333333333333	1	-0.0694444444444444	9	8
GAPDH	0	9	1	14	316.47	632.94	15	1	1	-Inf	1	-0.0666666666666667	15	9
GAPVD1	0	54	2	13	1399.53	2799.06	15	1	0.0447570332480818	-Inf	0.822543273817637	-0.133333333333333	15	54
GAR1	7	10	1	3	195.03	390.06	15	1	1	0.523809523809524	1	0.161764705882353	4	17
GAREM1	7	32	2	4	817.74	1635.48	15	1	0.583437322745321	-1.28571428571429	1	-0.153846153846154	6	39
GAREM2	4	10	7	16	450.45	900.9	15	1	1	-0.09375	1	-0.0186335403726708	23	14
GARNL3	19	31	26	21	975.15	1950.3	15	1	0.10535966964028	-1.02005012531328	0.983519885969203	-0.173191489361702	47	50
GARS	3	20	0	5	647.46	1294.92	15	1	1	1	1	0.130434782608696	5	23
GART	12	37	9	5	1011.78	2023.56	15	1	0.00927287639180901	-4.55	0.565270798227953	-0.397959183673469	14	49
GART-B	20	32	4	9	1025.64	2051.28	15	1	0.752684707141648	0.288888888888889	1	0.0769230769230769	13	52
GAS2	3	7	0	1	302.61	605.22	15	1	1	1	1	0.3	1	10
GAS2L2	3	5	6	2	170.28	340.56	15	1	0.314685314685315	-4	1	-0.375	8	8
GAS2L3	22	25	1	3	724.68	1449.36	15	1	0.617310924369748	0.621212121212121	1	0.218085106382979	4	47
GAS6	9	29	2	9	638.88	1277.76	15	1	1	0.283950617283951	1	0.0550239234449761	11	38
GASTL	13	11	4	6	358.38	716.76	15	1	0.707985303535915	0.435897435897436	1	0.141666666666667	10	24
GATA4	0	5	2	6	236.61	473.22	15	1	0.487179487179487	-Inf	1	-0.25	8	5
GATA5	1	4	1	2	176.22	352.44	15	1	1	-1	1	-0.133333333333333	3	5
GATA6	0	13	1	4	372.24	744.48	15	1	0.277777777777778	-Inf	1	-0.2	5	13
GATAD1	0	6	2	0	215.16	430.32	15	1	0.0357142857142857	-Inf	0.788199921465956	-1	2	6
GATB	10	8	2	1	511.83	1023.66	15	1	1	-0.6	1	-0.111111111111111	3	18
GATM	2	9	0	1	419.76	839.52	15	1	1	1	1	0.181818181818182	1	11
GATSL2	5	12	1	5	353.43	706.86	15	1	1	0.52	1	0.127450980392157	6	17
GBA2	20	36	9	12	890.67	1781.34	15	1	0.604457252111024	-0.35	1	-0.0714285714285714	21	56
GBAS	1	3	0	2	253.77	507.54	15	1	1	1	1	0.25	2	4
GBE	13	12	1	3	321.09	642.18	15	1	0.597701149425287	0.692307692307692	1	0.27	4	25
GBE1	8	18	2	3	647.79	1295.58	15	1	1	-0.5	1	-0.0923076923076923	5	26
GBF1	6	51	2	16	1791.57	3583.14	15	1	1	-0.0625	1	-0.00584795321637427	18	57
GBGT1	6	15	4	1	338.58	677.16	15	1	0.0549103070842202	-9	0.846060006968071	-0.514285714285714	5	21
GBP7-LOC112531454-LOC112531455	44	43	3	1	598.29	1196.58	15	1	0.617376630859777	-1.93181818181818	1	-0.244252873563218	4	87
GBX1	0	3	0	0	204.6	409.2	15	1	1	NA	1	NA	0	3
GBX2	1	6	0	0	154.11	308.22	15	1	1	NA	1	NA	0	7
GC	11	34	0	4	479.82	959.64	15	1	0.562026845890993	1	1	0.244444444444444	4	45
GCAT	1	13	1	6	307.89	615.78	15	1	1	-1.16666666666667	1	-0.0714285714285714	7	14
GCC1	25	37	13	16	770.55	1541.1	15	1	0.819970743370209	-0.2025	1	-0.0450500556173526	29	62
GCC2	56	54	15	5	1647.36	3294.72	15	1	0.0536573526101759	-1.89285714285714	0.846060006968071	-0.240909090909091	20	110
GCG	1	3	1	0	204.93	409.86	15	1	0.4	-Inf	1	-0.75	1	4
GCGR	3	28	4	7	494.01	988.02	15	1	0.0634891828730083	-4.33333333333333	0.879809916506555	-0.266862170087977	11	31
GCH1	1	6	1	2	219.45	438.9	15	1	1	-2	1	-0.19047619047619	3	7
GCHFR	3	7	2	0	72.27	144.54	15	1	0.151515151515152	-Inf	1	-0.7	2	10
GCLC	2	21	0	4	593.67	1187.34	15	1	1	1	1	0.0869565217391304	4	23
GCLM	1	7	2	1	245.19	490.38	15	1	0.151515151515152	-13	1	-0.541666666666667	3	8
GCM1	13	23	7	6	348.81	697.62	15	1	0.331431460856039	-1.06410256410256	1	-0.177350427350427	13	36
GCM2	14	26	2	3	469.26	938.52	15	1	1	-0.238095238095238	1	-0.05	5	40
GCNA	35	51	12	4	502.92	1005.84	15	1	0.0144231084581652	-3.37142857142857	0.633043342145649	-0.343023255813953	16	86
GCNT1	4	26	0	0	422.73	845.46	15	1	1	NA	1	NA	0	30
GCNT2	8	20	1	7	369.27	738.54	15	1	0.647844009683963	0.642857142857143	1	0.160714285714286	8	28
GCNT3	29	18	1	4	418.11	836.22	15	1	0.149402068519716	0.844827586206897	1	0.417021276595745	5	47
GCNT4	8	9	2	2	451.44	902.88	15	1	1	-0.125	1	-0.0294117647058824	4	17
GCNT7	10	22	4	0	396.99	793.98	15	1	0.0169934640522876	-Inf	0.674707602339182	-0.6875	4	32
GCOM1	4	17	1	0	458.7	917.4	15	1	0.227272727272727	-Inf	1	-0.80952380952381	1	21
GCSH	3	5	0	4	154.11	308.22	15	1	0.490909090909091	1	1	0.375	4	8
GDA	7	11	0	1	432.63	865.26	15	1	1	1	1	0.388888888888889	1	18
GDAP1	7	12	1	2	340.56	681.12	15	1	1	0.142857142857143	1	0.0350877192982456	3	19
GDAP1L1	3	10	3	3	350.79	701.58	15	1	0.320101724900487	-2.33333333333333	1	-0.269230769230769	6	13
GDAP2	1	19	0	5	491.04	982.08	15	1	1	1	1	0.05	5	20
GDE1	3	10	0	0	249.81	499.62	15	1	1	NA	1	NA	0	13
GDF10	3	18	1	4	363	726	15	1	1	-0.5	1	-0.0571428571428572	5	21
GDF11	0	2	0	0	201.3	402.6	15	1	1	NA	1	NA	0	2
GDF15	5	17	8	16	281.49	562.98	15	1	0.520681884380126	-0.7	1	-0.106060606060606	24	22
GDF2	8	20	5	5	424.71	849.42	15	1	0.262862984550653	-1.5	1	-0.214285714285714	10	28
GDF3	10	12	6	7	369.27	738.54	15	1	1	-0.0285714285714285	1	-0.00699300699300703	13	22
GDF5	4	13	2	3	495.99	991.98	15	1	0.585326953748006	-1.16666666666667	1	-0.164705882352941	5	17
GDF7	5	5	1	5	236.61	473.22	15	1	0.306943056943057	0.8	1	0.333333333333333	6	10
GDF9	10	30	1	8	454.74	909.48	15	1	0.662142093256807	0.625	1	0.138888888888889	9	40
GDPD1	0	8	0	0	309.87	619.74	15	1	1	NA	1	NA	0	8
GDPD2	9	20	5	1	532.29	1064.58	15	1	0.0277514231499051	-10.1111111111111	0.761210061313465	-0.522988505747126	6	29
GDPD4	8	21	1	3	572.88	1145.76	15	1	1	0.125	1	0.0258620689655172	4	29
GDPD5	3	15	3	6	550.44	1100.88	15	1	0.36734569778048	-1.5	1	-0.166666666666667	9	18
GDPGP1	8	5	1	3	129.69	259.38	15	1	0.294117647058823	0.791666666666667	1	0.365384615384615	4	13
GEMIN2	2	10	2	2	261.36	522.72	15	1	0.244505494505494	-4	1	-0.333333333333333	4	12
GEMIN4	30	53	21	21	973.5	1947	15	1	0.177587899145843	-0.766666666666667	1	-0.13855421686747	42	83
GEMIN5	28	50	10	6	1440.78	2881.56	15	1	0.0563174278965127	-1.97619047619048	0.846060006968071	-0.266025641025641	16	78
GEMIN8	5	6	6	1	226.71	453.42	15	1	0.150735294117647	-6.2	1	-0.402597402597403	7	11
GEN1	59	38	3	2	939.51	1879.02	15	1	1	0.0338983050847458	1	0.00824742268041234	5	97
GET4	1	7	0	2	272.58	545.16	15	1	1	1	1	0.125	2	8
GFAP	3	12	3	5	407.88	815.76	15	1	0.621385479509049	-1.4	1	-0.175	8	15
GFER	1	6	0	0	121.77	243.54	15	1	1	NA	1	NA	0	7
GFI1	2	14	1	3	381.48	762.96	15	1	0.508771929824561	-1.33333333333333	1	-0.125	4	16
GFI1B	8	18	3	2	332.64	665.28	15	1	0.31731906704098	-2.375	1	-0.292307692307692	5	26
GFM1	9	37	5	11	732.6	1465.2	15	1	0.487953355702645	-0.868686868686869	1	-0.116847826086957	16	46
GFM2	18	25	5	3	770.22	1540.44	15	1	0.441927409261577	-1.31481481481481	1	-0.206395348837209	8	43
GFOD1	9	23	0	0	352.44	704.88	15	1	1	NA	1	NA	0	32
GFOD2	4	17	1	4	382.14	764.28	15	1	1	-0.0625	1	-0.00952380952380955	5	21
GFPT1	0	28	1	0	672.87	1345.74	15	1	0.0344827586206896	-Inf	0.788199921465956	-1	1	28
GFPT2	2	25	0	2	673.86	1347.72	15	1	1	1	1	0.0740740740740741	2	27
GFRA1	7	6	1	2	362.34	724.68	15	1	1	0.571428571428571	1	0.205128205128205	3	13
GFRA2	3	10	3	8	321.09	642.18	15	1	1	-0.25	1	-0.0419580419580419	11	13
GFRA3	4	12	0	2	404.58	809.16	15	1	1	1	1	0.25	2	16
GFRA4	2	13	2	13	427.68	855.36	15	1	1	0	1	0	15	15
GFRAL	13	12	2	1	395.34	790.68	15	1	1	-0.846153846153846	1	-0.146666666666667	3	25
GGA1	7	35	4	5	528.99	1057.98	15	1	0.0868396813364677	-3	0.951277979139867	-0.277777777777778	9	42
GGA2	23	29	10	11	948.09	1896.18	15	1	0.801364060625527	-0.146245059288538	1	-0.0338827838827839	21	52
GGA3	11	32	5	2	709.5	1419	15	1	0.0273732434694507	-6.27272727272727	0.761210061313465	-0.458471760797342	7	43
GGACT	1	5	0	4	201.96	403.92	15	1	1	1	1	0.166666666666667	4	6
GGCT	2	6	1	2	142.56	285.12	15	1	1	-0.5	1	-0.0833333333333333	3	8
GGGT5L	14	46	3	3	1021.68	2043.36	15	1	0.172165970817478	-2.28571428571429	1	-0.266666666666667	6	60
GGH	13	19	7	0	322.74	645.48	15	1	0.00831600831600832	-Inf	0.54233354502865	-0.59375	7	32
GGNBP2	1	18	2	2	729.3	1458.6	15	1	0.0666290231507622	-17	0.884435842948953	-0.447368421052632	4	19
GGPS1	0	10	1	4	297	594	15	1	0.333333333333333	-Inf	1	-0.2	5	10
GGT7	11	26	1	1	600.27	1200.54	15	1	0.526315789473684	-1.36363636363636	1	-0.202702702702703	2	37
GH	1	8	0	0	212.85	425.7	15	1	1	NA	1	NA	0	9
GHITM	5	17	3	1	343.53	687.06	15	1	0.0721070234113713	-9.2	0.910388883446916	-0.522727272727273	4	22
GHR	3	17	0	0	551.43	1102.86	15	1	1	NA	1	NA	0	20
GHRH	6	11	1	1	166.32	332.64	15	1	1	-0.833333333333333	1	-0.147058823529412	2	17
GHRHR	7	11	3	1	408.87	817.74	15	1	0.293233082706767	-3.71428571428571	1	-0.361111111111111	4	18
GHRHR-LR	5	12	1	1	439.56	879.12	15	1	1	-1.4	1	-0.205882352941176	2	17
GHRL	7	9	3	0	115.83	231.66	15	1	0.210526315789474	-Inf	1	-0.5625	3	16
GHSR	1	8	0	3	347.16	694.32	15	1	1	1	1	0.111111111111111	3	9
GID4	0	9	2	4	153.45	306.9	15	1	0.142857142857143	-Inf	1	-0.333333333333333	6	9
GID8	0	5	0	4	226.71	453.42	15	1	1	NA	1	0	4	5
GIF	20	17	8	18	397.98	795.96	15	1	0.077992357769958	0.622222222222222	0.927455919491027	0.232848232848233	26	37
GIGYF2	3	24	0	1	1125.3	2250.6	15	1	1	1	1	0.111111111111111	1	27
GIMD1	7	10	3	1	217.47	434.94	15	1	0.31077694235589	-3.28571428571429	1	-0.338235294117647	4	17
GIN1	17	14	2	1	520.74	1041.48	15	1	1	-0.647058823529412	1	-0.118279569892473	3	31
GINM1	8	13	2	1	287.1	574.2	15	1	0.550395256916996	-2.25	1	-0.285714285714286	3	21
GINS1	1	7	1	2	135.63	271.26	15	1	0.490909090909091	-2.5	1	-0.208333333333333	3	8
GINS2	3	9	1	1	150.15	300.3	15	1	0.505494505494505	-2	1	-0.25	2	12
GINS3	0	11	0	3	212.85	425.7	15	1	1	NA	1	0	3	11
GINS4	2	7	0	0	219.45	438.9	15	1	1	NA	1	NA	0	9
GIP	4	4	0	0	150.48	300.96	15	1	1	NA	1	NA	0	8
GIPC2	3	5	2	1	258.39	516.78	15	1	0.545454545454546	-2.33333333333333	1	-0.291666666666667	3	8
GIT2	0	25	0	11	704.55	1409.1	15	1	1	NA	1	0	11	25
GJA1	1	15	0	2	378.18	756.36	15	1	1	1	1	0.0625	2	16
GJA3	7	23	3	8	415.14	830.28	15	1	1	-0.232142857142857	1	-0.0393939393939394	11	30
GJA4	5	15	6	11	322.08	644.16	15	1	0.719474758406905	-0.636363636363636	1	-0.102941176470588	17	20
GJA5	5	12	2	8	366.3	732.6	15	1	0.678389243606635	0.4	1	0.0941176470588235	10	17
GJA8	5	10	2	1	396.99	793.98	15	1	0.528186274509804	-3	1	-0.333333333333333	3	15
GJA9	13	28	4	7	513.81	1027.62	15	1	1	-0.230769230769231	1	-0.0465631929046563	11	41
GJB1	4	9	0	1	274.23	548.46	15	1	1	1	1	0.307692307692308	1	13
GJB2	0	6	0	2	223.74	447.48	15	1	1	NA	1	0	2	6
GJB3	1	16	0	5	266.31	532.62	15	1	1	1	1	0.0588235294117647	5	17
GJB5	9	15	2	3	249.15	498.3	15	1	1	-0.111111111111111	1	-0.025	5	24
GJB6	0	9	0	4	261.36	522.72	15	1	1	NA	1	0	4	9
GJC1	2	5	0	0	390.06	780.12	15	1	1	NA	1	NA	0	7
GJC2	0	18	1	12	411.84	823.68	15	1	0.419354838709678	-Inf	1	-0.0769230769230769	13	18
GJD2	0	13	0	2	275.22	550.44	15	1	1	NA	1	0	2	13
GJD4	14	18	3	0	411.84	823.68	15	1	0.103896103896104	-Inf	0.983379501385042	-0.5625	3	32
GK	4	19	0	0	470.25	940.5	15	1	1	NA	1	NA	0	23
GK5	12	12	4	6	472.89	945.78	15	1	0.714591970876732	0.333333333333333	1	0.1	10	24
GKAP1	18	10	0	0	365.97	731.94	15	1	1	NA	1	NA	0	28
GKN1	26	9	1	1	287.1	574.2	15	1	0.472972972972973	0.653846153846154	1	0.242857142857143	2	35
GKN2	3	8	1	0	182.16	364.32	15	1	0.333333333333333	-Inf	1	-0.727272727272727	1	11
GLA	6	10	3	3	300.96	601.92	15	1	0.655019902697921	-0.666666666666667	1	-0.125	6	16
GLB1L	4	21	3	3	233.64	467.28	15	1	0.11002728577812	-4.25	0.98538656216834	-0.34	6	25
GLB1L2	6	33	5	10	627.99	1255.98	15	1	0.255774653486852	-1.75	1	-0.179487179487179	15	39
GLCCI1	4	5	1	0	433.29	866.58	15	1	1	-Inf	1	-0.555555555555556	1	9
GLCE	5	28	4	10	634.59	1269.18	15	1	0.418844445097421	-1.24	1	-0.134199134199134	14	33
GLDC	16	34	3	3	1022.01	2044.02	15	1	0.397084048027444	-1.125	1	-0.18	6	50
GLDN	7	14	3	6	518.76	1037.52	15	1	1	0	1	0	9	21
GLE1	19	30	5	1	695.97	1391.94	15	1	0.0754924296322742	-6.89473684210526	0.916693788391901	-0.445578231292517	6	49
GLI1	30	45	4	2	1241.79	2483.58	15	1	0.231998874986883	-2	1	-0.266666666666667	6	75
GLI2	19	50	2	9	1459.92	2919.84	15	1	0.718521868679211	0.415204678362573	1	0.0935441370223979	11	69
GLIPR1L	18	17	5	2	411.84	823.68	15	1	0.427507479336748	-1.36111111111111	1	-0.2	7	35
GLIPR2	0	9	0	1	153.45	306.9	15	1	1	NA	1	0	1	9
GLIS3	38	24	4	3	638.88	1277.76	15	1	1	0.157894736842105	1	0.0414746543778802	7	62
GLMN	15	30	1	1	629.64	1259.28	15	1	1	-1	1	-0.166666666666667	2	45
GLMP	19	23	0	1	368.28	736.56	15	1	1	1	1	0.452380952380952	1	42
GLO1	3	9	1	2	171.6	343.2	15	1	1	-0.5	1	-0.0833333333333333	3	12
GLOD4	4	16	2	4	266.31	532.62	15	1	0.595951874212744	-1	1	-0.133333333333333	6	20
GLOD5	9	10	2	0	148.5	297	15	1	0.476190476190476	-Inf	1	-0.526315789473684	2	19
GLP1R	2	10	0	2	522.72	1045.44	15	1	1	1	1	0.166666666666667	2	12
GLP2R	11	3	1	1	216.81	433.62	15	1	0.45	0.727272727272727	1	0.285714285714286	2	14
GLRA1	0	10	4	4	439.23	878.46	15	1	0.0228758169934641	-Inf	0.732390215148836	-0.5	8	10
GLRA3	4	6	0	1	437.58	875.16	15	1	1	1	1	0.4	1	10
GLRA4	1	19	4	15	410.85	821.7	15	1	0.181764181764182	-4.06666666666667	1	-0.160526315789474	19	20
GLRB	4	11	0	1	462.99	925.98	15	1	1	1	1	0.266666666666667	1	15
GLRX	5	10	1	3	98.01	196.02	15	1	1	0.333333333333333	1	0.0833333333333333	4	15
GLRX2	1	10	0	1	121.11	242.22	15	1	1	1	1	0.0909090909090909	1	11
GLRX3	0	14	2	2	302.28	604.56	15	1	0.0392156862745098	-Inf	0.794052121283243	-0.5	4	14
GLRX5	0	7	0	0	103.29	206.58	15	1	1	NA	1	NA	0	7
GLS	0	18	0	1	534.93	1069.86	15	1	1	NA	1	0	1	18
GLT1D1	10	17	1	0	402.93	805.86	15	1	0.392857142857143	-Inf	1	-0.62962962962963	1	27
GLT8D1	5	18	1	7	369.27	738.54	15	1	1	0.485714285714286	1	0.0923913043478261	8	23
GLT8D2	0	12	2	3	347.49	694.98	15	1	0.0735294117647058	-Inf	0.913861472365723	-0.4	5	12
GLTP	1	7	1	6	112.86	225.72	15	1	1	-0.166666666666667	1	-0.0178571428571428	7	8
GLTSCR1L	14	33	2	3	1079.1	2158.2	15	1	0.637362637362637	-0.571428571428571	1	-0.102127659574468	5	47
GLUD1	0	13	0	0	428.67	857.34	15	1	1	NA	1	NA	0	13
GLUL	0	15	1	10	370.26	740.52	15	1	0.423076923076923	-Inf	1	-0.0909090909090909	11	15
GLYCTK	18	22	8	1	501.93	1003.86	15	1	0.0256137091155116	-8.77777777777778	0.761210061313465	-0.438888888888889	9	40
GLYR1	9	14	1	3	580.8	1161.6	15	1	1	0.481481481481482	1	0.141304347826087	4	23
GM2A	1	4	2	3	200.31	400.62	15	1	1	-1.66666666666667	1	-0.2	5	5
GMCL1	1	30	1	6	435.27	870.54	15	1	0.338549075391181	-4	1	-0.110599078341014	7	31
GMEB2	3	20	2	9	514.47	1028.94	15	1	1	-0.481481481481481	1	-0.0513833992094862	11	23
GMFB	2	1	3	0	117.81	235.62	15	1	1	-Inf	1	-0.333333333333333	3	3
GMNC	12	10	0	0	278.85	557.7	15	1	1	NA	1	NA	0	22
GMNN	14	11	3	3	230.67	461.34	15	1	1	0.214285714285714	1	0.0600000000000001	6	25
GMPPA	3	12	1	1	287.1	574.2	15	1	0.426470588235294	-3	1	-0.3	2	15
GMPR	41	17	21	6	531.63	1063.26	15	1	0.604178885598277	-0.451219512195122	1	-0.0708812260536399	27	58
GMPS	1	30	2	4	688.05	1376.1	15	1	0.0624195624195624	-14	0.878102185642472	-0.301075268817204	6	31
GMSRAL	29	9	2	1	381.15	762.3	15	1	1	0.379310344827586	1	0.0964912280701755	3	38
GNA11	1	17	1	0	429.33	858.66	15	1	0.105263157894737	-Inf	0.983379501385042	-0.944444444444444	1	18
GNA12	0	5	0	2	285.12	570.24	15	1	1	NA	1	0	2	5
GNA13	0	8	0	3	374.22	748.44	15	1	1	NA	1	0	3	8
GNAI2	0	10	1	3	251.79	503.58	15	1	0.285714285714286	-Inf	1	-0.25	4	10
GNAO1	0	11	0	7	298.32	596.64	15	1	1	NA	1	0	7	11
GNAQ	5	9	1	0	331.98	663.96	15	1	0.4	-Inf	1	-0.642857142857143	1	14
GNAT1	0	2	0	0	99.33	198.66	15	1	1	NA	1	NA	0	2
GNAT2	0	7	1	5	338.25	676.5	15	1	0.461538461538462	-Inf	1	-0.166666666666667	6	7
GNAT3	4	15	2	0	351.45	702.9	15	1	0.0714285714285714	-Inf	0.908058284769907	-0.789473684210526	2	19
GNB1	0	4	0	0	337.59	675.18	15	1	1	NA	1	NA	0	4
GNB1L	9	12	5	4	325.71	651.42	15	1	0.694392803598201	-0.666666666666667	1	-0.126984126984127	9	21
GNB4	0	12	0	2	337.59	675.18	15	1	1	NA	1	0	2	12
GNB5	0	11	0	0	359.04	718.08	15	1	1	NA	1	NA	0	11
GNE	1	31	1	3	714.45	1428.9	15	1	0.212698412698413	-9.33333333333333	1	-0.21875	4	32
GNG10	0	4	0	0	46.53	93.06	15	1	1	NA	1	NA	0	4
GNG11	0	1	0	1	69.96	139.92	15	1	1	NA	1	0	1	1
GNG12	1	6	1	1	73.26	146.52	15	1	0.416666666666667	-5	1	-0.357142857142857	2	7
GNG13	0	5	0	1	66.66	133.32	15	1	1	NA	1	0	1	5
GNG2	0	1	0	2	71.28	142.56	15	1	1	NA	1	0	2	1
GNG4	0	2	1	0	74.25	148.5	15	1	0.333333333333333	-Inf	1	-1	1	2
GNG5	0	1	0	1	41.58	83.16	15	1	1	NA	1	0	1	1
GNGT2	2	2	0	1	68.31	136.62	15	1	1	1	1	0.5	1	4
GNL2	17	24	5	9	697.95	1395.9	15	1	0.762047346179309	0.215686274509804	1	0.0574912891986062	14	41
GNL3	33	28	4	5	537.57	1075.14	15	1	0.725727549543254	0.321212121212121	1	0.0965391621129327	9	61
GNOT2	2	2	2	0	78.54	157.08	15	1	0.466666666666667	-Inf	1	-0.5	2	4
GNPAT	13	26	3	6	652.41	1304.82	15	1	1	0	1	0	9	39
GNPDA1	0	8	0	1	254.43	508.86	15	1	1	NA	1	0	1	8
GNPDA2	0	7	0	0	273.24	546.48	15	1	1	NA	1	NA	0	7
GNPNAT1	0	15	1	3	189.09	378.18	15	1	0.210526315789474	-Inf	1	-0.25	4	15
GNPTAB	14	45	5	4	1452.99	2905.98	15	1	0.103106233760594	-3.01785714285714	0.983165897366278	-0.318267419962335	9	59
GNPTG	5	5	1	2	286.44	572.88	15	1	1	0.5	1	0.166666666666667	3	10
GNRH1	3	2	2	0	92.07	184.14	15	1	1	-Inf	1	-0.4	2	5
GNRHR	4	5	2	11	329.01	658.02	15	1	0.177797434763379	0.772727272727273	1	0.290598290598291	13	9
GNS	7	35	3	8	526.68	1053.36	15	1	0.415538650137939	-0.875	1	-0.106060606060606	11	42
GOLGA1	16	25	3	5	797.94	1595.88	15	1	1	0.0625	1	0.0152439024390244	8	41
GOLGA2	12	25	3	1	829.62	1659.24	15	1	0.130295250320924	-5.25	1	-0.425675675675676	4	37
GOLGA3	25	56	8	8	1497.87	2995.74	15	1	0.157740596334571	-1.24	1	-0.191358024691358	16	81
GOLGA4	77	67	18	10	2206.05	4412.1	15	1	0.308868343547593	-0.566233766233766	1	-0.108134920634921	28	144
GOLGA5	10	23	6	5	729.63	1459.26	15	1	0.169430401972737	-1.76	1	-0.242424242424242	11	33
GOLGA7	0	2	0	0	132.33	264.66	15	1	1	NA	1	NA	0	2
GOLGA7B	0	6	0	1	67.32	134.64	15	1	1	NA	1	0	1	6
GOLGB1	132	92	17	13	3411.21	6822.42	15	1	0.845150548313603	0.0885780885780886	1	0.0226190476190476	30	224
GOLM1	9	12	1	0	386.1	772.2	15	1	0.454545454545454	-Inf	1	-0.571428571428571	1	21
GOLPH3L	26	32	7	12	641.85	1283.7	15	1	0.601817379900359	0.282051282051282	1	0.0798548094373866	19	58
GOLT1B	0	6	0	0	131.01	262.02	15	1	1	NA	1	NA	0	6
GON4L	49	75	3	13	2139.39	4278.78	15	1	0.167866564711397	0.646781789638933	1	0.207661290322581	16	124
GOPC	0	10	0	2	367.29	734.58	15	1	1	NA	1	0	2	10
GORAB	15	19	5	8	340.56	681.12	15	1	1	0.208333333333333	1	0.0565610859728506	13	34
GORASP1	16	18	6	4	402.93	805.86	15	1	0.720512781204784	-0.6875	1	-0.129411764705882	10	34
GORASP2	3	18	1	3	404.91	809.82	15	1	0.526877470355731	-1	1	-0.107142857142857	4	21
GOSR1	8	7	1	1	196.02	392.04	15	1	1	0.125	1	0.0333333333333333	2	15
GOSR2	0	8	0	2	202.29	404.58	15	1	1	NA	1	0	2	8
GOT1	3	19	0	3	329.67	659.34	15	1	1	1	1	0.136363636363636	3	22
GP1BA-LOC101750889	37	27	4	6	693.66	1387.32	15	1	0.325573368457259	0.513513513513513	1	0.178125	10	64
GP1BB	3	4	3	2	196.02	392.04	15	1	1	-1	1	-0.171428571428571	5	7
GPA33	13	8	3	0	289.08	578.16	15	1	0.525691699604743	-Inf	1	-0.380952380952381	3	21
GPALPP1	33	24	5	8	582.12	1164.24	15	1	0.232325358034803	0.545454545454545	1	0.194331983805668	13	57
GPAM	3	30	1	3	814.11	1628.22	15	1	0.380422439245969	-2.33333333333333	1	-0.159090909090909	4	33
GPAT3	0	12	0	7	395.01	790.02	15	1	1	NA	1	0	7	12
GPAT4	0	10	0	3	451.44	902.88	15	1	1	NA	1	0	3	10
GPATCH1	24	26	2	2	942.48	1884.96	15	1	1	-0.0833333333333333	1	-0.02	4	50
GPATCH11	3	8	1	1	237.93	475.86	15	1	1	-1.66666666666667	1	-0.227272727272727	2	11
GPATCH2L	4	16	3	3	480.15	960.3	15	1	0.292915779872302	-3	1	-0.3	6	20
GPATCH3	12	22	4	6	377.52	755.04	15	1	1	-0.222222222222222	1	-0.0470588235294118	10	34
GPATCH4	3	8	1	5	140.91	281.82	15	1	1	0.466666666666667	1	0.106060606060606	6	11
GPATCH8	30	71	8	8	1400.19	2800.38	15	1	0.1496565015175	-1.36666666666667	1	-0.202970297029703	16	101
GPBP1	3	10	1	3	345.18	690.36	15	1	1	-0.111111111111111	1	-0.0192307692307692	4	13
GPBP1L1	4	11	0	2	467.28	934.56	15	1	1	1	1	0.266666666666667	2	15
GPC1	5	16	2	0	450.45	900.9	15	1	0.08300395256917	-Inf	0.949431371776132	-0.761904761904762	2	21
GPC2	17	9	1	1	306.57	613.14	15	1	1	0.470588235294118	1	0.153846153846154	2	26
GPC3	14	15	3	0	490.05	980.1	15	1	0.22883064516129	-Inf	1	-0.517241379310345	3	29
GPC4	1	21	0	3	530.64	1061.28	15	1	1	1	1	0.0454545454545455	3	22
GPC5	7	3	0	0	98.67	197.34	15	1	1	NA	1	NA	0	10
GPCPD1	3	33	2	3	672.21	1344.42	15	1	0.103924750266214	-6.33333333333333	0.983379501385042	-0.316666666666667	5	36
GPD1L	1	11	0	4	344.85	689.7	15	1	1	1	1	0.0833333333333333	4	12
GPD1L2	5	9	0	2	346.5	693	15	1	1	1	1	0.357142857142857	2	14
GPD2	1	19	1	7	720.72	1441.44	15	1	0.497354497354497	-1.71428571428571	1	-0.075	8	20
GPER1	0	8	0	1	354.42	708.84	15	1	1	NA	1	0	1	8
GPHB5	2	12	0	3	129.69	259.38	15	1	1	1	1	0.142857142857143	3	14
GPI	0	23	0	0	539.55	1079.1	15	1	1	NA	1	NA	0	23
GPLD1	22	29	6	5	827.64	1655.28	15	1	0.523237311037243	-0.581818181818182	1	-0.114081996434938	11	51
GPM6A	0	6	3	2	418.11	836.22	15	1	0.0606060606060606	-Inf	0.870851370851371	-0.6	5	6
GPN1	7	15	2	2	371.58	743.16	15	1	0.590635451505017	-1.14285714285714	1	-0.181818181818182	4	22
GPN2	1	8	0	2	309.87	619.74	15	1	1	1	1	0.111111111111111	2	9
GPN3	2	14	1	4	430.98	861.96	15	1	1	-0.75	1	-0.075	5	16
GPNMB	11	20	5	7	554.4	1108.8	15	1	0.73657857408202	-0.298701298701299	1	-0.0618279569892473	12	31
GPR1	2	11	0	1	347.49	694.98	15	1	1	1	1	0.153846153846154	1	13
GPR107	10	17	1	3	515.79	1031.58	15	1	1	0.433333333333333	1	0.12037037037037	4	27
GPR119	15	16	0	3	316.8	633.6	15	1	0.237967914438503	1	1	0.483870967741935	3	31
GPR12	0	3	0	1	331.65	663.3	15	1	1	NA	1	0	1	3
GPR135	0	23	1	9	315.48	630.96	15	1	0.303030303030303	-Inf	1	-0.1	10	23
GPR137B	2	10	0	2	332.64	665.28	15	1	1	1	1	0.166666666666667	2	12
GPR137C	4	12	0	4	275.22	550.44	15	1	0.537667698658411	1	1	0.25	4	16
GPR139	1	9	0	1	348.15	696.3	15	1	1	1	1	0.1	1	10
GPR141	10	9	1	2	343.53	687.06	15	1	1	0.55	1	0.192982456140351	3	19
GPR142	3	7	3	2	188.76	377.52	15	1	0.328671328671329	-2.5	1	-0.3	5	10
GPR143	6	18	2	5	389.07	778.14	15	1	1	-0.2	1	-0.0357142857142857	7	24
GPR146	2	9	1	0	330.66	661.32	15	1	0.25	-Inf	1	-0.818181818181818	1	11
GPR148	8	10	1	0	349.47	698.94	15	1	0.473684210526316	-Inf	1	-0.555555555555556	1	18
GPR149	15	41	7	9	664.95	1329.9	15	1	0.226334667146984	-1.12592592592593	1	-0.169642857142857	16	56
GPR15	7	27	0	2	366.3	732.6	15	1	1	1	1	0.205882352941176	2	34
GPR153	24	34	4	1	557.7	1115.4	15	1	0.162122891563865	-4.66666666666667	1	-0.386206896551724	5	58
GPR155	10	32	5	4	848.43	1696.86	15	1	0.102245060406109	-3	0.97944276119185	-0.317460317460317	9	42
GPR157	2	12	2	3	323.07	646.14	15	1	0.27218782249742	-3	1	-0.257142857142857	5	14
GPR158	22	37	6	5	1023.66	2047.32	15	1	0.327768190907251	-1.01818181818182	1	-0.172573189522342	11	59
GPR160	10	15	11	4	335.61	671.22	15	1	0.0550480263355681	-3.125	0.846060006968071	-0.333333333333333	15	25
GPR161	3	17	1	3	520.74	1041.48	15	1	0.544042913608131	-0.888888888888889	1	-0.1	4	20
GPR162	2	29	2	4	563.31	1126.62	15	1	0.115224468165645	-6.25	1	-0.268817204301075	6	31
GPR17	2	7	0	3	341.55	683.1	15	1	1	1	1	0.222222222222222	3	9
GPR174	3	15	2	5	325.71	651.42	15	1	0.596837944664032	-1	1	-0.119047619047619	7	18
GPR18	4	20	0	6	318.78	637.56	15	1	0.556869184455391	1	1	0.166666666666667	6	24
GPR180	4	5	5	1	365.31	730.62	15	1	0.286713286713287	-5.25	1	-0.388888888888889	6	9
GPR182	6	13	0	0	361.35	722.7	15	1	1	NA	1	NA	0	19
GPR183,UBAC2	2	1	1	0	352.44	704.88	15	1	1	-Inf	1	-0.333333333333333	1	3
GPR19	8	12	1	0	411.84	823.68	15	1	0.428571428571429	-Inf	1	-0.6	1	20
GPR20	2	11	1	2	352.44	704.88	15	1	0.489285714285714	-1.75	1	-0.179487179487179	3	13
GPR21	0	11	1	2	345.51	691.02	15	1	0.214285714285714	-Inf	1	-0.333333333333333	3	11
GPR22	0	9	2	4	429.66	859.32	15	1	0.142857142857143	-Inf	1	-0.333333333333333	6	9
GPR26	1	7	0	2	334.62	669.24	15	1	1	1	1	0.125	2	8
GPR34L	7	8	4	3	334.62	669.24	15	1	1	-0.523809523809524	1	-0.104761904761905	7	15
GPR35	15	15	2	3	306.9	613.8	15	1	1	0.333333333333333	1	0.1	5	30
GPR35L	19	10	2	0	312.84	625.68	15	1	1	-Inf	1	-0.344827586206897	2	29
GPR37	1	24	0	3	357.06	714.12	15	1	1	1	1	0.04	3	25
GPR37L1	5	8	4	9	447.15	894.3	15	1	1	0.288888888888889	1	0.0769230769230769	13	13
GPR39	9	14	0	3	304.92	609.84	15	1	0.529230769230769	1	1	0.391304347826087	3	23
GPR50	2	11	1	3	290.73	581.46	15	1	1	-0.833333333333333	1	-0.0961538461538461	4	13
GPR52	2	7	2	1	358.38	716.76	15	1	0.236363636363636	-6	1	-0.444444444444444	3	9
GPR55	10	11	0	1	305.91	611.82	15	1	1	1	1	0.476190476190476	1	21
GPR6	1	14	0	5	323.07	646.14	15	1	1	1	1	0.0666666666666667	5	15
GPR62	7	14	2	4	405.9	811.8	15	1	1	0	1	0	6	21
GPR63	0	9	0	0	415.8	831.6	15	1	1	NA	1	NA	0	9
GPR68	9	16	2	4	355.41	710.82	15	1	1	0.111111111111111	1	0.0266666666666667	6	25
GPR78	0	14	0	0	299.31	598.62	15	1	1	NA	1	NA	0	14
GPR83	11	14	7	7	419.76	839.52	15	1	0.749571596067703	-0.272727272727273	1	-0.06	14	25
GPR83L	1	18	3	5	415.8	831.6	15	1	0.0646153846153846	-9.8	0.884435842948953	-0.322368421052632	8	19
GPR87	3	18	1	4	353.43	706.86	15	1	1	-0.5	1	-0.0571428571428572	5	21
GPR89B	1	18	0	1	451.44	902.88	15	1	1	1	1	0.0526315789473684	1	19
GPRC5A	15	12	1	3	353.43	706.86	15	1	0.332591768631813	0.733333333333333	1	0.305555555555556	4	27
GPRC5B	2	14	0	1	384.12	768.24	15	1	1	1	1	0.125	1	16
GPRC5C	7	5	8	11	380.16	760.32	15	1	0.472547597169157	0.480519480519481	1	0.162280701754386	19	12
GPRC6A	12	37	1	4	918.06	1836.12	15	1	1	0.229166666666667	1	0.0448979591836735	5	49
GPRIN1	4	12	6	12	365.31	730.62	15	1	0.714591970876732	-0.5	1	-0.0833333333333333	18	16
GPRIN2	31	27	2	2	599.94	1199.88	15	1	1	0.129032258064516	1	0.0344827586206896	4	58
GPRIN3	55	36	20	15	749.43	1498.86	15	1	0.839855126075523	0.127272727272727	1	0.032967032967033	35	91
GPS1	6	6	1	2	224.07	448.14	15	1	1	0.5	1	0.166666666666667	3	12
GPSM1	3	26	0	8	618.09	1236.18	15	1	1	1	1	0.103448275862069	8	29
GPSM2	5	36	1	3	657.36	1314.72	15	1	0.447961340984597	-1.4	1	-0.128048780487805	4	41
GPT2	3	8	0	2	438.57	877.14	15	1	1	1	1	0.272727272727273	2	11
GPX1	1	5	0	3	116.82	233.64	15	1	1	1	1	0.166666666666667	3	6
GPX3	0	1	1	1	36.3	72.6	15	1	1	-Inf	1	-0.5	2	1
GPX4	0	1	1	1	59.73	119.46	15	1	1	-Inf	1	-0.5	2	1
GPX7	0	6	3	0	208.89	417.78	15	1	0.0119047619047619	-Inf	0.596226042284133	-1	3	6
GPX8	1	11	2	0	208.89	417.78	15	1	0.032967032967033	-Inf	0.784275503573749	-0.916666666666667	2	12
GRAMD1B	4	21	4	5	690.36	1380.72	15	1	0.164758228096578	-3.2	1	-0.284444444444444	9	25
GRAMD1C	6	22	3	5	640.86	1281.72	15	1	0.383727016946935	-1.2	1	-0.160714285714286	8	28
GRAMD3	13	13	1	3	451.44	902.88	15	1	0.601532567049808	0.666666666666667	1	0.25	4	26
GRAMD4	5	24	2	5	660.66	1321.32	15	1	0.601668966706917	-0.92	1	-0.113300492610837	7	29
GRAP	1	4	0	0	188.1	376.2	15	1	1	NA	1	NA	0	5
GRAP2	2	15	0	2	293.04	586.08	15	1	1	1	1	0.117647058823529	2	17
GRB14	12	6	2	1	374.22	748.44	15	1	1	0	1	0	3	18
GRB2	7	4	4	1	262.02	524.04	15	1	1	-1.28571428571429	1	-0.163636363636364	5	11
GRB7	0	1	0	1	100.32	200.64	15	1	1	NA	1	0	1	1
GREB1L	12	75	11	20	1947.33	3894.66	15	1	0.0157576897840014	-2.4375	0.65359215014741	-0.216907675194661	31	87
GREM1	2	11	0	1	183.15	366.3	15	1	1	1	1	0.153846153846154	1	13
GREM2	1	10	0	2	167.31	334.62	15	1	1	1	1	0.0909090909090909	2	11
GRHL1	0	26	1	2	632.61	1265.22	15	1	0.103448275862069	-Inf	0.983165897366278	-0.333333333333333	3	26
GRHL2	2	13	2	7	633.6	1267.2	15	1	0.614624505928854	-0.857142857142857	1	-0.0888888888888889	9	15
GRHL3	11	33	0	0	651.42	1302.84	15	1	1	NA	1	NA	0	44
GRIA1	3	34	0	2	860.64	1721.28	15	1	1	1	1	0.0810810810810811	2	37
GRIA2-GRIA3-GRIA4	0	10	0	4	584.1	1168.2	15	1	1	NA	1	0	4	10
GRIA4	3	19	1	2	741.51	1483.02	15	1	0.421739130434783	-2.16666666666667	1	-0.196969696969697	3	22
GRID2	5	18	3	3	445.5	891	15	1	0.304509283819629	-2.6	1	-0.282608695652174	6	23
GRID2IP	12	26	14	20	1067.88	2135.76	15	1	0.465322890270187	-0.516666666666667	1	-0.0959752321981424	34	38
GRIFIN	0	9	0	1	126.72	253.44	15	1	1	NA	1	0	1	9
GRIK1	1	30	4	5	927.96	1855.92	15	1	0.0061275850749535	-23	0.467685236262114	-0.412186379928315	9	31
GRIK3	2	27	1	11	872.52	1745.04	15	1	1	-0.227272727272727	1	-0.014367816091954	12	29
GRIK4	10	39	14	52	956.67	1913.34	15	1	1	-0.05	1	-0.0080395794681509	66	49
GRIN2A	5	42	4	2	1344.42	2688.84	15	1	0.00543718212974595	-15.8	0.467685236262114	-0.560283687943262	6	47
GRIN2B	13	37	4	10	1305.15	2610.3	15	1	1	-0.138461538461538	1	-0.0257142857142857	14	50
GRIN2C	15	17	21	28	759.66	1519.32	15	1	0.820149301714579	0.15	1	0.0401785714285715	49	32
GRIN3A	31	43	1	4	1052.04	2104.08	15	1	0.643144330685969	0.653225806451613	1	0.218918918918919	5	74
GRIN3B	24	14	9	15	725.34	1450.68	15	1	0.0683116438084688	0.65	0.888803134120932	0.256578947368421	24	38
GRIP1	8	33	6	7	1082.07	2164.14	15	1	0.0752247696137915	-2.53571428571429	0.916285648878989	-0.266416510318949	13	41
GRIP2	13	37	4	8	1056.99	2113.98	15	1	0.721042492152688	-0.423076923076923	1	-0.0733333333333333	12	50
GRK4	1	15	0	2	547.14	1094.28	15	1	1	1	1	0.0625	2	16
GRK5	4	3	0	1	574.2	1148.4	15	1	1	1	1	0.571428571428571	1	7
GRK6	0	18	0	6	553.08	1106.16	15	1	1	NA	1	0	6	18
GRK7	12	17	4	5	640.53	1281.06	15	1	1	-0.133333333333333	1	-0.0306513409961686	9	29
GRM1	9	36	4	7	843.48	1686.96	15	1	0.258683275467519	-1.28571428571429	1	-0.163636363636364	11	45
GRM3	8	61	0	1	934.56	1869.12	15	1	1	1	1	0.115942028985507	1	69
GRM4	2	15	8	24	886.71	1773.42	15	1	0.459039298971788	-1.5	1	-0.132352941176471	32	17
GRM5	9	33	3	6	935.88	1871.76	15	1	0.423653255721754	-0.833333333333333	1	-0.119047619047619	9	42
GRM7	15	42	4	13	817.41	1634.82	15	1	1	0.138461538461538	1	0.0278637770897833	17	57
GRM8	3	13	1	2	324.72	649.44	15	1	0.530443756449948	-1.16666666666667	1	-0.145833333333333	3	16
GRP	1	2	1	0	100.65	201.3	15	1	1	-Inf	1	-0.666666666666667	1	3
GRPEL1	0	13	1	4	197.34	394.68	15	1	0.277777777777778	-Inf	1	-0.2	5	13
GRPEL2	0	6	0	0	200.31	400.62	15	1	1	NA	1	NA	0	6
GRPR	6	19	2	3	397.98	795.96	15	1	0.589350623833382	-1.11111111111111	1	-0.16	5	25
GRSF1	13	21	0	5	337.59	675.18	15	1	0.148772832983359	1	1	0.382352941176471	5	34
GRTP1	2	16	2	7	336.6	673.2	15	1	0.581538461538461	-1.28571428571429	1	-0.111111111111111	9	18
GRXCR1	4	20	1	0	291.06	582.12	15	1	0.2	-Inf	1	-0.833333333333333	1	24
GSAP	24	39	4	6	820.05	1640.1	15	1	1	-0.0833333333333333	1	-0.0190476190476191	10	63
GSC	0	3	0	0	166.98	333.96	15	1	1	NA	1	NA	0	3
GSC2	6	9	0	4	158.4	316.8	15	1	0.255417956656347	1	1	0.4	4	15
GSE1	9	8	4	15	450.78	901.56	15	1	0.0819143551624086	0.762962962962963	0.947249589490969	0.318885448916409	19	17
GSG1	4	15	1	7	312.84	625.68	15	1	1	0.464285714285714	1	0.0855263157894737	8	19
GSG2	27	23	0	2	429.66	859.32	15	1	0.226244343891403	1	1	0.54	2	50
GSK3B	8	9	2	2	386.43	772.86	15	1	1	-0.125	1	-0.0294117647058824	4	17
GSKIP	2	5	0	0	137.61	275.22	15	1	1	NA	1	NA	0	7
GSL	0	18	1	11	364.65	729.3	15	1	0.4	-Inf	1	-0.0833333333333333	12	18
GSN	11	23	0	5	780.45	1560.9	15	1	0.295874822190612	1	1	0.323529411764706	5	34
GSPT1	11	19	1	0	554.4	1108.8	15	1	0.387096774193548	-Inf	1	-0.633333333333333	1	30
GSR	11	39	3	7	454.74	909.48	15	1	0.685056138641569	-0.519480519480519	1	-0.08	10	50
GSTA4L	10	10	2	1	221.76	443.52	15	1	1	-1	1	-0.166666666666667	3	20
GSTAL3	6	14	0	0	227.7	455.4	15	1	1	NA	1	NA	0	20
GSTCD	14	16	5	9	619.74	1239.48	15	1	0.53402263716885	0.365079365079365	1	0.10952380952381	14	30
GSTK1	5	7	2	2	222.75	445.5	15	1	1	-0.4	1	-0.0833333333333333	4	12
GSTM2	2	0	0	0	21.78	43.56	15	1	1	NA	1	NA	0	2
GSTO1	7	12	2	1	233.31	466.62	15	1	0.544155844155844	-2.42857142857143	1	-0.298245614035088	3	19
GSTT1	1	8	2	1	234.96	469.92	15	1	0.127272727272727	-15	1	-0.555555555555556	3	9
GSTT1L	3	8	1	2	240.57	481.14	15	1	1	-0.333333333333333	1	-0.0606060606060606	3	11
GSTZ1	4	11	0	2	208.89	417.78	15	1	1	1	1	0.266666666666667	2	15
GTDC1	14	10	9	2	524.7	1049.4	15	1	0.258982198851989	-2.21428571428571	1	-0.234848484848485	11	24
GTF2A1	0	7	0	0	364.32	728.64	15	1	1	NA	1	NA	0	7
GTF2A1L	13	15	4	4	481.14	962.28	15	1	1	-0.153846153846154	1	-0.0357142857142857	8	28
GTF2B	0	13	0	0	308.22	616.44	15	1	1	NA	1	NA	0	13
GTF2E1L	16	23	9	2	418.77	837.54	15	1	0.0374296615256088	-5.46875	0.789311843512415	-0.407925407925408	11	39
GTF2E2	0	5	0	4	255.09	510.18	15	1	1	NA	1	0	4	5
GTF2F2	1	6	0	1	156.42	312.84	15	1	1	1	1	0.142857142857143	1	7
GTF2H1	0	9	1	3	543.51	1087.02	15	1	0.307692307692308	-Inf	1	-0.25	4	9
GTF2H2	4	21	1	0	367.29	734.58	15	1	0.192307692307692	-Inf	1	-0.84	1	25
GTF2H3	3	8	1	0	302.28	604.56	15	1	0.333333333333333	-Inf	1	-0.727272727272727	1	11
GTF2H5	0	4	0	1	71.28	142.56	15	1	1	NA	1	0	1	4
GTF2I	20	32	3	10	1021.68	2043.36	15	1	0.351848042131518	0.52	1	0.153846153846154	13	52
GTF2IRD1	4	25	3	17	983.07	1966.14	15	1	1	-0.102941176470588	1	-0.0120689655172414	20	29
GTF3A	5	5	3	3	262.68	525.36	15	1	1	0	1	0	6	10
GTF3C3	6	30	0	7	900.57	1801.14	15	1	0.567134599883801	1	1	0.166666666666667	7	36
GTF3C4	3	38	1	7	743.82	1487.64	15	1	0.522031754422398	-0.80952380952381	1	-0.0518292682926829	8	41
GTF3C6	5	13	1	1	223.41	446.82	15	1	0.521052631578947	-1.6	1	-0.222222222222222	2	18
GTPBP1	1	26	0	8	622.38	1244.76	15	1	1	1	1	0.037037037037037	8	27
GTPBP10	12	25	3	2	422.07	844.14	15	1	0.329497524298551	-2.125	1	-0.275675675675676	5	37
GTPBP2	1	20	0	7	552.42	1104.84	15	1	1	1	1	0.0476190476190476	7	21
GTPBP3	0	1	1	1	29.37	58.74	15	1	1	-Inf	1	-0.5	2	1
GTPBP4	4	13	0	4	609.84	1219.68	15	1	0.545530492898914	1	1	0.235294117647059	4	17
GTPBP6	6	22	2	3	427.35	854.7	15	1	0.573600296625881	-1.44444444444444	1	-0.185714285714286	5	28
GTPBP8	4	8	0	1	226.05	452.1	15	1	1	1	1	0.333333333333333	1	12
GTSE1	31	29	7	8	710.82	1421.64	15	1	0.779174679368387	0.181451612903226	1	0.05	15	60
GTSF1	7	7	2	1	156.75	313.5	15	1	1	-1	1	-0.166666666666667	3	14
GUCA1A	3	9	1	1	198	396	15	1	0.505494505494505	-2	1	-0.25	2	12
GUCA1B	0	10	0	0	220.11	440.22	15	1	1	NA	1	NA	0	10
GUCA1C	3	2	2	1	171.27	342.54	15	1	1	-0.333333333333333	1	-0.0666666666666667	3	5
GUCY1A2	6	24	2	1	651.09	1302.18	15	1	0.138563049853372	-7	1	-0.466666666666667	3	30
GUCY1A3	8	19	4	3	682.11	1364.22	15	1	0.211337760910816	-2.16666666666667	1	-0.275132275132275	7	27
GUCY1B3	1	8	0	1	780.12	1560.24	15	1	1	1	1	0.111111111111111	1	9
GUCY1B4	9	30	5	6	772.2	1544.4	15	1	0.252074067616493	-1.77777777777778	1	-0.223776223776224	11	39
GUCY2C	16	27	0	5	952.05	1904.1	15	1	0.154168885898766	1	1	0.372093023255814	5	43
GUCY2F	6	57	5	16	1109.79	2219.58	15	1	0.132321810580012	-1.96875	1	-0.142857142857143	21	63
GUF1	14	28	4	3	641.85	1283.7	15	1	0.398469479555576	-1.66666666666667	1	-0.238095238095238	7	42
GUK1	2	13	3	6	197.67	395.34	15	1	0.325592885375494	-2.25	1	-0.2	9	15
GULP1	3	7	0	0	275.22	550.44	15	1	1	NA	1	NA	0	10
GUSB	4	34	3	5	594.99	1189.98	15	1	0.0890168796898926	-4.1	0.953357353910386	-0.269736842105263	8	38
GXYLT2	1	12	2	2	347.82	695.64	15	1	0.120588235294118	-11	1	-0.423076923076923	4	13
GYG1	8	10	0	1	327.36	654.72	15	1	1	1	1	0.444444444444444	1	18
GYG2	15	24	4	2	410.52	821.04	15	1	0.376818586971735	-2.2	1	-0.282051282051282	6	39
GYPC	3	2	0	0	84.15	168.3	15	1	1	NA	1	NA	0	5
GYS2	4	19	1	2	721.38	1442.76	15	1	0.488461538461538	-1.375	1	-0.159420289855072	3	23
GZF1	42	77	10	23	1565.85	3131.7	15	1	0.680965315820152	0.202898550724638	1	0.0499108734402852	33	119
GZMK	22	14	8	2	390.06	780.12	15	1	0.45521894080558	-1.54545454545455	1	-0.188888888888889	10	36
GZMM	5	4	3	3	138.27	276.54	15	1	1	0.2	1	0.0555555555555556	6	9
H1F0	6	8	3	4	193.05	386.1	15	1	1	0	1	0	7	14
H1FOO	22	22	3	2	254.1	508.2	15	1	1	-0.5	1	-0.1	5	44
H2A2BL	0	10	0	0	128.7	257.4	15	1	1	NA	1	NA	0	10
H2AFV	0	5	0	2	71.61	143.22	15	1	1	NA	1	0	2	5
H2AFX	0	5	0	0	117.81	235.62	15	1	1	NA	1	NA	0	5
H2AFY	0	12	0	1	369.27	738.54	15	1	1	NA	1	0	1	12
H2AFY2	1	11	1	3	368.94	737.88	15	1	0.45	-2.66666666666667	1	-0.166666666666667	4	12
H2AFZ	0	8	0	3	125.07	250.14	15	1	1	NA	1	0	3	8
H6PD	12	39	6	9	783.09	1566.18	15	1	0.321706783444664	-1.16666666666667	1	-0.164705882352941	15	51
HAAO	6	9	0	0	284.13	568.26	15	1	1	NA	1	NA	0	15
HABP2	19	21	3	2	560.34	1120.68	15	1	0.665154093401399	-0.657894736842105	1	-0.125	5	40
HABP4	5	4	3	0	247.17	494.34	15	1	0.490909090909091	-Inf	1	-0.444444444444444	3	9
HACD1	1	1	0	1	201.3	402.6	15	1	1	1	1	0.5	1	2
HACD2	1	4	0	1	237.27	474.54	15	1	1	1	1	0.2	1	5
HACD3	1	13	0	4	294.03	588.06	15	1	1	1	1	0.0714285714285714	4	14
HACD4	5	9	0	0	217.8	435.6	15	1	1	NA	1	NA	0	14
HACL1	6	27	6	4	547.8	1095.6	15	1	0.0171439861684291	-5.75	0.67478445727067	-0.418181818181818	10	33
HADH	4	10	0	5	270.93	541.86	15	1	0.530443756449948	1	1	0.285714285714286	5	14
HADHA	4	35	3	19	738.54	1477.08	15	1	0.695143765988637	-0.381578947368421	1	-0.0337995337995338	22	39
HAGH	0	12	0	1	277.86	555.72	15	1	1	NA	1	0	1	12
HAGHL	2	3	1	2	172.26	344.52	15	1	1	0.25	1	0.0666666666666667	3	5
HAL	2	19	3	6	654.39	1308.78	15	1	0.143236074270557	-3.75	1	-0.238095238095238	9	21
HAO1	3	12	5	2	367.29	734.58	15	1	0.0523501266535323	-9	0.843251957917679	-0.514285714285714	7	15
HAO2	5	13	3	3	352.44	704.88	15	1	0.36176409402954	-1.6	1	-0.222222222222222	6	18
HAPLN1	4	21	1	1	352.44	704.88	15	1	0.341880341880342	-4.25	1	-0.34	2	25
HAPLN2	3	5	2	3	113.19	226.38	15	1	1	-0.111111111111111	1	-0.025	5	8
HAPLN3	3	3	1	10	239.58	479.16	15	1	0.0987394957983193	0.9	0.971353639774823	0.409090909090909	11	6
HAPLN4	8	11	8	10	408.87	817.74	15	1	1	-0.1	1	-0.0233918128654971	18	19
HARBI1	3	18	3	4	345.51	691.02	15	1	0.144258639910814	-3.5	1	-0.285714285714286	7	21
HARS	5	23	5	8	441.54	883.08	15	1	0.241426118030739	-1.875	1	-0.206043956043956	13	28
HARS2	8	31	1	6	384.45	768.9	15	1	1	0.354166666666667	1	0.0622710622710623	7	39
HAS2	0	10	0	0	547.47	1094.94	15	1	1	NA	1	NA	0	10
HAT1	2	9	1	0	401.61	803.22	15	1	0.25	-Inf	1	-0.818181818181818	1	11
HAUS1	48	9	0	2	262.68	525.36	15	1	0.0321449444769141	1	0.784275503573749	0.842105263157895	2	57
HAUS2	11	10	1	0	244.53	489.06	15	1	1	-Inf	1	-0.476190476190476	1	21
HAUS3	27	19	6	5	595.98	1191.96	15	1	1	0.155555555555556	1	0.0415019762845851	11	46
HAUS3L	23	10	2	1	249.48	498.96	15	1	1	0.130434782608696	1	0.0303030303030304	3	33
HAVCR1	14	9	6	9	297	594	15	1	0.320095401296736	0.571428571428571	1	0.208695652173913	15	23
HBBA	5	4	0	1	139.92	279.84	15	1	1	1	1	0.555555555555556	1	9
HBE	1	1	0	1	53.13	106.26	15	1	1	1	1	0.5	1	2
HBE1	2	8	0	1	146.52	293.04	15	1	1	1	1	0.2	1	10
HBEGF	1	4	0	1	134.31	268.62	15	1	1	1	1	0.2	1	5
HBP1	5	8	2	5	520.74	1041.48	15	1	1	0.36	1	0.0989010989010989	7	13
HCCS	3	18	1	2	271.26	542.52	15	1	0.436758893280632	-2	1	-0.19047619047619	3	21
HCFC2	10	19	7	8	745.14	1490.28	15	1	0.52065111284413	-0.6625	1	-0.12183908045977	15	29
HCK	10	12	0	12	492.69	985.38	15	1	0.00584082867338773	1	0.467685236262114	0.454545454545455	12	22
HCLS1	11	13	5	2	479.16	958.32	15	1	0.39438882709183	-1.95454545454545	1	-0.255952380952381	7	24
HCN1	6	27	1	2	424.71	849.42	15	1	0.488235294117647	-1.25	1	-0.151515151515151	3	33
HCN2	0	16	0	3	564.3	1128.6	15	1	1	NA	1	0	3	16
HCN3	3	29	1	2	584.76	1169.52	15	1	0.313216195569137	-3.83333333333333	1	-0.239583333333333	3	32
HCN4	6	38	1	6	1183.05	2366.1	15	1	1	-0.0555555555555556	1	-0.0064935064935065	7	44
HCRTR2	9	9	1	1	493.68	987.36	15	1	1	0	1	0	2	18
HDAC1	1	20	1	4	460.02	920.04	15	1	0.353846153846154	-4	1	-0.152380952380952	5	21
HDAC11	12	16	0	7	361.35	722.7	15	1	0.0695331413989399	1	0.897609643513588	0.428571428571429	7	28
HDAC2	1	10	1	3	466.95	933.9	15	1	0.476190476190476	-2.33333333333333	1	-0.159090909090909	4	11
HDAC4	11	30	5	17	1090.98	2181.96	15	1	0.771698457054982	0.197860962566845	1	0.041019955654102	22	41
HDAC7	5	29	4	27	962.28	1924.56	15	1	1	0.140740740740741	1	0.0180265654648956	31	34
HDAC8	0	18	0	9	329.34	658.68	15	1	1	NA	1	0	9	18
HDC	6	14	4	6	613.14	1226.28	15	1	0.6903845779408	-0.555555555555556	1	-0.1	10	20
HDDC2	3	4	0	0	174.24	348.48	15	1	1	NA	1	NA	0	7
HDGFRP2	7	29	4	13	603.24	1206.48	15	1	0.730044371026934	-0.274725274725275	1	-0.0408496732026144	17	36
HDGFRP3	0	3	1	0	174.24	348.48	15	1	0.25	-Inf	1	-1	1	3
HDHD2	2	16	3	2	257.4	514.8	15	1	0.0481737941692175	-11	0.829468895324472	-0.488888888888889	5	18
HDHD3	9	10	4	2	201.63	403.26	15	1	0.64472049689441	-1.22222222222222	1	-0.192982456140351	6	19
HDLBP	0	22	0	11	1255.32	2510.64	15	1	1	NA	1	0	11	22
HDX	6	13	2	4	691.02	1382.04	15	1	1	-0.0833333333333333	1	-0.0175438596491228	6	19
HEATR1	35	65	5	17	2112.33	4224.66	15	1	0.323229228626041	0.453781512605042	1	0.122727272727273	22	100
HEATR3	7	17	3	10	641.85	1283.7	15	1	1	0.271428571428571	1	0.0608974358974359	13	24
HEATR5A	49	76	3	4	2035.44	4070.88	15	1	1	-0.163265306122449	1	-0.0365714285714285	7	125
HEATR5B	5	80	2	4	2051.94	4103.88	15	1	0.0659775336347424	-7	0.884435842948953	-0.274509803921569	6	85
HEBP1	7	5	3	2	309.87	619.74	15	1	1	-0.0714285714285714	1	-0.0166666666666666	5	12
HEBP2	4	12	4	1	181.5	363	15	1	0.0474716202270382	-11	0.828231827900648	-0.55	5	16
HECA	6	20	1	3	510.84	1021.68	15	1	1	-0.111111111111111	1	-0.0192307692307692	4	26
HECTD2	5	16	3	3	719.73	1439.46	15	1	0.319104084321476	-2.2	1	-0.261904761904762	6	21
HECTD3	2	31	1	7	760.65	1521.3	15	1	0.488180112570357	-1.21428571428571	1	-0.0643939393939394	8	33
HECTD3L	31	38	3	12	748.77	1497.54	15	1	0.0888099684112261	0.693548387096774	0.953357353910386	0.249275362318841	15	69
HECTD4	6	180	8	36	4325.31	8650.62	15	1	0.00121256579331845	-5.66666666666667	0.254094564439392	-0.149560117302053	44	186
HECW1	0	12	0	4	456.72	913.44	15	1	1	NA	1	0	4	12
HECW2	11	42	5	5	1094.61	2189.22	15	1	0.105681010119823	-2.81818181818182	0.983805342817882	-0.292452830188679	10	53
HEG1	115	91	21	20	1679.04	3358.08	15	1	0.609724143574779	0.169130434782609	1	0.0460573052332465	41	206
HELB	36	45	15	9	1011.12	2022.24	15	1	0.16331170045911	-1.08333333333333	1	-0.180555555555556	24	81
HELLS	6	26	2	6	800.58	1601.16	15	1	0.649867261012772	-0.444444444444444	1	-0.0625	8	32
HELQ	42	40	5	6	951.06	1902.12	15	1	0.75856512432479	0.206349206349206	1	0.057649667405765	11	82
HELZ	3	25	1	7	1887.93	3775.86	15	1	1	-0.19047619047619	1	-0.0178571428571429	8	28
HELZ2	96	106	13	53	2763.09	5526.18	15	1	4.86967231699369e-05	0.729166666666667	0.04042271543353	0.278277827782778	66	202
HEMGN	13	11	2	2	261.03	522.06	15	1	1	0.153846153846154	1	0.0416666666666666	4	24
HEMK1	13	12	6	3	350.46	700.92	15	1	0.697391040550106	-0.846153846153846	1	-0.146666666666667	9	25
HENMT1	13	15	1	0	375.21	750.42	15	1	0.482758620689655	-Inf	1	-0.535714285714286	1	28
HEP21	0	5	3	6	106.92	213.84	15	1	0.258241758241758	-Inf	1	-0.333333333333333	9	5
HEPACAM	2	20	2	2	204.6	409.2	15	1	0.0986622073578595	-9	0.971353639774823	-0.409090909090909	4	22
HEPACAM2	4	18	3	4	461.34	922.68	15	1	0.311046399876985	-2.375	1	-0.246753246753247	7	22
HEPH	15	48	5	3	1144.44	2288.88	15	1	0.0353759606508416	-4.33333333333333	0.788199921465956	-0.386904761904762	8	63
HEPHL1	10	49	3	12	1151.37	2302.74	15	1	0.719209162604197	-0.225	1	-0.0305084745762712	15	59
HERC1	19	130	4	11	4627.59	9255.18	15	1	0.231341284043026	-1.48803827751196	1	-0.139149888143177	15	149
HERC2	8	189	4	28	4578.42	9156.84	15	1	0.0692146175780861	-2.375	0.895413112719721	-0.0843908629441624	32	197
HERC4	0	27	3	4	1034.88	2069.76	15	1	0.00584893048128342	-Inf	0.467685236262114	-0.428571428571429	7	27
HERPUD1	11	12	6	2	364.32	728.64	15	1	0.239906068471141	-2.27272727272727	1	-0.271739130434783	8	23
HERPUD2	7	8	1	0	265.32	530.64	15	1	1	-Inf	1	-0.533333333333333	1	15
HES1	0	9	4	1	125.73	251.46	15	1	0.00499500499500499	-Inf	0.460299276725364	-0.8	5	9
HES4	1	14	0	2	206.58	413.16	15	1	1	1	1	0.0666666666666667	2	15
HES5	1	5	1	2	156.42	312.84	15	1	1	-1.5	1	-0.166666666666667	3	6
HES6	5	12	5	1	225.72	451.44	15	1	0.0515319920354245	-11	0.843251957917679	-0.53921568627451	6	17
HESX1	10	5	1	1	198	396	15	1	1	0.5	1	0.166666666666667	2	15
HEXA	10	20	6	6	490.71	981.42	15	1	0.483039385647702	-1	1	-0.166666666666667	12	30
HEXB	16	24	1	2	497.31	994.62	15	1	1	0.25	1	0.0666666666666667	3	40
HEXDC	7	16	3	2	410.85	821.7	15	1	0.315018315018315	-2.42857142857143	1	-0.295652173913043	5	23
HEXDCL	21	21	10	11	530.31	1060.62	15	1	1	0.0909090909090909	1	0.0238095238095238	21	42
HEY1	0	9	0	1	233.97	467.94	15	1	1	NA	1	0	1	9
HEY2	1	4	0	1	157.74	315.48	15	1	1	1	1	0.2	1	5
HEYL	3	28	0	0	296.67	593.34	15	1	1	NA	1	NA	0	31
HFM1	42	44	0	3	1205.82	2411.64	15	1	0.243871297242084	1	1	0.488372093023256	3	86
HGF	12	26	2	3	744.48	1488.96	15	1	1	-0.444444444444444	1	-0.0842105263157895	5	38
HGFAC	10	19	2	1	540.54	1081.08	15	1	0.540322580645161	-2.8	1	-0.32183908045977	3	29
HGH1	6	5	0	4	153.12	306.24	15	1	0.103296703296703	1	0.983165897366278	0.545454545454545	4	11
HGSNAT	18	21	3	4	562.98	1125.96	15	1	1	0.125	1	0.032967032967033	7	39
HHAT	6	14	4	5	299.97	599.94	15	1	0.67490380683784	-0.866666666666667	1	-0.144444444444444	9	20
HHATL	9	19	7	9	498.96	997.92	15	1	0.522721342516815	-0.641975308641975	1	-0.116071428571429	16	28
HHEX	4	7	0	1	149.16	298.32	15	1	1	1	1	0.363636363636364	1	11
HHIP	3	13	1	3	555.39	1110.78	15	1	1	-0.444444444444444	1	-0.0625	4	16
HHIPL1	14	28	2	5	733.92	1467.84	15	1	1	0.2	1	0.0476190476190476	7	42
HHLA1-OC90	51	40	4	1	960.96	1921.92	15	1	0.389065491456851	-2.13725490196078	1	-0.23956043956044	5	91
HHLA2	6	3	2	2	107.25	214.5	15	1	1	0.5	1	0.166666666666667	4	9
HIBADH	0	7	0	1	322.08	644.16	15	1	1	NA	1	0	1	7
HIBCH	7	13	1	2	379.17	758.34	15	1	1	0.0714285714285714	1	0.0166666666666667	3	20
HIC2	1	13	2	5	565.29	1130.58	15	1	0.247368421052632	-4.2	1	-0.214285714285714	7	14
HID1	5	26	5	6	835.56	1671.12	15	1	0.0944308889638498	-3.33333333333333	0.960983694935281	-0.293255131964809	11	31
HIF1A	1	25	0	4	792.33	1584.66	15	1	1	1	1	0.0384615384615385	4	26
HIF1AN	0	6	0	1	309.87	619.74	15	1	1	NA	1	0	1	6
HIGD1A	1	5	0	1	93.72	187.44	15	1	1	1	1	0.166666666666667	1	6
HIGD2A	0	1	2	0	55.11	110.22	15	1	0.333333333333333	-Inf	1	-1	2	1
HINFP	16	15	7	6	457.38	914.76	15	1	1	-0.09375	1	-0.0223325062034739	13	31
HINT1Z-HINT2Z	0	5	0	3	69.96	139.92	15	1	1	NA	1	0	3	5
HINT3	1	6	0	2	129.03	258.06	15	1	1	1	1	0.142857142857143	2	7
HIP1	54	115	12	8	1991.22	3982.44	15	1	0.0231808860042564	-2.19444444444444	0.735459686256967	-0.280473372781065	20	169
HIP1R	38	62	17	20	1622.94	3245.88	15	1	0.436166980352365	-0.386842105263158	1	-0.0794594594594595	37	100
HIPK1	2	32	2	2	1200.87	2401.74	15	1	0.0474564790354264	-15	0.828231827900648	-0.441176470588235	4	34
HIPK2	2	14	1	10	842.82	1685.64	15	1	1	0.3	1	0.0340909090909091	11	16
HIPK3	10	32	5	11	1182.06	2364.12	15	1	0.738153477182798	-0.454545454545455	1	-0.0744047619047619	16	42
HIST1H103-HIST1H111R	4	30	6	13	196.68	393.36	15	1	0.14016709557177	-2.46153846153846	1	-0.198142414860681	19	34
HIST1H110-HISTH1	3	15	7	8	216.81	433.62	15	1	0.126362625139043	-3.375	1	-0.3	15	18
HIST1H2A4L1-HIST1H2A4L3-HISTH2A4L1	0	5	0	5	26.73	53.46	15	1	1	NA	1	0	5	5
HIST1H2B5L	0	3	0	0	125.73	251.46	15	1	1	NA	1	NA	0	3
HIST1H2B8	0	12	0	4	125.73	251.46	15	1	1	NA	1	0	4	12
HIST1H3A-HIST1H3G-HIST2H3	0	2	0	1	40.92	81.84	15	1	1	NA	1	0	1	2
HIST2H3L	0	1	0	1	86.79	173.58	15	1	1	NA	1	0	1	1
HIVEP1	144	139	4	3	2686.86	5373.72	15	1	1	-0.287037037037037	1	-0.0625946491670873	7	283
HIVEP2	24	91	8	14	2497.77	4995.54	15	1	0.166181404971529	-1.16666666666667	1	-0.154940711462451	22	115
HIVEP3	30	98	17	30	2435.4	4870.8	15	1	0.122945434977041	-0.851111111111111	1	-0.127327127659574	47	128
HJURP	74	25	13	5	731.94	1463.88	15	1	0.77690781468563	0.121621621621622	1	0.0252525252525253	18	99
HK2	4	23	3	19	842.16	1684.32	15	1	1	0.0921052631578947	1	0.0117845117845118	22	27
HK3	28	25	4	19	666.93	1333.86	15	1	0.00516106703742921	0.81203007518797	0.463165107753452	0.354388843314192	23	53
HLCS	21	28	3	4	809.82	1619.64	15	1	1	0	1	0	7	49
HLF	0	3	0	2	255.09	510.18	15	1	1	NA	1	0	2	3
HM13	0	12	0	4	311.52	623.04	15	1	1	NA	1	0	4	12
HMBOX1	6	14	1	5	427.68	855.36	15	1	1	0.533333333333333	1	0.133333333333333	6	20
HMBS	3	9	0	0	329.67	659.34	15	1	1	NA	1	NA	0	12
HMCN1	65	119	11	10	3650.79	7301.58	15	1	0.153645543923767	-1.01384615384615	1	-0.170548654244306	21	184
HMG20A	1	12	0	2	345.51	691.02	15	1	1	1	1	0.0769230769230769	2	13
HMG20B	0	15	1	7	261.03	522.06	15	1	0.347826086956522	-Inf	1	-0.125	8	15
HMGB1	0	5	0	1	213.84	427.68	15	1	1	NA	1	0	1	5
HMGB2	0	7	0	0	141.9	283.8	15	1	1	NA	1	NA	0	7
HMGB3	0	2	0	2	200.97	401.94	15	1	1	NA	1	0	2	2
HMGCL	4	20	1	1	272.91	545.82	15	1	0.353846153846154	-4	1	-0.333333333333333	2	24
HMGCLL1	10	8	3	1	368.61	737.22	15	1	0.616131237183869	-1.4	1	-0.194444444444444	4	18
HMGCR	6	33	0	6	874.17	1748.34	15	1	0.575872737585727	1	1	0.153846153846154	6	39
HMGCS1	3	13	12	7	584.1	1168.2	15	1	0.0155344615082488	-6.42857142857143	0.648792215932744	-0.444078947368421	19	16
HMGCS2	3	10	3	7	434.28	868.56	15	1	1	-0.428571428571429	1	-0.0692307692307692	10	13
HMGN1	3	1	2	0	59.4	118.8	15	1	1	-Inf	1	-0.25	2	4
HMGN4	3	5	0	4	101.97	203.94	15	1	0.490909090909091	1	1	0.375	4	8
HMGXB3	19	66	10	7	1305.81	2611.62	15	1	0.00594669246225449	-3.96240601503759	0.467685236262114	-0.364705882352941	17	85
HMGXB4	9	15	1	2	565.95	1131.9	15	1	1	0.166666666666667	1	0.0416666666666667	3	24
HMMR	16	22	5	3	647.13	1294.26	15	1	0.439038934217607	-1.29166666666667	1	-0.203947368421053	8	38
HMOX1	4	13	0	1	294.03	588.06	15	1	1	1	1	0.235294117647059	1	17
HMP19	3	5	1	2	232.65	465.3	15	1	1	0.166666666666667	1	0.0416666666666667	3	8
HMX1	1	3	0	0	86.79	173.58	15	1	1	NA	1	NA	0	4
HMX2	1	6	0	3	174.24	348.48	15	1	1	1	1	0.142857142857143	3	7
HMX3	0	3	0	1	149.82	299.64	15	1	1	NA	1	0	1	3
HNF1B	0	5	0	3	411.51	823.02	15	1	1	NA	1	0	3	5
HNF4A	1	21	1	3	463.32	926.64	15	1	0.289230769230769	-6	1	-0.204545454545455	4	22
HNF4beta	7	27	1	9	453.09	906.18	15	1	0.658524048170882	0.571428571428571	1	0.105882352941176	10	34
HNF4G	2	13	1	0	428.67	857.34	15	1	0.1875	-Inf	1	-0.866666666666667	1	15
HNMT	7	11	2	1	290.07	580.14	15	1	0.553383458646617	-2.14285714285714	1	-0.277777777777778	3	18
HNRNPA0	0	5	1	0	125.07	250.14	15	1	0.166666666666667	-Inf	1	-1	1	5
HNRNPA2B1	0	12	0	0	337.26	674.52	15	1	1	NA	1	NA	0	12
HNRNPA3	1	8	0	4	373.23	746.46	15	1	1	1	1	0.111111111111111	4	9
HNRNPD	0	13	0	2	256.74	513.48	15	1	1	NA	1	0	2	13
HNRNPDL	1	7	0	4	253.77	507.54	15	1	1	1	1	0.125	4	8
HNRNPH2	1	18	0	6	456.06	912.12	15	1	1	1	1	0.0526315789473684	6	19
HNRNPH3	0	5	0	0	369.27	738.54	15	1	1	NA	1	NA	0	5
HNRNPK-HNRNPKL	3	12	0	1	438.57	877.14	15	1	1	1	1	0.2	1	15
HNRNPLL	0	7	0	5	414.81	829.62	15	1	1	NA	1	0	5	7
HNRNPM	3	16	0	3	641.85	1283.7	15	1	1	1	1	0.157894736842105	3	19
HNRNPR	3	16	1	1	624.69	1249.38	15	1	0.352380952380952	-4.33333333333333	1	-0.342105263157895	2	19
HNRNPU-HNRNPUL1	1	17	1	1	564.96	1129.92	15	1	0.194736842105263	-16	1	-0.444444444444444	2	18
HOGA1	8	7	15	11	319.77	639.54	15	1	1	-0.193181818181818	1	-0.0435897435897435	26	15
HOMER1	0	11	1	0	345.51	691.02	15	1	0.0833333333333334	-Inf	0.949431371776132	-1	1	11
HOMER2	1	7	0	2	349.8	699.6	15	1	1	1	1	0.125	2	8
HOMER3	4	14	3	3	400.62	801.24	15	1	0.306844185562721	-2.5	1	-0.277777777777778	6	18
HOOK1	5	20	1	2	694.98	1389.96	15	1	0.52991452991453	-1	1	-0.133333333333333	3	25
HORMAD2	16	13	6	4	352.44	704.88	15	1	1	-0.21875	1	-0.0482758620689655	10	29
HOXA1	0	5	0	1	117.48	234.96	15	1	1	NA	1	0	1	5
HOXA10	0	6	1	2	233.64	467.28	15	1	0.333333333333333	-Inf	1	-0.333333333333333	3	6
HOXA13	0	3	0	0	233.97	467.94	15	1	1	NA	1	NA	0	3
HOXA2	0	2	0	2	300.63	601.26	15	1	1	NA	1	0	2	2
HOXA3	4	10	1	4	395.34	790.68	15	1	1	0.375	1	0.0857142857142857	5	14
HOXA6	0	2	0	0	229.68	459.36	15	1	1	NA	1	NA	0	2
HOXA7	1	0	1	1	217.8	435.6	15	1	1	1	1	0.5	2	1
HOXA9	0	1	1	0	181.5	363	15	1	1	-Inf	1	-1	1	1
HOXB6	0	5	0	0	181.17	362.34	15	1	1	NA	1	NA	0	5
HOXC13	0	4	0	0	216.48	432.96	15	1	1	NA	1	NA	0	4
HOXCDX1L	0	5	2	2	275.22	550.44	15	1	0.166666666666667	-Inf	1	-0.5	4	5
HOXD1	0	2	0	0	67.32	134.64	15	1	1	NA	1	NA	0	2
HOXD12	2	2	0	0	264.33	528.66	15	1	1	NA	1	NA	0	4
HOXD13	0	2	0	0	175.23	350.46	15	1	1	NA	1	NA	0	2
HOXD4	1	3	0	0	235.62	471.24	15	1	1	NA	1	NA	0	4
HOXD9	1	1	3	1	225.39	450.78	15	1	1	-2	1	-0.25	4	2
HP1BP3	2	11	1	1	528.66	1057.32	15	1	0.371428571428571	-4.5	1	-0.346153846153846	2	13
HPCA	0	9	1	1	169.62	339.24	15	1	0.181818181818182	-Inf	1	-0.5	2	9
HPCAL4	3	14	0	1	190.08	380.16	15	1	1	1	1	0.176470588235294	1	17
HPD	2	14	4	9	376.53	753.06	15	1	0.363984674329502	-2.11111111111111	1	-0.182692307692308	13	16
HPF1	3	9	1	0	294.36	588.72	15	1	0.307692307692308	-Inf	1	-0.75	1	12
HPGD	1	9	1	0	256.74	513.48	15	1	0.181818181818182	-Inf	1	-0.9	1	10
HPGDS	0	7	0	0	198	396	15	1	1	NA	1	NA	0	7
HPRT1	0	7	0	3	201.96	403.92	15	1	1	NA	1	0	3	7
HPS1	8	10	5	6	518.1	1036.2	15	1	1	-0.0416666666666667	1	-0.0101010101010101	11	18
HPS3	30	32	4	5	1019.7	2039.4	15	1	1	0.146666666666667	1	0.0394265232974911	9	62
HPS4	31	31	16	10	613.8	1227.6	15	1	0.357266484289773	-0.6	1	-0.115384615384615	26	62
HPS5	21	47	5	8	1256.97	2513.94	15	1	0.746770289757067	-0.398809523809524	1	-0.0757918552036199	13	68
HPSE	7	24	7	10	502.92	1005.84	15	1	0.200704442181464	-1.4	1	-0.18595825426945	17	31
HPSE2	2	17	1	3	389.07	778.14	15	1	0.452851496329757	-1.83333333333333	1	-0.144736842105263	4	19
HPX	4	15	0	6	213.18	426.36	15	1	0.540395256916996	1	1	0.210526315789474	6	19
HRAS	0	9	0	1	188.1	376.2	15	1	1	NA	1	0	1	9
HRASLS	6	11	1	1	168.3	336.6	15	1	1	-0.833333333333333	1	-0.147058823529412	2	17
HRG	16	20	0	2	475.2	950.4	15	1	0.499288762446657	1	1	0.444444444444444	2	36
HRH1	23	21	0	1	472.23	944.46	15	1	0.488888888888889	1	1	0.522727272727273	1	44
HRH2	25	10	2	4	361.02	722.04	15	1	0.156663081566804	0.8	1	0.380952380952381	6	35
HRH2L	10	15	3	3	384.12	768.24	15	1	0.675830287621166	-0.5	1	-0.1	6	25
HRH3	8	8	1	3	377.85	755.7	15	1	0.591331269349845	0.666666666666667	1	0.25	4	16
HRH3L-HRH4	23	40	3	4	807.84	1615.68	15	1	1	-0.304347826086957	1	-0.0634920634920635	7	63
HS1BP3	21	15	2	2	377.85	755.7	15	1	1	0.285714285714286	1	0.0833333333333334	4	36
HS2ST1	2	6	3	0	333.63	667.26	15	1	0.0606060606060606	-Inf	0.870851370851371	-0.75	3	8
HS3ST1	2	8	0	0	317.79	635.58	15	1	1	NA	1	NA	0	10
HS3ST1L	2	8	0	0	306.9	613.8	15	1	1	NA	1	NA	0	10
HS3ST2	2	8	0	3	262.35	524.7	15	1	1	1	1	0.2	3	10
HS3ST3B1L	4	3	5	4	415.8	831.6	15	1	1	0.0625	1	0.0158730158730158	9	7
HS3ST4	2	8	1	2	242.22	484.44	15	1	1	-1	1	-0.133333333333333	3	10
HS3ST5	3	15	0	1	342.54	685.08	15	1	1	1	1	0.166666666666667	1	18
HS3ST6	0	2	1	2	238.59	477.18	15	1	1	-Inf	1	-0.333333333333333	3	2
HS6ST1	6	1	4	0	294.03	588.06	15	1	1	-Inf	1	-0.142857142857143	4	7
HSCB	4	9	0	0	159.39	318.78	15	1	1	NA	1	NA	0	13
HSD11B1a	8	15	3	2	291.06	582.12	15	1	0.353072853072853	-1.8125	1	-0.252173913043478	5	23
HSD11B1b	18	21	1	3	308.88	617.76	15	1	0.617567458066607	0.611111111111111	1	0.211538461538462	4	39
HSD11B1L	2	12	0	1	286.11	572.22	15	1	1	1	1	0.142857142857143	1	14
HSD17B1	1	3	2	0	74.58	149.16	15	1	0.4	-Inf	1	-0.75	2	4
HSD17B11-HSD17B11L	3	6	2	3	189.09	378.18	15	1	1	-0.333333333333333	1	-0.0666666666666667	5	9
HSD17B14	13	20	8	4	554.4	1108.8	15	1	0.176261168887374	-2.07692307692308	1	-0.272727272727273	12	33
HSD17B2	16	25	1	3	387.09	774.18	15	1	1	0.479166666666667	1	0.140243902439024	4	41
HSD17B4	3	15	1	1	451.77	903.54	15	1	0.368421052631579	-4	1	-0.333333333333333	2	18
HSD3B1	0	1	0	2	50.82	101.64	15	1	1	NA	1	0	2	1
HSD3B7	17	22	6	8	370.26	740.52	15	1	1	0.0294117647058824	1	0.00732600732600736	14	39
HSDL1	6	8	0	3	328.68	657.36	15	1	0.514705882352941	1	1	0.428571428571429	3	14
HSDL2	13	11	4	3	553.74	1107.48	15	1	1	-0.128205128205128	1	-0.0297619047619048	7	24
HSF1	18	21	4	3	471.24	942.48	15	1	0.694271128757799	-0.555555555555556	1	-0.10989010989011	7	39
HSF2	7	22	1	2	512.82	1025.64	15	1	1	-0.571428571428571	1	-0.0919540229885057	3	29
HSF2BP	5	10	2	3	316.8	633.6	15	1	1	-0.333333333333333	1	-0.0666666666666667	5	15
HSF3	4	19	5	1	505.89	1011.78	15	1	0.00548187444739168	-22.75	0.467685236262114	-0.659420289855073	6	23
HSF4	8	27	8	4	503.91	1007.82	15	1	0.0115089512090754	-5.75	0.593603434168836	-0.438095238095238	12	35
HSF5	14	13	6	2	519.75	1039.5	15	1	0.419278996865204	-1.78571428571429	1	-0.231481481481482	8	27
HSFL1-HSFL2	14	12	2	3	232.98	465.96	15	1	0.653936472623903	0.428571428571429	1	0.138461538461538	5	26
HSP90AA1	0	35	0	1	721.71	1443.42	15	1	1	NA	1	0	1	35
HSP90AB1	4	45	7	16	796.29	1592.58	15	1	0.0301529337989988	-3.921875	0.771992783106328	-0.222715173025732	23	49
HSP90B1	2	34	1	3	748.44	1496.88	15	1	0.277327935222672	-4.66666666666667	1	-0.194444444444444	4	36
HSPA12A	8	17	1	1	688.71	1377.42	15	1	1	-1.125	1	-0.18	2	25
HSPA13	10	20	5	3	468.27	936.54	15	1	0.223024707519864	-2.33333333333333	1	-0.291666666666667	8	30
HSPA14	7	23	2	1	477.18	954.36	15	1	0.17375366568915	-5.57142857142857	1	-0.433333333333333	3	30
HSPA2	0	43	0	10	628.65	1257.3	15	1	1	NA	1	0	10	43
HSPA4	6	29	1	10	798.27	1596.54	15	1	1	0.516666666666667	1	0.0805194805194805	11	35
HSPA4L	10	30	0	2	800.25	1600.5	15	1	1	1	1	0.25	2	40
HSPA5	0	57	0	9	594.99	1189.98	15	1	1	NA	1	0	9	57
HSPA8	0	36	0	13	640.53	1281.06	15	1	1	NA	1	0	13	36
HSPA9	2	24	4	12	640.53	1281.06	15	1	0.179821670193942	-3	1	-0.173076923076923	16	26
HSPB1	0	5	0	3	150.81	301.62	15	1	1	NA	1	0	3	5
HSPB11	3	3	2	0	124.08	248.16	15	1	0.464285714285714	-Inf	1	-0.5	2	6
HSPB2	1	5	3	4	178.2	356.4	15	1	0.559440559440559	-2.75	1	-0.261904761904762	7	6
HSPB3	7	5	0	0	148.5	297	15	1	1	NA	1	NA	0	12
HSPB8	1	12	2	4	198.99	397.98	15	1	0.2218782249742	-5	1	-0.256410256410256	6	13
HSPBAP1	14	14	5	3	483.12	966.24	15	1	0.695149492702329	-0.666666666666667	1	-0.125	8	28
HSPD1	4	18	1	6	568.26	1136.52	15	1	1	0.25	1	0.038961038961039	7	22
HSPG2	37	114	24	72	3118.17	6236.34	15	1	1	-0.027027027027027	1	-0.00496688741721854	96	151
HSPH1	6	23	4	6	810.48	1620.96	15	1	0.244052449260679	-1.55555555555556	1	-0.193103448275862	10	29
HTATSF1	4	11	1	2	413.49	826.98	15	1	1	-0.375	1	-0.0666666666666667	3	15
HTR1A	4	20	1	2	397.98	795.96	15	1	0.473504273504273	-1.5	1	-0.166666666666667	3	24
HTR1B	0	6	0	4	355.08	710.16	15	1	1	NA	1	0	4	6
HTR1E	1	14	0	9	361.35	722.7	15	1	1	1	1	0.0666666666666667	9	15
HTR1F	3	12	0	0	363.33	726.66	15	1	1	NA	1	NA	0	15
HTR2A	3	10	1	2	466.62	933.24	15	1	1	-0.666666666666667	1	-0.102564102564103	3	13
HTR2B	5	13	3	6	459.36	918.72	15	1	1	-0.3	1	-0.0555555555555555	9	18
HTR2C	1	22	0	3	469.26	938.52	15	1	1	1	1	0.0434782608695652	3	23
HTR3A	7	27	6	3	482.13	964.26	15	1	0.01374790320069	-6.71428571428571	0.628451090139802	-0.46078431372549	9	34
HTR4	22	25	1	1	499.62	999.24	15	1	1	-0.136363636363636	1	-0.0319148936170213	2	47
HTR5A	2	18	0	3	346.17	692.34	15	1	1	1	1	0.1	3	20
HTR6	6	18	3	7	429.66	859.32	15	1	1	-0.285714285714286	1	-0.05	10	24
HTR7	1	8	0	6	407.55	815.1	15	1	1	1	1	0.111111111111111	6	9
HTR7L	1	15	4	12	421.74	843.48	15	1	0.332591768631813	-4	1	-0.1875	16	16
HTRA1	0	20	0	5	323.73	647.46	15	1	1	NA	1	0	5	20
HTRA2	1	10	2	4	288.42	576.84	15	1	0.514705882352941	-4	1	-0.242424242424242	6	11
HTRA3	2	17	0	1	402.93	805.86	15	1	1	1	1	0.105263157894737	1	19
HTT	6	43	0	6	1342.11	2684.22	15	1	1	1	1	0.122448979591837	6	49
HUNK	2	15	2	8	565.29	1130.58	15	1	0.612535612535613	-0.875	1	-0.0823529411764706	10	17
HVCN1	9	12	3	2	235.62	471.24	15	1	0.634782608695652	-1	1	-0.171428571428571	5	21
HYAL1	13	21	7	21	355.74	711.48	15	1	0.29098326868421	0.461538461538462	1	0.132352941176471	28	34
HYAL2	0	17	0	4	316.8	633.6	15	1	1	NA	1	0	4	17
HYAL6	8	18	2	4	474.21	948.42	15	1	1	-0.125	1	-0.0256410256410256	6	26
HYDIN	2	1	1	0	1749	3498	15	1	1	-Inf	1	-0.333333333333333	1	3
HYI	3	10	9	3	194.7	389.4	15	1	0.0169317154779532	-9	0.674707602339182	-0.519230769230769	12	13
HYKK	11	17	4	1	342.54	685.08	15	1	0.152277783395692	-5.18181818181818	1	-0.407142857142857	5	28
HYOU1	17	37	4	5	966.9	1933.8	15	1	0.465839532340516	-0.741176470588235	1	-0.12962962962963	9	54
IAH1	7	20	2	3	241.56	483.12	15	1	0.604247775305895	-0.904761904761905	1	-0.140740740740741	5	27
IAPP	9	4	0	0	134.64	269.28	15	1	1	NA	1	NA	0	13
IARS	14	44	1	9	978.45	1956.9	15	1	0.438701125720607	0.650793650793651	1	0.141379310344828	10	58
IARS2	11	35	2	6	977.46	1954.92	15	1	1	-0.0606060606060606	1	-0.0108695652173913	8	46
IBA57	2	9	2	5	243.87	487.74	15	1	1	-0.8	1	-0.103896103896104	7	11
IBSP	2	10	2	6	224.73	449.46	15	1	1	-0.666666666666667	1	-0.0833333333333333	8	12
IBTK	35	38	4	8	1336.83	2673.66	15	1	0.533488054974926	0.457142857142857	1	0.146118721461187	12	73
ICA1	11	19	2	2	554.07	1108.14	15	1	0.627177850612386	-0.727272727272727	1	-0.133333333333333	4	30
ICE2	41	40	3	7	961.29	1922.58	15	1	0.318085630014294	0.581881533101045	1	0.206172839506173	10	81
ICK	7	17	3	2	616.77	1233.54	15	1	0.306429202980927	-2.64285714285714	1	-0.308333333333333	5	24
ICMT	0	2	0	0	176.88	353.76	15	1	1	NA	1	NA	0	2
ICOS	6	2	1	1	210.87	421.74	15	1	1	0.666666666666667	1	0.25	2	8
ICOSLG	7	5	0	0	300.3	600.6	15	1	1	NA	1	NA	0	12
ID2-ID3	8	6	8	7	80.85	161.7	15	1	1	0.142857142857143	1	0.0380952380952381	15	14
IDE	3	27	3	3	1048.74	2097.48	15	1	0.0451311022942902	-8	0.822543273817637	-0.4	6	30
IDH1	2	13	1	2	411.84	823.68	15	1	0.442401960784314	-2.25	1	-0.2	3	15
IDH2	0	13	0	6	338.91	677.82	15	1	1	NA	1	0	6	13
IDH3A	0	12	0	3	354.42	708.84	15	1	1	NA	1	0	3	12
IDH3B	2	17	0	5	278.19	556.38	15	1	1	1	1	0.105263157894737	5	19
IDI1	4	8	1	3	222.75	445.5	15	1	1	0.333333333333333	1	0.0833333333333333	4	12
IDNK	11	12	2	0	179.52	359.04	15	1	0.48	-Inf	1	-0.521739130434783	2	23
IDO2	7	22	6	2	383.13	766.26	15	1	0.0133673521719062	-8.42857142857143	0.618176018064783	-0.508620689655172	8	29
IDS	13	17	5	1	535.59	1071.18	15	1	0.17741935483871	-5.53846153846154	1	-0.4	6	30
IDUA	18	19	6	4	556.38	1112.76	15	1	0.723793229254182	-0.583333333333333	1	-0.113513513513513	10	37
IER3IP1	0	7	1	0	57.75	115.5	15	1	0.125	-Inf	1	-1	1	7
IER5	2	2	1	1	58.41	116.82	15	1	1	0	1	0	2	4
IFFO1	1	11	0	5	381.48	762.96	15	1	1	1	1	0.0833333333333333	5	12
IFFO2	6	10	2	1	394.68	789.36	15	1	0.545923632610939	-2.33333333333333	1	-0.291666666666667	3	16
IFI30	8	8	2	5	134.64	269.28	15	1	0.405034324942792	0.6	1	0.214285714285714	7	16
IFI35	72	85	22	21	1490.28	2980.56	15	1	0.606095750267207	-0.236772486772487	1	-0.0530291808620945	43	157
IFI6	5	6	4	1	106.92	213.84	15	1	0.307692307692308	-3.8	1	-0.345454545454546	5	11
IFIH1	34	39	8	4	990	1980	15	1	0.227824975753099	-1.29411764705882	1	-0.200913242009132	12	73
IFIT5	42	16	2	2	475.2	950.4	15	1	0.572655486739148	0.619047619047619	1	0.224137931034483	4	58
IFITM1	2	1	1	0	97.02	194.04	15	1	1	-Inf	1	-0.333333333333333	1	3
IFITM3	5	2	0	0	63.69	127.38	15	1	1	NA	1	NA	0	7
IFITM5	1	7	0	3	133.65	267.3	15	1	1	1	1	0.125	3	8
IFNAR1	40	23	4	5	563.64	1127.28	15	1	0.296856658137933	0.54	1	0.19047619047619	9	63
IFNAR2	36	29	4	1	414.81	829.62	15	1	0.383244537269807	-2.22222222222222	1	-0.246153846153846	5	65
IFNG	5	13	0	3	163.35	326.7	15	1	0.548872180451128	1	1	0.277777777777778	3	18
IFNGR1	34	27	1	3	415.8	831.6	15	1	0.327698511166253	0.735294117647059	1	0.307377049180328	4	61
IFNGR2	18	17	8	7	307.56	615.12	15	1	1	-0.0793650793650793	1	-0.0190476190476191	15	35
IFNKL1	5	5	2	1	183.15	366.3	15	1	1	-1	1	-0.166666666666667	3	10
IFNL3A-IFNL3L-LOC112532795	12	10	2	5	179.52	359.04	15	1	0.389846743295019	0.666666666666667	1	0.25974025974026	7	22
IFRD1	0	16	1	2	425.04	850.08	15	1	0.157894736842105	-Inf	1	-0.333333333333333	3	16
IFT122	9	34	3	4	856.35	1712.7	15	1	0.336669750231267	-1.83333333333333	1	-0.219269102990033	7	43
IFT140	33	81	13	11	1553.64	3107.28	15	1	0.0300976216988355	-1.90082644628099	0.771992783106328	-0.25219298245614	24	114
IFT172	28	57	8	4	1807.74	3615.48	15	1	0.0511690687978577	-3.07142857142857	0.843251957917679	-0.337254901960784	12	85
IFT20	0	4	0	0	61.38	122.76	15	1	1	NA	1	NA	0	4
IFT22	0	7	0	2	179.19	358.38	15	1	1	NA	1	0	2	7
IFT27	1	2	0	0	176.88	353.76	15	1	1	NA	1	NA	0	3
IFT43	8	7	2	2	240.57	481.14	15	1	1	0.125	1	0.0333333333333333	4	15
IFT52	2	19	2	3	405.9	811.8	15	1	0.154849498327759	-5.33333333333333	1	-0.304761904761905	5	21
IFT57	7	9	1	2	385.11	770.22	15	1	1	0.357142857142857	1	0.104166666666667	3	16
IFT80	10	41	8	11	809.82	1619.64	15	1	0.0700076361919324	-1.98181818181818	0.899885163830271	-0.224974200206398	19	51
IFT81	16	16	2	1	707.85	1415.7	15	1	1	-1	1	-0.166666666666667	3	32
IFT88	7	29	4	7	804.54	1609.08	15	1	0.255509419566968	-1.36734693877551	1	-0.169191919191919	11	36
IGBP1	7	9	0	2	198.33	396.66	15	1	0.496732026143791	1	1	0.4375	2	16
IGDCC3	4	22	5	25	719.4	1438.8	15	1	1	-0.1	1	-0.0128205128205128	30	26
IGDCC4	21	57	8	11	1189.98	2379.96	15	1	0.263373097372512	-0.974025974025974	1	-0.151821862348178	19	78
IGF1R	6	37	1	6	1170.18	2340.36	15	1	1	-0.0277777777777777	1	-0.00332225913621262	7	43
IGF2	0	3	1	2	166.32	332.64	15	1	1	-Inf	1	-0.333333333333333	3	3
IGF2BP1	7	13	1	4	546.48	1092.96	15	1	1	0.535714285714286	1	0.15	5	20
IGF2BP2	3	10	1	4	517.11	1034.22	15	1	1	0.166666666666667	1	0.0307692307692308	5	13
IGF2BP3	1	17	0	4	505.89	1011.78	15	1	1	1	1	0.0555555555555556	4	18
IGF2R	48	92	22	14	2273.04	4546.08	15	1	0.00423691937403527	-2.01190476190476	0.454065685553736	-0.268253968253968	36	140
IGFBP1	5	11	0	2	260.7	521.4	15	1	1	1	1	0.3125	2	16
IGFBP2	3	10	2	1	189.42	378.84	15	1	0.214285714285714	-5.66666666666667	1	-0.435897435897436	3	13
IGFBP3	2	4	0	0	181.83	363.66	15	1	1	NA	1	NA	0	6
IGFBP4	0	4	0	3	121.44	242.88	15	1	1	NA	1	0	3	4
IGFBP5	0	7	0	3	163.02	326.04	15	1	1	NA	1	0	3	7
IGFBP7	14	3	3	0	277.2	554.4	15	1	1	-Inf	1	-0.176470588235294	3	17
IGFN1	85	80	15	11	1951.62	3903.24	15	1	0.673781813597204	-0.283422459893048	1	-0.0617715617715617	26	165
IGHMBP2	21	42	20	21	968.55	1937.1	15	1	0.151056180581692	-0.904761904761905	1	-0.154471544715447	41	63
IGHVL	20	9	6	0	198.66	397.32	15	1	0.30369156460238	-Inf	1	-0.310344827586207	6	29
IGLL1	20	7	2	0	111.87	223.74	15	1	1	-Inf	1	-0.259259259259259	2	27
IGSF10	145	110	43	19	2616.57	5233.14	15	1	0.0840711348327625	-0.716878402903811	0.949431371776132	-0.124920936116382	62	255
IGSF11	3	5	3	2	397.32	794.64	15	1	0.592074592074592	-1.5	1	-0.225	5	8
IGSF21	0	11	2	5	325.05	650.1	15	1	0.137254901960784	-Inf	1	-0.285714285714286	7	11
IGSF3	6	39	12	20	1146.09	2292.18	15	1	0.0269745231160064	-2.9	0.761210061313465	-0.241666666666667	32	45
IGSF5	5	8	2	3	363.33	726.66	15	1	1	-0.0666666666666667	1	-0.0153846153846154	5	13
IGSF9	36	24	16	19	1000.56	2001.12	15	1	0.204201873695197	0.43859649122807	1	0.142857142857143	35	60
IGSF9B	2	36	0	21	1214.4	2428.8	15	1	0.533606078316774	1	1	0.0526315789473684	21	38
IHH	0	5	1	2	140.25	280.5	15	1	0.375	-Inf	1	-0.333333333333333	3	5
IK	1	24	0	4	486.42	972.84	15	1	1	1	1	0.04	4	25
IKBIP	21	19	1	1	620.4	1240.8	15	1	1	0.0952380952380952	1	0.025	2	40
IKBKAP	28	43	9	3	1171.83	2343.66	15	1	0.0291444474048379	-3.60714285714286	0.768994411487961	-0.355633802816901	12	71
IKBKB	5	23	2	3	724.68	1449.36	15	1	0.281904135908585	-2.06666666666667	1	-0.221428571428571	5	28
IKBKE	8	22	4	9	693.99	1387.98	15	1	1	-0.222222222222222	1	-0.041025641025641	13	30
IKZF3	3	9	4	7	497.64	995.28	15	1	0.666846143491722	-0.714285714285714	1	-0.113636363636364	11	12
IKZF4	3	4	1	2	430.65	861.3	15	1	1	0.333333333333333	1	0.0952380952380952	3	7
IKZF5	0	12	0	1	442.53	885.06	15	1	1	NA	1	0	1	12
IL10	9	11	1	3	176.22	352.44	15	1	0.614624505928854	0.592592592592593	1	0.2	4	20
IL10RA	29	17	3	7	590.37	1180.74	15	1	0.0804041379727295	0.748768472906404	0.937475435512484	0.330434782608696	10	46
IL10RB	37	16	1	1	330	660	15	1	0.526599326599327	0.567567567567568	1	0.19811320754717	2	53
IL11RA	8	18	1	7	409.86	819.72	15	1	0.403040415276233	0.678571428571429	1	0.182692307692308	8	26
IL12A	10	8	1	4	150.48	300.96	15	1	0.316770186335404	0.8	1	0.355555555555556	5	18
IL12B	11	7	1	0	312.84	625.68	15	1	1	-Inf	1	-0.388888888888889	1	18
IL12RB1	29	15	13	14	434.28	868.56	15	1	0.213397649708895	0.519704433497537	1	0.177609427609428	27	44
IL12RB2	56	36	14	10	841.17	1682.34	15	1	0.819212912085752	0.1	1	0.0253623188405797	24	92
IL13	7	3	1	2	140.58	281.16	15	1	0.510489510489511	0.785714285714286	1	0.366666666666667	3	10
IL13RA1	19	17	0	3	391.71	783.42	15	1	0.230769230769231	1	1	0.527777777777778	3	36
IL13RA2	7	11	1	3	354.42	708.84	15	1	1	0.476190476190476	1	0.138888888888889	4	18
IL15	6	4	1	0	208.56	417.12	15	1	1	-Inf	1	-0.4	1	10
IL15RA	9	5	6	0	134.64	269.28	15	1	0.260448916408669	-Inf	1	-0.357142857142857	6	14
IL16	26	42	6	2	1394.91	2789.82	15	1	0.0632750100653929	-3.84615384615385	0.878860036236239	-0.367647058823529	8	68
IL17A	5	10	2	3	168.3	336.6	15	1	1	-0.333333333333333	1	-0.0666666666666667	5	15
IL17B	12	12	2	0	167.31	334.62	15	1	0.483076923076923	-Inf	1	-0.5	2	24
IL17F	8	14	0	1	166.32	332.64	15	1	1	1	1	0.363636363636364	1	22
IL17RC	13	7	13	8	355.41	710.82	15	1	1	0.125	1	0.030952380952381	21	20
IL17RD	18	23	1	1	673.53	1347.06	15	1	1	-0.277777777777778	1	-0.0609756097560976	2	41
IL17RE	3	6	2	12	259.38	518.76	15	1	0.342833368004993	0.666666666666667	1	0.19047619047619	14	9
IL17REL	9	14	0	1	406.89	813.78	15	1	1	1	1	0.391304347826087	1	23
IL18	4	10	1	2	196.02	392.04	15	1	1	-0.25	1	-0.0476190476190476	3	14
IL1R1	11	22	7	3	550.44	1100.88	15	1	0.0665633196307585	-3.66666666666667	0.884435842948953	-0.366666666666667	10	33
IL1R2	13	15	5	4	406.89	813.78	15	1	0.713981956473614	-0.442307692307692	1	-0.0912698412698413	9	28
IL1RAP	13	20	2	10	591.36	1182.72	15	1	0.283293195750677	0.692307692307692	1	0.227272727272727	12	33
IL1RAPL1	5	10	2	2	455.4	910.8	15	1	0.602683178534572	-1	1	-0.166666666666667	4	15
IL1RAPL2	4	18	2	5	444.51	889.02	15	1	0.611936339522547	-0.8	1	-0.103896103896104	7	22
IL1RL2	19	13	3	5	579.15	1158.3	15	1	0.429521829521829	0.589473684210526	1	0.21875	8	32
IL2	4	5	0	0	140.58	281.16	15	1	1	NA	1	NA	0	9
IL20	4	5	1	3	175.23	350.46	15	1	1	0.583333333333333	1	0.194444444444444	4	9
IL20RA	23	23	11	5	564.96	1129.92	15	1	0.249683111300786	-1.2	1	-0.1875	16	46
IL21	3	5	1	0	132.66	265.32	15	1	0.444444444444444	-Inf	1	-0.625	1	8
IL21R	20	24	1	2	585.09	1170.18	15	1	1	0.4	1	0.121212121212121	3	44
IL22	6	8	1	1	196.02	392.04	15	1	1	-0.333333333333333	1	-0.0714285714285715	2	14
IL22RA2	9	10	2	2	248.49	496.98	15	1	1	-0.111111111111111	1	-0.0263157894736842	4	19
IL2RA	2	12	1	2	223.41	446.82	15	1	0.464705882352941	-2	1	-0.19047619047619	3	14
IL2RB	19	31	1	7	579.15	1158.3	15	1	0.241246355755139	0.766917293233083	1	0.255	8	50
IL2RG	4	4	1	3	311.52	623.04	15	1	0.575757575757576	0.666666666666667	1	0.25	4	8
IL3-KK34	31	13	4	2	220.77	441.54	15	1	1	0.161290322580645	1	0.037878787878788	6	44
IL31RA	38	33	3	1	868.56	1737.12	15	1	0.621522892755769	-1.60526315789474	1	-0.214788732394366	4	71
IL4	14	2	4	2	132	264	15	1	0.291866028708134	0.714285714285714	1	0.208333333333333	6	16
IL4I1	17	34	5	16	520.74	1041.48	15	1	0.575659233468352	0.375	1	0.0952380952380952	21	51
IL4R	54	44	8	3	1002.87	2005.74	15	1	0.344552938304265	-1.17283950617284	1	-0.176252319109462	11	98
IL5	23	4	3	0	172.26	344.52	15	1	1	-Inf	1	-0.148148148148148	3	27
IL5RA	8	11	1	3	410.85	821.7	15	1	1	0.541666666666667	1	0.171052631578947	4	19
IL6	4	5	0	1	149.49	298.98	15	1	1	1	1	0.444444444444444	1	9
IL6ST	21	36	3	5	918.72	1837.44	15	1	1	-0.0285714285714285	1	-0.00657894736842107	8	57
IL7	4	6	0	0	176.88	353.76	15	1	1	NA	1	NA	0	10
IL7R	10	23	0	2	431.64	863.28	15	1	1	1	1	0.303030303030303	2	33
IL8L1	3	6	2	0	103.95	207.9	15	1	0.181818181818182	-Inf	1	-0.666666666666667	2	9
IL8L2	7	2	1	1	102.96	205.92	15	1	0.490909090909091	0.714285714285714	1	0.277777777777778	2	9
IL9R	17	12	0	1	514.8	1029.6	15	1	0.433333333333333	1	1	0.586206896551724	1	29
ILDR1	11	25	7	5	524.37	1048.74	15	1	0.100784218106742	-2.18181818181818	0.97551364278138	-0.277777777777778	12	36
ILDR2	3	20	4	8	567.6	1135.2	15	1	0.199898580121704	-2.33333333333333	1	-0.202898550724638	12	23
ILK	0	26	1	0	448.47	896.94	15	1	0.037037037037037	-Inf	0.788413232354762	-1	1	26
ILKAP	5	27	2	5	330.33	660.66	15	1	0.587584033404467	-1.16	1	-0.129464285714286	7	32
IMMP1L	1	5	0	0	165.33	330.66	15	1	1	NA	1	NA	0	6
IMMT	8	44	3	9	683.1	1366.2	15	1	0.418152607080812	-0.833333333333333	1	-0.0961538461538461	12	52
IMP3	6	8	0	2	133.32	266.64	15	1	0.5	1	1	0.428571428571429	2	14
IMPA2	1	6	0	0	254.43	508.86	15	1	1	NA	1	NA	0	7
IMPACT	6	16	1	1	316.8	633.6	15	1	0.507246376811594	-1.66666666666667	1	-0.227272727272727	2	22
IMPAD1	4	5	0	3	309.54	619.08	15	1	0.490909090909091	1	1	0.444444444444444	3	9
IMPG1	33	25	5	2	833.91	1667.82	15	1	0.689871010316486	-0.893939393939394	1	-0.145320197044335	7	58
IMPG2	54	68	8	6	1451.34	2902.68	15	1	0.405515680269541	-0.679012345679012	1	-0.128805620608899	14	122
INA	6	7	1	1	174.24	348.48	15	1	1	-0.166666666666667	1	-0.0384615384615384	2	13
INF2	15	42	7	4	1216.71	2433.42	15	1	0.0303774511463576	-3.9	0.773114333163925	-0.373205741626794	11	57
ING1	1	6	0	2	239.91	479.82	15	1	1	1	1	0.142857142857143	2	7
ING3	3	13	0	2	408.54	817.08	15	1	1	1	1	0.1875	2	16
ING4	0	12	0	1	222.09	444.18	15	1	1	NA	1	0	1	12
ING5	0	6	0	1	185.46	370.92	15	1	1	NA	1	0	1	6
INHA	3	9	1	3	248.82	497.64	15	1	1	0	1	0	4	12
INHBB	0	2	0	2	291.06	582.12	15	1	1	NA	1	0	2	2
INHBE	3	6	2	3	272.58	545.16	15	1	1	-0.333333333333333	1	-0.0666666666666667	5	9
INO80	2	53	1	3	1545.39	3090.78	15	1	0.192992709711157	-7.83333333333333	1	-0.213636363636364	4	55
INO80C	0	3	0	2	133.65	267.3	15	1	1	NA	1	0	2	3
INO80D	5	14	0	3	867.24	1734.48	15	1	1	1	1	0.263157894736842	3	19
INPP4B	8	32	5	4	994.95	1989.9	15	1	0.0434134962682772	-4	0.82003270728968	-0.355555555555556	9	40
INPP5D	5	33	2	8	1203.18	2406.36	15	1	0.625055575873617	-0.65	1	-0.068421052631579	10	38
INPP5E	7	28	6	6	653.4	1306.8	15	1	0.0650283844578489	-3	0.884435842948953	-0.3	12	35
INPP5F	11	38	4	4	1083.72	2167.44	15	1	0.187529008172737	-2.45454545454545	1	-0.275510204081633	8	49
INPP5K	24	16	1	4	520.74	1041.48	15	1	0.15531622848696	0.833333333333333	1	0.4	5	40
INPPL1	13	23	16	18	890.01	1780.02	15	1	0.467193661130854	-0.572649572649573	1	-0.109477124183007	34	36
INS-IGF2	0	4	0	3	106.92	213.84	15	1	1	NA	1	0	3	4
INSC	7	7	3	4	264	528	15	1	1	0.25	1	0.0714285714285715	7	14
INSIG1	2	8	2	0	231.33	462.66	15	1	0.0909090909090909	-Inf	0.953786405978059	-0.8	2	10
INSIG2	0	8	0	3	223.74	447.48	15	1	1	NA	1	0	3	8
INSM1	3	3	0	0	148.5	297	15	1	1	NA	1	NA	0	6
INSR	9	48	0	16	1368.84	2737.68	15	1	0.191546448501838	1	1	0.157894736842105	16	57
INSRR	2	10	1	10	617.76	1235.52	15	1	1	0.5	1	0.0757575757575757	11	12
INTS1	9	84	8	12	2088.9	4177.8	15	1	0.0022156647408811	-5.22222222222222	0.334726684582354	-0.303225806451613	20	93
INTS10	3	20	2	1	702.57	1405.14	15	1	0.0846153846153845	-12.3333333333333	0.950053667262968	-0.536231884057971	3	23
INTS11	1	18	0	6	594.99	1189.98	15	1	1	1	1	0.0526315789473684	6	19
INTS12	4	18	1	5	459.36	918.72	15	1	1	0.1	1	0.0151515151515152	6	22
INTS2	52	104	5	23	2471.04	4942.08	15	1	0.123086981849427	0.565217391304348	1	0.154761904761905	28	156
INTS3	2	29	1	16	963.27	1926.54	15	1	1	0.09375	1	0.00569259962049336	17	31
INTS4	13	74	1	5	975.15	1950.3	15	1	1	-0.138461538461538	1	-0.0172413793103448	6	87
INTS6	3	17	0	3	817.74	1635.48	15	1	1	1	1	0.15	3	20
INTS6L	2	27	3	9	860.97	1721.94	15	1	0.139401226050777	-3.5	1	-0.181034482758621	12	29
INTS7	3	32	1	4	856.02	1712.04	15	1	0.427070795491848	-1.66666666666667	1	-0.114285714285714	5	35
INTS8	3	38	3	9	956.67	1913.34	15	1	0.121289270425151	-3.22222222222222	1	-0.176829268292683	12	41
INTS9	3	18	2	4	535.59	1071.18	15	1	0.303121516164994	-2	1	-0.19047619047619	6	21
INTU	20	34	5	2	907.17	1814.34	15	1	0.111572633858266	-3.25	0.988343113691994	-0.343915343915344	7	54
INVS	35	45	8	6	1109.79	2219.58	15	1	0.395142293325118	-0.714285714285714	1	-0.133928571428571	14	80
IP6K2	0	21	0	2	404.25	808.5	15	1	1	NA	1	0	2	21
IP6K3	4	8	2	1	404.91	809.82	15	1	0.525274725274725	-3	1	-0.333333333333333	3	12
IPCEF1	4	8	0	2	413.82	827.64	15	1	1	1	1	0.333333333333333	2	12
IPO11	3	28	3	7	935.55	1871.1	15	1	0.143464487495296	-3	1	-0.203225806451613	10	31
IPO13	6	43	4	10	1022.67	2045.34	15	1	0.20919541266147	-1.86666666666667	1	-0.163265306122449	14	49
IPO5	2	21	2	4	693.33	1386.66	15	1	0.179781903919835	-4.25	1	-0.246376811594203	6	23
IPO7	2	28	1	6	978.12	1956.24	15	1	0.477477477477477	-1.33333333333333	1	-0.0761904761904762	7	30
IPO8	5	35	0	5	1010.79	2021.58	15	1	1	1	1	0.125	5	40
IPO9	1	32	1	8	743.49	1486.98	15	1	0.386759581881533	-3	1	-0.0808080808080808	9	33
IPP	4	23	3	2	506.88	1013.76	15	1	0.0565906562847609	-7.625	0.846060006968071	-0.451851851851852	5	27
IPPK	14	24	5	6	532.62	1065.24	15	1	0.729174098095904	-0.428571428571429	1	-0.0861244019138756	11	38
IQCA1	27	61	10	11	1207.47	2414.94	15	1	0.19889359691271	-1.05387205387205	1	-0.169372294372294	21	88
IQCB1	16	19	3	1	569.58	1139.16	15	1	0.341649341649342	-2.5625	1	-0.292857142857143	4	35
IQCC	12	12	3	0	165.33	330.66	15	1	0.230769230769231	-Inf	1	-0.5	3	24
IQCD	27	17	4	2	422.73	845.46	15	1	1	-0.259259259259259	1	-0.053030303030303	6	44
IQCE	31	20	6	2	680.13	1360.26	15	1	0.697276194722185	-0.935483870967742	1	-0.142156862745098	8	51
IQCG	29	12	4	1	429.33	858.66	15	1	1	-0.655172413793103	1	-0.0926829268292684	5	41
IQCH	38	29	12	7	1111.77	2223.54	15	1	0.793009627899097	-0.308270676691729	1	-0.0644147682639434	19	67
IQCK	15	9	0	0	246.51	493.02	15	1	1	NA	1	NA	0	24
IQGAP2	5	16	0	1	614.46	1228.92	15	1	1	1	1	0.238095238095238	1	21
IQGAP3-LOC415616	24	58	7	12	1770.78	3541.56	15	1	0.584161952633902	-0.409722222222222	1	-0.0757381258023107	19	82
IQSEC1	1	36	2	3	1157.64	2315.28	15	1	0.0331010452961673	-23	0.784275503573749	-0.372972972972973	5	37
IQSEC3	5	24	1	7	1000.56	2001.12	15	1	1	0.314285714285714	1	0.0474137931034483	8	29
IQUB	32	26	4	5	742.5	1485	15	1	0.722575061512494	0.35	1	0.10727969348659	9	58
IRAK1BP1	4	6	3	0	218.13	436.26	15	1	0.192307692307693	-Inf	1	-0.6	3	10
IRAK2	17	31	4	6	672.87	1345.74	15	1	1	-0.215686274509804	1	-0.0458333333333333	10	48
IRAK4	12	21	5	1	420.09	840.18	15	1	0.0683882262829631	-7.75	0.888803134120932	-0.46969696969697	6	33
IREB2	7	20	4	2	842.16	1684.32	15	1	0.145786985539488	-4.71428571428571	1	-0.407407407407407	6	27
IRF1	5	10	0	5	308.88	617.76	15	1	0.266318369453045	1	1	0.333333333333333	5	15
IRF2BP2	2	4	2	1	205.26	410.52	15	1	0.523809523809524	-3	1	-0.333333333333333	3	6
IRF6	5	17	1	1	503.91	1007.82	15	1	0.445652173913043	-2.4	1	-0.272727272727273	2	22
IRF8	17	19	3	13	456.72	913.44	15	1	0.0679014401487291	0.742081447963801	0.887960242513107	0.284722222222222	16	36
IRF9	7	1	2	6	185.46	370.92	15	1	0.0405594405594406	0.952380952380952	0.798931947804628	0.625	8	8
IRS2	5	27	2	9	711.15	1422.3	15	1	1	-0.2	1	-0.0255681818181818	11	32
IRX1	10	20	1	2	368.61	737.22	15	1	1	0	1	0	3	30
IRX2	1	14	0	0	356.73	713.46	15	1	1	NA	1	NA	0	15
IRX4	5	7	1	0	292.38	584.76	15	1	0.461538461538462	-Inf	1	-0.583333333333333	1	12
IRX5	1	3	2	2	238.26	476.52	15	1	1	-2	1	-0.25	4	4
IRX6	10	11	2	4	139.26	278.52	15	1	0.661835748792271	0.45	1	0.142857142857143	6	21
ISCA1	0	2	0	0	58.74	117.48	15	1	1	NA	1	NA	0	2
ISCA2	3	3	1	3	138.27	276.54	15	1	0.571428571428572	0.666666666666667	1	0.25	4	6
ISCU	2	17	0	3	130.35	260.7	15	1	1	1	1	0.105263157894737	3	19
ISL1	0	7	0	0	302.28	604.56	15	1	1	NA	1	NA	0	7
ISL2	2	0	0	0	9.24	18.48	15	1	1	NA	1	NA	0	2
ISLR	5	14	4	10	402.27	804.54	15	1	1	-0.12	1	-0.0225563909774436	14	19
ISM1	2	12	2	2	414.81	829.62	15	1	0.197058823529412	-5	1	-0.357142857142857	4	14
ISM2	9	33	7	8	477.18	954.36	15	1	0.0937343828643915	-2.20833333333333	0.958791526417971	-0.252380952380952	15	42
ISOC1	0	5	0	2	151.47	302.94	15	1	1	NA	1	0	2	5
ISPD	13	10	1	1	398.31	796.62	15	1	1	0.230769230769231	1	0.0652173913043478	2	23
IST1	2	14	1	4	363.33	726.66	15	1	1	-0.75	1	-0.075	5	16
ISX	11	7	2	1	305.91	611.82	15	1	1	-0.272727272727273	1	-0.0555555555555555	3	18
ISY1	2	11	0	2	270.6	541.2	15	1	1	1	1	0.153846153846154	2	13
ITCH	7	23	0	0	870.21	1740.42	15	1	1	NA	1	NA	0	30
ITFG1	1	23	3	6	545.49	1090.98	15	1	0.0523460410557186	-10.5	0.843251957917679	-0.291666666666667	9	24
ITFG2	6	13	2	5	437.25	874.5	15	1	1	0.133333333333333	1	0.0300751879699248	7	19
ITGA1	8	38	6	2	1154.67	2309.34	15	1	0.00238606883941854	-13.25	0.340562014186822	-0.576086956521739	8	46
ITGA11	3	35	9	24	1129.92	2259.84	15	1	0.0539066152531925	-3.375	0.846060006968071	-0.19377990430622	33	38
ITGA2	34	32	4	0	1119.36	2238.72	15	1	0.119724723114424	-Inf	1	-0.484848484848485	4	66
ITGA2B	17	28	3	2	463.65	927.3	15	1	0.377230077970133	-1.47058823529412	1	-0.222222222222222	5	45
ITGA4	15	29	5	3	917.07	1834.14	15	1	0.234628410533074	-2.22222222222222	1	-0.284090909090909	8	44
ITGA6	21	40	4	4	1062.27	2124.54	15	1	0.44799861590383	-0.904761904761905	1	-0.155737704918033	8	61
ITGA7	4	11	7	9	204.27	408.54	15	1	0.45779368380326	-1.13888888888889	1	-0.170833333333333	16	15
ITGA8	4	24	3	6	1005.84	2011.68	15	1	0.327010942286085	-2	1	-0.19047619047619	9	28
ITGA9	4	4	0	1	179.19	358.38	15	1	1	1	1	0.5	1	8
ITGAV	1	41	0	8	973.83	1947.66	15	1	1	1	1	0.0238095238095238	8	42
ITGB1	1	30	1	3	792.99	1585.98	15	1	0.218487394957983	-9	1	-0.217741935483871	4	31
ITGB1BP1	0	2	0	0	198.99	397.98	15	1	1	NA	1	NA	0	2
ITGB1BP2	14	13	5	7	375.21	750.42	15	1	0.731094147111945	0.336734693877551	1	0.101851851851852	12	27
ITGB2	19	33	1	6	742.5	1485	15	1	0.404483951587598	0.710526315789474	1	0.222527472527473	7	52
ITGB3	102	59	7	30	1538.13	3076.26	15	1	9.3373587051242e-07	0.865032679738562	0.00563509597854245	0.444351183481618	37	161
ITGB3BP	13	3	2	0	138.6	277.2	15	1	1	-Inf	1	-0.1875	2	16
ITGB4	35	82	8	41	1805.1	3610.2	15	1	0.0814988959698961	0.542857142857143	0.94404191396991	0.13587999302285	49	117
ITGB5	5	55	5	12	767.91	1535.82	15	1	0.0369563063554289	-3.58333333333333	0.788413232354762	-0.21078431372549	17	60
ITGB6	6	30	2	2	782.1	1564.2	15	1	0.172338330233067	-4	1	-0.333333333333333	4	36
ITGB8	12	12	0	1	737.22	1474.44	15	1	1	1	1	0.5	1	24
ITGBL1	7	6	0	0	307.89	615.78	15	1	1	NA	1	NA	0	13
ITIH2	2	37	2	10	939.51	1879.02	15	1	0.232016806722689	-2.7	1	-0.115384615384615	12	39
ITIH3	12	34	3	4	878.13	1756.26	15	1	0.389436587098169	-1.125	1	-0.167701863354037	7	46
ITIH5	16	33	3	11	942.48	1884.96	15	1	0.522275969227884	0.4375	1	0.112244897959184	14	49
ITK	2	17	1	5	625.68	1251.36	15	1	1	-0.7	1	-0.0614035087719298	6	19
ITM2A	2	17	0	4	222.42	444.84	15	1	1	1	1	0.105263157894737	4	19
ITM2B	0	10	0	1	227.7	455.4	15	1	1	NA	1	0	1	10
ITM2C	0	13	0	5	224.73	449.46	15	1	1	NA	1	0	5	13
ITPA	1	7	0	1	139.92	279.84	15	1	1	1	1	0.125	1	8
ITPK1	1	18	1	1	377.19	754.38	15	1	0.185714285714286	-17	1	-0.447368421052632	2	19
ITPKA	1	7	0	2	322.74	645.48	15	1	1	1	1	0.125	2	8
ITPKB	3	6	3	2	323.73	647.46	15	1	0.58041958041958	-2	1	-0.266666666666667	5	9
ITPR1	5	86	3	24	2625.81	5251.62	15	1	0.381424509082543	-1.15	1	-0.0561660561660562	27	91
ITPR3	1	80	4	45	2561.13	5122.26	15	1	0.0666174834138577	-6.11111111111111	0.884435842948953	-0.0692869740488788	49	81
ITPRIP	6	30	3	4	544.5	1089	15	1	0.146571787823243	-2.75	1	-0.261904761904762	7	36
ITSN1	2	34	4	7	1663.2	3326.4	15	1	0.0209538971236796	-8.71428571428571	0.712432502205107	-0.308080808080808	11	36
ITSN2	15	62	7	3	1735.8	3471.6	15	1	0.00203648324374549	-8.64444444444444	0.327855520331649	-0.505194805194805	10	77
IVD	6	12	0	6	372.24	744.48	15	1	0.277036464679485	1	1	0.333333333333333	6	18
IVNS1ABP	6	27	0	1	635.58	1271.16	15	1	1	1	1	0.181818181818182	1	33
IWS1	4	29	1	2	671.88	1343.76	15	1	0.370448179271708	-2.625	1	-0.212121212121212	3	33
IYD	10	16	3	1	304.26	608.52	15	1	0.290348476555373	-3.8	1	-0.365384615384615	4	26
JADE1	13	41	3	3	833.58	1667.16	15	1	0.327533913685441	-2.15384615384615	1	-0.259259259259259	6	54
JADE2	5	24	5	16	785.4	1570.8	15	1	0.723236203989986	-0.5	1	-0.0656814449917898	21	29
JADE3	2	29	2	12	814.11	1628.22	15	1	0.577636833450787	-1.41666666666667	1	-0.0783410138248848	14	31
JAG1	3	36	0	12	1143.45	2286.9	15	1	1	1	1	0.0769230769230769	12	39
JAG2	5	29	2	1	1200.21	2400.42	15	1	0.0855855855855855	-10.6	0.950356516076024	-0.519607843137255	3	34
JAK1	10	39	2	10	996.6	1993.2	15	1	1	0.22	1	0.0374149659863946	12	49
JAK2	4	37	3	4	1119.69	2239.38	15	1	0.0534443514377039	-5.9375	0.846060006968071	-0.331010452961672	7	41
JAKMIP1	6	17	0	1	436.26	872.52	15	1	1	1	1	0.260869565217391	1	23
JAKMIP2	8	52	2	2	1348.38	2696.76	15	1	0.111878635642517	-5.5	0.989285811139328	-0.366666666666667	4	60
JAKMIP3	10	19	4	9	900.57	1801.14	15	1	1	0.155555555555556	1	0.0371352785145889	13	29
JAM2	4	7	1	1	280.5	561	15	1	1	-0.75	1	-0.136363636363636	2	11
JAM3	1	5	0	1	282.81	565.62	15	1	1	1	1	0.166666666666667	1	6
JAML	15	13	4	6	282.48	564.96	15	1	0.713981956473614	0.422222222222222	1	0.135714285714286	10	28
JARID2	3	11	2	6	1221	2442	15	1	1	-0.222222222222222	1	-0.0357142857142857	8	14
JAZF1	1	7	0	2	187.11	374.22	15	1	1	1	1	0.125	2	8
JCHAIN	9	8	0	4	159.39	318.78	15	1	0.103759398496241	1	0.983379501385042	0.529411764705882	4	17
JDP2	0	2	0	2	162.36	324.72	15	1	1	NA	1	0	2	2
JKAMP	0	21	2	11	307.56	615.12	15	1	0.13903743315508	-Inf	1	-0.153846153846154	13	21
JMJD1C	14	79	8	17	2171.4	4342.8	15	1	0.0796620065035359	-1.65546218487395	0.936566440349175	-0.169462365591398	25	93
JMJD4	2	17	3	3	418.77	837.54	15	1	0.0698475437605872	-7.5	0.898784491674081	-0.394736842105263	6	19
JMJD6	0	20	2	7	368.28	736.56	15	1	0.0886699507389163	-Inf	0.953024314709457	-0.222222222222222	9	20
JMY	29	29	8	8	894.96	1789.92	15	1	1	0	1	0	16	58
JOSD1	1	4	0	3	200.97	401.94	15	1	1	1	1	0.2	3	5
JPH1	1	18	3	2	567.27	1134.54	15	1	0.0183512140033879	-26	0.677255339142531	-0.547368421052632	5	19
JPH2-LOC107054877	13	39	3	15	620.73	1241.46	15	1	0.745363670071064	0.4	1	0.0833333333333333	18	52
JPH3	0	11	0	11	735.24	1470.48	15	1	1	NA	1	0	11	11
JPT1	1	3	0	2	137.94	275.88	15	1	1	1	1	0.25	2	4
JPT2	4	14	2	1	172.59	345.18	15	1	0.184210526315789	-6	1	-0.444444444444444	3	18
JUN	1	7	0	8	286.44	572.88	15	1	1	1	1	0.125	8	8
JUND	1	5	0	5	184.8	369.6	15	1	1	1	1	0.166666666666667	5	6
JUP	0	14	1	18	606.21	1212.42	15	1	1	-Inf	1	-0.0526315789473684	19	14
K123	6	18	3	2	276.21	552.42	15	1	0.287230011367942	-3.5	1	-0.35	5	24
KALRN	10	86	9	9	2346.63	4693.26	15	1	0.000301166488148429	-7.6	0.145403180478062	-0.395833333333333	18	96
KANK1	26	88	9	11	1333.86	2667.72	15	1	0.0522606305262216	-1.76923076923077	0.843251957917679	-0.221929824561404	20	114
KANK3	27	34	10	32	920.37	1840.74	15	1	0.0385533459113747	0.606481481481481	0.789311843512415	0.204527712724434	42	61
KANK4	45	54	14	16	987.36	1974.72	15	1	1	-0.05	1	-0.0121212121212121	30	99
KANSL1	16	31	10	11	1123.98	2247.96	15	1	0.418247966735589	-0.761363636363636	1	-0.135764944275583	21	47
KANSL1L	38	55	8	6	1532.85	3065.7	15	1	0.264767165178284	-0.929824561403509	1	-0.162826420890937	14	93
KANSL2	2	29	1	6	442.2	884.4	15	1	0.467164532954007	-1.41666666666667	1	-0.0783410138248848	7	31
KANSL3	7	37	10	16	1132.56	2265.12	15	1	0.045235975641808	-2.30357142857143	0.822543273817637	-0.225524475524476	26	44
KARS	9	25	2	3	576.18	1152.36	15	1	0.608819345661451	-0.851851851851852	1	-0.135294117647059	5	34
KAT14	2	30	0	6	774.18	1548.36	15	1	1	1	1	0.0625	6	32
KAT2B	10	21	1	1	792	1584	15	1	1	-1.1	1	-0.17741935483871	2	31
KAT6A	22	65	2	8	2028.84	4057.68	15	1	1	0.261363636363636	1	0.0528735632183908	10	87
KAT6B	12	43	6	11	1821.27	3642.54	15	1	0.337876428243626	-0.954545454545455	1	-0.13475935828877	17	55
KAT7	1	21	1	4	600.93	1201.86	15	1	0.341880341880342	-4.25	1	-0.154545454545455	5	22
KATNA1	0	11	0	0	491.04	982.08	15	1	1	NA	1	NA	0	11
KATNAL2	9	20	1	2	519.75	1039.5	15	1	1	-0.111111111111111	1	-0.0229885057471264	3	29
KATNB1	1	28	1	2	638.55	1277.1	15	1	0.181451612903226	-13	1	-0.298850574712644	3	29
KATNBL1	2	11	4	0	300.96	601.92	15	1	0.00630252100840335	-Inf	0.467685236262114	-0.846153846153846	4	13
KAZALD1	2	7	3	6	247.5	495	15	1	1	-0.75	1	-0.111111111111111	9	9
KBP	3	19	0	3	483.12	966.24	15	1	1	1	1	0.136363636363636	3	22
KBTBD11	8	59	2	7	579.81	1159.62	15	1	0.337038980917221	-1.10714285714286	1	-0.102819237147595	9	67
KBTBD12	10	24	5	9	607.2	1214.4	15	1	0.73804599365611	-0.333333333333333	1	-0.0630252100840336	14	34
KBTBD13	4	14	3	8	454.41	908.82	15	1	1	-0.3125	1	-0.0505050505050505	11	18
KBTBD2	3	22	0	3	617.76	1235.52	15	1	1	1	1	0.12	3	25
KBTBD3	0	13	1	2	608.85	1217.7	15	1	0.1875	-Inf	1	-0.333333333333333	3	13
KBTBD4	1	22	0	4	524.37	1048.74	15	1	1	1	1	0.0434782608695652	4	23
KBTBD8	2	12	1	2	590.7	1181.4	15	1	0.464705882352941	-2	1	-0.19047619047619	3	14
KCNA1	1	10	0	0	487.08	974.16	15	1	1	NA	1	NA	0	11
KCNA10	5	30	4	12	510.18	1020.36	15	1	0.435984276893857	-1	1	-0.107142857142857	16	35
KCNA2	0	29	0	3	495	990	15	1	1	NA	1	0	3	29
KCNA3	4	24	3	3	501.93	1003.86	15	1	0.0856819520203672	-5	0.950356516076024	-0.357142857142857	6	28
KCNA4	4	18	3	8	654.39	1308.78	15	1	0.66096588802373	-0.6875	1	-0.0909090909090909	11	22
KCNA5	5	33	1	0	497.97	995.94	15	1	0.153846153846154	-Inf	1	-0.868421052631579	1	38
KCNA6	4	30	3	6	476.19	952.38	15	1	0.146571787823243	-2.75	1	-0.215686274509804	9	34
KCNAB1	1	6	1	9	338.58	677.16	15	1	1	0.333333333333333	1	0.0428571428571428	10	7
KCNAB2	2	19	8	2	395.01	790.02	15	1	0.000217824766840582	-37	0.111675492225535	-0.704761904761905	10	21
KCNB1	3	21	1	2	719.73	1439.46	15	1	0.394529914529914	-2.5	1	-0.208333333333333	3	24
KCNB2	9	26	0	1	725.67	1451.34	15	1	1	1	1	0.257142857142857	1	35
KCNC1	0	8	0	3	589.38	1178.76	15	1	1	NA	1	0	3	8
KCNC2	2	18	1	1	405.9	811.8	15	1	0.25974025974026	-8	1	-0.4	2	20
KCNC4	0	21	0	2	588.72	1177.44	15	1	1	NA	1	0	2	21
KCND2	8	19	1	1	482.79	965.58	15	1	0.532019704433498	-1.375	1	-0.203703703703704	2	27
KCND3	8	6	0	3	440.55	881.1	15	1	0.205882352941176	1	1	0.571428571428571	3	14
KCNE1	3	7	2	3	125.73	251.46	15	1	1	-0.555555555555556	1	-0.1	5	10
KCNE2	1	5	0	0	124.74	249.48	15	1	1	NA	1	NA	0	6
KCNE4	4	5	1	1	162.36	324.72	15	1	1	-0.25	1	-0.0555555555555556	2	9
KCNE5	1	2	0	1	99	198	15	1	1	1	1	0.333333333333333	1	3
KCNG1	1	15	1	2	503.91	1007.82	15	1	0.298245614035088	-6.5	1	-0.270833333333333	3	16
KCNG2	9	11	4	8	512.82	1025.64	15	1	0.712792682000014	0.388888888888889	1	0.116666666666667	12	20
KCNG3	0	8	0	6	403.59	807.18	15	1	1	NA	1	0	6	8
KCNG4	1	17	2	4	506.88	1013.76	15	1	0.143280632411067	-7.5	1	-0.277777777777778	6	18
KCNH2	0	5	0	7	368.61	737.22	15	1	1	NA	1	0	7	5
KCNH5	8	26	0	3	543.18	1086.36	15	1	1	1	1	0.235294117647059	3	34
KCNH6	4	26	4	12	1133.55	2267.1	15	1	0.421090980833515	-1.16666666666667	1	-0.116666666666667	16	30
KCNH7	9	30	4	0	1115.73	2231.46	15	1	0.00579369581071227	-Inf	0.467685236262114	-0.769230769230769	4	39
KCNH8	10	30	1	0	754.38	1508.76	15	1	0.268292682926829	-Inf	1	-0.75	1	40
KCNJ1	1	9	2	1	368.28	736.56	15	1	0.108391608391608	-17	0.985224113668503	-0.566666666666667	3	10
KCNJ11	0	14	0	6	391.38	782.76	15	1	1	NA	1	0	6	14
KCNJ12	0	16	0	4	425.7	851.4	15	1	1	NA	1	0	4	16
KCNJ13	6	20	4	1	363.33	726.66	15	1	0.0274378939562477	-12.3333333333333	0.761210061313465	-0.569230769230769	5	26
KCNJ14L	25	35	3	4	531.63	1063.26	15	1	1	-0.05	1	-0.0119047619047619	7	60
KCNJ15	0	18	0	0	399.96	799.92	15	1	1	NA	1	NA	0	18
KCNJ16	5	22	1	3	425.7	851.4	15	1	1	-0.466666666666667	1	-0.0648148148148148	4	27
KCNJ2	0	15	0	6	423.72	847.44	15	1	1	NA	1	0	6	15
KCNJ3	1	13	1	10	465.96	931.92	15	1	1	-0.3	1	-0.0194805194805195	11	14
KCNJ4	0	17	0	3	451.44	902.88	15	1	1	NA	1	0	3	17
KCNJ5	5	13	0	1	420.75	841.5	15	1	1	1	1	0.277777777777778	1	18
KCNJ8	0	27	3	1	417.78	835.56	15	1	0.00088987764182425	-Inf	0.24410961674588	-0.75	4	27
KCNJ9	1	16	3	11	443.19	886.38	15	1	0.304115684093437	-3.36363636363636	1	-0.15546218487395	14	17
KCNK10	4	24	1	1	530.31	1060.62	15	1	0.310344827586207	-5	1	-0.357142857142857	2	28
KCNK12	4	10	1	3	346.17	692.34	15	1	1	0.166666666666667	1	0.0357142857142857	4	14
KCNK13	2	9	0	4	359.04	718.08	15	1	1	1	1	0.181818181818182	4	11
KCNK15	2	8	3	5	321.75	643.5	15	1	0.607843137254902	-1.4	1	-0.175	8	10
KCNK16	3	9	0	0	292.05	584.1	15	1	1	NA	1	NA	0	12
KCNK17	3	11	0	1	259.71	519.42	15	1	1	1	1	0.214285714285714	1	14
KCNK18	2	7	0	3	393.03	786.06	15	1	1	1	1	0.222222222222222	3	9
KCNK2	7	16	1	2	502.92	1005.84	15	1	1	-0.142857142857143	1	-0.0289855072463768	3	23
KCNK4	0	9	1	2	316.8	633.6	15	1	0.25	-Inf	1	-0.333333333333333	3	9
KCNK5	3	12	1	2	422.73	845.46	15	1	1	-1	1	-0.133333333333333	3	15
KCNK9	1	7	0	0	280.17	560.34	15	1	1	NA	1	NA	0	8
KCNMA1	9	14	0	0	725.67	1451.34	15	1	1	NA	1	NA	0	23
KCNMB1	2	10	3	4	198.99	397.98	15	1	0.304695562435501	-2.75	1	-0.261904761904762	7	12
KCNMB4	0	3	0	1	122.43	244.86	15	1	1	NA	1	0	1	3
KCNN1	6	1	0	0	553.74	1107.48	15	1	1	NA	1	NA	0	7
KCNN2	0	3	1	0	396.33	792.66	15	1	0.25	-Inf	1	-1	1	3
KCNN3	0	4	0	9	397.65	795.3	15	1	1	NA	1	0	9	4
KCNQ1	9	10	0	1	407.88	815.76	15	1	1	1	1	0.473684210526316	1	19
KCNQ2	3	20	1	13	784.41	1568.82	15	1	1	0.487179487179487	1	0.0590062111801242	14	23
KCNQ3	4	18	0	2	763.29	1526.58	15	1	1	1	1	0.181818181818182	2	22
KCNQ4	5	5	3	9	266.64	533.28	15	1	0.377708978328174	0.666666666666667	1	0.25	12	10
KCNQ5	3	12	3	6	790.02	1580.04	15	1	0.63490742666944	-1	1	-0.133333333333333	9	15
KCNRG	23	23	8	6	294.36	588.72	15	1	0.763391441898727	-0.333333333333333	1	-0.0714285714285714	14	46
KCNS1	4	11	1	9	464.97	929.94	15	1	0.614624505928854	0.694444444444444	1	0.166666666666667	10	15
KCNS2	0	10	1	3	473.22	946.44	15	1	0.285714285714286	-Inf	1	-0.25	4	10
KCNS3	4	16	0	0	490.05	980.1	15	1	1	NA	1	NA	0	20
KCNT1	4	49	3	27	1207.47	2414.94	15	1	0.699340693581628	-0.361111111111111	1	-0.0245283018867925	30	53
KCNT2	3	42	3	5	1162.26	2324.52	15	1	0.0377431669329561	-7.4	0.789311843512415	-0.308333333333333	8	45
KCNU1	35	25	3	4	899.91	1799.82	15	1	0.45551723369963	0.464285714285714	1	0.154761904761905	7	60
KCNV1	1	19	2	4	501.93	1003.86	15	1	0.123076923076923	-8.5	1	-0.283333333333333	6	20
KCNV2	3	34	6	5	560.34	1120.68	15	1	0.00227515645635987	-12.6	0.334879262253954	-0.464373464373464	11	37
KCTD1	0	10	1	8	586.41	1172.82	15	1	0.473684210526316	-Inf	1	-0.111111111111111	9	10
KCTD14	5	12	1	2	241.56	483.12	15	1	1	-0.2	1	-0.0392156862745098	3	17
KCTD15	0	4	0	0	258.39	516.78	15	1	1	NA	1	NA	0	4
KCTD16	4	16	1	5	472.23	944.46	15	1	1	0.2	1	0.0333333333333334	6	20
KCTD17	0	6	0	0	239.58	479.16	15	1	1	NA	1	NA	0	6
KCTD18	25	12	7	5	302.94	605.88	15	1	0.728673957926183	0.328	1	0.0923423423423423	12	37
KCTD19	39	40	8	10	845.79	1691.58	15	1	0.796715936145436	0.17948717948718	1	0.049226441631505	18	79
KCTD20	12	19	2	0	434.61	869.22	15	1	0.172348484848485	-Inf	1	-0.612903225806452	2	31
KCTD21	0	11	0	1	258.39	516.78	15	1	1	NA	1	0	1	11
KCTD3	7	44	1	3	783.42	1566.84	15	1	0.477019835510402	-1.0952380952381	1	-0.112745098039216	4	51
KCTD4	0	10	2	3	255.42	510.84	15	1	0.0952380952380952	-Inf	0.960983694935281	-0.4	5	10
KCTD5	1	7	0	1	221.1	442.2	15	1	1	1	1	0.125	1	8
KCTD6	0	4	0	1	235.62	471.24	15	1	1	NA	1	0	1	4
KCTD8	1	14	0	1	198.66	397.32	15	1	1	1	1	0.0666666666666667	1	15
KCTD9	0	19	1	6	370.26	740.52	15	1	0.269230769230769	-Inf	1	-0.142857142857143	7	19
KDELC1	4	19	2	1	436.92	873.84	15	1	0.123076923076923	-8.5	1	-0.492753623188406	3	23
KDELC2	3	6	2	5	437.25	874.5	15	1	1	0.2	1	0.0476190476190476	7	9
KDELR2	0	5	0	0	181.5	363	15	1	1	NA	1	NA	0	5
KDELR3	1	7	1	3	212.85	425.7	15	1	1	-1.33333333333333	1	-0.125	4	8
KDF1	7	22	1	3	413.82	827.64	15	1	1	-0.0476190476190477	1	-0.0086206896551724	4	29
KDM1A	12	24	4	8	879.12	1758.24	15	1	1	0	1	0	12	36
KDM1B	8	17	0	1	827.97	1655.94	15	1	1	1	1	0.32	1	25
KDM2A	6	33	3	8	1095.27	2190.54	15	1	0.392235858007338	-1.0625	1	-0.118881118881119	11	39
KDM2B	1	7	1	6	669.9	1339.8	15	1	1	-0.166666666666667	1	-0.0178571428571428	7	8
KDM3A	12	64	3	10	1295.25	2590.5	15	1	0.453742366129871	-0.6	1	-0.0728744939271255	13	76
KDM3B	13	42	5	5	1650	3300	15	1	0.123999834104007	-2.23076923076923	1	-0.263636363636364	10	55
KDM4A	9	33	3	7	898.26	1796.52	15	1	0.679159201059681	-0.571428571428571	1	-0.0857142857142857	10	42
KDM4B	26	5	1	0	1405.14	2810.28	15	1	1	-Inf	1	-0.161290322580645	1	31
KDM4C	16	10	1	1	340.56	681.12	15	1	1	0.375	1	0.115384615384615	2	26
KDM5A	10	40	2	6	1661.22	3322.44	15	1	0.664911800369277	-0.333333333333333	1	-0.05	8	50
KDM5B	3	44	2	8	1460.91	2921.82	15	1	0.207665389889819	-2.66666666666667	1	-0.136170212765957	10	47
KDM6A	5	11	2	3	1284.36	2568.72	15	1	1	-0.466666666666667	1	-0.0875	5	16
KDM7A	2	24	1	3	859.65	1719.3	15	1	0.359605911330049	-3	1	-0.173076923076923	4	26
KDM8	6	15	2	2	395.01	790.02	15	1	0.5699604743083	-1.5	1	-0.214285714285714	4	21
KDR	13	62	4	15	1315.38	2630.76	15	1	0.741993166033222	-0.271794871794872	1	-0.0371929824561403	19	75
KEL	35	29	2	5	819.39	1638.78	15	1	0.247988565346052	0.668571428571429	1	0.261160714285714	7	64
KERA	5	3	1	0	350.46	700.92	15	1	1	-Inf	1	-0.375	1	8
KHDC4	6	16	0	1	484.11	968.22	15	1	1	1	1	0.272727272727273	1	22
KHDRBS1	0	5	0	1	331.65	663.3	15	1	1	NA	1	0	1	5
KHDRBS3	7	10	2	2	285.45	570.9	15	1	1	-0.428571428571429	1	-0.0882352941176471	4	17
KIAA0040	1	6	0	0	111.87	223.74	15	1	1	NA	1	NA	0	7
KIAA0100	24	81	12	60	2042.7	4085.4	15	1	0.347383108870721	0.325	1	0.0619047619047619	72	105
KIAA0232	9	23	8	4	1378.08	2756.16	15	1	0.0352734867168996	-4.11111111111111	0.788199921465956	-0.385416666666667	12	32
KIAA0319	33	41	10	6	1189.65	2379.3	15	1	0.270764678289839	-1.07070707070707	1	-0.179054054054054	16	74
KIAA0319L	22	42	3	10	1110.78	2221.56	15	1	0.529119166634344	0.427272727272727	1	0.112980769230769	13	64
KIAA0355	7	28	0	2	1048.41	2096.82	15	1	1	1	1	0.2	2	35
KIAA0408	32	34	9	4	1208.13	2416.26	15	1	0.229259736008196	-1.390625	1	-0.207459207459207	13	66
KIAA0430	20	64	3	6	1724.58	3449.16	15	1	0.684675915201195	-0.6	1	-0.0952380952380952	9	84
KIAA0513	3	5	1	5	297.66	595.32	15	1	0.580419580419581	0.666666666666667	1	0.208333333333333	6	8
KIAA0753	51	31	3	1	881.76	1763.52	15	1	1	-0.823529411764706	1	-0.128048780487805	4	82
KIAA0825	13	17	8	6	610.83	1221.66	15	1	0.520570073302769	-0.743589743589744	1	-0.138095238095238	14	30
KIAA0895	25	27	3	1	596.31	1192.62	15	1	0.610977701543739	-2.24	1	-0.269230769230769	4	52
KIAA0895L	0	11	0	5	287.43	574.86	15	1	1	NA	1	0	5	11
KIAA0922	25	43	6	4	1535.49	3070.98	15	1	0.18350327221028	-1.58	1	-0.232352941176471	10	68
KIAA1024	9	39	1	4	942.48	1884.96	15	1	1	-0.0833333333333333	1	-0.0125	5	48
KIAA1024L	11	6	1	0	238.59	477.18	15	1	1	-Inf	1	-0.352941176470588	1	17
KIAA1107	74	53	8	5	1704.12	3408.24	15	1	1	-0.145945945945946	1	-0.0327074500302847	13	127
KIAA1109	16	159	9	31	4872.45	9744.9	15	1	0.0268421949931193	-1.88508064516129	0.761210061313465	-0.133571428571429	40	175
KIAA1143	3	1	2	0	143.88	287.76	15	1	1	-Inf	1	-0.25	2	4
KIAA1147	1	11	1	1	363	726	15	1	0.274725274725275	-10	1	-0.416666666666667	2	12
KIAA1191	5	13	3	3	264.99	529.98	15	1	0.36176409402954	-1.6	1	-0.222222222222222	6	18
KIAA1210	44	29	9	6	995.94	1991.88	15	1	1	0.0113636363636364	1	0.00273972602739725	15	73
KIAA1211L	31	46	9	4	961.29	1922.58	15	1	0.0712293134708001	-2.33870967741935	0.908058284769907	-0.28971028971029	13	77
KIAA1217	24	51	9	14	1620.96	3241.92	15	1	0.615753628036139	-0.366071428571429	1	-0.071304347826087	23	75
KIAA1257	74	47	12	7	1262.25	2524.5	15	1	1	-0.0888030888030888	1	-0.0200086994345368	19	121
KIAA1324	3	7	4	10	289.08	578.16	15	1	1	0.0666666666666667	1	0.0142857142857143	14	10
KIAA1324L	4	37	2	2	957.33	1914.66	15	1	0.0799355683076613	-8.25	0.936566440349175	-0.402439024390244	4	41
KIAA1328	20	22	4	1	513.15	1026.3	15	1	0.347517730496454	-3.4	1	-0.323809523809524	5	42
KIAA1429	2	94	5	25	1803.78	3607.56	15	1	0.00839577152343541	-8.4	0.54233354502865	-0.145833333333333	30	96
KIAA1456	10	9	1	5	460.35	920.7	15	1	0.180434782608696	0.82	1	0.359649122807018	6	19
KIAA1462	44	43	19	16	1271.49	2542.98	15	1	0.841556250050807	-0.160511363636364	1	-0.0371100164203612	35	87
KIAA1468	5	23	3	6	926.64	1853.28	15	1	0.372695103245388	-1.3	1	-0.154761904761905	9	28
KIAA1522	24	58	13	18	867.24	1734.48	15	1	0.26145631220062	-0.74537037037037	1	-0.126671911880409	31	82
KIAA1524	19	51	13	5	879.12	1758.24	15	1	0.000714897730192321	-5.97894736842105	0.233065034151711	-0.450793650793651	18	70
KIAA1549	59	69	21	13	1905.09	3810.18	15	1	0.124241417864887	-0.889178617992177	1	-0.156709558823529	34	128
KIAA1549L	92	81	21	20	2216.28	4432.56	15	1	0.862979861947788	0.0755434782608696	1	0.0195967855632313	41	173
KIAA1551	117	79	18	5	1877.04	3754.08	15	1	0.112130713563389	-1.43076923076923	0.990055515037369	-0.18566992014197	23	196
KIAA1614	10	12	9	9	379.5	759	15	1	1	-0.2	1	-0.0454545454545455	18	22
KIAA1644	9	5	0	0	252.45	504.9	15	1	1	NA	1	NA	0	14
KIAA1671	97	88	27	19	2013.66	4027.32	15	1	0.510057364753938	-0.289202387411829	1	-0.0626321974148062	46	185
KIAA1683	45	23	7	7	405.9	811.8	15	1	0.361124908520018	0.488888888888889	1	0.161764705882353	14	68
KIAA1755	28	43	25	19	1033.56	2067.12	15	1	0.0844813001895249	-1.02067669172932	0.949431371776132	-0.17381562099872	44	71
KIAA1841	12	20	4	4	712.8	1425.6	15	1	0.690496879351368	-0.666666666666667	1	-0.125	8	32
KIAA1958	9	51	1	4	722.37	1444.74	15	1	0.578836783259047	-0.416666666666667	1	-0.05	5	60
KIAA2013	3	27	3	3	458.37	916.74	15	1	0.0451311022942902	-8	0.822543273817637	-0.4	6	30
KIAA2026	56	59	8	4	2051.61	4103.22	15	1	0.363817434951542	-1.10714285714286	1	-0.179710144927536	12	115
KIDINS220	5	54	3	7	1764.18	3528.36	15	1	0.0843037001281851	-3.62857142857143	0.949431371776132	-0.215254237288136	10	59
KIF11	24	35	2	4	1056.33	2112.66	15	1	1	0.270833333333333	1	0.0734463276836159	6	59
KIF12	8	2	3	4	199.32	398.64	15	1	0.161764705882353	0.8125	1	0.371428571428571	7	10
KIF13A	20	68	8	14	1903.11	3806.22	15	1	0.272358561816002	-0.942857142857143	1	-0.136363636363636	22	88
KIF13B	31	103	10	22	1969.11	3938.22	15	1	0.36499732740928	-0.510263929618768	1	-0.0811567164179104	32	134
KIF14	61	58	12	13	1646.37	3292.74	15	1	0.827928596440259	0.122320302648172	1	0.0326050420168067	25	119
KIF15	19	45	5	6	1307.13	2614.26	15	1	0.314300606850015	-0.973684210526316	1	-0.157670454545455	11	64
KIF16B	44	54	7	10	1873.08	3746.16	15	1	1	0.140909090909091	1	0.0372148859543818	17	98
KIF17	22	29	10	8	750.75	1501.5	15	1	0.417865918566331	-0.647727272727273	1	-0.124183006535948	18	51
KIF18A	30	36	6	4	921.69	1843.38	15	1	0.503247513491606	-0.8	1	-0.145454545454545	10	66
KIF18B	29	45	6	16	838.2	1676.4	15	1	0.449671992400558	0.418103448275862	1	0.119164619164619	22	74
KIF1A	4	35	5	22	1616.34	3232.68	15	1	0.469183610134173	-0.988636363636364	1	-0.0826210826210826	27	39
KIF1B	10	69	1	15	2361.48	4722.96	15	1	0.683705830633378	0.54	1	0.0640822784810127	16	79
KIF1BP	3	24	3	4	587.4	1174.8	15	1	0.0856819520203672	-5	0.950356516076024	-0.317460317460317	7	27
KIF20A	9	37	3	5	853.71	1707.42	15	1	0.356094339247809	-1.46666666666667	1	-0.179347826086957	8	46
KIF20AL	19	34	10	9	824.67	1649.34	15	1	0.276412435658296	-0.988304093567251	1	-0.167825223435948	19	53
KIF20B-KIF20BL	98	68	20	10	1908.39	3816.78	15	1	0.544190253345655	-0.387755102040816	1	-0.0763052208835341	30	166
KIF21A	3	23	1	2	601.92	1203.84	15	1	0.370552818828681	-2.83333333333333	1	-0.217948717948718	3	26
KIF21B	0	37	3	1	1026.63	2053.26	15	1	0.000375234521575985	-Inf	0.161908753078878	-0.75	4	37
KIF23	6	47	7	11	927.3	1854.6	15	1	0.0149983935172909	-3.98484848484848	0.642329698273754	-0.275681341719078	18	53
KIF24	35	53	2	5	1409.76	2819.52	15	1	0.701669444987001	0.394285714285714	1	0.112012987012987	7	88
KIF25	14	23	2	8	558.36	1116.72	15	1	0.45682557694784	0.589285714285714	1	0.178378378378378	10	37
KIF26A	31	79	9	4	1919.61	3839.22	15	1	0.00479347410385354	-4.73387096774194	0.460299276725364	-0.41048951048951	13	110
KIF26B	21	52	2	9	1667.16	3334.32	15	1	0.719218204328606	0.44973544973545	1	0.10585305105853	11	73
KIF27	22	55	4	2	1343.1	2686.2	15	1	0.0737583795440415	-4	0.913861472365723	-0.380952380952381	6	77
KIF2A	2	22	0	0	669.24	1338.48	15	1	1	NA	1	NA	0	24
KIF2B	22	29	7	8	651.42	1302.84	15	1	1	-0.153409090909091	1	-0.0352941176470588	15	51
KIF2C	11	32	3	7	715.11	1430.22	15	1	1	-0.246753246753247	1	-0.0441860465116279	10	43
KIF3C	0	11	3	9	578.16	1156.32	15	1	0.217391304347826	-Inf	1	-0.25	12	11
KIF4A	11	48	6	11	1215.72	2431.44	15	1	0.188228773582919	-1.3801652892562	1	-0.166500498504487	17	59
KIF5C	1	43	1	14	906.84	1813.68	15	1	0.447106954997078	-2.07142857142857	1	-0.0439393939393939	15	44
KIF6	40	30	1	3	862.29	1724.58	15	1	0.317988642704058	0.75	1	0.321428571428571	4	70
KIF7	19	57	14	14	1265.55	2531.1	15	1	0.0190074764866158	-2	0.683149554847669	-0.25	28	76
KIF9	30	75	9	16	783.75	1567.5	15	1	0.474557596647145	-0.40625	1	-0.0742857142857143	25	105
KIFAP3	3	28	3	7	795.3	1590.6	15	1	0.143464487495296	-3	1	-0.203225806451613	10	31
KIFC3	8	30	0	7	830.94	1661.88	15	1	0.321206568058525	1	1	0.210526315789474	7	38
KIN	4	19	2	3	378.51	757.02	15	1	0.285470085470086	-2.16666666666667	1	-0.226086956521739	5	23
KIRREL	4	2	1	3	251.13	502.26	15	1	0.523809523809524	0.833333333333333	1	0.416666666666667	4	6
KIRREL3	5	36	1	2	752.07	1504.14	15	1	0.363032316520689	-2.6	1	-0.211382113821138	3	41
KIT	3	27	1	4	929.28	1858.56	15	1	0.476604278074866	-1.25	1	-0.1	5	30
KIZ	44	29	7	5	592.02	1184.04	15	1	1	0.0772727272727273	1	0.0194063926940639	12	73
KL	12	37	7	14	954.03	1908.06	15	1	0.559099593798825	-0.541666666666667	1	-0.0884353741496599	21	49
KLB	9	50	2	7	996.93	1993.86	15	1	0.631158640299297	-0.587301587301587	1	-0.0696798493408663	9	59
KLC1	7	20	1	1	705.87	1411.74	15	1	0.482758620689655	-1.85714285714286	1	-0.240740740740741	2	27
KLF10	4	22	0	2	279.18	558.36	15	1	1	1	1	0.153846153846154	2	26
KLF13	6	9	0	2	275.22	550.44	15	1	0.514705882352941	1	1	0.4	2	15
KLF15	6	14	1	1	399.96	799.92	15	1	1	-1.33333333333333	1	-0.2	2	20
KLF2	5	12	1	4	344.52	689.04	15	1	1	0.4	1	0.0941176470588235	5	17
KLF3	2	9	0	3	344.52	689.04	15	1	1	1	1	0.181818181818182	3	11
KLF4	0	5	2	5	130.35	260.7	15	1	0.46969696969697	-Inf	1	-0.285714285714286	7	5
KLF5	0	11	1	3	366.3	732.6	15	1	0.266666666666667	-Inf	1	-0.25	4	11
KLF6	1	11	1	0	281.16	562.32	15	1	0.153846153846154	-Inf	1	-0.916666666666667	1	12
KLF7	0	10	1	0	271.26	542.52	15	1	0.0909090909090909	-Inf	0.953786405978059	-1	1	10
KLF8	8	15	0	1	320.43	640.86	15	1	1	1	1	0.347826086956522	1	23
KLHDC1	2	10	0	2	442.53	885.06	15	1	1	1	1	0.166666666666667	2	12
KLHDC10	3	24	1	11	362.34	724.68	15	1	1	0.272727272727273	1	0.0277777777777778	12	27
KLHDC2	5	24	1	6	413.82	827.64	15	1	1	0.2	1	0.0295566502463054	7	29
KLHDC3	0	20	0	9	377.85	755.7	15	1	1	NA	1	0	9	20
KLHDC4	11	21	4	8	572.88	1145.76	15	1	1	0.0454545454545454	1	0.0104166666666667	12	32
KLHDC7A	29	21	11	11	697.29	1394.58	15	1	0.610361051187338	0.275862068965517	1	0.08	22	50
KLHDC8A	1	11	5	4	280.5	561	15	1	0.0464396284829721	-12.75	0.828231827900648	-0.472222222222222	9	12
KLHDC8B	6	17	2	16	345.18	690.36	15	1	0.429043578979394	0.645833333333333	1	0.14975845410628	18	23
KLHL10	9	39	0	13	599.94	1199.88	15	1	0.183574555960363	1	1	0.1875	13	48
KLHL11	8	15	1	3	554.4	1108.8	15	1	1	0.375	1	0.0978260869565217	4	23
KLHL12	0	30	0	6	541.53	1083.06	15	1	1	NA	1	0	6	30
KLHL14	2	14	0	4	568.26	1136.52	15	1	1	1	1	0.125	4	16
KLHL17	0	10	1	12	456.72	913.44	15	1	1	-Inf	1	-0.0769230769230769	13	10
KLHL18	2	31	2	13	538.89	1077.78	15	1	0.579401788467468	-1.38461538461538	1	-0.0727272727272727	15	33
KLHL2	4	15	1	2	577.5	1155	15	1	1	-0.875	1	-0.12280701754386	3	19
KLHL21	4	60	1	3	559.35	1118.7	15	1	0.268570761986039	-4	1	-0.1875	4	64
KLHL23-SSB	19	52	3	4	921.36	1842.72	15	1	0.395631247686042	-1.05263157894737	1	-0.160965794768612	7	71
KLHL24	0	22	1	1	594.99	1189.98	15	1	0.0833333333333333	-Inf	0.949431371776132	-0.5	2	22
KLHL25	0	24	1	9	584.1	1168.2	15	1	0.294117647058823	-Inf	1	-0.1	10	24
KLHL26	0	15	2	6	582.45	1164.9	15	1	0.110671936758893	-Inf	0.98538656216834	-0.25	8	15
KLHL28	2	33	0	6	566.28	1132.56	15	1	1	1	1	0.0571428571428571	6	35
KLHL29	3	19	2	3	550.44	1100.88	15	1	0.220748172922086	-3.22222222222222	1	-0.263636363636364	5	22
KLHL3	1	35	3	10	638.88	1277.76	15	1	0.0519690762521475	-9.5	0.843251957917679	-0.202991452991453	13	36
KLHL30	6	12	5	13	536.58	1073.16	15	1	1	0.230769230769231	1	0.0555555555555555	18	18
KLHL31	3	23	2	8	627.66	1255.32	15	1	0.603439860792802	-0.916666666666667	1	-0.0846153846153846	10	26
KLHL33	5	28	9	5	675.18	1350.36	15	1	0.00151661503948347	-9.08	0.284493574108469	-0.491341991341991	14	33
KLHL34	11	30	2	2	590.04	1180.08	15	1	0.567233799791939	-1.72727272727273	1	-0.231707317073171	4	41
KLHL35	6	36	4	9	581.13	1162.26	15	1	0.223254741304477	-1.66666666666667	1	-0.164835164835165	13	42
KLHL36	1	24	0	6	609.84	1219.68	15	1	1	1	1	0.04	6	25
KLHL4	4	20	2	4	713.79	1427.58	15	1	0.570503978779841	-1.5	1	-0.166666666666667	6	24
KLHL40	2	33	6	13	613.8	1227.6	15	1	0.0172833188489551	-6.61538461538461	0.67478445727067	-0.258646616541353	19	35
KLHL41	3	16	1	1	600.93	1201.86	15	1	0.352380952380952	-4.33333333333333	1	-0.342105263157895	2	19
KLHL42	2	20	0	1	432.3	864.6	15	1	1	1	1	0.0909090909090909	1	22
KLHL5	5	25	0	3	700.92	1401.84	15	1	1	1	1	0.166666666666667	3	30
KLHL6	4	19	0	6	604.89	1209.78	15	1	0.552608311229001	1	1	0.173913043478261	6	23
KLHL7	0	26	0	4	560.67	1121.34	15	1	1	NA	1	0	4	26
KLHL8	3	30	1	8	611.82	1223.64	15	1	1	-0.25	1	-0.0202020202020202	9	33
KLK7-LOC107055482	12	8	3	2	201.63	403.26	15	1	1	0	1	0	5	20
KMO	6	25	4	4	569.25	1138.5	15	1	0.167243517088718	-3.16666666666667	1	-0.306451612903226	8	31
KMT2A	45	117	11	12	3835.92	7671.84	15	1	0.0566376541532892	-1.38333333333333	0.846060006968071	-0.20048309178744	23	162
KMT2C	47	202	22	32	4880.7	9761.4	15	1	0.00107513268662003	-1.95478723404255	0.254094564439392	-0.218652387327086	54	249
KMT2D	2	4	0	1	267.63	535.26	15	1	1	1	1	0.333333333333333	1	6
KMT2E	5	30	2	4	1245.09	2490.18	15	1	0.267701986572333	-2	1	-0.19047619047619	6	35
KMT5A	4	9	0	1	305.58	611.16	15	1	1	1	1	0.307692307692308	1	13
KMT5B	2	15	2	4	849.42	1698.84	15	1	0.270468661773009	-2.75	1	-0.215686274509804	6	17
KNDC1	49	59	12	6	1866.15	3732.3	15	1	0.126988464540051	-1.40816326530612	1	-0.212962962962963	18	108
KNG1	31	17	3	3	643.17	1286.34	15	1	0.658830537536737	0.451612903225806	1	0.145833333333333	6	48
KNL1	147	82	18	7	2310.66	4621.32	15	1	0.512994538097483	-0.434402332361516	1	-0.0780786026200873	25	229
KNOP1	36	13	3	1	597.63	1195.26	15	1	1	-0.0833333333333333	1	-0.0153061224489796	4	49
KNSTRN	4	8	3	2	232.32	464.64	15	1	0.592760180995475	-2	1	-0.266666666666667	5	12
KNTC1	62	91	17	19	2207.7	4415.4	15	1	0.573598737219905	-0.313242784380306	1	-0.0669934640522876	36	153
KPNA1	0	20	0	0	529.32	1058.64	15	1	1	NA	1	NA	0	20
KPNA2	2	23	0	1	524.7	1049.4	15	1	1	1	1	0.08	1	25
KPNA3	0	4	2	3	465.3	930.6	15	1	0.444444444444445	-Inf	1	-0.4	5	4
KPNA4	0	10	0	3	494.01	988.02	15	1	1	NA	1	0	3	10
KPNA5	0	11	3	2	533.28	1066.56	15	1	0.0178571428571429	-Inf	0.677255339142531	-0.6	5	11
KPNA6	1	12	0	1	530.31	1060.62	15	1	1	1	1	0.0769230769230769	1	13
KPNA7	7	33	4	9	467.28	934.56	15	1	0.431634224099435	-1.0952380952381	1	-0.132692307692308	13	40
KPNB1	2	24	0	9	837.54	1675.08	15	1	1	1	1	0.0769230769230769	9	26
KRAS	0	2	0	0	187.11	374.22	15	1	1	NA	1	NA	0	2
KREMEN1	13	8	3	0	527.34	1054.68	15	1	0.525691699604743	-Inf	1	-0.380952380952381	3	21
KRIT1	1	20	0	1	729.63	1459.26	15	1	1	1	1	0.0476190476190476	1	21
KRR1	3	10	2	3	368.28	736.56	15	1	0.582749766573296	-1.22222222222222	1	-0.169230769230769	5	13
KRT10	2	25	2	8	560.34	1120.68	15	1	0.291392232568703	-2.125	1	-0.125925925925926	10	27
KRT14	1	5	0	5	310.86	621.72	15	1	1	1	1	0.166666666666667	5	6
KRT15	12	18	1	3	471.24	942.48	15	1	1	0.5	1	0.15	4	30
KRT17	2	6	1	2	300.96	601.92	15	1	1	-0.5	1	-0.0833333333333333	3	8
KRT18	0	1	1	0	86.79	173.58	15	1	1	-Inf	1	-1	1	1
KRT19	5	26	3	4	419.76	839.52	15	1	0.146121283118187	-2.9	1	-0.267281105990783	7	31
KRT20	19	18	0	6	433.62	867.24	15	1	0.0265282080369999	1	0.761210061313465	0.513513513513513	6	37
KRT222	0	8	0	2	278.19	556.38	15	1	1	NA	1	0	2	8
KRT23	5	12	3	4	429.66	859.32	15	1	0.646626447541779	-0.8	1	-0.134453781512605	7	17
KRT5	3	16	0	3	484.11	968.22	15	1	1	1	1	0.157894736842105	3	19
KRT6A	2	24	2	1	535.59	1071.18	15	1	0.0421455938697318	-23	0.807456060329624	-0.58974358974359	3	26
KRT7	5	15	0	2	465.96	931.92	15	1	1	1	1	0.25	2	20
KRT75L4	4	26	0	3	568.26	1136.52	15	1	1	1	1	0.133333333333333	3	30
KRT8	11	26	1	3	548.79	1097.58	15	1	1	0.212121212121212	1	0.0472972972972973	4	37
KRT80	9	19	4	1	484.11	968.22	15	1	0.0656748238783834	-7.44444444444444	0.884435842948953	-0.478571428571429	5	28
KRT9L	18	23	8	4	587.4	1174.8	15	1	0.202126062490759	-1.55555555555556	1	-0.227642276422764	12	41
KRTC42L	7	10	2	6	508.2	1016.4	15	1	0.660761389640108	0.523809523809524	1	0.161764705882353	8	17
KRTCAP3	4	5	3	1	140.58	281.16	15	1	0.559440559440559	-2.75	1	-0.305555555555556	4	9
KSR1	6	24	3	4	799.92	1599.84	15	1	0.327010942286085	-2	1	-0.228571428571429	7	30
KSR2	0	25	0	17	678.48	1356.96	15	1	1	NA	1	0	17	25
KTI12	1	3	0	1	99.33	198.66	15	1	1	1	1	0.25	1	4
KTN1	15	42	7	15	1328.58	2657.16	15	1	0.780020592434964	-0.306666666666667	1	-0.0550239234449761	22	57
KY	53	36	4	10	678.15	1356.3	15	1	0.0424500372454791	0.728301886792453	0.809908753242774	0.309791332263242	14	89
KYAT3	5	17	2	0	449.46	898.92	15	1	0.0760869565217392	-Inf	0.919736921581953	-0.772727272727273	2	22
KYNU	13	14	3	2	498.96	997.92	15	1	1	-0.615384615384615	1	-0.118518518518519	5	27
L2HGDH	8	25	5	8	439.56	879.12	15	1	0.468901093020427	-0.953125	1	-0.142191142191142	13	33
L3HYPDH	4	15	3	5	212.19	424.38	15	1	0.633363737711564	-1.25	1	-0.164473684210526	8	19
L3MBTL1	19	30	1	1	878.79	1757.58	15	1	1	-0.578947368421053	1	-0.112244897959184	2	49
L3MBTL2	3	30	2	11	697.29	1394.58	15	1	0.611921613943859	-0.818181818181818	1	-0.0629370629370629	13	33
L3MBTL3	11	17	2	1	789.03	1578.06	15	1	0.557508342602892	-2.09090909090909	1	-0.273809523809524	3	28
L3MBTL4	17	23	3	3	792.99	1585.98	15	1	1	-0.352941176470588	1	-0.075	6	40
LACC1	9	9	4	1	434.61	869.22	15	1	0.339356295878035	-3	1	-0.3	5	18
LACTB	7	17	2	2	433.62	867.24	15	1	0.574065934065934	-1.42857142857143	1	-0.208333333333333	4	24
LACTB2	7	4	0	0	253.11	506.22	15	1	1	NA	1	NA	0	11
LACTBL1	7	26	3	5	575.52	1151.04	15	1	0.378027351522783	-1.22857142857143	1	-0.162878787878788	8	33
LAD1	10	13	3	3	374.88	749.76	15	1	1	-0.3	1	-0.0652173913043478	6	23
LAG3	32	11	3	7	500.94	1001.88	15	1	0.0215214523838614	0.852678571428571	0.721018759249189	0.444186046511628	10	43
LAMA1	54	129	13	20	2981.88	5963.76	15	1	0.30705484281328	-0.552777777777778	1	-0.0988574267262792	33	183
LAMA2	42	97	14	8	3042.27	6084.54	15	1	0.00348562727046834	-3.04166666666667	0.414682332734186	-0.334205362982341	22	139
LAMA3	114	112	23	18	3283.5	6567	15	1	0.610907117057119	-0.255360623781676	1	-0.0565508309950357	41	226
LAMA4	39	49	6	8	1709.73	3419.46	15	1	1	0.0576923076923077	1	0.0146103896103896	14	88
LAMA5	54	172	26	43	3599.31	7198.62	15	1	0.0301889472764032	-0.925925925925926	0.771992783106328	-0.137873541105553	69	226
LAMB1	11	79	8	16	1729.53	3459.06	15	1	0.0266973377067713	-2.59090909090909	0.761210061313465	-0.211111111111111	24	90
LAMB2	29	66	32	44	1380.39	2760.78	15	1	0.148200521784732	-0.655172413793103	1	-0.11578947368421	76	95
LAMB3	34	67	17	16	1112.76	2225.52	15	1	0.0975988592802055	-1.09375	0.971353639774823	-0.178517851785178	33	101
LAMB4	63	68	9	13	1706.76	3413.52	15	1	0.646111807244847	0.252747252747253	1	0.0718251214434421	22	131
LAMC1	13	53	7	7	1467.18	2934.36	15	1	0.0362062838902088	-3.07692307692308	0.788199921465956	-0.303030303030303	14	66
LAMC2	45	50	8	6	1155.66	2311.32	15	1	0.573635319570382	-0.481481481481481	1	-0.0977443609022556	14	95
LAMC3	45	64	41	37	1355.31	2710.62	15	1	0.13893134878495	-0.575975975975976	1	-0.112796988943778	78	109
LAMP1	17	21	0	3	400.62	801.24	15	1	0.253658536585366	1	1	0.447368421052632	3	38
LAMP2	16	16	2	1	402.6	805.2	15	1	1	-1	1	-0.166666666666667	3	32
LAMP3	16	21	2	1	421.74	843.48	15	1	0.57914979757085	-1.625	1	-0.234234234234234	3	37
LAMP5	4	6	3	0	258.39	516.78	15	1	0.192307692307693	-Inf	1	-0.6	3	10
LAMTOR3	0	7	0	0	115.83	231.66	15	1	1	NA	1	NA	0	7
LAMTOR5	0	2	0	1	59.07	118.14	15	1	1	NA	1	0	1	2
LANCL1	2	24	1	5	382.8	765.6	15	1	0.475806451612903	-1.4	1	-0.0897435897435897	6	26
LANCL3	16	22	5	4	530.64	1061.28	15	1	0.486368738007024	-0.71875	1	-0.134502923976608	9	38
LAP3	12	25	0	1	514.8	1029.6	15	1	1	1	1	0.324324324324324	1	37
LAPTM4A	3	5	0	1	237.6	475.2	15	1	1	1	1	0.375	1	8
LAPTM4B	0	9	0	2	222.75	445.5	15	1	1	NA	1	0	2	9
LAPTM5	8	12	4	2	256.41	512.82	15	1	0.365217391304348	-2	1	-0.266666666666667	6	20
LARGE1	0	16	0	5	455.07	910.14	15	1	1	NA	1	0	5	16
LARGE2	7	35	4	13	721.71	1443.42	15	1	0.713223930772975	-0.538461538461539	1	-0.0686274509803922	17	42
LARP1	0	37	6	8	900.24	1800.48	15	1	0.000166745699204751	-Inf	0.0958390756857783	-0.428571428571429	14	37
LARP1B	20	24	3	2	921.36	1842.72	15	1	0.655039320692816	-0.8	1	-0.145454545454545	5	44
LARP4	4	17	5	5	715.77	1431.54	15	1	0.104543509882776	-3.25	0.983379501385042	-0.30952380952381	10	21
LARP4B	90	62	14	10	1810.71	3621.42	15	1	1	0.0355555555555556	1	0.00877192982456132	24	152
LARP6	11	17	5	8	430.65	861.3	15	1	1	0.0340909090909091	1	0.00824175824175821	13	28
LARP7	13	22	3	4	589.05	1178.1	15	1	1	-0.269230769230769	1	-0.0571428571428571	7	35
LARS	12	43	4	5	1172.16	2344.32	15	1	0.210433632789268	-1.86666666666667	1	-0.226262626262626	9	55
LARS2	16	34	8	8	895.95	1791.9	15	1	0.238012528379656	-1.125	1	-0.18	16	50
LAS1L	9	21	1	0	559.35	1118.7	15	1	0.32258064516129	-Inf	1	-0.7	1	30
LASP1	3	8	0	5	238.26	476.52	15	1	0.508928571428571	1	1	0.272727272727273	5	11
LAT2	14	13	0	3	179.52	359.04	15	1	0.227586206896552	1	1	0.518518518518518	3	27
LATS1	3	49	1	9	1128.6	2257.2	15	1	0.514694942143427	-0.814814814814815	1	-0.0423076923076923	10	52
LATS2	5	40	0	4	1114.74	2229.48	15	1	1	1	1	0.111111111111111	4	45
LBFABP	0	8	1	0	125.73	251.46	15	1	0.111111111111111	-Inf	0.98538656216834	-1	1	8
LBH	2	4	0	2	118.8	237.6	15	1	1	1	1	0.333333333333333	2	6
LBR	4	17	3	5	602.91	1205.82	15	1	0.356806212278476	-1.55	1	-0.18452380952381	8	21
LCA5	16	25	6	4	675.18	1350.36	15	1	0.295205060059004	-1.34375	1	-0.209756097560976	10	41
LCA5L	32	26	5	4	514.47	1028.94	15	1	1	-0.015625	1	-0.00383141762452111	9	58
LCAT	6	25	1	5	446.49	892.98	15	1	1	0.166666666666667	1	0.0268817204301075	6	31
LCK	1	11	0	5	318.45	636.9	15	1	1	1	1	0.0833333333333333	5	12
LCLAT1	11	14	1	3	368.28	736.56	15	1	0.622079070354932	0.575757575757576	1	0.19	4	25
LCMT1	4	7	2	2	294.36	588.72	15	1	1	-0.75	1	-0.136363636363636	4	11
LCMT2	42	27	2	2	878.13	1756.26	15	1	1	0.357142857142857	1	0.108695652173913	4	69
LCN15	4	13	0	0	181.17	362.34	15	1	1	NA	1	NA	0	17
LCOR	40	80	19	22	1927.53	3855.06	15	1	0.188325071795616	-0.727272727272727	1	-0.130081300813008	41	120
LCORL	4	8	0	0	596.97	1193.94	15	1	1	NA	1	NA	0	12
LCP1	3	28	1	3	618.75	1237.5	15	1	0.399064171122995	-2.11111111111111	1	-0.153225806451613	4	31
LCP2	9	16	0	7	528.66	1057.32	15	1	0.149189091868458	1	1	0.36	7	25
LCT	59	103	10	21	1905.75	3811.5	15	1	0.83820603615706	0.168684422921711	1	0.0416168857029072	31	162
LCTL	17	25	9	7	536.25	1072.5	15	1	0.377995033962536	-0.890756302521008	1	-0.157738095238095	16	42
LDAH	0	12	0	1	323.4	646.8	15	1	1	NA	1	0	1	12
LDB1	0	4	0	4	360.36	720.72	15	1	1	NA	1	0	4	4
LDB2	4	2	0	0	274.23	548.46	15	1	1	NA	1	NA	0	6
LDB3	2	11	0	0	309.21	618.42	15	1	1	NA	1	NA	0	13
LDHA	0	14	0	3	326.7	653.4	15	1	1	NA	1	0	3	14
LDHB	2	9	0	3	316.47	632.94	15	1	1	1	1	0.181818181818182	3	11
LDHD	3	9	1	9	207.9	415.8	15	1	0.593984962406015	0.666666666666667	1	0.15	10	12
LDLRAD3	27	20	4	6	566.94	1133.88	15	1	0.486276166149406	0.506172839506173	1	0.174468085106383	10	47
LDLRAD4	1	9	3	4	230.34	460.68	15	1	0.25	-5.75	1	-0.328571428571429	7	10
LEAP2	2	3	1	1	113.85	227.7	15	1	1	-0.5	1	-0.1	2	5
LECT2	6	20	2	4	321.75	643.5	15	1	0.624768261030775	-0.666666666666667	1	-0.102564102564103	6	26
LEF1	0	7	0	4	324.72	649.44	15	1	1	NA	1	0	4	7
LEKR1	25	31	15	7	695.97	1391.94	15	1	0.0798490136590813	-1.65714285714286	0.936566440349175	-0.23538961038961	22	56
LEMD2	7	23	2	6	451.11	902.22	15	1	1	-0.0952380952380953	1	-0.0166666666666667	8	30
LEMD3	3	17	3	4	569.91	1139.82	15	1	0.289642241816155	-3.25	1	-0.278571428571429	7	20
LEO1	4	27	0	5	631.29	1262.58	15	1	1	1	1	0.129032258064516	5	31
LEPR	39	37	7	10	1144.44	2288.88	15	1	0.593009062336176	0.335897435897436	1	0.101393188854489	17	76
LEPROT	1	9	0	5	125.4	250.8	15	1	1	1	1	0.1	5	10
LEPROTL1	1	5	0	1	125.4	250.8	15	1	1	1	1	0.166666666666667	1	6
LETM1	8	27	1	5	723.36	1446.72	15	1	1	0.325	1	0.0619047619047619	6	35
LEXM	13	9	6	4	297	594	15	1	1	-0.0384615384615385	1	-0.00909090909090904	10	22
LFNG	0	8	0	4	204.93	409.86	15	1	1	NA	1	0	4	8
LGALS1	5	8	1	3	133.65	267.3	15	1	1	0.466666666666667	1	0.134615384615385	4	13
LGALS2	5	3	1	1	130.68	261.36	15	1	1	0.4	1	0.125	2	8
LGALS3	14	17	1	2	218.46	436.92	15	1	1	0.392857142857143	1	0.118279569892473	3	31
LGALS8	8	8	3	3	294.03	588.06	15	1	1	0	1	0	6	16
LGALSL	0	4	0	1	159.39	318.78	15	1	1	NA	1	0	1	4
LGI2	1	16	1	2	516.12	1032.24	15	1	0.28421052631579	-7	1	-0.274509803921569	3	17
LGMN	5	16	2	1	427.68	855.36	15	1	0.193675889328063	-5.4	1	-0.428571428571429	3	21
LGR5	2	17	1	4	836.22	1672.44	15	1	0.521245059288538	-1.125	1	-0.0947368421052632	5	19
LGR6	2	19	2	10	945.78	1891.56	15	1	0.609970674486804	-0.9	1	-0.0714285714285714	12	21
LGSN	36	31	1	5	791.01	1582.02	15	1	0.107038898069777	0.827777777777778	0.983875031494079	0.370646766169154	6	67
LHCGR	5	31	2	9	688.71	1377.42	15	1	0.659322605746764	-0.377777777777778	1	-0.0429292929292929	11	36
LHFP	0	4	2	3	141.57	283.14	15	1	0.444444444444445	-Inf	1	-0.4	5	4
LHFPL2	1	6	0	3	216.81	433.62	15	1	1	1	1	0.142857142857143	3	7
LHFPL5	0	2	0	2	196.68	393.36	15	1	1	NA	1	0	2	2
LHPP	4	11	0	4	214.17	428.34	15	1	0.530443756449948	1	1	0.266666666666667	4	15
LHX1	0	1	1	0	214.17	428.34	15	1	1	-Inf	1	-1	1	1
LHX2	1	3	1	2	376.53	753.06	15	1	1	-0.5	1	-0.0833333333333333	3	4
LHX3	0	1	2	0	139.92	279.84	15	1	0.333333333333333	-Inf	1	-1	2	1
LHX4	0	2	1	0	144.21	288.42	15	1	0.333333333333333	-Inf	1	-1	1	2
LHX4-AS1	3	6	1	1	199.98	399.96	15	1	1	-1	1	-0.166666666666667	2	9
LHX5	0	2	0	2	198.99	397.98	15	1	1	NA	1	0	2	2
LHX6	0	8	0	6	270.27	540.54	15	1	1	NA	1	0	6	8
LHX8	1	11	0	0	312.84	625.68	15	1	1	NA	1	NA	0	12
LHX9	0	7	1	2	375.21	750.42	15	1	0.3	-Inf	1	-0.333333333333333	3	7
LIAS	6	19	2	3	354.42	708.84	15	1	0.589350623833382	-1.11111111111111	1	-0.16	5	25
LIFR	11	44	3	3	1082.07	2164.14	15	1	0.127535174370376	-3	1	-0.3	6	55
LIG1	1	8	0	1	125.4	250.8	15	1	1	1	1	0.111111111111111	1	9
LIG3	9	29	0	11	856.35	1712.7	15	1	0.097957781939622	1	0.971353639774823	0.236842105263158	11	38
LIG4	14	39	0	2	903.87	1807.74	15	1	1	1	1	0.264150943396226	2	53
LIMA1	21	27	5	6	809.49	1618.98	15	1	1	-0.0714285714285714	1	-0.0170454545454545	11	48
LIMCH1	46	60	17	10	1663.53	3327.06	15	1	0.0853910290077205	-1.21739130434783	0.950356516076024	-0.195667365478686	27	106
LIMD1	16	33	16	12	609.51	1219.02	15	1	0.0540473963033359	-1.75	0.846060006968071	-0.244897959183673	28	49
LIMD2	0	2	0	2	87.45	174.9	15	1	1	NA	1	0	2	2
LIME1	6	5	1	1	100.65	201.3	15	1	1	0.166666666666667	1	0.0454545454545454	2	11
LIMK1	22	35	7	14	794.97	1589.94	15	1	0.793917720740181	0.204545454545455	1	0.0526315789473684	21	57
LIMS1	1	19	2	2	384.12	768.24	15	1	0.0612648221343873	-18	0.873041798302308	-0.45	4	20
LIMS1-LIMS2	6	7	2	0	261.36	522.72	15	1	0.466666666666667	-Inf	1	-0.538461538461538	2	13
LIN28A	0	6	1	1	190.74	381.48	15	1	0.25	-Inf	1	-0.5	2	6
LIN54	2	26	3	4	774.18	1548.36	15	1	0.043837329653269	-8.75	0.822543273817637	-0.357142857142857	7	28
LIN7A	0	4	0	2	202.62	405.24	15	1	1	NA	1	0	2	4
LINC00954	21	35	8	3	906.18	1812.36	15	1	0.0458790010922966	-3.44444444444444	0.82527502709988	-0.352272727272727	11	56
LINGO1	0	13	1	6	600.93	1201.86	15	1	0.35	-Inf	1	-0.142857142857143	7	13
LINGO2	4	25	1	0	600.93	1201.86	15	1	0.166666666666667	-Inf	1	-0.862068965517241	1	29
LIPA	6	15	0	2	395.01	790.02	15	1	1	1	1	0.285714285714286	2	21
LIPC	5	19	2	1	536.58	1073.16	15	1	0.155555555555556	-6.6	1	-0.458333333333333	3	24
LIPG	15	31	0	12	452.43	904.86	15	1	0.0251085536444675	1	0.761210061313465	0.326086956521739	12	46
LIPI	5	17	2	2	457.38	914.76	15	1	0.287023411371238	-2.4	1	-0.272727272727273	4	22
LIPML1	9	13	1	0	391.05	782.1	15	1	0.434782608695652	-Inf	1	-0.590909090909091	1	22
LIPML2	10	13	0	0	399.96	799.92	15	1	1	NA	1	NA	0	23
LIPML3	11	15	1	0	395.01	790.02	15	1	0.444444444444444	-Inf	1	-0.576923076923077	1	26
LIPML4	12	29	1	8	693	1386	15	1	0.414099427177019	0.697916666666667	1	0.181571815718157	9	41
LIPT1	15	16	4	6	368.94	737.88	15	1	0.726864763450129	0.288888888888889	1	0.0838709677419355	10	31
LITAF	16	12	1	1	214.5	429	15	1	1	0.25	1	0.0714285714285714	2	28
LIX1	3	14	7	2	279.18	558.36	15	1	0.00850362452193116	-15.3333333333333	0.54233354502865	-0.601307189542484	9	17
LLGL2	6	42	1	4	1014.09	2028.18	15	1	0.522332938981108	-0.75	1	-0.075	5	48
LLPH	5	2	0	0	111.87	223.74	15	1	1	NA	1	NA	0	7
LMAN1	2	15	1	4	435.27	870.54	15	1	1	-0.875	1	-0.0823529411764706	5	17
LMAN2	0	11	0	7	240.24	480.48	15	1	1	NA	1	0	7	11
LMBR1	0	16	0	0	440.55	881.1	15	1	1	NA	1	NA	0	16
LMBRD1	3	16	0	0	524.37	1048.74	15	1	1	NA	1	NA	0	19
LMBRD2	18	33	1	0	815.43	1630.86	15	1	0.365384615384615	-Inf	1	-0.647058823529412	1	51
LMCD1	2	11	2	9	319.11	638.22	15	1	1	-0.222222222222222	1	-0.027972027972028	11	13
LMF1	15	22	11	12	689.04	1378.08	15	1	0.603234149662732	-0.344444444444445	1	-0.072855464159812	23	37
LMINA	16	17	2	3	576.84	1153.68	15	1	1	0.291666666666667	1	0.0848484848484848	5	33
LMLN	4	16	1	4	577.17	1154.34	15	1	1	0	1	0	5	20
LMNB1	24	19	1	2	543.84	1087.68	15	1	0.58498023715415	0.604166666666667	1	0.224806201550388	3	43
LMNB2	2	23	0	5	590.7	1181.4	15	1	1	1	1	0.08	5	25
LMO1	1	6	0	2	158.4	316.8	15	1	1	1	1	0.142857142857143	2	7
LMO2	0	3	0	1	169.29	338.58	15	1	1	NA	1	0	1	3
LMO4	0	1	0	1	125.73	251.46	15	1	1	NA	1	0	1	1
LMO7	49	61	5	6	1915.32	3830.64	15	1	1	-0.0374149659863945	1	-0.00909090909090909	11	110
LMOD1	13	23	1	7	547.8	1095.6	15	1	0.402448009756127	0.747252747252747	1	0.236111111111111	8	36
LMOD2	9	19	3	1	509.19	1018.38	15	1	0.136123470522803	-5.33333333333333	1	-0.428571428571429	4	28
LMOD3	7	15	6	5	526.68	1053.36	15	1	0.269707887991488	-1.57142857142857	1	-0.227272727272727	11	22
LMTK2	48	57	4	3	1437.15	2874.3	15	1	0.702529367630987	-0.583333333333333	1	-0.114285714285714	7	105
LMX1A	4	5	1	7	230.67	461.34	15	1	0.294117647058824	0.821428571428571	1	0.319444444444444	8	9
LMX1B	0	6	0	0	297.99	595.98	15	1	1	NA	1	NA	0	6
LNP1	6	4	0	1	198	396	15	1	0.454545454545455	1	1	0.6	1	10
LNPEP	25	38	3	7	1027.29	2054.58	15	1	0.731589554083715	0.348571428571429	1	0.0968253968253968	10	63
LNPK	7	17	4	1	438.57	877.14	15	1	0.0539093090817229	-8.71428571428571	0.846060006968071	-0.508333333333333	5	24
LNX1	17	28	6	7	771.21	1542.42	15	1	0.74902984076007	-0.411764705882353	1	-0.0837606837606838	13	45
LOC100857191	2	3	1	1	43.89	87.78	15	1	1	-0.5	1	-0.1	2	5
LOC100857197	3	7	1	1	187.11	374.22	15	1	1	-1.33333333333333	1	-0.2	2	10
LOC100857335	2	3	1	2	64.35	128.7	15	1	1	0.25	1	0.0666666666666667	3	5
LOC100857421-LOC107049109-LOC107053040-LOC107053041-LOC112532176-LOC112532200	40	14	4	5	362.67	725.34	15	1	0.113989341549092	0.72	0.996993733693869	0.296296296296296	9	54
LOC100857468	5	7	1	1	142.56	285.12	15	1	1	-0.4	1	-0.0833333333333333	2	12
LOC100857560-LOC101749671-LOC107050609-LOC107052549-LOC107055882-LOC107055885-LOC107055896-LOC107055944-LOC107055956-LOC107055976-LOC112529950-LOC112531710-LOC112531711-LOC112531712-LOC420615-NUPL2	6	10	2	2	160.38	320.76	15	1	1	-0.666666666666667	1	-0.125	4	16
LOC100857632	11	28	4	12	725.34	1450.68	15	1	1	0.151515151515151	1	0.032051282051282	16	39
LOC100857698-LOC100857710-LOC100858444-LOC100859148-LOC107049929-LOC107052804-LOC107052814	0	4	1	1	265.32	530.64	15	1	0.333333333333333	-Inf	1	-0.5	2	4
LOC100857706	31	18	5	6	340.23	680.46	15	1	0.320868859314654	0.516129032258065	1	0.178107606679035	11	49
LOC100857820-LOC101747680-LOC107049164-LOC415661-LOC415662-LOC769668	15	16	4	2	236.28	472.56	15	1	0.65988065988066	-1.13333333333333	1	-0.182795698924731	6	31
LOC100857834	13	6	6	5	289.74	579.48	15	1	0.695609338188049	0.446153846153846	1	0.138755980861244	11	19
LOC100857843	6	8	3	3	176.55	353.1	15	1	1	-0.333333333333333	1	-0.0714285714285715	6	14
LOC100857883	6	15	6	7	412.83	825.66	15	1	0.46175702471345	-1.14285714285714	1	-0.175824175824176	13	21
LOC100857892	12	6	1	2	140.91	281.82	15	1	0.530827067669173	0.75	1	0.333333333333333	3	18
LOC100858068	6	3	3	4	46.2	92.4	15	1	0.61451048951049	0.625	1	0.238095238095238	7	9
LOC100858131	50	28	21	10	694.98	1389.96	15	1	0.825102688737702	-0.176	1	-0.0363937138130686	31	78
LOC100858196	35	22	12	20	820.71	1641.42	15	1	0.0458743607505509	0.622857142857143	0.82527502709988	0.239035087719298	32	57
LOC100858293	3	4	3	3	115.17	230.34	15	1	1	-0.333333333333333	1	-0.0714285714285715	6	7
LOC100858347	45	31	9	15	775.5	1551	15	1	0.0989705858983822	0.586666666666667	0.971353639774823	0.217105263157895	24	76
LOC100858360	11	8	0	2	258.72	517.44	15	1	0.214285714285714	1	1	0.578947368421053	2	19
LOC100858426	0	4	0	1	89.1	178.2	15	1	1	NA	1	0	1	4
LOC100858460	9	18	2	2	385.11	770.22	15	1	0.60146194184014	-1	1	-0.166666666666667	4	27
LOC100858579	9	9	0	1	278.85	557.7	15	1	1	1	1	0.5	1	18
LOC100858647	11	1	0	1	110.88	221.76	15	1	0.153846153846154	1	1	0.916666666666667	1	12
LOC100858777	2	14	0	4	404.91	809.82	15	1	1	1	1	0.125	4	16
LOC100858814	0	1	1	1	103.62	207.24	15	1	1	-Inf	1	-0.5	2	1
LOC100858941	3	7	0	0	201.96	403.92	15	1	1	NA	1	NA	0	10
LOC100858942	5	2	1	2	82.17	164.34	15	1	0.5	0.8	1	0.380952380952381	3	7
LOC100858953	11	10	4	3	147.51	295.02	15	1	1	-0.212121212121212	1	-0.0476190476190476	7	21
LOC100858995	6	9	6	5	207.9	415.8	15	1	0.692165836586351	-0.8	1	-0.145454545454545	11	15
LOC100859173	5	14	1	2	408.87	817.74	15	1	1	-0.4	1	-0.0701754385964912	3	19
LOC100859230	6	29	5	21	538.89	1077.78	15	1	1	-0.150793650793651	1	-0.0208791208791209	26	35
LOC100859276-RBM14	3	13	3	8	401.94	803.88	15	1	0.661835748792271	-0.625	1	-0.0852272727272727	11	16
LOC100859284	2	4	0	1	55.11	110.22	15	1	1	1	1	0.333333333333333	1	6
LOC100859449	7	25	3	6	407.55	815.1	15	1	0.662243332484214	-0.785714285714286	1	-0.114583333333333	9	32
LOC100859549	9	6	1	0	125.07	250.14	15	1	1	-Inf	1	-0.4	1	15
LOC100859602	0	11	1	1	727.65	1455.3	15	1	0.153846153846154	-Inf	1	-0.5	2	11
LOC100859615	3	11	3	9	188.1	376.2	15	1	1	-0.222222222222222	1	-0.0357142857142857	12	14
LOC100859636	6	7	1	1	222.75	445.5	15	1	1	-0.166666666666667	1	-0.0384615384615384	2	13
LOC100859726	10	10	1	5	246.51	493.02	15	1	0.197324414715719	0.8	1	0.333333333333333	6	20
LOC100859837	20	17	5	13	549.78	1099.56	15	1	0.0872513236437999	0.673076923076923	0.951277979139867	0.262762762762763	18	37
LOC100859848	8	10	1	1	57.75	115.5	15	1	1	-0.25	1	-0.0555555555555556	2	18
LOC100859850	21	8	2	0	255.42	510.84	15	1	1	-Inf	1	-0.275862068965517	2	29
LOC101747255	21	17	4	9	363.33	726.66	15	1	0.1993501881751	0.64021164021164	1	0.244939271255061	13	38
LOC101747310	2	6	1	3	139.59	279.18	15	1	1	0	1	0	4	8
LOC101747338	12	19	4	11	320.43	640.86	15	1	0.519660612655771	0.424242424242424	1	0.120430107526882	15	31
LOC101747367	2	15	1	3	329.67	659.34	15	1	0.488721804511278	-1.5	1	-0.132352941176471	4	17
LOC101747373-MANBAL1-MANBAL14-MANBAL15-MANBAL17-MANBAL4-MANBAL7	0	7	0	1	85.14	170.28	15	1	1	NA	1	0	1	7
LOC101747386	11	10	1	1	140.58	281.16	15	1	1	0.0909090909090909	1	0.0238095238095238	2	21
LOC101747521	9	16	3	4	410.85	821.7	15	1	1	-0.333333333333333	1	-0.0685714285714286	7	25
LOC101747522	4	11	3	8	232.32	464.64	15	1	1	-0.03125	1	-0.00606060606060604	11	15
LOC101747537	19	6	3	1	185.13	370.26	15	1	1	0.0526315789473685	1	0.01	4	25
LOC101747588	29	33	18	7	746.46	1492.92	15	1	0.0362097014193151	-1.92610837438424	0.788199921465956	-0.252258064516129	25	62
LOC101747660	17	26	14	7	372.24	744.48	15	1	0.0620996234242264	-2.05882352941176	0.877684373220624	-0.271317829457364	21	43
LOC101747799	24	12	1	1	227.04	454.08	15	1	1	0.5	1	0.166666666666667	2	36
LOC101747820	2	6	1	2	192.39	384.78	15	1	1	-0.5	1	-0.0833333333333333	3	8
LOC101747844	10	8	0	1	311.85	623.7	15	1	0.473684210526316	1	1	0.555555555555556	1	18
LOC101747868	3	7	2	4	126.72	253.44	15	1	1	-0.166666666666667	1	-0.0333333333333333	6	10
LOC101747958	12	8	2	2	212.85	425.7	15	1	1	0.333333333333333	1	0.1	4	20
LOC101747995	5	4	1	0	130.68	261.36	15	1	1	-Inf	1	-0.444444444444444	1	9
LOC101748011	22	12	11	3	278.19	556.38	15	1	0.497921487840877	-1	1	-0.138655462184874	14	34
LOC101748017	0	3	0	2	175.23	350.46	15	1	1	NA	1	0	2	3
LOC101748058	6	17	6	3	722.7	1445.4	15	1	0.049268417900231	-4.66666666666667	0.837400931738441	-0.405797101449275	9	23
LOC101748060	83	76	21	9	2239.71	4479.42	15	1	0.108358084211167	-1.13654618473896	0.985224113668503	-0.177987421383648	30	159
LOC101748065	2	3	0	0	79.2	158.4	15	1	1	NA	1	NA	0	5
LOC101748113	23	25	7	2	454.08	908.16	15	1	0.149445857606381	-2.80434782608696	1	-0.298611111111111	9	48
LOC101748153	23	29	15	17	749.76	1499.52	15	1	0.825445734920032	-0.112531969309463	1	-0.0264423076923077	32	52
LOC101748203	8	12	2	4	206.91	413.82	15	1	1	0.25	1	0.0666666666666667	6	20
LOC101748207	35	42	6	4	767.91	1535.82	15	1	0.506138211579125	-0.8	1	-0.145454545454545	10	77
LOC101748311	3	13	5	2	266.31	532.62	15	1	0.02573045028288	-9.83333333333333	0.761210061313465	-0.526785714285714	7	16
LOC101748328	23	7	0	1	401.28	802.56	15	1	0.258064516129032	1	1	0.766666666666667	1	30
LOC101748329	7	10	4	0	196.02	392.04	15	1	0.0902255639097744	-Inf	0.953786405978059	-0.588235294117647	4	17
LOC101748521	8	42	4	8	803.88	1607.76	15	1	0.223476048595602	-1.625	1	-0.173333333333333	12	50
LOC101748543	8	8	2	6	329.01	658.02	15	1	0.387535334499933	0.666666666666667	1	0.25	8	16
LOC101748650-THRSP-THRSPB	9	8	0	3	133.65	267.3	15	1	0.218421052631579	1	1	0.529411764705882	3	17
LOC101748683	32	26	18	13	501.27	1002.54	15	1	0.826079092906023	-0.125	1	-0.0289210233592881	31	58
LOC101748694	12	23	4	4	543.51	1087.02	15	1	0.44327406488197	-0.916666666666667	1	-0.157142857142857	8	35
LOC101748744	8	19	1	9	367.29	734.58	15	1	0.393244746414936	0.736111111111111	1	0.196296296296296	10	27
LOC101748751	27	40	4	3	556.38	1112.76	15	1	0.443016403084805	-0.975308641975309	1	-0.168443496801706	7	67
LOC101748752	1	1	0	0	54.45	108.9	15	1	1	NA	1	NA	0	2
LOC101748883	8	6	2	3	292.71	585.42	15	1	0.628482972136223	0.5	1	0.171428571428571	5	14
LOC101748951	46	43	5	1	814.77	1629.54	15	1	0.21149685133703	-3.67391304347826	1	-0.316479400749064	6	89
LOC101749017	25	16	8	8	318.45	636.9	15	1	0.554307561344817	0.36	1	0.109756097560976	16	41
LOC101749023	2	16	3	7	661.65	1323.3	15	1	0.315018315018315	-2.42857142857143	1	-0.188888888888889	10	18
LOC101749151	6	9	3	3	357.39	714.78	15	1	1	-0.5	1	-0.1	6	15
LOC101749175	1	4	0	0	48.51	97.02	15	1	1	NA	1	NA	0	5
LOC101749214	21	24	6	7	523.71	1047.42	15	1	1	0.0204081632653061	1	0.00512820512820511	13	45
LOC101749216	2	4	0	1	97.68	195.36	15	1	1	1	1	0.333333333333333	1	6
LOC101749220	145	91	56	26	1658.25	3316.5	15	1	0.289900810954094	-0.351724137931035	1	-0.0685200496072758	82	236
LOC101749223	13	66	2	13	2047.32	4094.64	15	1	1	0.218934911242604	1	0.0312236286919831	15	79
LOC101749275	29	16	0	2	540.87	1081.74	15	1	0.141535615171138	1	1	0.644444444444444	2	45
LOC101749287	0	3	0	0	171.93	343.86	15	1	1	NA	1	NA	0	3
LOC101749307	18	16	7	4	260.37	520.74	15	1	0.729497812311199	-0.555555555555556	1	-0.106951871657754	11	34
LOC101749460	11	16	2	0	507.87	1015.74	15	1	0.192118226600985	-Inf	1	-0.592592592592593	2	27
LOC101749502	13	14	0	1	228.69	457.38	15	1	1	1	1	0.481481481481481	1	27
LOC101749593	12	28	8	9	512.82	1025.64	15	1	0.240058939182115	-1.07407407407407	1	-0.170588235294118	17	40
LOC101749599-UGT1A1	8	16	0	1	288.42	576.84	15	1	1	1	1	0.333333333333333	1	24
LOC101749628	0	2	0	0	80.19	160.38	15	1	1	NA	1	NA	0	2
LOC101749641	15	9	0	3	327.69	655.38	15	1	0.0752136752136752	1	0.916285648878989	0.625	3	24
LOC101749694	13	30	4	5	414.15	828.3	15	1	0.451415559463663	-0.846153846153846	1	-0.142118863049096	9	43
LOC101749834	6	16	2	4	398.64	797.28	15	1	1	-0.333333333333333	1	-0.0606060606060606	6	22
LOC101749904-LOC107049162-LOC112532554	23	25	4	4	522.72	1045.44	15	1	1	-0.0869565217391304	1	-0.0208333333333333	8	48
LOC101749950	0	5	0	2	316.14	632.28	15	1	1	NA	1	0	2	5
LOC101750112-LOC420486	4	12	1	1	479.49	958.98	15	1	0.490196078431373	-2	1	-0.25	2	16
LOC101750121	5	11	0	7	313.83	627.66	15	1	0.271895152902018	1	1	0.3125	7	16
LOC101750367	13	6	1	3	199.98	399.96	15	1	0.260079051383399	0.846153846153846	1	0.434210526315789	4	19
LOC101750423	27	20	3	3	393.03	786.06	15	1	1	0.259259259259259	1	0.074468085106383	6	47
LOC101750445	4	9	4	4	174.24	348.48	15	1	0.645820433436533	-1.25	1	-0.192307692307692	8	13
LOC101750583	53	35	5	5	672.21	1344.42	15	1	0.735888554138164	0.339622641509434	1	0.102272727272727	10	88
LOC101750612	38	33	16	12	852.39	1704.78	15	1	0.824452890338196	-0.157894736842105	1	-0.0362173038229376	28	71
LOC101750621	13	10	5	5	325.71	651.42	15	1	1	0.230769230769231	1	0.0652173913043478	10	23
LOC101750658	9	10	1	1	191.4	382.8	15	1	1	-0.111111111111111	1	-0.0263157894736842	2	19
LOC101750690	5	11	1	3	331.98	663.96	15	1	1	0.266666666666667	1	0.0625	4	16
LOC101750822	22	11	6	7	286.44	572.88	15	1	0.314646168394265	0.571428571428571	1	0.205128205128205	13	33
LOC101750842	7	7	4	2	337.26	674.52	15	1	0.642414860681115	-1	1	-0.166666666666667	6	14
LOC101750892	19	18	3	3	472.23	944.46	15	1	1	0.0526315789473685	1	0.0135135135135135	6	37
LOC101750908	2	0	1	0	40.92	81.84	15	1	1	NA	1	0	1	2
LOC101750948	12	17	1	2	408.87	817.74	15	1	1	0.291666666666667	1	0.0804597701149425	3	29
LOC101751416-LOC107049563-LOC107050168-LOC107052752-LOC107055859-LOC107055860	34	17	0	0	467.28	934.56	15	1	1	NA	1	NA	0	51
LOC101751418	17	7	2	1	169.29	338.58	15	1	1	0.176470588235294	1	0.0416666666666667	3	24
LOC101751615-LOC770126	23	13	12	7	296.01	592.02	15	1	1	0.031055900621118	1	0.00730994152046782	19	36
LOC101751669	3	5	2	12	388.74	777.48	15	1	0.308878256246677	0.722222222222222	1	0.232142857142857	14	8
LOC101751687	5	0	1	2	95.37	190.74	15	1	0.107142857142857	1	0.983875031494079	0.666666666666667	3	5
LOC101751717	4	5	2	1	161.7	323.4	15	1	1	-1.5	1	-0.222222222222222	3	9
LOC101751874	72	62	25	14	1434.84	2869.68	15	1	0.276103062567996	-0.537698412698413	1	-0.10371220818982	39	134
LOC101751902	6	25	1	4	238.92	477.84	15	1	1	-0.0416666666666667	1	-0.00645161290322582	5	31
LOC101751992	5	5	0	1	106.26	212.52	15	1	1	1	1	0.5	1	10
LOC101752020-LOC107049176	3	3	0	0	98.01	196.02	15	1	1	NA	1	NA	0	6
LOC101752065	9	16	7	10	402.93	805.86	15	1	0.757046175017362	-0.244444444444444	1	-0.0517647058823529	17	25
LOC101752158	21	15	5	5	326.7	653.4	15	1	0.726357100151768	0.285714285714286	1	0.0833333333333334	10	36
LOC101752250	12	8	0	1	229.68	459.36	15	1	0.428571428571429	1	1	0.6	1	20
LOC107048987-LOC112532770-MT	18	16	1	2	245.52	491.04	15	1	0.603861003861004	0.555555555555556	1	0.196078431372549	3	34
LOC107048995	10	11	0	1	251.46	502.92	15	1	1	1	1	0.476190476190476	1	21
LOC107049011	11	23	5	7	646.8	1293.6	15	1	0.726236072774569	-0.493506493506493	1	-0.0931372549019608	12	34
LOC107049018	18	21	6	0	297	594	15	1	0.0231870606232489	-Inf	0.735459686256967	-0.538461538461538	6	39
LOC107049033	29	18	0	6	571.23	1142.46	15	1	0.00586283860423705	1	0.467685236262114	0.617021276595745	6	47
LOC107049046-LOC107055485-RPL17	0	10	0	5	154.44	308.88	15	1	1	NA	1	0	5	10
LOC107049050-LOC418086	8	2	3	1	290.4	580.8	15	1	1	0.25	1	0.05	4	10
LOC107049066	2	8	0	1	321.75	643.5	15	1	1	1	1	0.2	1	10
LOC107049146	1	9	1	8	271.26	542.52	15	1	1	-0.125	1	-0.0111111111111111	9	10
LOC107049165	15	12	6	8	510.51	1021.02	15	1	0.520396573355145	0.4	1	0.126984126984127	14	27
LOC107049250	13	18	1	3	359.37	718.74	15	1	0.635026737967914	0.538461538461538	1	0.169354838709677	4	31
LOC107049469-LOC426064-LOC769729	17	9	0	0	189.42	378.84	15	1	1	NA	1	NA	0	26
LOC107049639-LOC107050249-LOC107050274-LOC112531365-LOC112531366-LOC112531367-LOC112531368-LOC112531369-LOC112531380-LOC112531381-LOC112531382-LOC112531383-LOC112531389-LOC112531391-LOC112531395-LOC112531398-LOC112531399-LOC112531413-LOC112531414-LOC112531417	15	7	1	0	54.12	108.24	15	1	1	-Inf	1	-0.318181818181818	1	22
LOC107049672	27	52	3	3	712.8	1425.6	15	1	0.660780342110397	-0.925925925925926	1	-0.158227848101266	6	79
LOC107049895	3	1	0	1	79.2	158.4	15	1	0.4	1	1	0.75	1	4
LOC107050083	14	8	9	6	513.81	1027.62	15	1	1	0.142857142857143	1	0.0363636363636364	15	22
LOC107050229	20	39	3	4	517.77	1035.54	15	1	0.687287369998237	-0.4625	1	-0.0895883777239709	7	59
LOC107050254	2	7	0	3	225.72	451.44	15	1	1	1	1	0.222222222222222	3	9
LOC107050336	8	5	0	0	102.63	205.26	15	1	1	NA	1	NA	0	13
LOC107050437	69	117	18	20	2371.71	4743.42	15	1	0.274369905133458	-0.526086956521739	1	-0.102716468590832	38	186
LOC107050638	34	29	27	24	822.69	1645.38	15	1	1	0.0404411764705882	1	0.0102707749766573	51	63
LOC107050706	0	1	0	1	141.24	282.48	15	1	1	NA	1	0	1	1
LOC107050717	0	1	1	3	93.39	186.78	15	1	1	-Inf	1	-0.25	4	1
LOC107050760	4	12	2	3	344.85	689.7	15	1	0.597523219814241	-1	1	-0.15	5	16
LOC107050879	1	23	1	11	915.75	1831.5	15	1	1	-1.09090909090909	1	-0.0416666666666667	12	24
LOC107051508-LOC771972	22	8	6	5	253.77	507.54	15	1	0.28017971001574	0.563636363636364	1	0.187878787878788	11	30
LOC107051671	22	11	1	1	263.34	526.68	15	1	1	0.5	1	0.166666666666667	2	33
LOC107051674	12	3	0	0	93.06	186.12	15	1	1	NA	1	NA	0	15
LOC107051846	9	51	8	15	963.6	1927.2	15	1	0.0671556076597387	-2.02222222222222	0.884435842948953	-0.197826086956522	23	60
LOC107051857	4	15	0	1	93.72	187.44	15	1	1	1	1	0.210526315789474	1	19
LOC107051902-LRRC63	28	14	8	3	363	726	15	1	1	-0.333333333333333	1	-0.0606060606060607	11	42
LOC107052104	33	25	11	11	675.84	1351.68	15	1	0.621671039958503	0.242424242424242	1	0.0689655172413793	22	58
LOC107052138-LOC107052143-OR10A4-OR10A7	6	7	0	1	317.79	635.58	15	1	1	1	1	0.461538461538462	1	13
LOC107052215	2	4	0	2	100.65	201.3	15	1	1	1	1	0.333333333333333	2	6
LOC107052456	10	12	0	4	198.99	397.98	15	1	0.135785953177258	1	1	0.454545454545455	4	22
LOC107052463	10	11	2	0	315.81	631.62	15	1	0.478260869565218	-Inf	1	-0.523809523809524	2	21
LOC107052467	6	15	4	8	278.52	557.04	15	1	1	-0.25	1	-0.0476190476190476	12	21
LOC107052576	3	2	1	0	134.64	269.28	15	1	1	-Inf	1	-0.4	1	5
LOC107052690	7	10	3	4	250.47	500.94	15	1	1	-0.0714285714285714	1	-0.0168067226890756	7	17
LOC107052882	9	5	4	2	265.32	530.64	15	1	1	-0.111111111111111	1	-0.0238095238095237	6	14
LOC107053055	37	42	5	5	1494.24	2988.48	15	1	1	-0.135135135135135	1	-0.0316455696202532	10	79
LOC107053414	37	55	2	4	1610.4	3220.8	15	1	1	0.256756756756757	1	0.068840579710145	6	92
LOC107053690	9	11	1	4	215.16	430.32	15	1	0.614624505928854	0.694444444444444	1	0.25	5	20
LOC107053700	13	9	2	1	196.68	393.36	15	1	1	-0.384615384615385	1	-0.0757575757575757	3	22
LOC107053714	56	28	2	5	642.51	1285.02	15	1	0.0940823339446129	0.8	0.960983694935281	0.380952380952381	7	84
LOC107053715	63	73	10	18	1197.9	2395.8	15	1	0.404128774914535	0.35626102292769	1	0.10609243697479	28	136
LOC107054051	0	13	1	1	181.17	362.34	15	1	0.133333333333333	-Inf	1	-0.5	2	13
LOC107054133	0	21	0	3	613.47	1226.94	15	1	1	NA	1	0	3	21
LOC107054221	1	0	1	1	49.5	99	15	1	1	1	1	0.5	2	1
LOC107054332-PARP11	5	7	0	0	328.68	657.36	15	1	1	NA	1	NA	0	12
LOC107054460-LOC107054461-LOC107054462-LOC107054465-LOC107054466-LOC107054467-LOC107054471-LOC107056903-LOC107056913-LOC107056929-LOC107056948-LOC107056991-LOC112531205-LOC112533411	46	59	42	71	833.58	1667.16	15	1	0.336284096469073	0.241273729332517	1	0.0664138221660345	113	105
LOC107054473	19	24	11	6	460.35	920.7	15	1	0.251569189287884	-1.31578947368421	1	-0.205198358413133	17	43
LOC107054634	0	3	2	2	140.58	281.16	15	1	0.428571428571429	-Inf	1	-0.5	4	3
LOC107054696-ZNF692	10	17	8	4	289.41	578.82	15	1	0.162853621140607	-2.4	1	-0.296296296296296	12	27
LOC107054772-LOC112529957	0	4	0	0	59.4	118.8	15	1	1	NA	1	NA	0	4
LOC107054849	10	8	11	7	231.33	462.66	15	1	1	-0.257142857142857	1	-0.0555555555555556	18	18
LOC107055024	15	46	8	11	1023	2046	15	1	0.15683499407475	-1.23030303030303	1	-0.175150992234685	19	61
LOC107055037	16	8	3	0	193.05	386.1	15	1	0.532307692307692	-Inf	1	-0.333333333333333	3	24
LOC107055038	31	22	7	2	343.53	687.06	15	1	0.461651595842498	-1.48387096774194	1	-0.192872117400419	9	53
LOC107055072	6	4	0	1	85.8	171.6	15	1	0.454545454545455	1	1	0.6	1	10
LOC107055076	13	9	0	0	255.09	510.18	15	1	1	NA	1	NA	0	22
LOC107055419-LOC112530874-LOC431300	48	50	7	3	1043.13	2086.26	15	1	0.320772255067808	-1.43055555555556	1	-0.210204081632653	10	98
LOC107055427	21	11	0	0	706.86	1413.72	15	1	1	NA	1	NA	0	32
LOC107055431-NEDD4L	17	30	1	7	897.93	1795.86	15	1	0.249747987861195	0.747899159663866	1	0.236702127659574	8	47
LOC107055625-LOC107055677-LOC107055678	3	1	0	2	38.94	77.88	15	1	0.4	1	1	0.75	2	4
LOC107055878	4	3	3	5	266.97	533.94	15	1	0.619269619269619	0.55	1	0.196428571428571	8	7
LOC107055922-RP1	191	131	22	9	4650.69	9301.38	15	1	0.250559081770482	-0.676556137289122	1	-0.116509717491485	31	322
LOC107056274	1	6	2	4	286.44	572.88	15	1	0.559440559440559	-2	1	-0.19047619047619	6	7
LOC107056275	15	13	6	5	364.32	728.64	15	1	1	-0.04	1	-0.00974025974025972	11	28
LOC107056277	3	3	2	4	233.64	467.28	15	1	1	0.5	1	0.166666666666667	6	6
LOC107056377	0	4	0	1	239.58	479.16	15	1	1	NA	1	0	1	4
LOC107056410-MRPL16	14	7	3	2	175.56	351.12	15	1	1	0.25	1	0.0666666666666667	5	21
LOC107056412	4	2	0	2	101.64	203.28	15	1	0.428571428571429	1	1	0.666666666666667	2	6
LOC107056600	4	16	0	1	317.79	635.58	15	1	1	1	1	0.2	1	20
LOC107056693	9	16	0	1	794.97	1589.94	15	1	1	1	1	0.36	1	25
LOC107056877	2	7	2	5	204.27	408.54	15	1	1	-0.4	1	-0.0634920634920635	7	9
LOC107057078	36	52	9	21	1095.6	2191.2	15	1	0.384651096588855	0.380952380952381	1	0.109090909090909	30	88
LOC107057310	11	28	4	7	654.06	1308.12	15	1	0.713313889211004	-0.454545454545455	1	-0.0815850815850816	11	39
LOC107057318	5	10	0	2	212.19	424.38	15	1	1	1	1	0.333333333333333	2	15
LOC107057363	2	6	2	2	166.32	332.64	15	1	0.547474747474747	-2	1	-0.25	4	8
LOC107057394	25	24	1	2	544.83	1089.66	15	1	1	0.52	1	0.17687074829932	3	49
LOC107057564	6	6	0	2	334.62	669.24	15	1	0.472527472527472	1	1	0.5	2	12
LOC107080643-LOC112533303	22	17	3	3	302.94	605.88	15	1	1	0.227272727272727	1	0.0641025641025641	6	39
LOC112529925	37	74	12	14	1879.02	3758.04	15	1	0.25821302414256	-0.714285714285714	1	-0.128205128205128	26	111
LOC112529930	15	5	1	2	187.11	374.22	15	1	0.209486166007905	0.833333333333333	1	0.416666666666667	3	20
LOC112529955	65	51	18	14	1260.27	2520.54	15	1	1	-0.00879120879120876	1	-0.00215517241379315	32	116
LOC112529965	2	6	3	2	305.58	611.16	15	1	0.292929292929293	-3.5	1	-0.35	5	8
LOC112529973	6	14	4	8	158.73	317.46	15	1	1	-0.166666666666667	1	-0.0333333333333333	12	20
LOC112529978-TPRN	17	16	5	3	460.35	920.7	15	1	0.703260483748289	-0.568627450980392	1	-0.109848484848485	8	33
LOC112530140	3	8	1	0	69.3	138.6	15	1	0.333333333333333	-Inf	1	-0.727272727272727	1	11
LOC112530162	1	12	0	2	273.57	547.14	15	1	1	1	1	0.0769230769230769	2	13
LOC112530196-TMEM79	13	28	2	0	374.55	749.1	15	1	0.116279069767442	-Inf	1	-0.682926829268293	2	41
LOC112530201	4	10	1	8	302.61	605.22	15	1	0.610567921780736	0.6875	1	0.174603174603175	9	14
LOC112530206	0	5	0	0	165.99	331.98	15	1	1	NA	1	NA	0	5
LOC112530287	3	15	1	9	233.64	467.28	15	1	1	0.444444444444444	1	0.0666666666666667	10	18
LOC112530493	5	1	1	0	375.21	750.42	15	1	1	-Inf	1	-0.166666666666667	1	6
LOC112530510-SAMSN1	16	15	0	1	598.62	1197.24	15	1	1	1	1	0.516129032258065	1	31
LOC112530656	12	15	3	0	310.86	621.72	15	1	0.224137931034483	-Inf	1	-0.555555555555556	3	27
LOC112530673	20	7	0	0	204.6	409.2	15	1	1	NA	1	NA	0	27
LOC112530773	6	2	0	0	144.21	288.42	15	1	1	NA	1	NA	0	8
LOC112530847	0	1	1	1	110.22	220.44	15	1	1	-Inf	1	-0.5	2	1
LOC112530906-SLC5A10	3	19	7	8	325.71	651.42	15	1	0.0563185379975278	-4.54166666666667	0.846060006968071	-0.33030303030303	15	22
LOC112530909	43	31	21	13	785.73	1571.46	15	1	0.833719831327913	-0.164579606440072	1	-0.0365659777424484	34	74
LOC112530959	7	25	2	1	400.95	801.9	15	1	0.155844155844156	-6.14285714285714	1	-0.447916666666667	3	32
LOC112530976	14	8	0	3	256.41	512.82	15	1	0.0717391304347827	1	0.909549689440994	0.636363636363636	3	22
LOC112531016-LOC112531021	11	7	9	7	267.96	535.92	15	1	1	0.181818181818182	1	0.0486111111111112	16	18
LOC112531049-UTRIM39L	19	9	3	3	493.35	986.7	15	1	0.641022704966302	0.526315789473684	1	0.178571428571429	6	28
LOC112531372	1	11	0	0	448.14	896.28	15	1	1	NA	1	NA	0	12
LOC112531549	36	13	4	3	2154.24	4308.48	15	1	0.394719671745199	0.518518518518519	1	0.163265306122449	7	49
LOC112531588	10	6	2	0	349.47	698.94	15	1	0.529411764705882	-Inf	1	-0.375	2	16
LOC112531692	11	17	7	8	507.54	1015.08	15	1	0.749718715906331	-0.352272727272727	1	-0.0738095238095238	15	28
LOC112531842	7	3	1	0	139.59	279.18	15	1	1	-Inf	1	-0.3	1	10
LOC112531844	1	0	1	0	80.19	160.38	15	1	1	NA	1	0	1	1
LOC112531899	12	3	0	0	105.6	211.2	15	1	1	NA	1	NA	0	15
LOC112532100	20	5	2	0	1177.11	2354.22	15	1	1	-Inf	1	-0.2	2	25
LOC112532300	2	5	2	3	91.41	182.82	15	1	1	-0.666666666666667	1	-0.114285714285714	5	7
LOC112532338	10	10	2	3	149.49	298.98	15	1	1	0.333333333333333	1	0.1	5	20
LOC112532351	16	33	9	5	866.25	1732.5	15	1	0.0605950930865821	-2.7125	0.870851370851371	-0.316326530612245	14	49
LOC112532477	8	7	0	0	280.17	560.34	15	1	1	NA	1	NA	0	15
LOC112532570-MUC	45	75	6	4	2082.96	4165.92	15	1	0.189063166464275	-1.5	1	-0.225	10	120
LOC112532681	16	13	3	1	474.21	948.42	15	1	0.619721407624633	-1.4375	1	-0.198275862068966	4	29
LOC112532692	0	2	1	1	198	396	15	1	1	-Inf	1	-0.5	2	2
LOC112532694	14	20	6	8	398.31	796.62	15	1	1	-0.0714285714285714	1	-0.0168067226890756	14	34
LOC112532762	22	22	8	1	384.45	768.9	15	1	0.0611728272200088	-7	0.873041798302308	-0.388888888888889	9	44
LOC112532911	10	5	2	0	222.42	444.84	15	1	1	-Inf	1	-0.333333333333333	2	15
LOC112532977	21	18	3	4	307.89	615.78	15	1	0.694271128757799	0.357142857142857	1	0.10989010989011	7	39
LOC112532998	18	14	9	4	206.91	413.82	15	1	0.513644223080889	-0.75	1	-0.129807692307692	13	32
LOC112533016	18	18	7	11	301.29	602.58	15	1	0.565398227382278	0.363636363636364	1	0.111111111111111	18	36
LOC112533191-OR6B1-OR6B1L2	10	13	2	1	321.75	643.5	15	1	0.58	-1.6	1	-0.231884057971014	3	23
LOC112533211	15	6	3	3	99.66	199.32	15	1	0.36734569778048	0.6	1	0.214285714285714	6	21
LOC112533280	2	2	0	1	155.43	310.86	15	1	1	1	1	0.5	1	4
LOC112533337	12	6	0	1	156.42	312.84	15	1	0.368421052631579	1	1	0.666666666666667	1	18
LOC112533358	2	3	0	3	90.75	181.5	15	1	0.464285714285714	1	1	0.4	3	5
LOC112533511	8	24	7	10	577.83	1155.66	15	1	0.331413522269997	-1.1	1	-0.161764705882353	17	32
LOC112533543	21	29	8	11	627.99	1255.98	15	1	1	-0.00432900432900429	1	-0.00105263157894736	19	50
LOC112533548-TRIM7	3	18	1	9	473.22	946.44	15	1	1	0.333333333333333	1	0.0428571428571428	10	21
LOC395159	0	4	0	1	134.31	268.62	15	1	1	NA	1	0	1	4
LOC395381	36	74	6	3	2184.93	4369.86	15	1	0.0654985319753801	-3.11111111111111	0.884435842948953	-0.339393939393939	9	110
LOC395944	28	79	6	4	1875.06	3750.12	15	1	0.0612617492642215	-3.23214285714286	0.873041798302308	-0.338317757009346	10	107
LOC395991	4	14	3	5	301.29	602.58	15	1	0.635293402249924	-1.1	1	-0.152777777777778	8	18
LOC396098	16	13	1	4	331.32	662.64	15	1	0.335288367546432	0.796875	1	0.351724137931034	5	29
LOC396365	11	5	5	4	108.9	217.8	15	1	0.670738995827164	0.431818181818182	1	0.131944444444444	9	16
LOC408038	3	6	0	0	117.81	235.62	15	1	1	NA	1	NA	0	9
LOC414835	61	128	19	23	2500.41	5000.82	15	1	0.150680203967451	-0.733428367783322	1	-0.12962962962963	42	189
LOC415324	34	19	0	3	409.2	818.4	15	1	0.0555555555555556	1	0.846060006968071	0.641509433962264	3	53
LOC415478	14	45	9	7	1274.46	2548.92	15	1	0.0292349593294787	-3.13265306122449	0.768994411487961	-0.32521186440678	16	59
LOC415664	3	8	2	4	254.43	508.86	15	1	1	-0.333333333333333	1	-0.0606060606060606	6	11
LOC415780	4	9	1	1	558.36	1116.72	15	1	1	-1.25	1	-0.192307692307692	2	13
LOC415787	9	22	3	2	558.36	1116.72	15	1	0.307422969187675	-2.66666666666667	1	-0.309677419354839	5	31
LOC416055	4	9	3	3	255.09	510.18	15	1	0.61687306501548	-1.25	1	-0.192307692307692	6	13
LOC416090	1	5	2	2	179.19	358.38	15	1	0.5	-4	1	-0.333333333333333	4	6
LOC416147	10	43	0	0	708.84	1417.68	15	1	1	NA	1	NA	0	53
LOC416169	24	34	10	14	846.45	1692.9	15	1	1	-0.0119047619047619	1	-0.00287356321839083	24	58
LOC416263	15	25	5	5	467.61	935.22	15	1	0.494011767498699	-0.666666666666667	1	-0.125	10	40
LOC416530	16	29	1	7	702.9	1405.8	15	1	0.411891102282599	0.741071428571429	1	0.230555555555556	8	45
LOC416622	9	19	1	0	484.44	968.88	15	1	0.344827586206897	-Inf	1	-0.678571428571429	1	28
LOC416755	38	46	18	16	980.43	1960.86	15	1	0.542374832501152	-0.361842105263158	1	-0.07703081232493	34	84
LOC416924	62	73	33	32	1379.4	2758.8	15	1	0.548056254654235	-0.214213709677419	1	-0.0484330484330484	65	135
LOC417013	18	19	10	5	641.52	1283.04	15	1	0.358189917933841	-1.11111111111111	1	-0.18018018018018	15	37
LOC417113	9	23	4	9	512.49	1024.98	15	1	1	-0.135802469135802	1	-0.0264423076923077	13	32
LOC417372	15	19	13	5	423.39	846.78	15	1	0.0799410129975777	-2.29333333333333	0.936566440349175	-0.281045751633987	18	34
LOC417386	5	21	1	1	299.97	599.94	15	1	0.388888888888889	-3.2	1	-0.307692307692308	2	26
LOC417741	6	8	1	2	284.13	568.26	15	1	1	0.333333333333333	1	0.0952380952380952	3	14
LOC417937	12	18	3	8	616.77	1233.54	15	1	0.715806992109993	0.4375	1	0.127272727272727	11	30
LOC417973	22	6	0	1	99	198	15	1	0.241379310344828	1	1	0.785714285714286	1	28
LOC418108	14	15	2	0	300.96	601.92	15	1	0.483870967741935	-Inf	1	-0.517241379310345	2	29
LOC418114	14	23	8	6	698.94	1397.88	15	1	0.342335762462985	-1.19047619047619	1	-0.193050193050193	14	37
LOC418222	19	9	3	2	349.8	699.6	15	1	1	0.289473684210526	1	0.0785714285714286	5	28
LOC418298	2	11	3	0	302.28	604.56	15	1	0.0178571428571429	-Inf	0.677255339142531	-0.846153846153846	3	13
LOC418355	9	12	0	2	216.81	433.62	15	1	0.50197628458498	1	1	0.428571428571429	2	21
LOC418414	5	6	1	0	119.79	239.58	15	1	1	-Inf	1	-0.545454545454545	1	11
LOC418421	24	32	2	0	705.54	1411.08	15	1	0.196612220205687	-Inf	1	-0.571428571428571	2	56
LOC418544	5	21	0	6	527.67	1055.34	15	1	0.554564595582393	1	1	0.192307692307692	6	26
LOC418667	8	14	2	0	282.15	564.3	15	1	0.16304347826087	-Inf	1	-0.636363636363636	2	22
LOC418701	1	10	2	3	151.14	302.28	15	1	0.214285714285714	-5.66666666666667	1	-0.309090909090909	5	11
LOC418927	2	5	1	0	128.7	257.4	15	1	0.375	-Inf	1	-0.714285714285714	1	7
LOC419074	3	30	0	5	691.02	1382.04	15	1	1	1	1	0.0909090909090909	5	33
LOC419080	5	17	0	5	315.81	631.62	15	1	0.546946612164003	1	1	0.227272727272727	5	22
LOC419112	2	8	1	2	230.34	460.68	15	1	1	-1	1	-0.133333333333333	3	10
LOC419250	8	18	3	4	380.16	760.32	15	1	0.66096588802373	-0.6875	1	-0.120879120879121	7	26
LOC419333	22	19	3	1	708.84	1417.68	15	1	0.617436826739152	-1.59090909090909	1	-0.213414634146341	4	41
LOC419390	2	2	0	1	160.38	320.76	15	1	1	1	1	0.5	1	4
LOC419409	12	22	1	6	606.87	1213.74	15	1	0.398553238732956	0.694444444444444	1	0.210084033613445	7	34
LOC419429	3	23	1	6	566.28	1132.56	15	1	1	-0.277777777777778	1	-0.0274725274725275	7	26
LOC419584	16	8	7	8	271.92	543.84	15	1	0.317821937621715	0.5625	1	0.2	15	24
LOC419741	40	21	8	6	433.62	867.24	15	1	0.553770747175893	0.3	1	0.0843091334894613	14	61
LOC419830	15	5	0	2	212.85	425.7	15	1	0.0909090909090909	1	0.953786405978059	0.75	2	20
LOC419851-PFKFB2	52	52	7	19	1062.6	2125.2	15	1	0.0468986063566066	0.631578947368421	0.828231827900648	0.230769230769231	26	104
LOC420107	5	2	3	5	136.62	273.24	15	1	0.314685314685315	0.76	1	0.339285714285714	8	7
LOC420160	12	12	3	13	329.67	659.34	15	1	0.0556161736558256	0.769230769230769	0.846060006968071	0.3125	16	24
LOC420294	36	53	10	12	778.14	1556.28	15	1	0.809589636784518	-0.226851851851852	1	-0.0500510725229826	22	89
LOC420734	14	9	0	1	248.49	496.98	15	1	0.416666666666667	1	1	0.608695652173913	1	23
LOC420748	69	38	1	4	776.16	1552.32	15	1	0.0647448950201244	0.86231884057971	0.884435842948953	0.444859813084112	5	107
LOC420807	7	10	3	3	377.19	754.38	15	1	1	-0.428571428571429	1	-0.0882352941176471	6	17
LOC420992	14	13	2	4	477.18	954.36	15	1	0.656183638386086	0.535714285714286	1	0.185185185185185	6	27
LOC421081	16	10	3	1	203.94	407.88	15	1	1	-0.875	1	-0.134615384615385	4	26
LOC421106	31	34	12	2	888.03	1776.06	15	1	0.0158383466149781	-5.58064516129032	0.65468782069447	-0.38021978021978	14	65
LOC421108	17	41	5	7	818.73	1637.46	15	1	0.497781246121998	-0.722689075630252	1	-0.123563218390805	12	58
LOC421195	164	94	10	9	2453.22	4906.44	15	1	0.338559540248562	0.363143631436314	1	0.109343125254998	19	258
LOC421255	4	0	2	0	492.03	984.06	15	1	1	NA	1	0	2	4
LOC421285	60	60	28	27	845.13	1690.26	15	1	1	-0.037037037037037	1	-0.00909090909090904	55	120
LOC421502	32	11	3	0	418.44	836.88	15	1	1	-Inf	1	-0.255813953488372	3	43
LOC421584	9	20	2	5	550.44	1100.88	15	1	1	0.111111111111111	1	0.0246305418719212	7	29
LOC421690	18	21	2	4	569.25	1138.5	15	1	0.678087085914653	0.416666666666667	1	0.128205128205128	6	39
LOC421856	3	3	0	2	216.81	433.62	15	1	0.464285714285714	1	1	0.5	2	6
LOC421892	33	25	2	2	568.59	1137.18	15	1	1	0.242424242424242	1	0.0689655172413793	4	58
LOC421965	6	24	4	2	480.15	960.3	15	1	0.0385112989477316	-7	0.789311843512415	-0.466666666666667	6	30
LOC422106	6	10	4	4	162.03	324.06	15	1	0.673352178399964	-0.666666666666667	1	-0.125	8	16
LOC422147	4	8	6	9	358.38	716.76	15	1	1	-0.333333333333333	1	-0.0666666666666667	15	12
LOC422150	6	5	4	1	240.57	481.14	15	1	0.587912087912088	-2.33333333333333	1	-0.254545454545455	5	11
LOC422171	35	44	5	4	1103.85	2207.7	15	1	0.726109453235898	-0.571428571428571	1	-0.112517580872011	9	79
LOC422177	34	26	13	9	460.02	920.04	15	1	1	-0.104575163398693	1	-0.0242424242424243	22	60
LOC422214	1	6	0	4	130.68	261.36	15	1	1	1	1	0.142857142857143	4	7
LOC422224	5	3	6	0	160.38	320.76	15	1	0.208791208791209	-Inf	1	-0.375	6	8
LOC422295	14	19	4	4	430.32	860.64	15	1	0.712631205314132	-0.357142857142857	1	-0.0757575757575757	8	33
LOC422304	10	5	4	2	198.66	397.32	15	1	1	0	1	0	6	15
LOC422308	25	43	9	14	857.34	1714.68	15	1	1	-0.105714285714286	1	-0.0236572890025575	23	68
LOC422320	4	31	4	8	674.19	1348.38	15	1	0.175590201785459	-2.875	1	-0.219047619047619	12	35
LOC422426	46	36	6	7	840.18	1680.36	15	1	0.55870490762498	0.329192546583851	1	0.0994371482176361	13	82
LOC422442	4	13	4	0	220.77	441.54	15	1	0.0116959064327485	-Inf	0.596226042284133	-0.764705882352941	4	17
LOC422643	24	17	1	0	406.89	813.78	15	1	1	-Inf	1	-0.414634146341463	1	41
LOC422901	18	14	1	0	356.73	713.46	15	1	1	-Inf	1	-0.4375	1	32
LOC422926	22	38	6	11	866.25	1732.5	15	1	1	0.0578512396694215	1	0.0137254901960784	17	60
LOC422928	21	19	6	3	303.6	607.2	15	1	0.487600689653053	-0.80952380952381	1	-0.141666666666667	9	40
LOC423110	32	37	16	17	704.22	1408.44	15	1	1	-0.088235294117647	1	-0.0210803689064559	33	69
LOC423240	2	17	0	0	243.21	486.42	15	1	1	NA	1	NA	0	19
LOC423277	0	4	0	2	143.55	287.1	15	1	1	NA	1	0	2	4
LOC423462	18	8	3	0	263.34	526.68	15	1	0.540229885057471	-Inf	1	-0.307692307692308	3	26
LOC423629	12	6	3	0	219.78	439.56	15	1	0.526315789473684	-Inf	1	-0.333333333333333	3	18
LOC423693	18	25	2	3	661.65	1323.3	15	1	1	0.0740740740740741	1	0.0186046511627907	5	43
LOC423719	6	4	7	9	227.04	454.08	15	1	0.688167990308252	0.481481481481482	1	0.1625	16	10
LOC423731	8	6	3	1	200.97	401.94	15	1	1	-1.25	1	-0.178571428571429	4	14
LOC423752	23	24	2	5	530.97	1061.94	15	1	0.430547255186545	0.582608695652174	1	0.203647416413374	7	47
LOC423967	26	16	3	5	190.41	380.82	15	1	0.255235638444554	0.630769230769231	1	0.244047619047619	8	42
LOC424109	2	7	0	1	207.9	415.8	15	1	1	1	1	0.222222222222222	1	9
LOC424167	26	35	1	2	1064.25	2128.5	15	1	1	0.326923076923077	1	0.092896174863388	3	61
LOC424199	5	10	6	9	374.88	749.76	15	1	1	-0.333333333333333	1	-0.0666666666666667	15	15
LOC424300	99	96	17	11	1913.34	3826.68	15	1	0.419143517590438	-0.49862258953168	1	-0.0994505494505494	28	195
LOC424401	1	4	1	0	114.84	229.68	15	1	0.333333333333333	-Inf	1	-0.8	1	5
LOC424430	7	19	4	8	295.68	591.36	15	1	0.714373694040644	-0.357142857142857	1	-0.0641025641025641	12	26
LOC424473	28	33	7	5	728.97	1457.94	15	1	0.533440299099771	-0.65	1	-0.12431693989071	12	61
LOC424748	29	30	7	7	618.75	1237.5	15	1	1	-0.0344827586206897	1	-0.00847457627118642	14	59
LOC424918	4	6	0	0	114.84	229.68	15	1	1	NA	1	NA	0	10
LOC424919	12	14	9	16	375.87	751.74	15	1	0.572488913493729	0.34375	1	0.101538461538462	25	26
LOC425001	11	5	4	2	278.19	556.38	15	1	1	0.0909090909090909	1	0.0208333333333334	6	16
LOC425049	4	19	0	1	477.18	954.36	15	1	1	1	1	0.173913043478261	1	23
LOC425431-NES	37	21	10	12	497.31	994.62	15	1	0.203095577095792	0.527027027027027	1	0.183385579937304	22	58
LOC425470	38	15	6	3	486.09	972.18	15	1	0.71098905548167	0.210526315789474	1	0.050314465408805	9	53
LOC425623	6	3	2	0	58.74	117.48	15	1	1	-Inf	1	-0.333333333333333	2	9
LOC425795	1	34	1	9	547.8	1095.6	15	1	0.398989898989899	-2.77777777777778	1	-0.0714285714285714	10	35
LOC426037	3	9	1	2	118.8	237.6	15	1	1	-0.5	1	-0.0833333333333333	3	12
LOC426220	1	6	2	4	162.36	324.72	15	1	0.559440559440559	-2	1	-0.19047619047619	6	7
LOC426385	4	10	1	9	329.67	659.34	15	1	0.357707509881423	0.722222222222222	1	0.185714285714286	10	14
LOC426456	23	3	1	2	171.27	342.54	15	1	0.0684181718664477	0.934782608695652	0.888803134120932	0.551282051282051	3	26
LOC426514	4	8	3	7	304.59	609.18	15	1	1	0.142857142857143	1	0.0333333333333333	10	12
LOC426710	13	7	4	1	163.35	326.7	15	1	1	-1.15384615384615	1	-0.15	5	20
LOC426743	19	19	13	12	509.85	1019.7	15	1	1	-0.0833333333333333	1	-0.02	25	38
LOC426821	19	32	3	9	556.05	1112.1	15	1	0.516203345402017	0.43859649122807	1	0.122549019607843	12	51
LOC426897	20	22	5	6	487.41	974.82	15	1	1	0.0833333333333334	1	0.0216450216450216	11	42
LOC426957-LOC428289	3	3	0	4	61.05	122.1	15	1	0.2	1	1	0.5	4	6
LOC427400	5	16	1	1	340.89	681.78	15	1	0.462450592885375	-2.2	1	-0.261904761904762	2	21
LOC427533	3	16	14	7	423.39	846.78	15	1	0.00156252770268343	-9.66666666666667	0.284493574108469	-0.508771929824561	21	19
LOC427545	16	17	3	1	400.62	801.24	15	1	0.603861003861004	-2.1875	1	-0.265151515151515	4	33
LOC427594	9	22	2	9	459.36	918.72	15	1	0.69591847641808	0.45679012345679	1	0.108504398826979	11	31
LOC427656	2	8	1	2	250.47	500.94	15	1	1	-1	1	-0.133333333333333	3	10
LOC427665	5	10	2	8	358.38	716.76	15	1	0.659246931558145	0.5	1	0.133333333333333	10	15
LOC427775	6	23	3	1	319.77	639.54	15	1	0.0523460410557185	-10.5	0.843251957917679	-0.543103448275862	4	29
LOC427778	36	32	6	13	590.7	1181.4	15	1	0.123341573035477	0.58974358974359	1	0.213622291021672	19	68
LOC427783	10	11	3	1	314.82	629.64	15	1	0.59304347826087	-2.3	1	-0.273809523809524	4	21
LOC427799	0	8	0	3	274.56	549.12	15	1	1	NA	1	0	3	8
LOC427826	11	20	1	5	503.91	1007.82	15	1	0.640869861458097	0.636363636363636	1	0.188172043010753	6	31
LOC427933	5	10	1	0	283.14	566.28	15	1	0.375	-Inf	1	-0.666666666666667	1	15
LOC428094	17	26	2	4	539.55	1079.1	15	1	1	0.235294117647059	1	0.062015503875969	6	43
LOC428144	3	13	1	2	307.56	615.12	15	1	0.530443756449948	-1.16666666666667	1	-0.145833333333333	3	16
LOC428250	127	109	45	27	2586.21	5172.42	15	1	0.22312486509108	-0.430446194225722	1	-0.086864406779661	72	236
LOC428335	0	13	0	1	460.35	920.7	15	1	1	NA	1	0	1	13
LOC428383	10	10	3	4	264.33	528.66	15	1	1	0.25	1	0.0714285714285715	7	20
LOC428541	7	12	2	4	227.04	454.08	15	1	1	0.142857142857143	1	0.0350877192982456	6	19
LOC428667	11	6	0	1	359.7	719.4	15	1	0.388888888888889	1	1	0.647058823529412	1	17
LOC428702	9	5	2	3	267.3	534.6	15	1	0.602683178534572	0.62962962962963	1	0.242857142857143	5	14
LOC428714	23	33	6	4	897.93	1795.86	15	1	0.314626166962708	-1.15217391304348	1	-0.189285714285714	10	56
LOC428824	22	39	9	17	666.6	1333.2	15	1	1	0.0614973262032086	1	0.0145018915510719	26	61
LOC428967	6	12	0	0	437.58	875.16	15	1	1	NA	1	NA	0	18
LOC429098	9	22	4	9	582.12	1164.24	15	1	1	-0.0864197530864197	1	-0.0173697270471464	13	31
LOC429348	6	14	3	4	236.61	473.22	15	1	0.652660383095166	-0.75	1	-0.128571428571429	7	20
LOC430422	36	48	7	8	937.86	1875.72	15	1	0.785515760978328	-0.166666666666667	1	-0.0380952380952381	15	84
LOC430433-LOC776507	15	4	10	4	448.8	897.6	15	1	0.695149492702329	0.333333333333333	1	0.075187969924812	14	19
LOC430443	0	4	0	1	187.11	374.22	15	1	1	NA	1	0	1	4
LOC431250	6	16	0	6	349.47	698.94	15	1	0.289353400222965	1	1	0.272727272727273	6	22
LOC431321	1	9	1	3	157.41	314.82	15	1	0.505494505494505	-2	1	-0.15	4	10
LOC431322	0	9	0	0	113.85	227.7	15	1	1	NA	1	NA	0	9
LOC693258	3	6	1	1	93.39	186.78	15	1	1	-1	1	-0.166666666666667	2	9
LOC768477	7	5	6	2	105.93	211.86	15	1	0.642414860681115	-1.14285714285714	1	-0.166666666666667	8	12
LOC768647	24	30	2	1	764.28	1528.56	15	1	0.586807928913192	-1.5	1	-0.222222222222222	3	54
LOC768760	18	50	15	15	885.06	1770.12	15	1	0.0359488604460061	-1.77777777777778	0.788199921465956	-0.235294117647059	30	68
LOC768978	1	40	0	5	610.83	1221.66	15	1	1	1	1	0.024390243902439	5	41
LOC769486	2	6	3	0	66.33	132.66	15	1	0.0606060606060606	-Inf	0.870851370851371	-0.75	3	8
LOC769510	53	72	17	24	879.12	1758.24	15	1	1	0.0377358490566038	1	0.00936585365853659	41	125
LOC769512	2	11	3	10	303.93	607.86	15	1	1	-0.65	1	-0.0769230769230769	13	13
LOC769646	20	10	7	3	166.98	333.96	15	1	1	-0.166666666666667	1	-0.0333333333333333	10	30
LOC769726	4	9	1	2	296.01	592.02	15	1	1	-0.125	1	-0.0256410256410256	3	13
LOC770026	9	22	2	3	306.9	613.8	15	1	0.630894024276377	-0.62962962962963	1	-0.109677419354839	5	31
LOC770271	32	18	5	5	286.11	572.22	15	1	0.48511514127538	0.4375	1	0.14	10	50
LOC770277	22	19	6	5	441.54	883.08	15	1	1	-0.0363636363636364	1	-0.00886917960088685	11	41
LOC770450	2	1	0	0	85.14	170.28	15	1	1	NA	1	NA	0	3
LOC770492	2	9	1	6	201.63	403.26	15	1	1	0.25	1	0.038961038961039	7	11
LOC770548	4	5	4	0	92.07	184.14	15	1	0.104895104895105	-Inf	0.983379501385042	-0.555555555555556	4	9
LOC770617	1	4	0	2	122.76	245.52	15	1	1	1	1	0.2	2	5
LOC770653	25	25	1	1	263.34	526.68	15	1	1	0	1	0	2	50
LOC770881	6	4	2	3	216.81	433.62	15	1	0.608391608391608	0.555555555555556	1	0.2	5	10
LOC770936	8	10	1	1	276.87	553.74	15	1	1	-0.25	1	-0.0555555555555556	2	18
LOC770996	5	13	5	6	549.78	1099.56	15	1	0.431998286571	-1.16666666666667	1	-0.176767676767677	11	18
LOC771012	20	13	1	2	343.53	687.06	15	1	0.558823529411765	0.675	1	0.272727272727273	3	33
LOC771069	0	4	0	5	240.57	481.14	15	1	1	NA	1	0	5	4
LOC771085	17	18	7	2	395.01	790.02	15	1	0.150033667333724	-2.70588235294118	1	-0.292063492063492	9	35
LOC771308	7	25	1	1	365.64	731.28	15	1	0.420677361853832	-2.57142857142857	1	-0.28125	2	32
LOC771362	11	18	3	2	707.85	1415.7	15	1	0.627177850612386	-1.45454545454545	1	-0.220689655172414	5	29
LOC771388	16	10	1	4	360.36	720.72	15	1	0.148354138343015	0.84375	1	0.415384615384615	5	26
LOC771422	5	29	3	2	446.49	892.98	15	1	0.0490936280409964	-7.7	0.836265558112488	-0.452941176470588	5	34
LOC771456	7	14	3	3	319.77	639.54	15	1	0.638187899057464	-1	1	-0.166666666666667	6	21
LOC771494	25	30	7	5	758.34	1516.68	15	1	0.528919573690673	-0.68	1	-0.128787878787879	12	55
LOC771515	5	14	4	2	140.25	280.5	15	1	0.142450592885376	-4.6	1	-0.403508771929825	6	19
LOC771545	19	11	6	8	212.85	425.7	15	1	0.327371806695906	0.565789473684211	1	0.204761904761905	14	30
LOC771612	12	11	3	1	270.27	540.54	15	1	0.605128205128205	-1.75	1	-0.228260869565217	4	23
LOC771811	16	8	3	4	332.31	664.62	15	1	0.383866974701235	0.625	1	0.238095238095238	7	24
LOC771917	3	9	3	2	187.11	374.22	15	1	0.280058177117001	-3.5	1	-0.35	5	12
LOC771994	7	5	6	4	112.53	225.06	15	1	1	-0.0714285714285714	1	-0.0166666666666666	10	12
LOC771995	8	15	5	7	436.59	873.18	15	1	0.726005085015096	-0.339285714285714	1	-0.068840579710145	12	23
LOC772017	24	28	10	7	570.9	1141.8	15	1	0.412540201773484	-0.666666666666667	1	-0.126696832579186	17	52
LOC772071	0	6	0	2	165.33	330.66	15	1	1	NA	1	0	2	6
LOC776067	91	129	11	19	3087.81	6175.62	15	1	0.695004755311262	0.179294389820706	1	0.046969696969697	30	220
LOC776273	2	37	2	22	1115.07	2230.14	15	1	0.631779607665382	-0.681818181818182	1	-0.032051282051282	24	39
LOC776275	1	8	1	5	106.92	213.84	15	1	1	-0.6	1	-0.0555555555555556	6	9
LOC776376	9	8	0	1	211.2	422.4	15	1	1	1	1	0.529411764705882	1	17
LOC776594	13	13	3	6	362.01	724.02	15	1	0.460491455152189	0.5	1	0.166666666666667	9	26
LOH11CR2A	32	26	9	4	767.91	1535.82	15	1	0.535917083715495	-0.828125	1	-0.140583554376658	13	58
LONP1	1	29	3	8	821.04	1642.08	15	1	0.0521378493137158	-9.875	0.843251957917679	-0.239393939393939	11	30
LONP2	0	38	1	8	844.14	1688.28	15	1	0.191489361702127	-Inf	1	-0.111111111111111	9	38
LONRF1	7	15	4	5	542.85	1085.7	15	1	0.68276903731757	-0.714285714285714	1	-0.126262626262626	9	22
LONRF3	1	13	0	2	484.44	968.88	15	1	1	1	1	0.0714285714285714	2	14
LOX	0	10	0	2	203.61	407.22	15	1	1	NA	1	0	2	10
LOXHD1	22	87	6	16	2236.08	4472.16	15	1	0.568273877048216	-0.482954545454545	1	-0.0708924103419516	22	109
LOXL1	6	17	1	4	277.2	554.4	15	1	1	0.291666666666667	1	0.0608695652173913	5	23
LOXL2	4	33	1	14	667.26	1334.52	15	1	1	0.410714285714286	1	0.0414414414414414	15	37
LOXL3	8	27	4	8	704.22	1408.44	15	1	0.470829855550737	-0.6875	1	-0.104761904761905	12	35
LOXL4	7	33	15	11	866.91	1733.82	15	1	0.00117993263892152	-5.42857142857143	0.254094564439392	-0.401923076923077	26	40
LPAR1	2	10	0	3	364.32	728.64	15	1	1	1	1	0.166666666666667	3	12
LPAR3	1	5	0	1	358.38	716.76	15	1	1	1	1	0.166666666666667	1	6
LPAR4	1	17	2	4	345.51	691.02	15	1	0.143280632411067	-7.5	1	-0.277777777777778	6	18
LPAR5	22	12	0	2	367.29	734.58	15	1	0.144444444444444	1	1	0.647058823529412	2	34
LPCAT1	1	14	0	2	484.11	968.22	15	1	1	1	1	0.0666666666666667	2	15
LPCAT2	6	14	2	2	520.41	1040.82	15	1	0.578392621870883	-1.33333333333333	1	-0.2	4	20
LPCAT3	11	18	2	4	522.39	1044.78	15	1	1	0.181818181818182	1	0.0459770114942529	6	29
LPGAT1	2	11	0	0	328.68	657.36	15	1	1	NA	1	NA	0	13
LPIN2	7	27	1	6	878.13	1756.26	15	1	1	0.357142857142857	1	0.0630252100840336	7	34
LPL	3	16	0	4	450.78	901.56	15	1	1	1	1	0.157894736842105	4	19
LPO	33	19	0	0	726.66	1453.32	15	1	1	NA	1	NA	0	52
LPP	1	8	0	0	147.51	295.02	15	1	1	NA	1	NA	0	9
LPXN	10	12	0	2	224.4	448.8	15	1	0.492753623188406	1	1	0.454545454545455	2	22
LRAT	3	21	1	1	203.28	406.56	15	1	0.289230769230769	-6	1	-0.375	2	24
LRBA	44	65	10	4	2827.44	5654.88	15	1	0.0429487376959503	-2.69318181818182	0.817651835946562	-0.310615989515072	14	109
LRCH1	8	17	2	3	668.25	1336.5	15	1	1	-0.416666666666667	1	-0.08	5	25
LRCH2	3	19	0	1	646.14	1292.28	15	1	1	1	1	0.136363636363636	1	22
LRCH3	3	24	4	0	748.77	1497.54	15	1	0.00111234705228031	-Inf	0.254094564439392	-0.888888888888889	4	27
LRFN2	4	11	1	1	297	594	15	1	0.514705882352941	-1.75	1	-0.233333333333333	2	15
LRFN3	3	24	1	8	676.83	1353.66	15	1	1	0	1	0	9	27
LRG1	2	5	4	3	169.29	338.58	15	1	0.592074592074592	-2.33333333333333	1	-0.285714285714286	7	7
LRGUK	29	32	2	14	642.18	1284.36	15	1	0.0113268784318387	0.842364532019704	0.593149540517961	0.350409836065574	16	61
LRIF1	56	53	2	5	731.61	1463.22	15	1	0.43847425725071	0.621428571428571	1	0.228047182175623	7	109
LRIG1	9	37	3	13	1031.58	2063.16	15	1	1	0.0512820512820513	1	0.00815217391304349	16	46
LRIG2	9	36	0	0	952.71	1905.42	15	1	1	NA	1	NA	0	45
LRIG3	18	31	4	2	1028.94	2057.88	15	1	0.203987212688656	-2.44444444444444	1	-0.299319727891156	6	49
LRIT1	11	20	7	6	620.73	1241.46	15	1	0.322782666067139	-1.12121212121212	1	-0.183622828784119	13	31
LRIT2	9	39	3	3	495	990	15	1	0.115614044359882	-3.33333333333333	1	-0.3125	6	48
LRIT3	31	52	10	15	919.71	1839.42	15	1	0.818100963778004	-0.118279569892473	1	-0.0265060240963856	25	83
LRMP	47	47	10	5	1447.05	2894.1	15	1	0.274504184904376	-1	1	-0.166666666666667	15	94
LRMPL	2	8	5	3	213.84	427.68	15	1	0.144796380090498	-5.66666666666667	1	-0.425	8	10
LRP1	5	252	4	30	4252.38	8504.76	15	1	0.0129148001847204	-5.72	0.61231737012987	-0.0981918059052415	34	257
LRP11	6	15	0	2	308.88	617.76	15	1	1	1	1	0.285714285714286	2	21
LRP12	4	34	2	5	825.66	1651.32	15	1	0.229683390914248	-2.4	1	-0.180451127819549	7	38
LRP1B	36	124	12	12	4435.2	8870.4	15	1	0.0105858069949796	-2.44444444444444	0.585928868752023	-0.275	24	160
LRP2	32	167	13	9	4616.37	9232.74	15	1	2.64015135261135e-05	-6.53819444444444	0.0380389774661281	-0.430105070808588	22	199
LRP3	4	26	1	2	823.68	1647.36	15	1	0.399560117302053	-2.25	1	-0.2	3	30
LRP4	8	61	4	11	1858.56	3717.12	15	1	0.213699594459638	-1.77272727272727	1	-0.150724637681159	15	69
LRP5	7	58	0	3	1447.38	2894.76	15	1	1	1	1	0.107692307692308	3	65
LRP6	4	75	1	4	1574.1	3148.2	15	1	0.269969444172353	-3.6875	1	-0.149367088607595	5	79
LRP8	10	24	5	4	828.63	1657.26	15	1	0.237672756495338	-2	1	-0.261437908496732	9	34
LRPAP1	4	13	2	0	341.88	683.76	15	1	0.087719298245614	-Inf	0.951277979139867	-0.764705882352941	2	17
LRR1	8	21	3	7	381.15	762.3	15	1	1	-0.125	1	-0.0241379310344828	10	29
LRRC1	9	31	6	5	737.55	1475.1	15	1	0.0612252008358531	-3.13333333333333	0.873041798302308	-0.320454545454545	11	40
LRRC10	1	6	1	3	249.81	499.62	15	1	1	-1	1	-0.107142857142857	4	7
LRRC14B	42	35	6	8	959.31	1918.62	15	1	0.562523864526201	0.375	1	0.116883116883117	14	77
LRRC15	4	24	8	10	533.94	1067.88	15	1	0.0382834150361677	-3.8	0.789311843512415	-0.301587301587302	18	28
LRRC17	0	17	1	0	433.62	867.24	15	1	0.0555555555555556	-Inf	0.846060006968071	-1	1	17
LRRC18	8	8	3	0	260.37	520.74	15	1	0.228070175438596	-Inf	1	-0.5	3	16
LRRC2	1	5	0	0	161.37	322.74	15	1	1	NA	1	NA	0	6
LRRC23	6	13	2	5	294.69	589.38	15	1	1	0.133333333333333	1	0.0300751879699248	7	19
LRRC27	18	30	4	11	884.07	1768.14	15	1	0.544236258017849	0.393939393939394	1	0.108333333333333	15	48
LRRC28	0	9	1	0	364.32	728.64	15	1	0.1	-Inf	0.971353639774823	-1	1	9
LRRC30	13	16	3	1	296.01	592.02	15	1	0.335288367546432	-2.69230769230769	1	-0.301724137931034	4	29
LRRC31	19	19	9	3	577.17	1154.34	15	1	0.186265673089731	-2	1	-0.25	12	38
LRRC32	11	20	3	2	669.24	1338.48	15	1	0.356617647058823	-1.72727272727273	1	-0.245161290322581	5	31
LRRC34	19	21	6	5	414.81	829.62	15	1	0.74316307182049	-0.326315789473684	1	-0.0704545454545454	11	40
LRRC38	1	4	0	2	291.06	582.12	15	1	1	1	1	0.2	2	5
LRRC39	7	9	2	0	336.6	673.2	15	1	0.470588235294118	-Inf	1	-0.5625	2	16
LRRC3C	4	3	1	3	258.39	516.78	15	1	0.545454545454546	0.75	1	0.321428571428571	4	7
LRRC40	8	35	4	7	554.73	1109.46	15	1	0.236829933597838	-1.5	1	-0.177589852008457	11	43
LRRC41	39	29	4	8	677.16	1354.32	15	1	0.208141418962141	0.628205128205128	1	0.240196078431373	12	68
LRRC42	7	14	3	3	418.77	837.54	15	1	0.638187899057464	-1	1	-0.166666666666667	6	21
LRRC45	12	20	1	2	591.69	1183.38	15	1	1	0.166666666666667	1	0.0416666666666667	3	32
LRRC46	7	7	2	0	161.04	322.08	15	1	0.475	-Inf	1	-0.5	2	14
LRRC47	5	26	5	3	396.99	793.98	15	1	0.016409809753463	-7.66666666666667	0.669143255825333	-0.463709677419355	8	31
LRRC49	16	22	4	3	724.68	1449.36	15	1	0.682214174556772	-0.833333333333333	1	-0.150375939849624	7	38
LRRC4C	0	14	3	2	628.32	1256.64	15	1	0.0103199174406605	-Inf	0.585928868752023	-0.6	5	14
LRRC56	31	23	5	7	645.15	1290.3	15	1	0.354965054395452	0.470046082949309	1	0.157407407407407	12	54
LRRC57	1	10	0	1	236.61	473.22	15	1	1	1	1	0.0909090909090909	1	11
LRRC59	5	10	2	1	269.28	538.56	15	1	0.528186274509804	-3	1	-0.333333333333333	3	15
LRRC6	25	23	4	3	720.72	1441.44	15	1	1	-0.226666666666667	1	-0.050595238095238	7	48
LRRC66	123	65	26	10	1218.69	2437.38	15	1	0.563429890629563	-0.373983739837398	1	-0.067966903073286	36	188
LRRC7	5	28	2	13	1439.13	2878.26	15	1	1	0.138461538461538	1	0.0181818181818182	15	33
LRRC72	4	10	2	1	226.38	452.76	15	1	0.514705882352941	-4	1	-0.380952380952381	3	14
LRRC73	0	9	2	1	297.33	594.66	15	1	0.0454545454545455	-Inf	0.822543273817637	-0.666666666666667	3	9
LRRC74A	18	10	9	3	462.33	924.66	15	1	0.715876990387799	-0.666666666666667	1	-0.107142857142857	12	28
LRRC75A	4	10	6	4	327.03	654.06	15	1	0.211233005788128	-2.75	1	-0.314285714285714	10	14
LRRC8A	2	39	0	6	802.89	1605.78	15	1	1	1	1	0.0487804878048781	6	41
LRRC8C	0	16	0	4	794.97	1589.94	15	1	1	NA	1	0	4	16
LRRC9	59	31	15	7	1370.82	2741.64	15	1	1	-0.12590799031477	1	-0.0262626262626262	22	90
LRRCC1	30	38	9	6	1004.85	2009.7	15	1	0.392025911993868	-0.9	1	-0.158823529411765	15	68
LRRFIP1	42	36	7	5	1284.69	2569.38	15	1	1	-0.2	1	-0.0448717948717949	12	78
LRRIQ1	80	43	4	2	1396.89	2793.78	15	1	1	-0.075	1	-0.016260162601626	6	123
LRRIQ4	22	23	3	4	580.14	1160.28	15	1	1	0.215909090909091	1	0.0603174603174603	7	45
LRRK2	27	93	7	15	2491.83	4983.66	15	1	0.415061615605357	-0.607407407407407	1	-0.0931818181818182	22	120
LRRN1	1	51	0	4	709.83	1419.66	15	1	1	1	1	0.0192307692307692	4	52
LRRN2	17	31	8	13	680.46	1360.92	15	1	1	-0.122171945701357	1	-0.0267857142857142	21	48
LRRN3	7	23	1	2	701.91	1403.82	15	1	1	-0.642857142857143	1	-0.1	3	30
LRRN4	36	32	11	5	775.17	1550.34	15	1	0.279309515172466	-0.955555555555555	1	-0.158088235294118	16	68
LRRTM2	2	5	5	4	379.17	758.34	15	1	0.357517482517483	-2.125	1	-0.26984126984127	9	7
LRRTM4	9	4	3	2	123.75	247.5	15	1	1	0.333333333333333	1	0.0923076923076923	5	13
LRSAM1	14	25	6	3	720.72	1441.44	15	1	0.136571184286767	-2.57142857142857	1	-0.307692307692308	9	39
LRTM2	1	13	0	3	367.29	734.58	15	1	1	1	1	0.0714285714285714	3	14
LRWD1	11	28	3	7	743.49	1486.98	15	1	1	-0.0909090909090908	1	-0.0179487179487179	10	39
LSAMP	2	6	2	2	191.07	382.14	15	1	0.547474747474747	-2	1	-0.25	4	8
LSG1	18	17	0	1	522.39	1044.78	15	1	1	1	1	0.514285714285714	1	35
LSM1	0	3	0	2	94.71	189.42	15	1	1	NA	1	0	2	3
LSM10	1	2	2	5	122.76	245.52	15	1	1	0.2	1	0.0476190476190476	7	3
LSM11	6	8	2	1	207.57	415.14	15	1	0.576470588235294	-1.66666666666667	1	-0.238095238095238	3	14
LSM14A	1	12	0	2	379.5	759	15	1	1	1	1	0.0769230769230769	2	13
LSM14B	1	12	1	6	381.81	763.62	15	1	1	-1	1	-0.0659340659340659	7	13
LSM3	0	7	0	0	101.97	203.94	15	1	1	NA	1	NA	0	7
LSM4	0	3	0	4	101.64	203.28	15	1	1	NA	1	0	4	3
LSM5	0	2	1	1	91.08	182.16	15	1	1	-Inf	1	-0.5	2	2
LSM6	0	4	0	1	80.19	160.38	15	1	1	NA	1	0	1	4
LSM7	8	26	5	8	658.35	1316.7	15	1	0.46682558708781	-1.03125	1	-0.149321266968326	13	34
LSMEM1	7	5	2	2	156.42	312.84	15	1	1	0.285714285714286	1	0.0833333333333334	4	12
LSP1	9	19	2	2	335.61	671.22	15	1	0.593159065628476	-1.11111111111111	1	-0.178571428571429	4	28
LSS	8	35	2	6	692.01	1384.02	15	1	0.646933973320217	-0.458333333333333	1	-0.063953488372093	8	43
LTA4H	3	24	2	5	554.4	1108.8	15	1	0.268371571502501	-2.2	1	-0.174603174603175	7	27
LTBP1	9	31	8	4	1732.5	3465	15	1	0.0110400707733171	-5.88888888888889	0.58625245283752	-0.441666666666667	12	40
LTBP2	25	44	12	33	1613.7	3227.4	15	1	0.313300550857144	0.36	1	0.0956521739130435	45	69
LTC4S	4	5	1	2	149.49	298.98	15	1	1	0.375	1	0.111111111111111	3	9
LTC4SL	2	6	0	1	144.54	289.08	15	1	1	1	1	0.25	1	8
LTK	17	52	6	4	1422.96	2845.92	15	1	0.0557247856458377	-3.58823529411765	0.846060006968071	-0.353623188405797	10	69
LTN1	39	52	12	11	1740.42	3480.84	15	1	0.485258596888627	-0.454545454545455	1	-0.093167701863354	23	91
LTV1	19	25	2	8	598.62	1197.24	15	1	0.283758554864665	0.671052631578947	1	0.231818181818182	10	44
LUC7L2	0	6	0	1	334.62	669.24	15	1	1	NA	1	0	1	6
LUC7L3	2	8	0	1	337.92	675.84	15	1	1	1	1	0.2	1	10
LUM	2	9	0	0	340.56	681.12	15	1	1	NA	1	NA	0	11
LURAP1	13	10	3	2	216.48	432.96	15	1	1	-0.153846153846154	1	-0.0347826086956522	5	23
LURAP1L	9	4	0	0	216.48	432.96	15	1	1	NA	1	NA	0	13
LUZP1	41	32	6	4	1147.41	2294.82	15	1	1	-0.170731707317073	1	-0.0383561643835616	10	73
LUZP2	11	7	5	0	183.15	366.3	15	1	0.271895152902018	-Inf	1	-0.388888888888889	5	18
LVRN	14	25	4	2	781.44	1562.88	15	1	0.198889879264241	-2.57142857142857	1	-0.307692307692308	6	39
LY6CLEL	7	8	1	3	125.07	250.14	15	1	0.602683178534572	0.619047619047619	1	0.216666666666667	4	15
LY6E	2	3	0	0	108.57	217.14	15	1	1	NA	1	NA	0	5
LY6EL	0	4	1	0	125.73	251.46	15	1	0.2	-Inf	1	-1	1	4
LY75	19	47	9	4	1635.15	3270.3	15	1	0.00948957548375336	-4.56578947368421	0.573230339530418	-0.404428904428904	13	66
LY9	27	9	2	7	274.23	548.46	15	1	0.00567537714147858	0.904761904761905	0.467685236262114	0.527777777777778	9	36
LY96	5	9	0	0	154.44	308.88	15	1	1	NA	1	NA	0	14
LYAR	9	8	5	0	324.72	649.44	15	1	0.115364167995747	-Inf	1	-0.470588235294118	5	17
LYG2	8	10	0	3	202.95	405.9	15	1	0.257142857142857	1	1	0.444444444444444	3	18
LYPD1	2	8	0	0	140.58	281.16	15	1	1	NA	1	NA	0	10
LYPD2	8	5	1	2	126.72	253.44	15	1	0.55	0.6875	1	0.282051282051282	3	13
LYPD6	6	5	2	0	168.3	336.6	15	1	0.487179487179487	-Inf	1	-0.454545454545455	2	11
LYPD6B	5	5	2	1	168.3	336.6	15	1	1	-1	1	-0.166666666666667	3	10
LYPLA1	1	6	0	1	205.92	411.84	15	1	1	1	1	0.142857142857143	1	7
LYPLA2	0	18	1	1	226.05	452.1	15	1	0.1	-Inf	0.971353639774823	-0.5	2	18
LYPLAL1	4	4	0	1	234.63	469.26	15	1	1	1	1	0.5	1	8
LYRM1	0	2	1	0	121.77	243.54	15	1	0.333333333333333	-Inf	1	-1	1	2
LYRM2	2	3	0	2	88.11	176.22	15	1	1	1	1	0.4	2	5
LYRM7	2	6	1	0	102.3	204.6	15	1	0.333333333333333	-Inf	1	-0.75	1	8
LYRM9	4	4	0	0	78.21	156.42	15	1	1	NA	1	NA	0	8
LYSMD2	1	4	2	0	147.84	295.68	15	1	0.142857142857143	-Inf	1	-0.8	2	5
LYSMD3	6	7	1	3	264.33	528.66	15	1	0.602941176470588	0.611111111111111	1	0.211538461538462	4	13
LYSMD4	9	10	6	6	299.97	599.94	15	1	1	-0.111111111111111	1	-0.0263157894736842	12	19
LYST	65	123	24	30	3763.98	7527.96	15	1	0.202328110645478	-0.513846153846154	1	-0.0986997635933806	54	188
LYVE1	6	12	3	3	310.2	620.4	15	1	0.63490742666944	-1	1	-0.166666666666667	6	18
LZIC	1	8	0	0	189.09	378.18	15	1	1	NA	1	NA	0	9
LZTFL1	2	17	1	4	294.03	588.06	15	1	0.521245059288538	-1.125	1	-0.0947368421052632	5	19
LZTR1	20	45	2	15	873.51	1747.02	15	1	0.137342076533858	0.7	1	0.190045248868778	17	65
LZTS1	5	18	3	11	519.75	1039.5	15	1	1	0.0181818181818182	1	0.00310559006211181	14	23
LZTS2	4	7	4	6	438.24	876.48	15	1	1	-0.166666666666667	1	-0.0363636363636364	10	11
M1AP	16	10	9	4	521.73	1043.46	15	1	0.733415447771268	-0.40625	1	-0.0769230769230769	13	26
M6PR	10	13	1	2	276.21	552.42	15	1	1	0.35	1	0.101449275362319	3	23
MAATS1	18	19	2	5	665.28	1330.56	15	1	0.42798551420219	0.577777777777778	1	0.200772200772201	7	37
MAB21L1	0	12	0	1	356.07	712.14	15	1	1	NA	1	0	1	12
MAB21L2	0	5	0	2	356.4	712.8	15	1	1	NA	1	0	2	5
MAB21L3	3	17	2	2	384.12	768.24	15	1	0.179277244494636	-4.66666666666667	1	-0.35	4	20
MACC1	17	34	3	5	860.31	1720.62	15	1	1	-0.2	1	-0.0416666666666667	8	51
MACROD2	12	3	3	1	289.08	578.16	15	1	1	0.25	1	0.05	4	15
MAD1L1	1	12	0	2	365.31	730.62	15	1	1	1	1	0.0769230769230769	2	13
MAD2L1	1	8	1	4	186.78	373.56	15	1	1	-1	1	-0.0888888888888889	5	9
MAD2L1BP	9	7	2	1	219.12	438.24	15	1	1	-0.555555555555556	1	-0.104166666666667	3	16
MAD2L2	0	5	0	8	209.88	419.76	15	1	1	NA	1	0	8	5
MADCAM1	22	22	6	5	378.51	757.02	15	1	1	-0.2	1	-0.0454545454545454	11	44
MADD	8	52	6	7	1606.44	3212.88	15	1	0.0138527547510937	-4.57142857142857	0.628451090139802	-0.328205128205128	13	60
MAEA	2	9	0	1	407.88	815.76	15	1	1	1	1	0.181818181818182	1	11
MAEL	9	17	2	3	401.61	803.22	15	1	1	-0.259259259259259	1	-0.0538461538461539	5	26
MAF	0	2	0	0	236.94	473.88	15	1	1	NA	1	NA	0	2
MAF1	1	11	2	3	243.54	487.08	15	1	0.191176470588235	-6.33333333333333	1	-0.316666666666667	5	12
MAFB	0	9	0	4	297.33	594.66	15	1	1	NA	1	0	4	9
MAFG	0	3	0	0	161.37	322.74	15	1	1	NA	1	NA	0	3
MAFK	0	2	0	0	155.43	310.86	15	1	1	NA	1	NA	0	2
MAGI2	7	29	4	4	1066.23	2132.46	15	1	0.091852517651843	-3.14285714285714	0.953786405978059	-0.305555555555556	8	36
MAGI3	33	55	2	1	1410.75	2821.5	15	1	0.556323825986747	-2.33333333333333	1	-0.291666666666667	3	88
MAGOH	0	4	0	0	115.5	231	15	1	1	NA	1	NA	0	4
MAK	21	13	7	3	634.59	1269.18	15	1	0.723661490386869	-0.444444444444444	1	-0.0823529411764705	10	34
MAK16	7	13	5	4	243.54	487.08	15	1	0.422288855572214	-1.32142857142857	1	-0.205555555555556	9	20
MAL	13	7	0	2	154.44	308.88	15	1	0.155844155844156	1	1	0.65	2	20
MAL2	0	4	0	0	132.66	265.32	15	1	1	NA	1	NA	0	4
MALL	4	7	0	1	153.45	306.9	15	1	1	1	1	0.363636363636364	1	11
MALSU1	3	3	6	3	157.74	315.48	15	1	0.622377622377622	-1	1	-0.166666666666667	9	6
MAMDC2	12	28	2	0	632.28	1264.56	15	1	0.105691056910569	-Inf	0.983805342817882	-0.7	2	40
MAMDC4	53	71	10	4	1167.21	2334.42	15	1	0.0502425092058989	-2.34905660377358	0.838764987711203	-0.286866359447005	14	124
MAML1	9	26	3	8	944.13	1888.26	15	1	1	-0.0833333333333333	1	-0.0155844155844156	11	35
MAML3	14	15	7	4	475.2	950.4	15	1	0.48823854872242	-0.875	1	-0.153605015673981	11	29
MAMLD1	17	35	7	5	1029.6	2059.2	15	1	0.112835026386422	-1.88235294117647	0.99134365547716	-0.256410256410256	12	52
MAN1A1	2	18	1	1	462.33	924.66	15	1	0.25974025974026	-8	1	-0.4	2	20
MAN1B1	12	19	0	1	622.71	1245.42	15	1	1	1	1	0.387096774193548	1	31
MAN1C1	5	12	1	0	375.21	750.42	15	1	0.333333333333333	-Inf	1	-0.705882352941176	1	17
MAN2A1	23	29	4	1	829.62	1659.24	15	1	0.179058280349243	-4.04347826086957	1	-0.357692307692308	5	52
MAN2A2	13	50	6	13	1042.14	2084.28	15	1	0.359140449528179	-0.775147928994083	1	-0.109440267335004	19	63
MAN2B2	30	36	3	6	960.96	1921.92	15	1	0.72284595627467	0.4	1	0.121212121212121	9	66
MAN2C1	37	72	14	20	980.76	1961.52	15	1	0.538925163294017	-0.362162162162162	1	-0.0723151645979492	34	109
MANBA	33	49	5	4	873.18	1746.36	15	1	0.482633797688779	-0.856060606060606	1	-0.153116531165312	9	82
MANEA	4	15	1	0	453.42	906.84	15	1	0.25	-Inf	1	-0.789473684210526	1	19
MANEAL	2	13	2	6	283.14	566.28	15	1	0.588932806324111	-1.16666666666667	1	-0.116666666666667	8	15
MANF	2	5	0	0	106.26	212.52	15	1	1	NA	1	NA	0	7
MANSC1	26	16	1	0	441.54	883.08	15	1	1	-Inf	1	-0.380952380952381	1	42
MANSC4	18	7	1	1	241.23	482.46	15	1	0.512820512820513	0.611111111111111	1	0.22	2	25
MAOA	4	13	2	3	501.6	1003.2	15	1	0.585326953748006	-1.16666666666667	1	-0.164705882352941	5	17
MAOB	19	20	3	4	608.52	1217.04	15	1	1	0.210526315789474	1	0.0586080586080586	7	39
MAP1A	99	98	12	6	3128.73	6257.46	15	1	0.222237320998941	-0.97979797979798	1	-0.164128595600677	18	197
MAP1B	37	93	10	8	2204.4	4408.8	15	1	0.029769768074583	-2.14189189189189	0.771992783106328	-0.270940170940171	18	130
MAP1LC3A	0	3	0	2	112.53	225.06	15	1	1	NA	1	0	2	3
MAP1LC3B	0	3	0	1	110.22	220.44	15	1	1	NA	1	0	1	3
MAP1LC3C	1	4	1	1	141.57	283.14	15	1	1	-3	1	-0.3	2	5
MAP2	36	75	11	13	2026.2	4052.4	15	1	0.24136979176609	-0.762820512820513	1	-0.134009009009009	24	111
MAP2K1	0	14	0	5	365.64	731.28	15	1	1	NA	1	0	5	14
MAP2K3	0	18	0	9	340.23	680.46	15	1	1	NA	1	0	9	18
MAP2K4	4	12	0	0	429.66	859.32	15	1	1	NA	1	NA	0	16
MAP2K5	1	8	0	4	269.28	538.56	15	1	1	1	1	0.111111111111111	4	9
MAP2K6	0	9	0	4	328.68	657.36	15	1	1	NA	1	0	4	9
MAP3K1	10	35	3	7	1257.3	2514.6	15	1	0.685238306403401	-0.5	1	-0.0777777777777778	10	45
MAP3K13	8	35	2	7	956.34	1912.68	15	1	1	-0.25	1	-0.0361757105943152	9	43
MAP3K14	11	30	3	1	934.56	1869.12	15	1	0.0824524312896405	-7.18181818181818	0.949431371776132	-0.481707317073171	4	41
MAP3K15	25	42	7	10	1425.27	2850.54	15	1	0.785751638969554	-0.176	1	-0.0386303775241439	17	67
MAP3K19	76	57	13	16	1248.39	2496.78	15	1	0.303187019849859	0.390625	1	0.123152709359606	29	133
MAP3K2	1	24	2	4	849.09	1698.18	15	1	0.0878754171301445	-11	0.951277979139867	-0.293333333333333	6	25
MAP3K20	10	18	3	7	899.91	1799.82	15	1	1	0.228571428571429	1	0.0571428571428572	10	28
MAP3K21	13	38	1	7	877.8	1755.6	15	1	0.665745199539324	0.582417582417582	1	0.129901960784314	8	51
MAP3K3	4	11	2	5	649.11	1298.22	15	1	1	-0.1	1	-0.019047619047619	7	15
MAP3K4	14	48	4	5	1537.8	3075.6	15	1	0.217564546027863	-1.74285714285714	1	-0.218637992831541	9	62
MAP3K5	1	43	1	7	1215.39	2430.78	15	1	0.28657616892911	-5.14285714285714	1	-0.102272727272727	8	44
MAP3K6	8	11	13	9	496.65	993.3	15	1	0.354298124716535	-0.986111111111111	1	-0.169856459330144	22	19
MAP3K7	1	8	0	3	598.95	1197.9	15	1	1	1	1	0.111111111111111	3	9
MAP3K7CL	0	5	0	0	178.2	356.4	15	1	1	NA	1	NA	0	5
MAP3K8	2	17	1	2	483.12	966.24	15	1	0.370779220779221	-3.25	1	-0.228070175438596	3	19
MAP4	189	140	30	22	1986.27	3972.54	15	1	1	-0.0101010101010102	1	-0.00245499181669384	52	329
MAP4K3	2	30	0	5	849.42	1698.84	15	1	1	1	1	0.0625	5	32
MAP4K4	7	35	4	11	1428.9	2857.8	15	1	0.455190647113924	-0.818181818181818	1	-0.1	15	42
MAP6	1	10	1	0	261.69	523.38	15	1	0.166666666666667	-Inf	1	-0.909090909090909	1	11
MAP6D1	4	3	0	0	118.14	236.28	15	1	1	NA	1	NA	0	7
MAP7	15	14	2	3	731.94	1463.88	15	1	1	0.377777777777778	1	0.117241379310345	5	29
MAP7D1	3	6	2	4	205.26	410.52	15	1	1	0	1	0	6	9
MAP7D2	3	21	3	2	693	1386	15	1	0.0455643972885352	-9.5	0.823296819270389	-0.475	5	24
MAP7D3	17	15	4	2	754.05	1508.1	15	1	0.672399672399672	-0.764705882352941	1	-0.135416666666667	6	32
MAP9	30	18	8	3	534.27	1068.54	15	1	0.730118430911303	-0.6	1	-0.102272727272727	11	48
MAPK1	0	6	0	1	274.56	549.12	15	1	1	NA	1	0	1	6
MAPK10	6	14	5	4	514.47	1028.94	15	1	0.237062787287675	-1.91666666666667	1	-0.255555555555556	9	20
MAPK12	12	13	3	2	442.53	885.06	15	1	1	-0.625	1	-0.12	5	25
MAPK13	0	9	0	2	362.34	724.68	15	1	1	NA	1	0	2	9
MAPK14	0	8	0	1	319.11	638.22	15	1	1	NA	1	0	1	8
MAPK15	15	12	2	1	486.09	972.18	15	1	1	-0.6	1	-0.111111111111111	3	27
MAPK6	0	11	0	2	714.78	1429.56	15	1	1	NA	1	0	2	11
MAPK8	0	13	0	3	408.87	817.74	15	1	1	NA	1	0	3	13
MAPK8IP3	28	46	15	18	1350.69	2701.38	15	1	0.524221294158373	-0.369047619047619	1	-0.0761670761670761	33	74
MAPK9	0	7	0	1	430.65	861.3	15	1	1	NA	1	0	1	7
MAPKAP1	1	9	0	2	517.77	1035.54	15	1	1	1	1	0.1	2	10
MAPKAPK2	2	7	1	5	238.59	477.18	15	1	1	0.3	1	0.0555555555555556	6	9
MAPKAPK3	1	7	0	4	384.12	768.24	15	1	1	1	1	0.125	4	8
MAPKAPK5	0	13	1	5	455.4	910.8	15	1	0.315789473684211	-Inf	1	-0.166666666666667	6	13
MAPKKK3L	0	22	1	7	638.55	1277.1	15	1	0.266666666666666	-Inf	1	-0.125	8	22
MAPRE1	1	8	0	0	237.93	475.86	15	1	1	NA	1	NA	0	9
MAPRE2	4	5	1	3	238.92	477.84	15	1	1	0.583333333333333	1	0.194444444444444	4	9
MAPT	20	20	13	10	719.73	1439.46	15	1	0.793786487304455	-0.3	1	-0.0652173913043478	23	40
MARC1	4	10	2	3	243.21	486.42	15	1	1	-0.666666666666667	1	-0.114285714285714	5	14
MARCH1	14	13	2	2	503.91	1007.82	15	1	1	0.0714285714285714	1	0.0185185185185185	4	27
MARCH11	1	4	1	0	221.76	443.52	15	1	0.333333333333333	-Inf	1	-0.8	1	5
MARCH3	0	7	0	5	190.41	380.82	15	1	1	NA	1	0	5	7
MARCH4	4	3	0	0	180.84	361.68	15	1	1	NA	1	NA	0	7
MARCH5	0	6	1	0	269.61	539.22	15	1	0.142857142857143	-Inf	1	-1	1	6
MARCH6	2	26	5	5	899.25	1798.5	15	1	0.00802329207901964	-12	0.529186532206378	-0.428571428571429	10	28
MARCH7	21	26	2	5	763.29	1526.58	15	1	0.685350994937565	0.504761904761905	1	0.161094224924012	7	47
MARCH8	6	11	3	4	554.4	1108.8	15	1	1	-0.375	1	-0.0756302521008403	7	17
MARCO	21	23	3	0	458.37	916.74	15	1	0.234042553191489	-Inf	1	-0.522727272727273	3	44
MARK1	2	12	0	2	720.72	1441.44	15	1	1	1	1	0.142857142857143	2	14
MARK3	0	21	1	3	777.15	1554.3	15	1	0.16	-Inf	1	-0.25	4	21
MARS	23	68	12	17	773.52	1547.04	15	1	0.106336983664829	-1.08695652173913	0.983875031494079	-0.161045850701023	29	91
MARS2	12	28	5	7	505.23	1010.46	15	1	0.495936508502865	-0.666666666666667	1	-0.116666666666667	12	40
MARVELD1	1	4	0	2	122.43	244.86	15	1	1	1	1	0.2	2	5
MARVELD2	4	21	1	2	430.32	860.64	15	1	0.459401709401709	-1.625	1	-0.173333333333333	3	25
MAS1	3	8	2	0	326.7	653.4	15	1	0.128205128205128	-Inf	1	-0.727272727272727	2	11
MASP1	4	48	4	14	722.04	1444.08	15	1	0.190313255855112	-2.42857142857143	1	-0.145299145299145	18	52
MASP2	12	24	2	6	682.11	1364.22	15	1	1	0.333333333333333	1	0.0833333333333333	8	36
MAST2	24	47	5	8	1874.4	3748.8	15	1	0.75868205756992	-0.223958333333333	1	-0.0465872156013001	13	71
MAST3	8	65	12	43	1148.73	2297.46	15	1	0.138984559288726	-1.26744186046512	1	-0.108592777085928	55	73
MAST4	43	74	4	4	2239.71	4479.42	15	1	0.472890306065789	-0.720930232558139	1	-0.132478632478632	8	117
MASTL	33	31	5	9	896.61	1793.22	15	1	0.379420315730443	0.478114478114478	1	0.158482142857143	14	64
MAT1A	1	13	0	0	389.73	779.46	15	1	1	NA	1	NA	0	14
MAT2A	5	8	3	2	419.76	839.52	15	1	0.607843137254902	-1.4	1	-0.215384615384615	5	13
MAT2B	4	7	1	2	310.86	621.72	15	1	1	0.125	1	0.0303030303030303	3	11
MATK	12	28	8	14	580.14	1160.28	15	1	0.777092406167962	-0.333333333333333	1	-0.0636363636363637	22	40
MATN1	7	20	0	14	439.56	879.12	15	1	0.074515144155709	1	0.914637734923963	0.259259259259259	14	27
MATN2	24	52	7	12	1211.76	2423.52	15	1	0.78523888685676	-0.263888888888889	1	-0.0526315789473684	19	76
MATN3	8	25	3	2	466.29	932.58	15	1	0.134053336839715	-3.6875	1	-0.357575757575758	5	33
MATN4	10	15	5	9	595.32	1190.64	15	1	1	0.166666666666667	1	0.0428571428571429	14	25
MATR3	4	24	0	3	893.97	1787.94	15	1	1	1	1	0.142857142857143	3	28
MAU2	0	13	0	5	479.82	959.64	15	1	1	NA	1	0	5	13
MB	0	5	0	3	153.45	306.9	15	1	1	NA	1	0	3	5
MB21D1	20	12	1	0	241.89	483.78	15	1	1	-Inf	1	-0.375	1	32
MB21D2	0	14	1	2	441.21	882.42	15	1	0.176470588235294	-Inf	1	-0.333333333333333	3	14
MBD3	0	7	1	1	231.66	463.32	15	1	0.222222222222222	-Inf	1	-0.5	2	7
MBD5	7	26	2	4	1727.88	3455.76	15	1	0.606894820517111	-0.857142857142857	1	-0.121212121212121	6	33
MBIP	3	8	3	0	303.6	607.2	15	1	0.0549450549450549	-Inf	0.846060006968071	-0.727272727272727	3	11
MBL2	5	12	0	1	254.43	508.86	15	1	1	1	1	0.294117647058824	1	17
MBLAC2	1	6	3	1	157.74	315.48	15	1	0.0878787878787878	-17	0.951277979139867	-0.607142857142857	4	7
MBNL1	14	16	11	4	438.57	877.14	15	1	0.118479356160728	-2.14285714285714	1	-0.266666666666667	15	30
MBNL2	5	4	0	1	359.04	718.08	15	1	1	1	1	0.555555555555556	1	9
MBNL3	0	5	0	1	262.35	524.7	15	1	1	NA	1	0	1	5
MBOAT1	1	7	0	4	490.05	980.1	15	1	1	1	1	0.125	4	8
MBOAT2	5	12	0	2	438.57	877.14	15	1	1	1	1	0.294117647058824	2	17
MBP	4	6	1	1	278.19	556.38	15	1	1	-0.5	1	-0.1	2	10
MBTD1	3	5	1	2	686.07	1372.14	15	1	1	0.166666666666667	1	0.0416666666666667	3	8
MBTPS1	1	41	1	5	1050.39	2100.78	15	1	0.236702127659574	-7.2	1	-0.142857142857143	6	42
MBTPS2	5	15	1	2	490.05	980.1	15	1	1	-0.5	1	-0.0833333333333333	3	20
MC1R	3	7	1	1	311.85	623.7	15	1	1	-1.33333333333333	1	-0.2	2	10
MC2R	1	16	1	0	316.8	633.6	15	1	0.111111111111111	-Inf	0.98538656216834	-0.941176470588235	1	17
MC3R	2	5	2	0	322.74	645.48	15	1	0.166666666666667	-Inf	1	-0.714285714285714	2	7
MC5R	2	5	2	2	322.74	645.48	15	1	0.575757575757576	-1.5	1	-0.214285714285714	4	7
MCAM	7	9	6	13	433.29	866.58	15	1	0.503061372539537	0.406593406593407	1	0.121710526315789	19	16
MCC	1	17	0	4	419.1	838.2	15	1	1	1	1	0.0555555555555556	4	18
MCCC1	10	31	2	4	917.73	1835.46	15	1	0.637200697029021	-0.55	1	-0.0894308943089431	6	41
MCCC2	2	23	1	1	515.79	1031.58	15	1	0.213675213675214	-10.5	1	-0.42	2	25
MCCC2L	14	33	5	6	604.89	1209.78	15	1	0.476341401882809	-0.964285714285714	1	-0.156673114119923	11	47
MCEE	4	2	2	0	170.28	340.56	15	1	1	-Inf	1	-0.333333333333333	2	6
MCF2	10	34	3	3	1099.89	2199.78	15	1	0.172915290075327	-2.4	1	-0.272727272727273	6	44
MCF2L2	10	42	3	7	1363.23	2726.46	15	1	0.424434281083672	-0.8	1	-0.107692307692308	10	52
MCFD2	3	5	1	0	142.56	285.12	15	1	0.444444444444444	-Inf	1	-0.625	1	8
MCHR1	4	17	2	2	363	726	15	1	0.23399209486166	-3.25	1	-0.30952380952381	4	21
MCHR2	2	23	2	5	443.85	887.7	15	1	0.200500556173526	-3.6	1	-0.205714285714286	7	25
MCL1	0	8	0	0	120.45	240.9	15	1	1	NA	1	NA	0	8
MCM10	12	20	5	5	401.28	802.56	15	1	0.713547852187133	-0.666666666666667	1	-0.125	10	32
MCM2	4	41	2	8	818.07	1636.14	15	1	0.297589572839295	-1.5625	1	-0.111111111111111	10	45
MCM3	5	35	2	16	776.16	1552.32	15	1	1	0.125	1	0.0138888888888889	18	40
MCM3AP	35	73	8	9	1533.18	3066.36	15	1	0.276483186468739	-0.853968253968254	1	-0.146514161220044	17	108
MCM4	5	41	5	9	794.31	1588.62	15	1	0.0436320107467436	-3.55555555555556	0.822543273817637	-0.248447204968944	14	46
MCM5	6	38	2	27	721.71	1443.42	15	1	0.464928746629699	0.530864197530864	1	0.067398119122257	29	44
MCM6	4	31	1	3	781.44	1562.88	15	1	0.43616490984912	-1.58333333333333	1	-0.135714285714286	4	35
MCM8	7	58	2	13	978.45	1956.9	15	1	0.673520369252895	-0.274725274725275	1	-0.0256410256410256	15	65
MCM9	32	40	5	7	784.08	1568.16	15	1	1	0.107142857142857	1	0.0277777777777777	12	72
MCMBP	3	25	0	4	591.69	1183.38	15	1	1	1	1	0.107142857142857	4	28
MCMDC2	26	29	7	4	676.17	1352.34	15	1	0.510529803037956	-0.951923076923077	1	-0.163636363636364	11	55
MCOLN2	2	22	1	1	531.63	1063.26	15	1	0.221538461538462	-10	1	-0.416666666666667	2	24
MCOLN3	3	19	2	1	553.41	1106.82	15	1	0.091304347826087	-11.6666666666667	0.953786405978059	-0.53030303030303	3	22
MCPH1	34	16	2	1	697.95	1395.9	15	1	1	0.0588235294117647	1	0.0133333333333334	3	50
MCRS1	1	6	0	4	106.26	212.52	15	1	1	1	1	0.142857142857143	4	7
MCT2L	7	13	1	2	498.96	997.92	15	1	1	0.0714285714285714	1	0.0166666666666667	3	20
MCTP1	4	2	4	0	203.61	407.22	15	1	0.466666666666667	-Inf	1	-0.333333333333333	4	6
MCTP2	18	31	0	1	856.35	1712.7	15	1	1	1	1	0.36734693877551	1	49
MCTS1	1	10	0	2	180.18	360.36	15	1	1	1	1	0.0909090909090909	2	11
MCU	0	4	1	1	299.97	599.94	15	1	0.333333333333333	-Inf	1	-0.5	2	4
MCUR1	1	3	0	3	193.71	387.42	15	1	1	1	1	0.25	3	4
MDC1	84	45	6	3	802.23	1604.46	15	1	1	-0.0714285714285714	1	-0.0155038759689922	9	129
MDFI	1	2	3	2	172.92	345.84	15	1	1	-2	1	-0.266666666666667	5	3
MDGA2	24	36	10	17	907.17	1814.34	15	1	0.817434256170447	0.117647058823529	1	0.0296296296296297	27	60
MDH1	0	10	1	2	331.65	663.3	15	1	0.230769230769231	-Inf	1	-0.333333333333333	3	10
MDH1B	46	24	4	1	728.31	1456.62	15	1	0.659315885439752	-1.08695652173913	1	-0.142857142857143	5	70
MDH2	0	16	0	2	300.96	601.92	15	1	1	NA	1	0	2	16
MDK	1	5	0	2	97.35	194.7	15	1	1	1	1	0.166666666666667	2	6
MDM1	24	30	2	4	725.67	1451.34	15	1	0.689228916827428	0.375	1	0.111111111111111	6	54
MDM2	9	28	2	6	480.15	960.3	15	1	1	-0.037037037037037	1	-0.00675675675675674	8	37
MDM4	9	16	5	1	470.25	940.5	15	1	0.0671116054875788	-7.88888888888889	0.884435842948953	-0.473333333333333	6	25
MDN1	135	194	34	28	5345.34	10690.68	15	1	0.0506369915338771	-0.744973544973545	0.840481137782937	-0.138052750269634	62	329
ME1	1	15	4	1	537.57	1075.14	15	1	0.00398053958425476	-59	0.449019745625747	-0.7375	5	16
ME3	7	20	1	4	595.98	1191.96	15	1	1	0.285714285714286	1	0.0592592592592592	5	27
MEA1	0	1	1	0	37.29	74.58	15	1	1	-Inf	1	-1	1	1
MEAF6	9	11	1	2	283.8	567.6	15	1	1	0.388888888888889	1	0.116666666666667	3	20
MECOM	7	17	1	6	1084.05	2168.1	15	1	0.641701795917591	0.595238095238095	1	0.148809523809524	7	24
MECR	8	15	3	8	336.27	672.54	15	1	1	0.296875	1	0.075098814229249	11	23
MED1	5	67	1	18	1536.81	3073.62	15	1	1	0.255555555555556	1	0.016812865497076	19	72
MED10	0	4	0	0	96.36	192.72	15	1	1	NA	1	NA	0	4
MED12	2	91	1	8	2093.52	4187.04	15	1	0.24422830518346	-4.6875	1	-0.0896057347670251	9	93
MED12L	15	45	6	8	1523.28	3046.56	15	1	0.201138073603815	-1.25	1	-0.178571428571429	14	60
MED13	7	54	4	7	2156.55	4313.1	15	1	0.057092171018854	-3.40816326530612	0.850449180905408	-0.248882265275708	11	61
MED13L	9	58	9	20	2123.55	4247.1	15	1	0.0513223463681091	-1.9	0.843251957917679	-0.176016469377252	29	67
MED14	1	45	0	7	1385.67	2771.34	15	1	1	1	1	0.0217391304347826	7	46
MED16	3	41	0	12	777.81	1555.62	15	1	1	1	1	0.0681818181818182	12	44
MED17	1	27	0	8	629.64	1259.28	15	1	1	1	1	0.0357142857142857	8	28
MED18	1	8	2	0	180.18	360.36	15	1	0.0545454545454545	-Inf	0.846060006968071	-0.888888888888889	2	9
MED20	2	13	1	4	206.25	412.5	15	1	1	-0.625	1	-0.0666666666666667	5	15
MED21	1	5	0	1	143.55	287.1	15	1	1	1	1	0.166666666666667	1	6
MED22	0	4	0	3	157.74	315.48	15	1	1	NA	1	0	3	4
MED24	2	24	3	14	884.4	1768.8	15	1	0.368635712935203	-1.57142857142857	1	-0.0995475113122172	17	26
MED26	5	12	2	2	607.53	1215.06	15	1	0.574269005847953	-1.4	1	-0.205882352941176	4	17
MED28	0	4	1	0	175.89	351.78	15	1	0.2	-Inf	1	-1	1	4
MED30	0	4	0	0	159.06	318.12	15	1	1	NA	1	NA	0	4
MED31	1	2	0	0	121.44	242.88	15	1	1	NA	1	NA	0	3
MED4	0	14	0	6	239.58	479.16	15	1	1	NA	1	0	6	14
MED6	2	4	0	0	237.27	474.54	15	1	1	NA	1	NA	0	6
MED7	0	10	0	0	218.79	437.58	15	1	1	NA	1	NA	0	10
MED8	0	10	0	4	264.33	528.66	15	1	1	NA	1	0	4	10
MEF2B	3	5	3	1	152.46	304.92	15	1	0.545454545454546	-4	1	-0.375	4	8
MEF2C	0	7	0	1	473.55	947.1	15	1	1	NA	1	0	1	7
MEF2D	0	4	0	2	199.65	399.3	15	1	1	NA	1	0	2	4
MEGF10	9	44	3	3	1117.71	2235.42	15	1	0.0918946987574137	-3.88888888888889	0.953786405978059	-0.330188679245283	6	53
MEGF6	44	101	14	23	1390.29	2780.58	15	1	0.430744911448536	-0.397233201581028	1	-0.0749301025163094	37	145
MEGF6L	10	6	1	2	1688.28	3376.56	15	1	0.545923632610939	0.7	1	0.291666666666667	3	16
MEGF9	13	20	4	5	455.4	910.8	15	1	1	-0.230769230769231	1	-0.0505050505050505	9	33
MEI1	27	43	11	16	1382.37	2764.74	15	1	1	-0.0949074074074074	1	-0.0216931216931217	27	70
MEI4	8	3	2	2	129.69	259.38	15	1	0.56043956043956	0.625	1	0.227272727272727	4	11
MEIG1	3	2	1	0	130.68	261.36	15	1	1	-Inf	1	-0.4	1	5
MEIKIN	31	22	11	3	400.62	801.24	15	1	0.221605816021983	-1.60215053763441	1	-0.200808625336927	14	53
MEIOB	16	15	1	2	493.35	986.7	15	1	1	0.53125	1	0.182795698924731	3	31
MEIOC	27	30	6	3	863.28	1726.56	15	1	0.475238848398059	-1.22222222222222	1	-0.192982456140351	9	57
MELK	15	40	6	4	619.74	1239.48	15	1	0.0647628762783688	-3	0.884435842948953	-0.327272727272727	10	55
MELTF	25	29	9	2	733.59	1467.18	15	1	0.0465252983807114	-4.22	0.828231827900648	-0.355218855218855	11	54
MEOX1	6	21	1	1	240.57	481.14	15	1	0.431034482758621	-2.5	1	-0.277777777777778	2	27
MEOX2	0	8	0	0	139.59	279.18	15	1	1	NA	1	NA	0	8
MEP1A	36	47	7	11	1148.07	2296.14	15	1	0.797225217917853	0.169191919191919	1	0.0448460508701473	18	83
MEP1B	9	31	5	6	689.37	1378.74	15	1	0.148439431717609	-1.87037037037037	1	-0.229545454545455	11	40
MEPE	38	47	10	4	499.95	999.9	15	1	0.0850294754755179	-2.09210526315789	0.950356516076024	-0.267226890756303	14	85
MERTK	26	58	11	17	953.37	1906.74	15	1	0.488245135472899	-0.443438914027149	1	-0.0833333333333333	28	84
mesd	0	5	1	0	183.48	366.96	15	1	0.166666666666667	-Inf	1	-1	1	5
MESDC1	0	4	1	2	353.43	706.86	15	1	0.428571428571428	-Inf	1	-0.333333333333333	3	4
MESP1-MESP2	1	3	0	3	109.23	218.46	15	1	1	1	1	0.25	3	4
MEST	5	17	3	5	249.81	499.62	15	1	0.643056420507695	-1.04	1	-0.147727272727273	8	22
MET	7	45	5	4	1282.05	2564.1	15	1	0.0107131800607495	-7.03571428571429	0.585928868752023	-0.420940170940171	9	52
METAP1	1	15	0	0	344.52	689.04	15	1	1	NA	1	NA	0	16
METAP2	2	18	0	7	424.05	848.1	15	1	1	1	1	0.1	7	20
METRNL	1	4	0	0	258.39	516.78	15	1	1	NA	1	NA	0	5
METTL10	5	12	3	2	210.21	420.42	15	1	0.308878256246677	-2.6	1	-0.305882352941176	5	17
METTL11B	2	5	2	0	322.74	645.48	15	1	0.166666666666667	-Inf	1	-0.714285714285714	2	7
METTL15	5	12	2	0	275.22	550.44	15	1	0.12280701754386	-Inf	1	-0.705882352941176	2	17
METTL16	4	17	2	0	515.13	1030.26	15	1	0.0592885375494071	-Inf	0.865311545612266	-0.80952380952381	2	21
METTL18	19	25	6	7	342.54	685.08	15	1	1	-0.12781954887218	1	-0.0297202797202797	13	44
METTL21A	1	5	0	1	193.38	386.76	15	1	1	1	1	0.166666666666667	1	6
METTL21C	4	6	1	0	265.32	530.64	15	1	0.454545454545455	-Inf	1	-0.6	1	10
METTL21EP	3	13	0	0	253.44	506.88	15	1	1	NA	1	NA	0	16
METTL22	10	19	9	4	388.08	776.16	15	1	0.0493737640079104	-3.275	0.837400931738441	-0.347480106100796	13	29
METTL23	8	10	2	3	162.36	324.72	15	1	1	0.166666666666667	1	0.0444444444444444	5	18
METTL24	9	17	4	4	335.61	671.22	15	1	0.67945865776789	-0.888888888888889	1	-0.153846153846154	8	26
METTL25	13	11	2	1	517.44	1034.88	15	1	1	-0.692307692307692	1	-0.125	3	24
METTL2A	8	17	2	1	337.59	675.18	15	1	0.283882783882784	-3.25	1	-0.346666666666667	3	25
METTL4	35	17	6	3	596.64	1193.28	15	1	1	0.0285714285714286	1	0.0064102564102565	9	52
METTL5	2	8	0	0	210.87	421.74	15	1	1	NA	1	NA	0	10
METTL6	8	9	4	2	290.07	580.14	15	1	0.64040536122916	-1.25	1	-0.196078431372549	6	17
METTL7A	7	12	0	4	244.53	489.06	15	1	0.272727272727273	1	1	0.368421052631579	4	19
METTL8	16	15	4	0	393.03	786.06	15	1	0.118601986249045	-Inf	1	-0.483870967741935	4	31
MEX3A	1	10	2	4	372.24	744.48	15	1	0.514705882352941	-4	1	-0.242424242424242	6	11
MEX3D	2	7	4	7	304.92	609.84	15	1	0.642414860681115	-1	1	-0.141414141414141	11	9
MFAP1	0	26	0	2	388.74	777.48	15	1	1	NA	1	0	2	26
MFAP2	0	3	0	2	170.28	340.56	15	1	1	NA	1	0	2	3
MFAP3	3	13	2	5	338.58	677.16	15	1	0.621385479509049	-0.733333333333333	1	-0.0982142857142857	7	16
MFAP3L	4	9	1	2	379.17	758.34	15	1	1	-0.125	1	-0.0256410256410256	3	13
MFAP5	0	5	0	0	165.33	330.66	15	1	1	NA	1	NA	0	5
MFF	3	8	1	3	308.88	617.76	15	1	1	0.111111111111111	1	0.0227272727272727	4	11
MFGE8	2	19	2	9	437.91	875.82	15	1	0.593159065628476	-1.11111111111111	1	-0.0865800865800866	11	21
MFN1	5	29	3	7	733.59	1467.18	15	1	0.354989868767222	-1.48571428571429	1	-0.152941176470588	10	34
MFN2	1	18	1	12	748.44	1496.88	15	1	1	-0.5	1	-0.0242914979757085	13	19
MFNG	11	17	3	4	351.45	702.9	15	1	1	-0.159090909090909	1	-0.0357142857142857	7	28
MFRP	3	4	4	2	162.69	325.38	15	1	0.592074592074592	-1.66666666666667	1	-0.238095238095238	6	7
MFSD1	6	30	3	5	447.48	894.96	15	1	0.328823129163458	-2	1	-0.208333333333333	8	36
MFSD10	8	18	0	0	519.75	1039.5	15	1	1	NA	1	NA	0	26
MFSD11	8	19	3	2	444.51	889.02	15	1	0.30982341490545	-2.5625	1	-0.303703703703704	5	27
MFSD12	6	16	5	5	386.76	773.52	15	1	0.25153319742114	-1.66666666666667	1	-0.227272727272727	10	22
MFSD13A	10	22	5	6	504.9	1009.8	15	1	0.473157148164041	-0.833333333333333	1	-0.142045454545455	11	32
MFSD2A	0	41	0	4	453.42	906.84	15	1	1	NA	1	0	4	41
MFSD2B	7	13	5	4	492.03	984.06	15	1	0.422288855572214	-1.32142857142857	1	-0.205555555555556	9	20
MFSD4A	0	21	2	2	480.48	960.96	15	1	0.02	-Inf	0.695416702676231	-0.5	4	21
MFSD4B	14	43	7	13	446.16	892.32	15	1	0.392183547850362	-0.653846153846154	1	-0.104385964912281	20	57
MFSD5	1	13	0	0	126.06	252.12	15	1	1	NA	1	NA	0	14
MFSD6	13	35	1	0	780.12	1560.24	15	1	0.285714285714286	-Inf	1	-0.729166666666667	1	48
MFSD8	5	20	2	0	496.98	993.96	15	1	0.0598290598290598	-Inf	0.870044279682834	-0.8	2	25
MGA	54	96	9	12	2429.46	4858.92	15	1	0.630559190067384	-0.333333333333333	1	-0.0685714285714286	21	150
MGAM	21	43	8	12	580.47	1160.94	15	1	0.596404557650393	-0.365079365079365	1	-0.071875	20	64
MGARP	15	5	2	1	211.53	423.06	15	1	1	0.333333333333333	1	0.0833333333333334	3	20
MGAT2	3	5	2	5	326.04	652.08	15	1	1	0.333333333333333	1	0.0892857142857143	7	8
MGAT3	3	27	1	5	507.87	1015.74	15	1	0.53475935828877	-0.8	1	-0.0666666666666667	6	30
MGAT4A	6	12	0	1	527.67	1055.34	15	1	1	1	1	0.333333333333333	1	18
MGAT4B	9	19	2	4	556.05	1112.1	15	1	1	-0.0555555555555556	1	-0.0119047619047619	6	28
MGAT4C	19	25	5	6	926.97	1853.94	15	1	1	-0.0964912280701755	1	-0.0227272727272727	11	44
MGAT4D	16	14	2	2	524.7	1049.4	15	1	1	0.125	1	0.0333333333333333	4	30
MGAT5	2	30	0	3	735.57	1471.14	15	1	1	1	1	0.0625	3	32
MGAT5B	2	21	2	14	670.89	1341.78	15	1	1	-0.5	1	-0.0380434782608696	16	23
MGEA5	0	18	0	8	841.17	1682.34	15	1	1	NA	1	0	8	18
MGLL	3	15	1	5	308.88	617.76	15	1	1	0	1	0	6	18
MGME1	15	17	2	0	338.58	677.16	15	1	0.484848484848485	-Inf	1	-0.53125	2	32
MGP	0	3	0	0	102.96	205.92	15	1	1	NA	1	NA	0	3
MGST1	2	4	1	0	154.44	308.88	15	1	0.428571428571428	-Inf	1	-0.666666666666667	1	6
MGST2	7	3	1	0	146.52	293.04	15	1	1	-Inf	1	-0.3	1	10
MGST3	3	8	1	3	142.56	285.12	15	1	1	0.111111111111111	1	0.0227272727272727	4	11
MGTNIPA2L	4	9	1	3	336.27	672.54	15	1	1	0.25	1	0.0576923076923077	4	13
MHCDMA	5	5	0	1	155.76	311.52	15	1	1	1	1	0.5	1	10
MIA2	49	39	11	5	1359.27	2718.54	15	1	0.415116792397202	-0.751020408163265	1	-0.130681818181818	16	88
MIB1	0	34	0	6	967.89	1935.78	15	1	1	NA	1	0	6	34
MIB2	6	25	3	11	945.45	1890.9	15	1	1	-0.136363636363636	1	-0.0207373271889401	14	31
MICAL1	20	23	13	12	725.34	1450.68	15	1	0.802063906114648	-0.245833333333333	1	-0.0548837209302326	25	43
MICAL2	66	76	18	12	1937.76	3875.52	15	1	0.22829282955568	-0.727272727272727	1	-0.135211267605634	30	142
MICALL1	13	25	5	14	768.9	1537.8	15	1	0.76328335844467	0.313186813186813	1	0.0789473684210527	19	38
MICALL2	26	24	5	3	774.18	1548.36	15	1	0.711909680365782	-0.538461538461539	1	-0.105	8	50
MICU1	3	20	3	5	392.37	784.74	15	1	0.160539250639362	-3	1	-0.244565217391304	8	23
MICU2	2	9	1	2	384.12	768.24	15	1	1	-1.25	1	-0.151515151515151	3	11
MICU3	1	14	0	3	385.11	770.22	15	1	1	1	1	0.0666666666666667	3	15
MID1	0	6	0	2	242.55	485.1	15	1	1	NA	1	0	2	6
MID1IP1	0	3	3	4	117.48	234.96	15	1	0.475	-Inf	1	-0.428571428571429	7	3
MID2	0	7	1	10	640.2	1280.4	15	1	1	-Inf	1	-0.0909090909090909	11	7
MIEF1	4	19	3	3	457.38	914.76	15	1	0.131476569407604	-3.75	1	-0.326086956521739	6	23
MIEF2	11	16	6	10	447.81	895.62	15	1	1	0.127272727272727	1	0.0324074074074074	16	27
MIER1	4	15	3	1	505.89	1011.78	15	1	0.0671936758893281	-10.25	0.884435842948953	-0.539473684210526	4	19
MIER2	2	26	0	0	542.52	1085.04	15	1	1	NA	1	NA	0	28
MIF	0	1	0	2	79.2	158.4	15	1	1	NA	1	0	2	1
MIF4GD	3	12	0	1	220.77	441.54	15	1	1	1	1	0.2	1	15
MIGA1	3	13	1	0	595.98	1191.96	15	1	0.235294117647059	-Inf	1	-0.8125	1	16
MIGA2	5	35	5	16	575.52	1151.04	15	1	0.291188415096542	-1.1875	1	-0.113095238095238	21	40
MILR1	22	12	2	1	340.56	681.12	15	1	1	-0.0909090909090908	1	-0.0196078431372548	3	34
MINA	12	18	4	4	467.28	934.56	15	1	0.698446074157649	-0.5	1	-0.1	8	30
MINDY4B	11	22	10	4	508.86	1017.72	15	1	0.0250181270685489	-4	0.761210061313465	-0.380952380952381	14	33
MINPP1	5	5	0	0	330.33	660.66	15	1	1	NA	1	NA	0	10
MIOS	0	16	2	4	438.9	877.8	15	1	0.0649350649350649	-Inf	0.884435842948953	-0.333333333333333	6	16
MIPEP	16	22	1	8	749.43	1498.86	15	1	0.127154466456587	0.828125	1	0.309941520467836	9	38
MIPOL1	13	15	2	0	426.69	853.38	15	1	0.482758620689655	-Inf	1	-0.535714285714286	2	28
MIS12	12	4	0	2	192.06	384.12	15	1	0.0980392156862746	1	0.971353639774823	0.75	2	16
MIS18A	11	5	1	2	182.82	365.64	15	1	0.523219814241486	0.772727272727273	1	0.354166666666667	3	16
MIS18BP1	89	61	12	8	957	1914	15	1	1	-0.0280898876404494	1	-0.0066666666666666	20	150
MISP	35	37	6	15	841.83	1683.66	15	1	0.1358782083445	0.577142857142857	1	0.200396825396825	21	72
MITD1	3	11	1	2	212.19	424.38	15	1	1	-0.833333333333333	1	-0.119047619047619	3	14
MITF	5	9	3	2	528.66	1057.32	15	1	0.602683178534572	-1.7	1	-0.242857142857143	5	14
MKI67	171	81	37	20	2077.02	4154.04	15	1	0.754686604162797	0.123684210526316	1	0.0294486215538847	57	252
MKKS	14	28	6	9	529.65	1059.3	15	1	0.755167514410151	-0.333333333333333	1	-0.0666666666666667	15	42
MKL1	10	26	3	7	968.55	1937.1	15	1	1	-0.114285714285714	1	-0.0222222222222222	10	36
MKL2	42	29	0	1	980.1	1960.2	15	1	0.416666666666667	1	1	0.591549295774648	1	71
MKLN1	0	19	1	5	723.69	1447.38	15	1	0.24	-Inf	1	-0.166666666666667	6	19
MKNK1	2	14	1	2	408.87	817.74	15	1	0.422084623323013	-2.5	1	-0.208333333333333	3	16
MKNK2	0	21	0	0	222.09	444.18	15	1	1	NA	1	NA	0	21
MKRN1	6	9	0	0	333.63	667.26	15	1	1	NA	1	NA	0	15
MKRN2	20	57	8	6	875.16	1750.32	15	1	0.0286320934412853	-2.8	0.761210061313465	-0.311688311688312	14	77
MKS1	14	24	2	0	484.11	968.22	15	1	0.153846153846154	-Inf	1	-0.631578947368421	2	38
MKX	5	8	0	3	213.84	427.68	15	1	0.508928571428571	1	1	0.384615384615385	3	13
MLANA	0	2	1	0	112.86	225.72	15	1	0.333333333333333	-Inf	1	-1	1	2
MLC1	4	11	0	0	376.2	752.4	15	1	1	NA	1	NA	0	15
MLF1	7	13	3	4	263.34	526.68	15	1	1	-0.392857142857143	1	-0.0785714285714286	7	20
MLF2	1	16	1	4	225.06	450.12	15	1	0.411255411255411	-3	1	-0.141176470588235	5	17
MLH1	26	24	24	26	701.58	1403.16	15	1	0.841615338838669	0.14792899408284	1	0.04	50	50
MLH3	70	75	24	10	1427.58	2855.16	15	1	0.0222650278481794	-1.57142857142857	0.721018759249189	-0.223123732251521	34	145
MLIP	38	28	7	5	577.5	1155	15	1	1	-0.0315789473684212	1	-0.00757575757575757	12	66
MLLT10	3	30	1	10	984.72	1969.44	15	1	1	0	1	0	11	33
MLLT3	19	16	2	2	575.52	1151.04	15	1	1	0.157894736842105	1	0.0428571428571428	4	35
MLLT6	4	19	2	13	938.85	1877.7	15	1	1	0.269230769230769	1	0.0405797101449275	15	23
MLN	10	3	0	1	117.81	235.62	15	1	0.285714285714286	1	1	0.769230769230769	1	13
MLNR	10	13	4	11	355.41	710.82	15	1	0.32927326659251	0.527272727272727	1	0.168115942028985	15	23
MLPH	29	54	4	4	658.35	1316.7	15	1	0.454374549964707	-0.862068965517241	1	-0.150602409638554	8	83
MLX	2	3	0	1	168.3	336.6	15	1	1	1	1	0.4	1	5
MLXIP	15	30	3	12	897.27	1794.54	15	1	0.516753804918197	0.5	1	0.133333333333333	15	45
MLXIPL	19	51	2	2	1027.62	2055.24	15	1	0.31796170084806	-1.68421052631579	1	-0.228571428571429	4	70
MLYCD	0	17	2	2	373.56	747.12	15	1	0.0285714285714286	-Inf	0.761210061313465	-0.5	4	17
MMAA	8	13	2	3	408.87	817.74	15	1	1	-0.0833333333333333	1	-0.0190476190476191	5	21
MMAB	0	9	0	7	133.98	267.96	15	1	1	NA	1	0	7	9
MMACHC	3	6	1	4	216.81	433.62	15	1	1	0.5	1	0.133333333333333	5	9
MMADHC	4	15	1	2	291.06	582.12	15	1	1	-0.875	1	-0.12280701754386	3	19
MMD	0	6	0	3	236.28	472.56	15	1	1	NA	1	0	3	6
MMD2	2	4	0	5	241.89	483.78	15	1	0.454545454545455	1	1	0.333333333333333	5	6
MME	7	30	0	4	731.61	1463.22	15	1	1	1	1	0.189189189189189	4	37
MMEL1	2	21	1	5	766.26	1532.52	15	1	0.515325670498084	-1.1	1	-0.0797101449275362	6	23
MMGT1	0	2	1	0	99.33	198.66	15	1	0.333333333333333	-Inf	1	-1	1	2
MMP1	13	15	2	1	462.33	924.66	15	1	0.599555061179088	-1.30769230769231	1	-0.202380952380952	3	28
MMP10	24	24	0	0	565.62	1131.24	15	1	1	NA	1	NA	0	48
MMP11	6	18	0	10	456.39	912.78	15	1	0.147827651639076	1	1	0.25	10	24
MMP13	2	19	1	4	468.27	936.54	15	1	0.488461538461538	-1.375	1	-0.104761904761905	5	21
MMP15	0	26	1	7	594.33	1188.66	15	1	0.235294117647059	-Inf	1	-0.125	8	26
MMP16	5	8	1	0	367.29	734.58	15	1	0.428571428571428	-Inf	1	-0.615384615384615	1	13
MMP17	12	23	4	7	572.22	1144.44	15	1	1	-0.0952380952380953	1	-0.0207792207792208	11	35
MMP2	2	30	0	5	657.36	1314.72	15	1	1	1	1	0.0625	5	32
MMP23B	4	15	4	1	397.98	795.96	15	1	0.0276679841897233	-14	0.761210061313465	-0.589473684210526	5	19
MMP24	4	13	2	5	416.79	833.58	15	1	1	-0.3	1	-0.0504201680672269	7	17
MMP27	22	23	7	4	482.13	964.26	15	1	0.506380532943808	-0.829545454545455	1	-0.147474747474747	11	45
MMP28	8	14	4	13	472.23	944.46	15	1	0.494032408381686	0.461538461538462	1	0.128342245989305	17	22
MMP7	6	9	0	1	265.32	530.64	15	1	1	1	1	0.4	1	15
MMR1L1	116	106	22	9	2628.12	5256.24	15	1	0.0557131393786577	-1.23371647509579	0.846060006968071	-0.187154896832316	31	222
MMR1L2	42	47	7	4	1423.62	2847.24	15	1	0.352390979751699	-0.958333333333333	1	-0.164453524004086	11	89
MMR1L4	35	63	9	9	1434.84	2869.68	15	1	0.295075471580723	-0.8	1	-0.142857142857143	18	98
MMRN1	41	39	12	5	1214.73	2429.46	15	1	0.184509539405199	-1.28292682926829	1	-0.193382352941177	17	80
MMRN2	27	31	1	6	1003.86	2007.72	15	1	0.130011593377537	0.808641975308642	1	0.322660098522167	7	58
MMS19	21	37	7	14	978.12	1956.24	15	1	1	0.119047619047619	1	0.0287356321839081	21	58
MMS22L	29	31	6	9	1239.48	2478.96	15	1	0.773182361927533	0.28735632183908	1	0.0833333333333333	15	60
MN1	6	50	4	8	837.54	1675.08	15	1	0.0669273100924225	-3.16666666666667	0.884435842948953	-0.226190476190476	12	56
MNAT1	5	16	0	0	301.95	603.9	15	1	1	NA	1	NA	0	21
MNR2	2	8	2	1	109.56	219.12	15	1	0.202797202797203	-7	1	-0.466666666666667	3	10
MNS1	16	16	3	3	430.32	860.64	15	1	1	0	1	0	6	32
MNT	1	14	1	6	463.98	927.96	15	1	1	-1.33333333333333	1	-0.0761904761904762	7	15
MNX1	1	4	0	0	87.12	174.24	15	1	1	NA	1	NA	0	5
MOB1A	0	10	0	1	210.21	420.42	15	1	1	NA	1	0	1	10
MOB2	0	4	0	1	228.03	456.06	15	1	1	NA	1	0	1	4
MOB3A	0	10	1	1	214.83	429.66	15	1	0.166666666666667	-Inf	1	-0.5	2	10
MOB3B	2	5	0	0	137.94	275.88	15	1	1	NA	1	NA	0	7
MOB3C	0	8	0	3	203.28	406.56	15	1	1	NA	1	0	3	8
MOB4	0	6	0	2	203.94	407.88	15	1	1	NA	1	0	2	6
MOCOS	23	16	6	2	542.52	1085.04	15	1	0.691837270407563	-1.08695652173913	1	-0.16025641025641	8	39
MOCS1	7	21	6	2	608.85	1217.7	15	1	0.0156939082640843	-8	0.653191285336197	-0.5	8	28
MOCS2	2	4	0	0	154.44	308.88	15	1	1	NA	1	NA	0	6
MOCS3	9	24	3	7	434.28	868.56	15	1	1	-0.142857142857143	1	-0.0272727272727273	10	33
MOGAT1	1	13	0	7	327.03	654.06	15	1	1	1	1	0.0714285714285714	7	14
MOK	5	11	0	1	436.92	873.84	15	1	1	1	1	0.3125	1	16
MON2	3	60	2	10	1696.86	3393.72	15	1	0.178602082692378	-3	1	-0.119047619047619	12	63
MORC2	25	53	6	11	1079.1	2158.2	15	1	0.782413082736455	-0.156363636363636	1	-0.0324283559577677	17	78
MORC3	15	32	1	5	899.91	1799.82	15	1	0.65477918308107	0.573333333333333	1	0.152482269503546	6	47
MORN3	6	12	3	3	236.61	473.22	15	1	0.63490742666944	-1	1	-0.166666666666667	6	18
MORN4	0	2	0	3	73.26	146.52	15	1	1	NA	1	0	3	2
MORN5	4	2	0	2	110.88	221.76	15	1	0.428571428571429	1	1	0.666666666666667	2	6
MOS	15	13	4	7	346.5	693	15	1	0.480115351083093	0.504761904761905	1	0.172077922077922	11	28
MOSPD1	0	5	0	0	214.83	429.66	15	1	1	NA	1	NA	0	5
MOSPD2	3	12	1	0	508.53	1017.06	15	1	0.25	-Inf	1	-0.8	1	15
MOV10L1	27	53	2	4	1184.04	2368.08	15	1	1	0.0185185185185185	1	0.00416666666666671	6	80
MOXD1	4	13	1	2	524.37	1048.74	15	1	1	-0.625	1	-0.0980392156862745	3	17
MPC1	3	5	0	1	107.91	215.82	15	1	1	1	1	0.375	1	8
MPC2	1	4	0	2	117.15	234.3	15	1	1	1	1	0.2	2	5
MPDZ	65	81	8	4	2168.43	4336.86	15	1	0.227361979306403	-1.49230769230769	1	-0.221461187214612	12	146
MPHOSPH10	23	27	4	4	633.93	1267.86	15	1	1	-0.173913043478261	1	-0.04	8	50
MPHOSPH6	2	7	0	1	152.79	305.58	15	1	1	1	1	0.222222222222222	1	9
MPHOSPH8	19	27	3	6	768.9	1537.8	15	1	0.726957681136253	0.289473684210526	1	0.0797101449275363	9	46
MPHOSPH9	34	29	11	8	1154.67	2309.34	15	1	0.798648834094686	-0.172794117647059	1	-0.039264828738513	19	63
MPI	2	9	3	11	235.95	471.9	15	1	1	-0.227272727272727	1	-0.0324675324675325	14	11
MPL	40	25	3	7	404.25	808.5	15	1	0.0871839680100625	0.732142857142857	0.951277979139867	0.315384615384615	10	65
MPND	1	0	1	0	47.85	95.7	15	1	1	NA	1	0	1	1
MPP1	1	19	2	8	444.51	889.02	15	1	0.251231527093596	-3.75	1	-0.15	10	20
MPP2	0	15	2	3	485.1	970.2	15	1	0.0526315789473684	-Inf	0.843251957917679	-0.4	5	15
MPP3	5	9	1	1	576.51	1153.02	15	1	1	-0.8	1	-0.142857142857143	2	14
MPP4	11	22	4	2	611.82	1223.64	15	1	0.180349675705713	-3	1	-0.333333333333333	6	33
MPP5	1	19	0	1	669.24	1338.48	15	1	1	1	1	0.05	1	20
MPP7	0	14	2	2	571.23	1142.46	15	1	0.0392156862745098	-Inf	0.794052121283243	-0.5	4	14
MPPE1	7	14	4	2	395.01	790.02	15	1	0.187365291713118	-3	1	-0.333333333333333	6	21
MPPED2	0	7	0	3	292.05	584.1	15	1	1	NA	1	0	3	7
MPRIP	18	69	17	28	2368.41	4736.82	15	1	0.0399823599815942	-1.32738095238095	0.796805964245439	-0.17088122605364	45	87
MPST	7	19	1	4	295.02	590.04	15	1	1	0.321428571428571	1	0.0692307692307692	5	26
MPZL2	2	12	1	0	207.57	415.14	15	1	0.2	-Inf	1	-0.857142857142857	1	14
MPZL3	6	9	1	3	221.76	443.52	15	1	1	0.5	1	0.15	4	15
MRAS	0	9	1	1	206.91	413.82	15	1	0.181818181818182	-Inf	1	-0.5	2	9
MRC1	21	34	8	16	1437.48	2874.96	15	1	0.801508264384756	0.19047619047619	1	0.0484848484848485	24	55
MRC2	3	56	3	25	1160.61	2321.22	15	1	0.381726833931435	-1.24	1	-0.0562953995157385	28	59
MRE11	8	29	3	7	696.96	1393.92	15	1	0.678582996312556	-0.553571428571429	1	-0.0837837837837838	10	37
MREG	0	12	1	2	206.91	413.82	15	1	0.2	-Inf	1	-0.333333333333333	3	12
MRGBP	2	2	1	0	155.1	310.2	15	1	1	-Inf	1	-0.5	1	4
MRGPRH	6	7	0	5	313.83	627.66	15	1	0.114145658263305	1	0.997638012482328	0.461538461538462	5	13
MRM2	8	11	5	1	250.47	500.94	15	1	0.160248447204969	-5.875	1	-0.412280701754386	6	19
MRM3	20	19	7	8	301.62	603.24	15	1	1	0.16875	1	0.0461538461538461	15	39
MRNIP	30	6	3	6	319.77	639.54	15	1	0.00617953374916685	0.9	0.467685236262114	0.5	9	36
MROH1L1	18	47	13	24	1549.02	3098.04	15	1	0.503863501729317	-0.414351851851852	1	-0.0744282744282744	37	65
MRPL1	5	13	6	5	287.1	574.2	15	1	0.239866532898964	-2.12	1	-0.267676767676768	11	18
MRPL10	8	9	6	5	201.63	403.26	15	1	1	-0.35	1	-0.0748663101604278	11	17
MRPL13	33	25	8	4	499.95	999.9	15	1	0.749048841917747	-0.515151515151515	1	-0.0977011494252873	12	58
MRPL14	4	7	1	3	144.54	289.08	15	1	1	0.416666666666667	1	0.113636363636364	4	11
MRPL15	2	12	0	1	292.05	584.1	15	1	1	1	1	0.142857142857143	1	14
MRPL18	5	9	3	4	176.55	353.1	15	1	1	-0.35	1	-0.0714285714285714	7	14
MRPL19	5	14	1	0	226.71	453.42	15	1	0.3	-Inf	1	-0.736842105263158	1	19
MRPL20	3	4	0	0	148.5	297	15	1	1	NA	1	NA	0	7
MRPL21	2	4	1	0	175.89	351.78	15	1	0.428571428571428	-Inf	1	-0.666666666666667	1	6
MRPL22	4	9	0	1	191.4	382.8	15	1	1	1	1	0.307692307692308	1	13
MRPL23	2	3	0	1	146.85	293.7	15	1	1	1	1	0.4	1	5
MRPL27	3	10	1	2	131.34	262.68	15	1	1	-0.666666666666667	1	-0.102564102564103	3	13
MRPL3	2	19	1	2	334.62	669.24	15	1	0.342885375494071	-3.75	1	-0.238095238095238	3	21
MRPL30	4	4	1	2	143.55	287.1	15	1	1	0.5	1	0.166666666666667	3	8
MRPL34	1	2	3	1	78.87	157.74	15	1	0.485714285714286	-5	1	-0.416666666666667	4	3
MRPL35	2	7	1	1	110.22	220.44	15	1	0.490909090909091	-2.5	1	-0.277777777777778	2	9
MRPL37	17	20	4	8	361.68	723.36	15	1	0.517281092087092	0.411764705882353	1	0.126126126126126	12	37
MRPL38	9	15	2	4	338.58	677.16	15	1	1	0.166666666666667	1	0.0416666666666667	6	24
MRPL39	15	11	3	0	341.22	682.44	15	1	0.268472906403941	-Inf	1	-0.423076923076923	3	26
MRPL40	4	7	3	2	195.36	390.72	15	1	0.596153846153846	-1.625	1	-0.236363636363636	5	11
MRPL41	1	4	1	2	130.68	261.36	15	1	1	-1	1	-0.133333333333333	3	5
MRPL42	4	8	0	1	145.53	291.06	15	1	1	1	1	0.333333333333333	1	12
MRPL44	16	22	2	7	244.53	489.06	15	1	0.448862810536604	0.607142857142857	1	0.198830409356725	9	38
MRPL46	7	11	3	4	239.25	478.5	15	1	1	-0.178571428571429	1	-0.0396825396825397	7	18
MRPL47	9	9	3	1	235.29	470.58	15	1	0.593984962406015	-2	1	-0.25	4	18
MRPL48	6	13	4	4	203.94	407.88	15	1	0.414668423364076	-1.16666666666667	1	-0.184210526315789	8	19
MRPL50	8	12	0	0	167.31	334.62	15	1	1	NA	1	NA	0	20
MRPL51	1	2	0	1	98.34	196.68	15	1	1	1	1	0.333333333333333	1	3
MRPL54	2	6	0	1	95.7	191.4	15	1	1	1	1	0.25	1	8
MRPL55	2	4	3	3	122.76	245.52	15	1	1	-1	1	-0.166666666666667	6	6
MRPL57	4	4	1	0	102.96	205.92	15	1	1	-Inf	1	-0.5	1	8
MRPL58	3	10	2	2	131.34	262.68	15	1	0.53781512605042	-2.33333333333333	1	-0.269230769230769	4	13
MRPP3	21	29	8	8	580.8	1161.6	15	1	0.773016135362181	-0.380952380952381	1	-0.08	16	50
MRPS10	12	3	4	0	184.14	368.28	15	1	1	-Inf	1	-0.2	4	15
MRPS11	2	10	0	2	170.94	341.88	15	1	1	1	1	0.166666666666667	2	12
MRPS14	2	10	2	1	112.86	225.72	15	1	0.153846153846154	-9	1	-0.5	3	12
MRPS15	2	7	3	1	191.73	383.46	15	1	0.216783216783217	-9.5	1	-0.527777777777778	4	9
MRPS17	1	6	0	2	136.62	273.24	15	1	1	1	1	0.142857142857143	2	7
MRPS18A	7	3	4	0	156.09	312.18	15	1	0.505494505494505	-Inf	1	-0.3	4	10
MRPS18C	2	7	0	0	93.39	186.78	15	1	1	NA	1	NA	0	9
MRPS2	4	8	0	4	222.42	444.84	15	1	0.516483516483517	1	1	0.333333333333333	4	12
MRPS22	8	12	5	3	308.22	616.44	15	1	0.409661835748792	-1.5	1	-0.225	8	20
MRPS23	4	8	1	3	126.06	252.12	15	1	1	0.333333333333333	1	0.0833333333333333	4	12
MRPS25	3	5	0	0	141.57	283.14	15	1	1	NA	1	NA	0	8
MRPS27	12	8	2	0	372.24	744.48	15	1	0.515151515151515	-Inf	1	-0.4	2	20
MRPS28	2	1	0	0	123.42	246.84	15	1	1	NA	1	NA	0	3
MRPS30	5	8	3	0	242.22	484.44	15	1	0.2	-Inf	1	-0.615384615384615	3	13
MRPS31	9	14	3	4	368.28	736.56	15	1	1	-0.166666666666667	1	-0.0372670807453416	7	23
MRPS33	1	4	0	0	105.93	211.86	15	1	1	NA	1	NA	0	5
MRPS34	5	10	0	0	155.43	310.86	15	1	1	NA	1	NA	0	15
MRPS35	15	17	2	0	315.48	630.96	15	1	0.484848484848485	-Inf	1	-0.53125	2	32
MRPS36	17	11	3	2	242.22	484.44	15	1	1	0.0294117647058824	1	0.00714285714285712	5	28
MRPS5	9	15	1	4	398.97	797.94	15	1	0.632815460401667	0.583333333333333	1	0.175	5	24
MRPS6	1	4	0	0	112.86	225.72	15	1	1	NA	1	NA	0	5
MRPS7	1	4	1	1	213.18	426.36	15	1	1	-3	1	-0.3	2	5
MRPS9	8	12	0	3	345.18	690.36	15	1	0.525691699604743	1	1	0.4	3	20
MRRF	7	10	0	0	245.85	491.7	15	1	1	NA	1	NA	0	17
MRS2	0	10	0	0	375.54	751.08	15	1	1	NA	1	NA	0	10
MRTO4	4	9	1	2	187.77	375.54	15	1	1	-0.125	1	-0.0256410256410256	3	13
MRVLDC3	12	9	1	2	260.04	520.08	15	1	0.576086956521739	0.625	1	0.238095238095238	3	21
MSANTD1	0	6	0	2	277.53	555.06	15	1	1	NA	1	0	2	6
MSANTD2	8	20	1	3	476.19	952.38	15	1	1	0.166666666666667	1	0.0357142857142857	4	28
MSANTD3	0	5	0	1	272.25	544.5	15	1	1	NA	1	0	1	5
MSANTD4	1	13	0	1	342.54	685.08	15	1	1	1	1	0.0714285714285714	1	14
MSC	0	4	0	0	62.37	124.74	15	1	1	NA	1	NA	0	4
MSGN1	3	9	1	0	168.3	336.6	15	1	0.307692307692308	-Inf	1	-0.75	1	12
MSH2	12	31	4	3	873.51	1747.02	15	1	0.190266508083344	-2.44444444444444	1	-0.292358803986711	7	43
MSH3	29	24	4	3	911.13	1822.26	15	1	1	-0.103448275862069	1	-0.0242587601078167	7	53
MSH4	11	23	1	4	837.87	1675.74	15	1	1	0.477272727272727	1	0.123529411764706	5	34
MSH6	18	104	11	17	1266.54	2533.08	15	1	0.00644479080322777	-2.73856209150327	0.467685236262114	-0.245316159250585	28	122
MSI2	4	4	2	1	138.27	276.54	15	1	1	-1	1	-0.166666666666667	3	8
MSL2	1	16	0	4	539.55	1079.1	15	1	1	1	1	0.0588235294117647	4	17
MSL3	3	16	1	4	486.09	972.18	15	1	1	-0.333333333333333	1	-0.0421052631578948	5	19
MSLN	26	32	7	2	865.26	1730.52	15	1	0.0832330322653091	-3.30769230769231	0.949431371776132	-0.329501915708812	9	58
MSLNL	39	26	12	8	545.16	1090.32	15	1	1	0	1	0	20	65
MSMB	4	8	0	1	111.87	223.74	15	1	1	1	1	0.333333333333333	1	12
MSMO1	3	14	0	3	294.03	588.06	15	1	1	1	1	0.176470588235294	3	17
MSMP	2	5	0	1	99	198	15	1	1	1	1	0.285714285714286	1	7
MSRA	3	8	0	1	176.22	352.44	15	1	1	1	1	0.272727272727273	1	11
MSRB1	0	2	0	0	41.58	83.16	15	1	1	NA	1	NA	0	2
MSRB3	1	1	1	1	181.17	362.34	15	1	1	0	1	0	2	2
MST1	14	18	10	14	408.21	816.42	15	1	1	0.0816326530612245	1	0.0208333333333333	24	32
MSTN	1	5	0	0	372.24	744.48	15	1	1	NA	1	NA	0	6
MSTO1	14	25	1	1	446.82	893.64	15	1	1	-0.785714285714286	1	-0.141025641025641	2	39
MSX1	1	11	0	0	200.97	401.94	15	1	1	NA	1	NA	0	12
MSX2	0	10	0	2	220.77	441.54	15	1	1	NA	1	0	2	10
MTA1	0	9	0	5	682.77	1365.54	15	1	1	NA	1	0	5	9
MTA3	3	12	2	0	621.72	1243.44	15	1	0.0735294117647059	-Inf	0.913861472365723	-0.8	2	15
MTBP	20	33	9	6	837.54	1675.08	15	1	0.147937017109648	-1.475	1	-0.222641509433962	15	53
MTCH1	6	12	0	3	264.33	528.66	15	1	0.526315789473684	1	1	0.333333333333333	3	18
MTCH2	2	6	1	3	259.71	519.42	15	1	1	0	1	0	4	8
MTCL1	16	38	8	10	1482.69	2965.38	15	1	0.263306371541001	-0.9	1	-0.148148148148148	18	54
MTDH	3	20	2	5	564.63	1129.26	15	1	0.565035858139307	-1.66666666666667	1	-0.15527950310559	7	23
MTERF2	19	32	6	2	394.02	788.04	15	1	0.0608506964558149	-4.05263157894737	0.871782064889388	-0.377450980392157	8	51
MTERF3	12	15	4	4	410.85	821.7	15	1	1	-0.25	1	-0.0555555555555556	8	27
MTERF4	1	9	6	1	146.19	292.38	15	1	0.00365076100370219	-53	0.425431423415295	-0.757142857142857	7	10
MTF1	4	15	1	3	720.72	1441.44	15	1	1	-0.25	1	-0.0394736842105263	4	19
MTF2	2	7	3	0	619.41	1238.82	15	1	0.0454545454545455	-Inf	0.822543273817637	-0.777777777777778	3	9
MTFMT	12	20	3	4	323.07	646.14	15	1	1	-0.25	1	-0.0535714285714285	7	32
MTFR1	10	10	3	2	370.92	741.84	15	1	1	-0.5	1	-0.1	5	20
MTFR1L	5	9	1	0	284.13	568.26	15	1	0.4	-Inf	1	-0.642857142857143	1	14
MTFR2	14	15	0	0	341.55	683.1	15	1	1	NA	1	NA	0	29
MTG1	1	11	0	0	200.64	401.28	15	1	1	NA	1	NA	0	12
MTG2	6	22	2	5	702.9	1405.8	15	1	0.647844009683963	-0.466666666666667	1	-0.0714285714285714	7	28
MTHFD1	4	29	1	1	924.99	1849.98	15	1	0.26890756302521	-6.25	1	-0.378787878787879	2	33
MTHFD1L	18	24	10	7	868.56	1737.12	15	1	0.388628542839933	-0.904761904761905	1	-0.159663865546219	17	42
MTHFD2	5	12	0	2	332.64	665.28	15	1	1	1	1	0.294117647058824	2	17
MTHFD2L	5	14	1	3	297.33	594.66	15	1	1	0.0666666666666667	1	0.0131578947368421	4	19
MTHFR	1	33	1	5	645.48	1290.96	15	1	0.280769230769231	-5.6	1	-0.137254901960784	6	34
MTHFS	1	9	1	0	199.32	398.64	15	1	0.181818181818182	-Inf	1	-0.9	1	10
MTIF2	9	29	1	3	715.77	1431.54	15	1	1	-0.0740740740740742	1	-0.0131578947368421	4	38
MTIF3	11	15	3	5	265.32	530.64	15	1	1	0.181818181818182	1	0.0480769230769231	8	26
MTM1	6	31	2	4	597.96	1195.92	15	1	0.307758903782428	-1.58333333333333	1	-0.171171171171171	6	37
MTMR1	1	23	4	1	619.08	1238.16	15	1	0.00101890446718033	-91	0.250983202425848	-0.758333333333333	5	24
MTMR10	6	27	3	5	744.48	1488.96	15	1	0.341530386036918	-1.7	1	-0.193181818181818	8	33
MTMR11	0	2	0	0	6.93	13.86	15	1	1	NA	1	NA	0	2
MTMR12	8	17	4	4	668.91	1337.82	15	1	0.419611534183281	-1.125	1	-0.18	8	25
MTMR14	2	25	1	12	550.11	1100.22	15	1	1	-0.0416666666666667	1	-0.00284900284900286	13	27
MTMR2	1	27	0	6	611.16	1222.32	15	1	1	1	1	0.0357142857142857	6	28
MTMR3	7	34	4	15	1195.92	2391.84	15	1	0.729833044782374	-0.295238095238095	1	-0.0397946084724005	19	41
MTMR4	21	53	4	3	1146.42	2292.84	15	1	0.194061508851649	-2.36507936507937	1	-0.287644787644788	7	74
MTMR6	3	19	1	5	566.28	1132.56	15	1	1	-0.266666666666667	1	-0.0303030303030303	6	22
MTMR7	2	21	2	3	605.88	1211.76	15	1	0.135042735042735	-6	1	-0.31304347826087	5	23
MTMR8	9	24	5	11	623.7	1247.4	15	1	1	-0.212121212121212	1	-0.0397727272727273	16	33
MTMR9	19	31	2	8	504.57	1009.14	15	1	0.469673578188956	0.592105263157895	1	0.18	10	50
MTMR9LP	14	21	6	5	516.45	1032.9	15	1	0.49354345837613	-0.8	1	-0.145454545454545	11	35
MTNR1A	0	15	3	1	331.65	663.3	15	1	0.00412796697626419	-Inf	0.454065685553736	-0.75	4	15
MTNR1B	3	12	2	2	357.39	714.78	15	1	0.27218782249742	-3	1	-0.3	4	15
MTO1	14	31	9	3	607.86	1215.72	15	1	0.00866349240918743	-5.64285714285714	0.544626840515064	-0.438888888888889	12	45
MTOR	0	61	0	18	1391.94	2783.88	15	1	1	NA	1	0	18	61
MTPAP	10	17	1	3	519.42	1038.84	15	1	1	0.433333333333333	1	0.12037037037037	4	27
MTR	10	43	7	7	1185.36	2370.72	15	1	0.0339551516778143	-3.3	0.787252650978106	-0.311320754716981	14	53
MTRF1	11	20	1	2	429.66	859.32	15	1	1	0.0909090909090909	1	0.0215053763440861	3	31
MTRF1L	3	6	1	3	315.48	630.96	15	1	1	0.333333333333333	1	0.0833333333333333	4	9
MTRR	21	23	6	3	663.3	1326.6	15	1	0.467157396880872	-1.19047619047619	1	-0.189393939393939	9	44
MTSS1	12	27	5	7	693.99	1387.98	15	1	0.503137415524253	-0.607142857142857	1	-0.108974358974359	12	39
MTTP	8	31	1	1	885.06	1770.12	15	1	0.395121951219512	-2.875	1	-0.294871794871795	2	39
MTUS1	51	29	6	2	905.19	1810.38	15	1	0.707188166767367	-0.705882352941176	1	-0.1125	8	80
MTUS2	32	28	11	8	918.39	1836.78	15	1	0.795770247334361	-0.203125	1	-0.0456140350877193	19	60
MTX2	6	10	1	1	275.22	550.44	15	1	1	-0.666666666666667	1	-0.125	2	16
MTX3	2	14	0	5	280.83	561.66	15	1	1	1	1	0.125	5	16
MUC13	50	10	3	1	357.39	714.78	15	1	0.539131160131953	0.4	1	0.0833333333333334	4	60
MUC2	69	101	8	5	2437.38	4874.76	15	1	0.156184322302859	-1.34202898550725	1	-0.209502262443439	13	170
MUC4	117	76	52	46	1717.65	3435.3	15	1	0.257985088997425	0.265700483091787	1	0.0756053716823517	98	193
MUC4L	16	21	12	18	417.78	835.56	15	1	0.80876876934318	0.125	1	0.0324324324324324	30	37
MUC6	20	39	0	9	1284.03	2568.06	15	1	0.0495363931450909	1	0.837400931738441	0.338983050847458	9	59
MUL1	6	9	1	1	186.45	372.9	15	1	1	-0.5	1	-0.1	2	15
MUL1L	6	9	0	9	251.13	502.26	15	1	0.0518514666111919	1	0.843251957917679	0.4	9	15
MUM1	50	60	4	3	927.63	1855.26	15	1	0.702087755075118	-0.6	1	-0.116883116883117	7	110
MURC	4	9	1	4	352.44	704.88	15	1	1	0.4375	1	0.107692307692308	5	13
MUSK	10	63	6	10	928.95	1857.9	15	1	0.0355757006648867	-2.78	0.788199921465956	-0.238013698630137	16	73
MUSTN1	7	11	2	2	347.16	694.32	15	1	1	-0.571428571428571	1	-0.111111111111111	4	18
MUT	8	40	1	4	741.51	1483.02	15	1	1	-0.25	1	-0.0333333333333334	5	48
MUTYH	16	19	11	19	469.92	939.84	15	1	0.61416581796741	0.3125	1	0.0904761904761905	30	35
MVB12B	0	2	0	0	28.71	57.42	15	1	1	NA	1	NA	0	2
MVD	3	4	1	2	147.51	295.02	15	1	1	0.333333333333333	1	0.0952380952380952	3	7
MVK	2	17	5	9	321.42	642.84	15	1	0.106089397871934	-3.72222222222222	0.983805342817882	-0.25187969924812	14	19
MVP	4	22	1	6	646.8	1293.6	15	1	1	0.0833333333333334	1	0.010989010989011	7	26
MX1	67	21	2	4	678.15	1356.3	15	1	0.0411683612504138	0.843283582089552	0.798931947804628	0.428030303030303	6	88
MXD1	6	6	0	3	158.4	316.8	15	1	0.228571428571429	1	1	0.5	3	12
MXD3	6	5	6	3	206.25	412.5	15	1	0.66992140985949	-0.666666666666667	1	-0.121212121212121	9	11
MXD4	0	4	0	1	188.76	377.52	15	1	1	NA	1	0	1	4
MXI1	0	4	0	1	226.71	453.42	15	1	1	NA	1	0	1	4
MXRA5	87	84	15	7	2814.9	5629.8	15	1	0.173219944283302	-1.06896551724138	1	-0.17304625199362	22	171
MXRA7	0	2	0	3	91.08	182.16	15	1	1	NA	1	0	3	2
MXRA8	4	20	0	8	429.99	859.98	15	1	0.54972191323693	1	1	0.166666666666667	8	24
MYBBP1A	52	48	9	19	1242.12	2484.24	15	1	0.0864214258087858	0.562753036437247	0.951277979139867	0.198571428571429	28	100
MYBL1	3	25	0	3	739.86	1479.72	15	1	1	1	1	0.107142857142857	3	28
MYBL2	0	24	1	13	673.53	1347.06	15	1	0.368421052631579	-Inf	1	-0.0714285714285714	14	24
MYBPC1	1	36	3	6	1113.75	2227.5	15	1	0.0198179979777553	-17	0.69334271185944	-0.306306306306306	9	37
MYBPC3	14	29	5	3	1259.28	2518.56	15	1	0.130878589767418	-2.45238095238095	1	-0.299418604651163	8	43
MYBPH	5	28	3	7	415.14	830.28	15	1	0.361685475665832	-1.4	1	-0.148484848484848	10	33
MYC	2	14	2	0	370.59	741.18	15	1	0.0392156862745098	-Inf	0.794052121283243	-0.875	2	16
MYCBP	1	1	0	0	73.92	147.84	15	1	1	NA	1	NA	0	2
MYCBP2	9	154	5	12	4621.65	9243.3	15	1	0.00486690806224565	-6.12962962962963	0.460299276725364	-0.238902923132443	17	163
MYCBPAP	64	52	15	10	1187.01	2374.02	15	1	0.824648661638179	-0.21875	1	-0.0482758620689655	25	116
MYCL	9	28	0	3	301.95	603.9	15	1	1	1	1	0.243243243243243	3	37
MYCT1	4	5	3	1	226.05	452.1	15	1	0.559440559440559	-2.75	1	-0.305555555555556	4	9
MYD88	2	13	1	3	264.99	529.98	15	1	0.530443756449949	-1.16666666666667	1	-0.116666666666667	4	15
MYDGF	0	2	0	1	114.84	229.68	15	1	1	NA	1	0	1	2
MYEF2	4	12	0	0	548.79	1097.58	15	1	1	NA	1	NA	0	16
MYF5	1	5	0	0	180.51	361.02	15	1	1	NA	1	NA	0	6
MYF6	1	3	0	0	145.86	291.72	15	1	1	NA	1	NA	0	4
MYH10	0	62	3	12	1975.05	3950.1	15	1	0.0062200956937799	-Inf	0.467685236262114	-0.2	15	62
MYH13	77	75	8	10	1906.08	3812.16	15	1	0.803888948188799	0.220779220779221	1	0.0621345029239766	18	152
MYH15	1	69	1	8	1918.62	3837.24	15	1	0.216163583252191	-7.625	1	-0.0968253968253968	9	70
MYH1E	6	23	3	9	547.47	1094.94	15	1	1	-0.277777777777778	1	-0.0431034482758621	12	29
MYH9	2	77	1	9	1942.38	3884.76	15	1	0.30366137156141	-3.27777777777778	1	-0.0746835443037975	10	79
MYL1	1	9	0	1	191.07	382.14	15	1	1	1	1	0.1	1	10
MYL10	0	4	0	1	164.34	328.68	15	1	1	NA	1	0	1	4
MYL12A	2	22	0	1	389.07	778.14	15	1	1	1	1	0.0833333333333333	1	24
MYL2	1	6	0	6	164.34	328.68	15	1	1	1	1	0.142857142857143	6	7
MYL3	0	8	1	1	192.06	384.12	15	1	0.2	-Inf	1	-0.5	2	8
MYL4	10	11	2	5	255.42	510.84	15	1	0.661835748792271	0.56	1	0.19047619047619	7	21
MYL9	0	11	0	0	171.27	342.54	15	1	1	NA	1	NA	0	11
MYLIP	2	20	1	9	418.77	837.54	15	1	1	-0.111111111111111	1	-0.00909090909090909	10	22
MYLK	22	46	1	5	1886.94	3773.88	15	1	0.658707520949466	0.581818181818182	1	0.156862745098039	6	68
MYLK3	18	24	3	5	863.28	1726.56	15	1	1	0.2	1	0.0535714285714285	8	42
MYLKSML	15	24	1	1	382.8	765.6	15	1	1	-0.6	1	-0.115384615384615	2	39
MYNN	3	35	2	3	609.84	1219.68	15	1	0.0951394039879576	-6.77777777777778	0.960983694935281	-0.321052631578947	5	38
MYO10L	12	45	7	6	2004.09	4008.18	15	1	0.0334214175334041	-3.375	0.784747167725891	-0.327935222672065	13	57
MYO15A	31	50	28	47	1881.99	3763.98	15	1	1	0.0391214824982842	1	0.00938271604938268	75	81
MYO15L	66	48	10	14	1636.14	3272.28	15	1	0.177916277539781	0.480519480519481	1	0.162280701754386	24	114
MYO16	28	59	7	4	1693.56	3387.12	15	1	0.0509247711476576	-2.6875	0.842002722948256	-0.314524555903866	11	87
MYO18A	2	28	6	31	1442.43	2884.86	15	1	0.28139882742103	-1.70967741935484	1	-0.0954954954954955	37	30
MYO18B	53	90	44	45	2426.16	4852.32	15	1	0.0753912846367216	-0.660377358490566	0.916387518192578	-0.123752651842539	89	143
MYO19	23	19	10	7	958.32	1916.64	15	1	1	-0.180124223602484	1	-0.0406162464985994	17	42
MYO1B	11	40	4	10	1191.3	2382.6	15	1	0.721343857407243	-0.454545454545455	1	-0.0700280112044818	14	51
MYO1D	6	37	0	1	930.93	1861.86	15	1	1	1	1	0.13953488372093	1	43
MYO1E	2	38	3	10	1105.83	2211.66	15	1	0.0881514870098982	-4.7	0.951689130777703	-0.180769230769231	13	40
MYO1G	4	5	3	11	340.23	680.46	15	1	0.36303674787993	0.659090909090909	1	0.23015873015873	14	9
MYO1H	10	47	2	15	1011.78	2023.56	15	1	0.72121874886122	0.373333333333333	1	0.0577915376676987	17	57
MYO3A	42	43	11	9	1730.52	3461.04	15	1	0.804492170805617	-0.251322751322751	1	-0.0558823529411765	20	85
MYO3AL	23	35	8	9	992.31	1984.62	15	1	0.58982392748772	-0.352657004830918	1	-0.0740365111561866	17	58
MYO3B	17	36	6	2	1256.97	2513.94	15	1	0.0440350075957668	-5.35294117647059	0.822543273817637	-0.429245283018868	8	53
MYO5A	7	61	6	17	1820.61	3641.22	15	1	0.0844432174175333	-2.07563025210084	0.949431371776132	-0.157928388746803	23	68
MYO5B	34	78	28	29	1202.52	2405.04	15	1	0.0189716017811691	-1.21501014198783	0.683149554847669	-0.18765664160401	57	112
MYO5C	19	47	5	10	1682.01	3364.02	15	1	0.759259557859735	-0.236842105263158	1	-0.0454545454545454	15	66
MYO6	7	38	0	4	1290.63	2581.26	15	1	1	1	1	0.155555555555556	4	45
MYO7A	8	93	3	13	2216.28	4432.56	15	1	0.173685632858497	-1.68269230769231	1	-0.108292079207921	16	101
MYO7B	38	51	8	9	2031.15	4062.3	15	1	0.793289807844816	-0.192982456140351	1	-0.0436219431592862	17	89
MYO9B	34	76	7	21	2192.85	4385.7	15	1	0.6466087839897	0.254901960784314	1	0.0590909090909091	28	110
MYOC	4	14	7	17	307.23	614.46	15	1	0.730591754981999	-0.441176470588235	1	-0.0694444444444445	24	18
MYOCD	6	28	1	1	891.33	1782.66	15	1	0.355555555555555	-3.66666666666667	1	-0.323529411764706	2	34
MYOD1	1	10	0	2	211.2	422.4	15	1	1	1	1	0.0909090909090909	2	11
MYOF	17	63	7	4	2022.57	4045.14	15	1	0.00641388576360342	-5.48529411764706	0.467685236262114	-0.423863636363636	11	80
MYOG	1	6	2	6	218.13	436.26	15	1	1	-1	1	-0.107142857142857	8	7
MYOM1	21	41	7	9	1758.24	3516.48	15	1	0.56152965467361	-0.518518518518519	1	-0.0987903225806452	16	62
MYOM2	6	49	0	1	1426.59	2853.18	15	1	1	1	1	0.109090909090909	1	55
MYOM3	57	53	4	2	1302.84	2605.68	15	1	0.681788928643436	-0.859649122807018	1	-0.148484848484848	6	110
MYOT	2	19	2	3	510.84	1021.68	15	1	0.154849498327759	-5.33333333333333	1	-0.304761904761905	5	21
MYOZ1	1	3	0	3	292.05	584.1	15	1	1	1	1	0.25	3	4
MYOZ2	1	12	1	1	219.78	439.56	15	1	0.257142857142857	-11	1	-0.423076923076923	2	13
MYOZ3	5	8	2	3	242.55	485.1	15	1	1	-0.0666666666666667	1	-0.0153846153846154	5	13
MYPN	19	40	9	11	1327.59	2655.18	15	1	0.417554240901277	-0.722488038277512	1	-0.127966101694915	20	59
MYRFL	17	30	5	4	891	1782	15	1	0.293913884857281	-1.20588235294118	1	-0.193853427895981	9	47
MYRIP	30	7	11	1	529.32	1058.64	15	1	0.659771160577907	-1.56666666666667	1	-0.105855855855856	12	37
MYSM1	12	30	4	1	801.24	1602.48	15	1	0.0396286944917627	-9	0.794548741720226	-0.514285714285714	5	42
MYT1	12	24	5	17	1041.81	2083.62	15	1	0.553639509862256	0.411764705882353	1	0.106060606060606	22	36
MYT1L	1	12	2	0	1131.57	2263.14	15	1	0.0285714285714286	-Inf	0.761210061313465	-0.923076923076923	2	13
MZB1	3	2	2	7	148.17	296.34	15	1	0.265734265734266	0.80952380952381	1	0.377777777777778	9	5
MZT1	0	2	0	0	72.27	144.54	15	1	1	NA	1	NA	0	2
N4BP1	31	24	3	4	841.17	1682.34	15	1	0.691075712198741	0.419354838709677	1	0.135064935064935	7	55
N4BP2	71	47	16	7	1756.26	3512.52	15	1	0.485515757971561	-0.51307847082495	1	-0.0939572586588062	23	118
N4BP2L1	10	11	1	3	212.85	425.7	15	1	0.604347826086957	0.633333333333333	1	0.226190476190476	4	21
N4BP2L2	83	44	22	15	1257.3	2514.6	15	1	0.561330970497299	0.222489959839357	1	0.0589487124920195	37	127
N4BP3	1	16	4	7	348.81	697.62	15	1	0.0617826617826618	-8.14285714285714	0.876180863544705	-0.304812834224599	11	17
N6AMT1	3	6	2	0	169.62	339.24	15	1	0.181818181818182	-Inf	1	-0.666666666666667	2	9
NAA25	7	34	2	10	948.42	1896.84	15	1	1	0.0285714285714286	1	0.00406504065040653	12	41
NAA30	1	3	0	1	272.58	545.16	15	1	1	1	1	0.25	1	4
NAA35	1	24	1	0	694.65	1389.3	15	1	0.0769230769230769	-Inf	0.922367800589409	-0.96	1	25
NAA50	0	4	0	3	169.29	338.58	15	1	1	NA	1	0	3	4
NAAA	5	11	2	0	347.16	694.32	15	1	0.137254901960784	-Inf	1	-0.6875	2	16
NAALAD2	17	24	4	3	733.59	1467.18	15	1	0.682985275164136	-0.882352941176471	1	-0.156794425087108	7	41
NAALADL2	15	33	8	5	769.23	1538.46	15	1	0.0585985833262248	-2.52	0.861744483565755	-0.302884615384615	13	48
NAB1	3	22	1	5	495	990	15	1	1	-0.466666666666667	1	-0.0466666666666667	6	25
NABP1	1	5	2	9	195.36	390.72	15	1	1	-0.111111111111111	1	-0.0151515151515152	11	6
NACA	0	14	0	2	190.74	381.48	15	1	1	NA	1	0	2	14
NACC2	0	21	1	9	573.21	1146.42	15	1	0.322580645161291	-Inf	1	-0.1	10	21
NADK	1	12	0	1	435.6	871.2	15	1	1	1	1	0.0769230769230769	1	13
NADK2	6	12	0	2	411.51	823.02	15	1	1	1	1	0.333333333333333	2	18
NADSYN1	3	25	5	4	701.91	1403.82	15	1	0.0115402188457217	-9.41666666666667	0.593603434168836	-0.448412698412698	9	28
NAE1	35	45	4	2	1138.5	2277	15	1	0.40369175254062	-1.57142857142857	1	-0.229166666666667	6	80
NAGA	13	16	3	9	380.16	760.32	15	1	0.305403140716014	0.58974358974359	1	0.198275862068966	12	29
NAGLU	5	12	6	16	486.75	973.5	15	1	1	0.1	1	0.0213903743315508	22	17
NAGPA	36	32	16	13	823.68	1647.36	15	1	1	-0.0940170940170941	1	-0.0223123732251521	29	68
NAMPT	2	16	1	6	351.78	703.56	15	1	1	-0.333333333333333	1	-0.0317460317460317	7	18
NANOG	12	9	1	1	256.74	513.48	15	1	1	0.25	1	0.0714285714285714	2	21
NANOS1	0	4	0	2	59.73	119.46	15	1	1	NA	1	0	2	4
NANP	7	13	1	3	230.34	460.68	15	1	1	0.380952380952381	1	0.1	4	20
NANS	2	11	4	4	313.5	627	15	1	0.146174259177355	-4.5	1	-0.346153846153846	8	13
NAP1L1	2	13	0	3	415.8	831.6	15	1	1	1	1	0.133333333333333	3	15
NAPA-NAPB	0	16	3	8	261.69	523.38	15	1	0.0564102564102564	-Inf	0.846060006968071	-0.272727272727273	11	16
NAPEPLD	6	22	0	2	417.12	834.24	15	1	1	1	1	0.214285714285714	2	28
NAPG	2	13	0	1	295.35	590.7	15	1	1	1	1	0.133333333333333	1	15
NAPRT	16	47	7	26	677.49	1354.98	15	1	0.802398367578018	0.209134615384615	1	0.0418470418470418	33	63
NARF	4	17	1	2	446.49	892.98	15	1	0.521245059288538	-1.125	1	-0.142857142857143	3	21
NARFL	12	21	5	6	462	924	15	1	0.724420662116575	-0.458333333333333	1	-0.0909090909090909	11	33
NARS	14	19	0	3	245.85	491.7	15	1	0.266666666666667	1	1	0.424242424242424	3	33
NARS2	5	29	4	7	485.1	970.2	15	1	0.190322576440736	-2.31428571428571	1	-0.216577540106952	11	34
NASP	16	34	2	3	701.25	1402.5	15	1	1	-0.416666666666667	1	-0.08	5	50
NAT	8	11	2	0	293.04	586.08	15	1	0.214285714285714	-Inf	1	-0.578947368421053	2	19
NAT10	9	46	7	1	1003.2	2006.4	15	1	0.000142154652546186	-34.7777777777778	0.0857903328116232	-0.711363636363636	8	55
NAT8L	2	8	0	2	175.89	351.78	15	1	1	1	1	0.2	2	10
NAT9	4	11	2	4	184.8	369.6	15	1	1	-0.375	1	-0.0666666666666667	6	15
NATD1	0	3	0	2	77.88	155.76	15	1	1	NA	1	0	2	3
NAV1	4	52	10	38	1595.55	3191.1	15	1	0.0487154427633856	-2.42105263157895	0.833370237838852	-0.136904761904762	48	56
NAV2	31	83	4	4	2336.4	4672.8	15	1	0.22439909791359	-1.67741935483871	1	-0.228070175438596	8	114
NAV3	18	84	6	4	1869.45	3738.9	15	1	0.00626878328117862	-6	0.467685236262114	-0.423529411764706	10	102
NBEA	10	45	5	8	1957.56	3915.12	15	1	0.141613716268653	-1.8125	1	-0.202797202797203	13	55
NBEAL1	33	93	7	2	2714.25	5428.5	15	1	0.00290586953053233	-8.86363636363636	0.381237448190491	-0.515873015873016	9	126
NBEAL2	20	41	29	37	1675.08	3350.16	15	1	0.207912567674293	-0.606756756756757	1	-0.111525086934923	66	61
NBL1	1	6	1	3	177.21	354.42	15	1	1	-1	1	-0.107142857142857	4	7
NBR1	30	40	3	5	951.39	1902.78	15	1	1	0.2	1	0.0535714285714285	8	70
NCALD	0	4	0	5	192.06	384.12	15	1	1	NA	1	0	5	4
NCAM1	14	45	4	8	1090.98	2181.96	15	1	0.484519681924948	-0.607142857142857	1	-0.096045197740113	12	59
NCAN	25	24	18	20	740.19	1480.38	15	1	0.829780165891734	0.136	1	0.0365198711063373	38	49
NCAPD2	40	55	2	10	1274.79	2549.58	15	1	0.120417689922953	0.725	1	0.254385964912281	12	95
NCAPD3	66	61	9	17	1435.17	2870.34	15	1	0.133101633151864	0.510695187165775	1	0.173531193216233	26	127
NCAPG	34	41	3	1	1023.99	2047.98	15	1	0.335650358968147	-2.61764705882353	1	-0.296666666666667	4	75
NCAPG2	33	32	3	4	1115.73	2231.46	15	1	1	0.272727272727273	1	0.0791208791208791	7	65
NCAPH	31	27	2	2	676.17	1352.34	15	1	1	0.129032258064516	1	0.0344827586206896	4	58
NCBP1	0	22	0	1	766.59	1533.18	15	1	1	NA	1	0	1	22
NCBP2	0	6	0	0	135.63	271.26	15	1	1	NA	1	NA	0	6
NCBP3	1	24	1	3	548.46	1096.92	15	1	0.261083743842364	-7	1	-0.21	4	25
NCDN	33	32	8	6	712.8	1425.6	15	1	0.771964312331047	-0.292929292929293	1	-0.0637362637362637	14	65
NCEH1	3	18	2	1	360.03	720.06	15	1	0.0988142292490119	-11	0.971353639774823	-0.523809523809524	3	21
NCF1	9	9	1	4	386.1	772.2	15	1	0.339356295878035	0.75	1	0.3	5	18
NCF2	14	24	3	3	512.82	1025.64	15	1	0.661880943786786	-0.714285714285714	1	-0.131578947368421	6	38
NCF4	4	17	3	5	341.55	683.1	15	1	0.356806212278476	-1.55	1	-0.18452380952381	8	21
NCK2	1	8	0	3	377.19	754.38	15	1	1	1	1	0.111111111111111	3	9
NCKAP1	0	29	1	3	1103.85	2207.7	15	1	0.121212121212121	-Inf	1	-0.25	4	29
NCKAP1L	5	11	2	5	368.94	737.88	15	1	1	0.12	1	0.0267857142857143	7	16
NCKIPSD	6	31	5	12	695.97	1391.94	15	1	0.293005093504282	-1.15277777777778	1	-0.131955484896661	17	37
NCL	8	34	4	10	645.48	1290.96	15	1	0.469529397618868	-0.7	1	-0.0952380952380952	14	42
NCLN	5	18	0	2	514.47	1028.94	15	1	1	1	1	0.217391304347826	2	23
NCOA1	7	32	6	15	800.58	1601.16	15	1	0.348579609870701	-0.828571428571429	1	-0.106227106227106	21	39
NCOA2	9	36	3	0	1457.28	2914.56	15	1	0.0127197039777983	-Inf	0.61231737012987	-0.8	3	45
NCOA3	16	53	4	4	1364.88	2729.76	15	1	0.194196053775448	-2.3125	1	-0.268115942028985	8	69
NCOA4	12	19	2	3	554.4	1108.8	15	1	1	-0.0555555555555556	1	-0.0129032258064516	5	31
NCOA5	7	21	4	1	706.86	1413.72	15	1	0.0325361512791991	-11	0.784275503573749	-0.55	5	28
NCOA6	44	50	5	5	2030.49	4060.98	15	1	1	-0.136363636363636	1	-0.0319148936170213	10	94
NCOA7	10	19	4	4	937.53	1875.06	15	1	0.444819677362372	-0.9	1	-0.155172413793103	8	29
NCOR1	7	59	3	12	2515.92	5031.84	15	1	0.383362581915145	-1.10714285714286	1	-0.0939393939393939	15	66
NCOR2	12	55	12	23	2220.24	4440.48	15	1	0.0855861494300984	-1.39130434782609	0.950356516076024	-0.163752665245203	35	67
NCS1	0	2	0	2	167.64	335.28	15	1	1	NA	1	0	2	2
NCSTN	7	36	2	5	664.62	1329.24	15	1	0.594856734384949	-1.05714285714286	1	-0.122923588039867	7	43
NDC1	8	22	2	7	612.48	1224.96	15	1	1	0.214285714285714	1	0.0444444444444445	9	30
NDC80	4	27	1	1	634.59	1269.18	15	1	0.284090909090909	-5.75	1	-0.370967741935484	2	31
NDE1	3	11	2	1	339.57	679.14	15	1	0.191176470588235	-6.33333333333333	1	-0.452380952380952	3	14
NDFIP1	7	9	0	2	221.76	443.52	15	1	0.496732026143791	1	1	0.4375	2	16
NDNF	6	30	2	1	563.31	1126.62	15	1	0.101105153736733	-9	0.975691437149951	-0.5	3	36
NDP	1	2	1	0	132.66	265.32	15	1	1	-Inf	1	-0.666666666666667	1	3
NDRG1	1	13	0	0	380.16	760.32	15	1	1	NA	1	NA	0	14
NDST1	1	21	4	15	861.3	1722.6	15	1	0.164443993712286	-4.6	1	-0.165071770334928	19	22
NDST2	2	20	0	8	869.55	1739.1	15	1	1	1	1	0.0909090909090909	8	22
NDST4	4	31	3	7	865.26	1730.52	15	1	0.172215192634932	-2.32142857142857	1	-0.185714285714286	10	35
NDUFA1	1	0	1	0	35.64	71.28	15	1	1	NA	1	0	1	1
NDUFA10	10	19	2	2	354.42	708.84	15	1	0.609970674486804	-0.9	1	-0.155172413793103	4	29
NDUFA12	2	3	1	3	125.07	250.14	15	1	1	0.5	1	0.15	4	5
NDUFA2	0	3	0	1	58.74	117.48	15	1	1	NA	1	0	1	3
NDUFA4	0	2	0	0	68.31	136.62	15	1	1	NA	1	NA	0	2
NDUFA5	2	1	3	1	125.73	251.46	15	1	1	-0.5	1	-0.0833333333333334	4	3
NDUFA6	1	7	0	1	81.84	163.68	15	1	1	1	1	0.125	1	8
NDUFA7	1	6	2	1	98.01	196.02	15	1	0.183333333333333	-11	1	-0.523809523809524	3	7
NDUFA8	5	1	0	0	102.63	205.26	15	1	1	NA	1	NA	0	6
NDUFA9	2	9	3	1	377.19	754.38	15	1	0.076923076923077	-12.5	0.922367800589409	-0.568181818181818	4	11
NDUFAB1	5	8	1	3	185.79	371.58	15	1	1	0.466666666666667	1	0.134615384615385	4	13
NDUFAF1	5	14	4	0	276.21	552.42	15	1	0.0142292490118577	-Inf	0.629301355578728	-0.736842105263158	4	19
NDUFAF2	4	6	0	0	145.53	291.06	15	1	1	NA	1	NA	0	10
NDUFAF3	3	6	0	2	96.03	192.06	15	1	1	1	1	0.333333333333333	2	9
NDUFAF4	8	3	0	1	129.36	258.72	15	1	0.333333333333333	1	1	0.727272727272727	1	11
NDUFAF5	0	5	0	1	134.31	268.62	15	1	1	NA	1	0	1	5
NDUFAF6	5	13	2	3	265.65	531.3	15	1	0.621385479509049	-0.733333333333333	1	-0.122222222222222	5	18
NDUFB10	1	12	2	4	122.1	244.2	15	1	0.2218782249742	-5	1	-0.256410256410256	6	13
NDUFB3	2	4	2	1	119.79	239.58	15	1	0.523809523809524	-3	1	-0.333333333333333	3	6
NDUFB5	4	4	0	0	149.82	299.64	15	1	1	NA	1	NA	0	8
NDUFB6	5	1	0	1	78.87	157.74	15	1	0.285714285714286	1	1	0.833333333333333	1	6
NDUFB8	6	9	2	1	143.88	287.76	15	1	0.558823529411765	-2	1	-0.266666666666667	3	15
NDUFB9	4	11	0	2	173.25	346.5	15	1	1	1	1	0.266666666666667	2	15
NDUFC2	4	6	0	3	89.76	179.52	15	1	0.496503496503497	1	1	0.4	3	10
NDUFS1	3	26	2	1	704.55	1409.1	15	1	0.0564516129032258	-16.3333333333333	0.846060006968071	-0.563218390804598	3	29
NDUFS3	0	4	0	0	218.46	436.92	15	1	1	NA	1	NA	0	4
NDUFS5	1	1	0	0	55.77	111.54	15	1	1	NA	1	NA	0	2
NDUFS6	1	2	0	1	80.19	160.38	15	1	1	1	1	0.333333333333333	1	3
NDUFS8	0	1	0	3	51.81	103.62	15	1	1	NA	1	0	3	1
NDUFV2	1	10	1	2	229.68	459.36	15	1	0.395604395604396	-4	1	-0.242424242424242	3	11
NDUFV3	2	5	0	1	55.11	110.22	15	1	1	1	1	0.285714285714286	1	7
NEBL	6	0	0	0	81.18	162.36	15	1	1	NA	1	NA	0	6
NEBL1	34	199	19	54	5680.95	11361.9	15	1	0.0327080215721155	-1.05936819172113	0.784275503573749	-0.114351225821624	73	233
NECAB2	1	8	1	2	274.23	548.46	15	1	0.454545454545454	-3	1	-0.222222222222222	3	9
NECAB3	3	7	4	5	315.81	631.62	15	1	0.649916646820672	-0.866666666666667	1	-0.144444444444444	9	10
NECAP1	0	13	1	2	272.25	544.5	15	1	0.1875	-Inf	1	-0.333333333333333	3	13
NECAP2	12	13	2	9	199.32	398.64	15	1	0.141873323300399	0.759259259259259	1	0.298181818181818	11	25
NECTIN1	2	11	0	4	357.06	714.12	15	1	1	1	1	0.153846153846154	4	13
NECTIN3	17	18	5	1	663.63	1327.26	15	1	0.190799148116221	-4.29411764705882	1	-0.347619047619048	6	35
NEDD1	21	21	3	5	659.34	1318.68	15	1	0.704106877783276	0.4	1	0.125	8	42
NEDD4	21	40	7	8	1301.85	2603.7	15	1	0.388422274672213	-0.666666666666667	1	-0.122404371584699	15	61
NEDD9	20	37	2	3	806.85	1613.7	15	1	1	-0.233333333333333	1	-0.0491228070175439	5	57
NEFH	4	10	2	6	239.91	479.82	15	1	1	0.166666666666667	1	0.0357142857142857	8	14
NEFL	0	27	1	4	490.05	980.1	15	1	0.15625	-Inf	1	-0.2	5	27
NEFM	4	34	2	9	727.65	1455.3	15	1	0.60516056561385	-0.888888888888889	1	-0.076555023923445	11	38
NEGR1	5	6	2	4	237.6	475.2	15	1	1	0.4	1	0.121212121212121	6	11
NEIL1	12	15	10	5	259.38	518.76	15	1	0.20865434603599	-1.5	1	-0.222222222222222	15	27
NEIL2	10	18	8	3	313.83	627.66	15	1	0.0722123680966839	-3.8	0.910766230853683	-0.37012987012987	11	28
NEIL3	21	18	6	0	589.71	1179.42	15	1	0.0670234473410877	-Inf	0.884435842948953	-0.461538461538462	6	39
NEK1	21	24	2	3	1286.01	2572.02	15	1	1	0.238095238095238	1	0.0666666666666667	5	45
NEK10	43	34	4	8	1192.95	2385.9	15	1	0.214724132577105	0.604651162790698	1	0.225108225108225	12	77
NEK11	17	17	5	5	594.99	1189.98	15	1	1	0	1	0	10	34
NEK2	5	17	7	5	368.61	737.22	15	1	0.0619008733846476	-3.76	0.876180863544705	-0.356060606060606	12	22
NEK3	18	26	8	9	494.01	988.02	15	1	0.775052596872599	-0.283950617283951	1	-0.0614973262032085	17	44
NEK4	22	22	10	5	799.26	1598.52	15	1	0.37046278694094	-1	1	-0.166666666666667	15	44
NEK5	40	25	8	2	805.86	1611.72	15	1	0.313616814765383	-1.5	1	-0.184615384615385	10	65
NEK6	0	7	0	2	311.85	623.7	15	1	1	NA	1	0	2	7
NEK7	0	6	0	1	299.97	599.94	15	1	1	NA	1	0	1	6
NEK8	5	30	2	13	709.5	1419	15	1	1	0.0769230769230769	1	0.00952380952380952	15	35
NEK9	5	30	3	11	948.42	1896.84	15	1	0.672472851484533	-0.636363636363636	1	-0.0714285714285714	14	35
NELFA	2	9	0	0	515.46	1030.92	15	1	1	NA	1	NA	0	11
NELFB	2	20	0	2	543.51	1087.02	15	1	1	1	1	0.0909090909090909	2	22
NELFCD	0	21	2	1	556.38	1112.76	15	1	0.0108695652173913	-Inf	0.585928868752023	-0.666666666666667	3	21
NELL1	6	14	0	0	370.92	741.84	15	1	1	NA	1	NA	0	20
NELL2	5	23	2	4	778.8	1557.6	15	1	0.579813875191092	-1.3	1	-0.154761904761905	6	28
NEMF	19	64	8	16	1063.26	2126.52	15	1	0.29965674567876	-0.684210526315789	1	-0.104417670682731	24	83
NEMP2	16	27	1	4	409.53	819.06	15	1	0.642983956119941	0.578125	1	0.172093023255814	5	43
NENF	0	6	1	1	141.24	282.48	15	1	0.25	-Inf	1	-0.5	2	6
NEO1	5	56	7	11	1404.81	2809.62	15	1	0.00417876064326597	-6.12727272727273	0.454065685553736	-0.306921675774135	18	61
NEPRO	37	28	6	6	499.62	999.24	15	1	0.756007374910035	0.243243243243243	1	0.0692307692307692	12	65
NETO1	4	13	2	1	523.38	1046.76	15	1	0.201754385964912	-5.5	1	-0.431372549019608	3	17
NETO2	1	14	2	0	509.52	1019.04	15	1	0.0220588235294118	-Inf	0.721018759249189	-0.933333333333333	2	15
NEU2	23	16	2	2	376.2	752.4	15	1	1	0.304347826086957	1	0.0897435897435898	4	39
NEU4	6	18	1	4	409.53	819.06	15	1	1	0.25	1	0.05	5	24
NEURL1B	0	15	3	6	542.19	1084.38	15	1	0.041501976284585	-Inf	0.800205836669235	-0.333333333333333	9	15
NEURL2	2	5	0	1	170.28	340.56	15	1	1	1	1	0.285714285714286	1	7
NEUROD1	1	4	1	2	217.14	434.28	15	1	1	-1	1	-0.133333333333333	3	5
NEUROD4	5	14	2	5	325.05	650.1	15	1	1	-0.12	1	-0.0225563909774436	7	19
NEUROD6	0	17	0	2	332.97	665.94	15	1	1	NA	1	0	2	17
NEXN	5	18	1	0	605.88	1211.76	15	1	0.25	-Inf	1	-0.782608695652174	1	23
NF1	6	46	0	3	1579.05	3158.1	15	1	1	1	1	0.115384615384615	3	52
NF2	1	27	0	10	552.42	1104.84	15	1	1	1	1	0.0357142857142857	10	28
NF2L	1	20	1	1	642.51	1285.02	15	1	0.1699604743083	-19	1	-0.452380952380952	2	21
NFAM1	23	12	5	3	245.52	491.04	15	1	1	0.130434782608696	1	0.0321428571428571	8	35
NFASC	8	55	6	31	1335.18	2670.36	15	1	0.766522090866823	-0.330645161290323	1	-0.0351780351780352	37	63
NFAT5	11	43	3	9	1474.11	2948.22	15	1	0.707565011610745	-0.303030303030303	1	-0.0462962962962963	12	54
NFATC2	10	22	1	2	920.37	1840.74	15	1	1	-0.1	1	-0.0208333333333333	3	32
NFATC3	6	40	0	3	1079.76	2159.52	15	1	1	1	1	0.130434782608696	3	46
NFE2L2	9	25	4	2	578.16	1156.32	15	1	0.0748831538305222	-4.55555555555556	0.91574434319595	-0.401960784313725	6	34
NFIB	4	1	0	0	216.81	433.62	15	1	1	NA	1	NA	0	5
NFIC	0	9	0	3	361.68	723.36	15	1	1	NA	1	0	3	9
NFIL3	2	10	2	3	454.41	908.82	15	1	0.53781512605042	-2.33333333333333	1	-0.233333333333333	5	12
NFKB1	32	31	6	5	1010.79	2021.58	15	1	1	-0.1625	1	-0.0375180375180375	11	63
NFKB2	3	31	10	13	878.46	1756.92	15	1	0.00350435774141566	-6.94871794871795	0.414682332734186	-0.346547314578005	23	34
NFKBIA	4	18	0	3	283.14	566.28	15	1	1	1	1	0.181818181818182	3	22
NFKBIE	13	10	0	3	270.27	540.54	15	1	0.22	1	1	0.565217391304348	3	23
NFKBIZ	10	25	2	4	617.43	1234.86	15	1	1	-0.25	1	-0.0476190476190476	6	35
NFRKB	4	53	5	18	1294.92	2589.84	15	1	0.110659189120694	-2.68055555555556	0.98538656216834	-0.147215865751335	23	57
NFS1	3	18	0	3	385.11	770.22	15	1	1	1	1	0.142857142857143	3	21
NFU1	6	6	4	2	234.96	469.92	15	1	0.638009049773756	-1	1	-0.166666666666667	6	12
NFXL1	13	33	3	6	856.68	1713.36	15	1	0.709720708837529	-0.269230769230769	1	-0.0507246376811594	9	46
NFYC	0	13	0	6	332.64	665.28	15	1	1	NA	1	0	6	13
NGB	0	8	0	1	127.71	255.42	15	1	1	NA	1	0	1	8
NGEF	0	26	0	2	496.98	993.96	15	1	1	NA	1	0	2	26
NGF	8	7	0	0	237.6	475.2	15	1	1	NA	1	NA	0	15
NGFR	1	9	3	8	284.13	568.26	15	1	0.586466165413534	-2.375	1	-0.172727272727273	11	10
NGLY1	19	15	1	0	632.61	1265.22	15	1	1	-Inf	1	-0.441176470588235	1	34
NHEJ1	7	4	4	4	212.52	425.04	15	1	0.657696276891323	0.428571428571429	1	0.136363636363636	8	11
NHLH1	0	3	1	2	131.67	263.34	15	1	1	-Inf	1	-0.333333333333333	3	3
NHLRC1	6	13	3	5	346.17	692.34	15	1	1	-0.3	1	-0.0592105263157895	8	19
NHLRC2	17	24	6	5	718.08	1436.16	15	1	0.506575910918548	-0.694117647058824	1	-0.130820399113082	11	41
NHLRC3	8	12	0	0	308.88	617.76	15	1	1	NA	1	NA	0	20
NHLRC4	11	19	6	7	348.48	696.96	15	1	0.735697355452904	-0.480519480519481	1	-0.0948717948717949	13	30
NHP2	3	5	0	1	103.62	207.24	15	1	1	1	1	0.375	1	8
NHS	29	77	11	26	1359.6	2719.2	15	1	0.832640412568178	-0.123342175066313	1	-0.02371239163692	37	106
NHSL1	36	62	12	15	1642.74	3285.48	15	1	0.507134409428546	-0.377777777777778	1	-0.0770975056689342	27	98
NID1	23	52	8	10	1259.61	2519.22	15	1	0.278616160520652	-0.808695652173913	1	-0.137777777777778	18	75
NID2	17	29	14	17	774.18	1548.36	15	1	0.488095977451647	-0.404844290657439	1	-0.0820476858345021	31	46
NIF3L1	7	13	3	2	315.15	630.3	15	1	0.357707509881423	-1.78571428571429	1	-0.25	5	20
NIFK	14	15	1	3	190.41	380.82	15	1	0.607404692082111	0.642857142857143	1	0.232758620689655	4	29
NIM1KZ	7	18	0	1	432.63	865.26	15	1	1	1	1	0.28	1	25
NIN	74	108	23	31	2085.93	4171.86	15	1	0.875116599173688	-0.082824760244115	1	-0.0193325193325193	54	182
NINJ1	1	3	0	1	145.86	291.72	15	1	1	1	1	0.25	1	4
NINJ2	4	3	0	3	119.79	239.58	15	1	0.2	1	1	0.571428571428571	3	7
NINL	35	24	17	6	655.38	1310.76	15	1	0.308281884736571	-0.942857142857143	1	-0.145910095799558	23	59
NIP7	3	7	2	6	143.88	287.76	15	1	1	0.222222222222222	1	0.05	8	10
NIPA1	1	7	0	0	267.96	535.92	15	1	1	NA	1	NA	0	8
NIPA2	4	13	3	10	358.38	716.76	15	1	1	0.025	1	0.00452488687782804	13	17
NIPAL1	16	23	3	0	376.2	752.4	15	1	0.0844076655052265	-Inf	0.949431371776132	-0.58974358974359	3	39
NIPAL2	20	16	2	2	382.47	764.94	15	1	1	0.2	1	0.0555555555555556	4	36
NIPAL4	5	18	2	4	383.79	767.58	15	1	0.611936339522546	-0.8	1	-0.115942028985507	6	23
NIPSNAP1	0	8	1	2	108.57	217.14	15	1	0.272727272727273	-Inf	1	-0.333333333333333	3	8
NIPSNAP3L	2	5	2	1	225.72	451.44	15	1	0.5	-4	1	-0.380952380952381	3	7
NISCH	15	44	8	8	1377.09	2754.18	15	1	0.0723902736402419	-1.93333333333333	0.911545360143491	-0.245762711864407	16	59
NIT2	10	10	1	2	280.17	560.34	15	1	1	0.5	1	0.166666666666667	3	20
NKAIN1	1	4	2	5	164.34	328.68	15	1	1	-0.6	1	-0.0857142857142857	7	5
NKAIN4	7	10	0	5	234.63	469.26	15	1	0.134768740031898	1	1	0.411764705882353	5	17
NKAP	4	17	2	2	353.76	707.52	15	1	0.23399209486166	-3.25	1	-0.30952380952381	4	21
NKD1	4	7	3	1	418.77	837.54	15	1	0.282051282051282	-4.25	1	-0.386363636363636	4	11
NKIRAS2	1	8	1	1	190.08	380.16	15	1	0.345454545454545	-7	1	-0.388888888888889	2	9
NKRF	15	25	2	10	696.3	1392.6	15	1	0.294311111904011	0.666666666666667	1	0.208333333333333	12	40
NKTR	46	59	9	9	1441.11	2882.22	15	1	0.79821083390727	-0.282608695652174	1	-0.0619047619047619	18	105
NKX1-1	0	1	1	0	117.15	234.3	15	1	1	-Inf	1	-1	1	1
NKX2-1	1	1	0	1	266.31	532.62	15	1	1	1	1	0.5	1	2
NKX2-5	2	12	0	2	284.13	568.26	15	1	1	1	1	0.142857142857143	2	14
NKX2-8	1	5	1	0	132.33	264.66	15	1	0.285714285714286	-Inf	1	-0.833333333333333	1	6
NKX3-1	7	2	5	5	197.34	394.68	15	1	0.34984520123839	0.714285714285714	1	0.277777777777778	10	9
NKX6-2	1	5	0	1	240.9	481.8	15	1	1	1	1	0.166666666666667	1	6
NKX6-3	4	22	0	3	258.39	516.78	15	1	1	1	1	0.153846153846154	3	26
NLGN4L	0	22	2	1	608.85	1217.7	15	1	0.01	-Inf	0.5818356433428	-0.666666666666667	3	22
NLK	0	4	1	2	518.43	1036.86	15	1	0.428571428571428	-Inf	1	-0.333333333333333	3	4
NLN	10	22	4	0	663.96	1327.92	15	1	0.0169934640522876	-Inf	0.674707602339182	-0.6875	4	32
NLRC5	84	68	19	21	2290.86	4581.72	15	1	0.476348792495467	0.267573696145125	1	0.0776315789473685	40	152
NLRP1L	9	24	3	6	494.34	988.68	15	1	0.698665019211723	-0.333333333333333	1	-0.0606060606060606	9	33
NLRPL	40	38	12	10	857.67	1715.34	15	1	0.813854077235266	-0.14	1	-0.0326340326340326	22	78
NLRX1	11	14	11	10	776.49	1552.98	15	1	0.767535773880506	-0.4	1	-0.0838095238095238	21	25
NMB	1	8	1	1	105.27	210.54	15	1	0.345454545454545	-7	1	-0.388888888888889	2	9
NMBR	6	19	0	1	385.11	770.22	15	1	1	1	1	0.24	1	25
NMD3	17	20	2	3	493.02	986.04	15	1	1	0.215686274509804	1	0.0594594594594595	5	37
NME1	6	11	2	4	152.46	304.92	15	1	1	0.0833333333333334	1	0.0196078431372549	6	17
NME2	0	6	0	1	146.52	293.04	15	1	1	NA	1	0	1	6
NME5	4	6	1	3	211.86	423.72	15	1	1	0.5	1	0.15	4	10
NME6	3	5	0	1	155.43	310.86	15	1	1	1	1	0.375	1	8
NME7	7	16	3	2	377.19	754.38	15	1	0.315018315018315	-2.42857142857143	1	-0.295652173913043	5	23
NME8	20	18	3	2	569.25	1138.5	15	1	1	-0.35	1	-0.0736842105263158	5	38
NMI	19	12	3	2	352.44	704.88	15	1	1	0.0526315789473685	1	0.0129032258064516	5	31
NMNAT1	3	7	0	1	237.6	475.2	15	1	1	1	1	0.3	1	10
NMNAT2	1	11	0	2	276.87	553.74	15	1	1	1	1	0.0833333333333333	2	12
NMNAT3	7	20	3	1	272.25	544.5	15	1	0.0867630700778642	-7.57142857142857	0.951277979139867	-0.490740740740741	4	27
NMRK1	6	3	0	1	148.5	297	15	1	0.4	1	1	0.666666666666667	1	9
NMRK2	5	13	0	0	184.14	368.28	15	1	1	NA	1	NA	0	18
NMS	0	4	0	1	78.21	156.42	15	1	1	NA	1	0	1	4
NMT1	0	8	1	3	449.79	899.58	15	1	0.333333333333333	-Inf	1	-0.25	4	8
NMT2	0	9	1	6	481.47	962.94	15	1	0.4375	-Inf	1	-0.142857142857143	7	9
NMUR1	4	15	1	10	376.2	752.4	15	1	0.626015746705402	0.625	1	0.119617224880383	11	19
NMUR2	4	28	2	5	393.03	786.06	15	1	0.290195649328776	-1.8	1	-0.160714285714286	7	32
NNT	10	37	0	0	1115.73	2231.46	15	1	1	NA	1	NA	0	47
NOA1	11	16	2	1	389.4	778.8	15	1	0.564532019704434	-1.90909090909091	1	-0.259259259259259	3	27
NOB1	8	13	2	7	282.81	565.62	15	1	0.67490380683784	0.535714285714286	1	0.158730158730159	9	21
NOBOX	48	31	5	3	709.5	1419	15	1	1	-0.0763888888888888	1	-0.0174050632911392	8	79
NOC2L	24	40	10	14	748.11	1496.22	15	1	0.80733247453305	-0.19047619047619	1	-0.0416666666666667	24	64
NOC3L	26	31	6	6	1240.14	2480.28	15	1	1	-0.192307692307692	1	-0.043859649122807	12	57
NOC4L	12	15	7	6	459.36	918.72	15	1	0.737816793434146	-0.458333333333333	1	-0.094017094017094	13	27
NOCT	2	21	2	6	325.71	651.42	15	1	0.268298109010011	-2.5	1	-0.16304347826087	8	23
NOD1	12	38	5	13	942.48	1884.96	15	1	0.758434578401556	-0.217948717948718	1	-0.0377777777777778	18	50
NODAL	6	9	5	5	254.76	509.52	15	1	0.696829990577467	-0.5	1	-0.1	10	15
NOG	0	1	0	2	209.88	419.76	15	1	1	NA	1	0	2	1
NOL11	20	22	3	4	637.56	1275.12	15	1	1	0.175	1	0.0476190476190476	7	42
NOL12	11	7	7	3	210.54	421.08	15	1	0.702933222384023	-0.484848484848485	1	-0.0888888888888888	10	18
NOL4	13	12	1	3	656.04	1312.08	15	1	0.597701149425287	0.692307692307692	1	0.27	4	25
NOL6	2	3	2	0	1121.01	2242.02	15	1	0.428571428571428	-Inf	1	-0.6	2	5
NOL7	11	2	2	3	129.03	258.06	15	1	0.0987394957983193	0.878787878787879	0.971353639774823	0.446153846153846	5	13
NOL8	70	52	12	11	1156.32	2312.64	15	1	0.654072644394203	0.18961038961039	1	0.0520313613684961	23	122
NOL9	2	24	0	2	473.55	947.1	15	1	1	1	1	0.0769230769230769	2	26
NOLC1	8	24	7	4	620.07	1240.14	15	1	0.0306483085379878	-4.25	0.773114333163925	-0.386363636363636	11	32
NOM1	14	26	4	1	652.74	1305.48	15	1	0.14071351223932	-6.42857142857143	1	-0.45	5	40
NOMO3	11	43	6	5	1190.97	2381.94	15	1	0.0284050721893408	-3.69090909090909	0.761210061313465	-0.341750841750842	11	54
NONO	0	23	0	1	420.75	841.5	15	1	1	NA	1	0	1	23
NOP14	43	39	2	3	948.75	1897.5	15	1	0.669346758229673	0.395348837209302	1	0.124390243902439	5	82
NOP16	4	3	0	3	110.55	221.1	15	1	0.2	1	1	0.571428571428571	3	7
NOP2	18	24	3	2	451.44	902.88	15	1	0.644053642289557	-1	1	-0.171428571428571	5	42
NOP56	5	13	3	6	345.51	691.02	15	1	1	-0.3	1	-0.0555555555555555	9	18
NOP58	1	17	2	2	518.76	1037.52	15	1	0.0727272727272727	-16	0.911545360143491	-0.444444444444444	4	18
NOS1	12	80	10	31	1409.76	2819.52	15	1	0.130268780018183	-1.1505376344086	1	-0.113467656415695	41	92
NOS2	17	42	2	10	1138.5	2277	15	1	0.493712791758801	0.505882352941176	1	0.121468926553672	12	59
NOTCH1	8	63	25	61	2403.39	4806.78	15	1	0.00981663930599272	-2.22745901639344	0.5818356433428	-0.178021618080576	86	71
NOTCH2	20	86	6	35	2381.61	4763.22	15	1	0.635737322385834	0.262857142857143	1	0.0423377818683847	41	106
NOTO	3	5	0	0	96.03	192.06	15	1	1	NA	1	NA	0	8
NOTUM	0	10	0	1	351.45	702.9	15	1	1	NA	1	0	1	10
NOV	0	9	1	1	263.67	527.34	15	1	0.181818181818182	-Inf	1	-0.5	2	9
NOVA1	4	0	0	0	112.53	225.06	15	1	1	NA	1	NA	0	4
NOX1	8	23	1	5	508.2	1016.4	15	1	1	0.425	1	0.0913978494623656	6	31
NOX3	9	12	1	0	525.69	1051.38	15	1	0.454545454545454	-Inf	1	-0.571428571428571	1	21
NOX4	6	14	0	0	356.4	712.8	15	1	1	NA	1	NA	0	20
NOX5	16	11	12	11	560.01	1120.02	15	1	0.775906201996424	0.25	1	0.07085346215781	23	27
NOXA1	18	18	0	1	505.89	1011.78	15	1	1	1	1	0.5	1	36
NOXO1	26	22	2	6	463.98	927.96	15	1	0.251558873978408	0.717948717948718	1	0.291666666666667	8	48
NOXRED1-VIPAS39	22	37	8	7	848.76	1697.52	15	1	0.377553149454609	-0.922077922077922	1	-0.16045197740113	15	59
NPAS2	3	18	3	10	666.27	1332.54	15	1	0.652889722983945	-0.8	1	-0.0879120879120879	13	21
NPAS3	0	17	1	3	664.29	1328.58	15	1	0.19047619047619	-Inf	1	-0.25	4	17
NPAS4	5	12	3	12	264.66	529.32	15	1	0.691138301816833	0.4	1	0.0941176470588235	15	17
NPAT	47	75	11	18	1418.67	2837.34	15	1	1	0.024822695035461	1	0.00593555681175806	29	122
NPBWR2	0	7	1	2	329.67	659.34	15	1	0.3	-Inf	1	-0.333333333333333	3	7
NPC1	18	39	6	15	1254.33	2508.66	15	1	1	0.133333333333333	1	0.0300751879699248	21	57
NPC2	0	3	1	0	101.97	203.94	15	1	0.25	-Inf	1	-1	1	3
NPDC1	10	10	1	0	270.93	541.86	15	1	1	-Inf	1	-0.5	1	20
NPEPL1	1	18	1	6	469.26	938.52	15	1	0.473846153846154	-2	1	-0.0902255639097744	7	19
NPEPPS	3	28	1	5	835.56	1671.12	15	1	0.523582405935347	-0.866666666666667	1	-0.0698924731182796	6	31
NPFFR2	13	12	3	4	418.77	837.54	15	1	1	0.307692307692308	1	0.0914285714285715	7	25
NPHP1	9	20	4	4	651.75	1303.5	15	1	0.413214352872797	-1.22222222222222	1	-0.189655172413793	8	29
NPHP3	5	43	5	4	1098.9	2197.8	15	1	0.00538933776856552	-9.75	0.467685236262114	-0.451388888888889	9	48
NPHP4	53	93	11	9	1344.09	2688.18	15	1	0.141474433951748	-1.14465408805031	1	-0.186986301369863	20	146
NPHS2	9	15	0	6	380.16	760.32	15	1	0.140548187444739	1	1	0.375	6	24
NPL	21	13	0	0	379.17	758.34	15	1	1	NA	1	NA	0	34
NPLOC4	2	22	1	8	598.95	1197.9	15	1	1	-0.375	1	-0.0277777777777778	9	24
NPM1	5	9	1	4	270.93	541.86	15	1	1	0.55	1	0.157142857142857	5	14
NPM3	3	10	1	4	132.33	264.66	15	1	1	0.166666666666667	1	0.0307692307692308	5	13
NPNT	15	27	7	3	610.17	1220.34	15	1	0.0753399700547362	-3.2	0.916387518192578	-0.342857142857143	10	42
NPPA	3	6	2	0	139.59	279.18	15	1	0.181818181818182	-Inf	1	-0.666666666666667	2	9
NPPC	2	1	0	0	168.63	337.26	15	1	1	NA	1	NA	0	3
NPR1	20	38	5	5	846.78	1693.56	15	1	0.479847411356709	-0.9	1	-0.155172413793103	10	58
NPR2	3	11	6	21	593.01	1186.02	15	1	1	-0.0476190476190477	1	-0.00793650793650794	27	14
NPR3	0	9	0	0	369.27	738.54	15	1	1	NA	1	NA	0	9
NPRL2	2	8	2	6	287.1	574.2	15	1	1	-0.333333333333333	1	-0.05	8	10
NPS	3	6	0	0	97.68	195.36	15	1	1	NA	1	NA	0	9
NPSR1	6	14	0	0	289.08	578.16	15	1	1	NA	1	NA	0	20
NPTN	6	11	1	0	359.37	718.74	15	1	0.388888888888889	-Inf	1	-0.647058823529412	1	17
NPTX1	3	2	0	3	186.78	373.56	15	1	0.196428571428571	1	1	0.6	3	5
NPTX2	0	8	3	1	369.27	738.54	15	1	0.0181818181818182	-Inf	0.677255339142531	-0.75	4	8
NPTXR	1	8	2	5	273.57	547.14	15	1	0.55	-2.2	1	-0.174603174603175	7	9
NPVF	3	7	1	1	172.26	344.52	15	1	1	-1.33333333333333	1	-0.2	2	10
NPY1R	1	16	0	3	397.98	795.96	15	1	1	1	1	0.0588235294117647	3	17
NPY2R	3	20	0	2	382.14	764.28	15	1	1	1	1	0.130434782608696	2	23
NPY4R	1	14	2	0	374.22	748.44	15	1	0.0220588235294118	-Inf	0.721018759249189	-0.933333333333333	2	15
NPY5R	5	22	2	1	440.55	881.1	15	1	0.127586206896552	-7.8	1	-0.481481481481481	3	27
NPY7R	2	11	1	5	384.12	768.24	15	1	1	-0.1	1	-0.0128205128205128	6	13
NQO1	12	6	5	5	178.2	356.4	15	1	0.44426283099052	0.5	1	0.166666666666667	10	18
NR0B1	1	10	2	0	225.39	450.78	15	1	0.0384615384615385	-Inf	0.789311843512415	-0.909090909090909	2	11
NR0B2	16	11	0	6	272.25	544.5	15	1	0.0184042875922743	1	0.677255339142531	0.592592592592593	6	27
NR1D1	2	37	1	5	438.24	876.48	15	1	0.355954897815363	-2.7	1	-0.115384615384615	6	39
NR1D2	5	13	2	0	562.98	1125.96	15	1	0.110526315789474	-Inf	0.98538656216834	-0.722222222222222	2	18
NR1H3	0	14	0	2	415.8	831.6	15	1	1	NA	1	0	2	14
NR1H4	4	13	0	2	526.68	1053.36	15	1	1	1	1	0.235294117647059	2	17
NR2C2	4	22	2	3	623.7	1247.4	15	1	0.240602433038473	-2.66666666666667	1	-0.246153846153846	5	26
NR2C2AP	5	3	2	5	134.64	269.28	15	1	0.314685314685315	0.76	1	0.339285714285714	7	8
NR2E1	1	19	1	4	372.57	745.14	15	1	0.366666666666667	-3.75	1	-0.15	5	20
NR2E3	3	24	0	4	267.63	535.26	15	1	1	1	1	0.111111111111111	4	27
NR2F2	1	1	0	0	391.71	783.42	15	1	1	NA	1	NA	0	2
NR2F6	2	4	1	7	211.86	423.72	15	1	0.538461538461538	0.714285714285714	1	0.208333333333333	8	6
NR3C1	2	24	0	9	379.5	759	15	1	1	1	1	0.0769230769230769	9	26
NR3C2	6	10	1	0	345.51	691.02	15	1	0.411764705882353	-Inf	1	-0.625	1	16
NR4A2	0	4	1	3	516.12	1032.24	15	1	1	-Inf	1	-0.25	4	4
NR4A3	1	7	0	4	448.8	897.6	15	1	1	1	1	0.125	4	8
NR5A1	0	3	0	6	320.1	640.2	15	1	1	NA	1	0	6	3
NR5A2	0	15	0	2	478.5	957	15	1	1	NA	1	0	2	15
NR6A1	1	5	1	3	409.86	819.72	15	1	1	-0.666666666666667	1	-0.0833333333333333	4	6
NRAP	21	61	10	1	1726.89	3453.78	15	1	4.64955958551483e-05	-28.047619047619	0.04042271543353	-0.652993348115299	11	82
NRARP	0	3	0	0	100.32	200.64	15	1	1	NA	1	NA	0	3
NRBF2	3	9	2	3	278.19	556.38	15	1	0.600032320620556	-1	1	-0.15	5	12
NRBP1	2	10	2	2	503.25	1006.5	15	1	0.244505494505494	-4	1	-0.333333333333333	4	12
NRBP2	10	13	2	2	469.26	938.52	15	1	1	-0.3	1	-0.0652173913043478	4	23
NRCAM	30	58	7	3	1807.74	3615.48	15	1	0.0385060472531804	-3.51111111111111	0.789311843512415	-0.359090909090909	10	88
NRDC	5	37	2	14	1023.66	2047.32	15	1	1	-0.0571428571428572	1	-0.00595238095238096	16	42
NRDE2	25	40	11	7	1159.29	2318.58	15	1	0.109860635708752	-1.51428571428571	0.98538656216834	-0.226495726495727	18	65
NRF1	3	17	0	8	457.38	914.76	15	1	0.536019536019536	1	1	0.15	8	20
NRG1	7	20	2	4	641.19	1282.38	15	1	1	-0.428571428571429	1	-0.0740740740740741	6	27
NRG2	4	9	1	3	436.92	873.84	15	1	1	0.25	1	0.0576923076923077	4	13
NRG3	6	8	1	2	361.35	722.7	15	1	1	0.333333333333333	1	0.0952380952380952	3	14
NRG4	1	2	0	0	114.84	229.68	15	1	1	NA	1	NA	0	3
NRIP1	23	26	4	2	1141.47	2282.94	15	1	0.421551811118959	-1.26086956521739	1	-0.197278911564626	6	49
NRIP3	5	10	2	5	216.81	433.62	15	1	1	0.2	1	0.0476190476190476	7	15
NRK	11	48	4	8	1206.81	2413.62	15	1	0.264271435317461	-1.18181818181818	1	-0.146892655367232	12	59
NRN1L	4	1	2	2	133.98	267.96	15	1	0.523809523809524	0.75	1	0.3	4	5
NRP1	11	32	2	3	1059.96	2119.92	15	1	0.602477130229212	-0.939393939393939	1	-0.144186046511628	5	43
NRP2	8	31	5	7	900.24	1800.48	15	1	0.253807689633467	-1.76785714285714	1	-0.211538461538462	12	39
NRROS	15	24	6	8	697.95	1395.9	15	1	1	-0.2	1	-0.0439560439560439	14	39
NRSN1	9	7	0	0	176.88	353.76	15	1	1	NA	1	NA	0	16
NRSN2	3	2	5	2	58.74	117.48	15	1	1	-0.666666666666667	1	-0.114285714285714	7	5
NRXN1	10	8	3	0	250.47	500.94	15	1	0.257142857142857	-Inf	1	-0.444444444444444	3	18
NRXN3	15	33	7	12	1105.5	2211	15	1	0.774457330201648	-0.283333333333333	1	-0.0559210526315789	19	48
NSA2	2	9	0	1	211.2	422.4	15	1	1	1	1	0.181818181818182	1	11
NSD1	31	86	7	18	2479.62	4959.24	15	1	1	-0.0788530465949822	1	-0.0150427350427351	25	117
NSDHL	1	22	3	2	343.53	687.06	15	1	0.0114774114774115	-32	0.593603434168836	-0.556521739130435	5	23
NSF	19	32	3	3	851.73	1703.46	15	1	0.666692129452805	-0.684210526315789	1	-0.127450980392157	6	51
NSFL1C	3	18	0	6	325.71	651.42	15	1	1	1	1	0.142857142857143	6	21
NSG1	1	3	0	0	184.14	368.28	15	1	1	NA	1	NA	0	4
NSL1	11	9	1	4	249.15	498.3	15	1	0.321739130434783	0.795454545454545	1	0.35	5	20
NSMAF	5	28	0	2	892.32	1784.64	15	1	1	1	1	0.151515151515152	2	33
NSMCE1	4	5	4	1	253.44	506.88	15	1	0.300699300699301	-4	1	-0.355555555555556	5	9
NSMCE2	2	1	0	0	109.89	219.78	15	1	1	NA	1	NA	0	3
NSMCE4A	6	9	1	2	290.73	581.46	15	1	1	0.25	1	0.0666666666666667	3	15
NSMF	0	9	1	3	492.69	985.38	15	1	0.307692307692308	-Inf	1	-0.25	4	9
NSRP1	9	16	8	7	495.33	990.66	15	1	0.335527128908664	-1.03174603174603	1	-0.173333333333333	15	25
NSUN2	10	25	1	1	718.74	1437.48	15	1	0.512012012012012	-1.5	1	-0.214285714285714	2	35
NSUN3	5	17	4	0	334.29	668.58	15	1	0.00842809364548495	-Inf	0.54233354502865	-0.772727272727273	4	22
NSUN4	14	17	7	16	369.27	738.54	15	1	0.397853527498013	0.46875	1	0.14726507713885	23	31
NSUN5	7	15	1	1	326.7	653.4	15	1	1	-1.14285714285714	1	-0.181818181818182	2	22
NSUN6	9	15	1	1	465.3	930.6	15	1	1	-0.666666666666667	1	-0.125	2	24
NSUN7	46	41	7	2	717.75	1435.5	15	1	0.180779846581529	-2.1195652173913	1	-0.24904214559387	9	87
NT5C1A	4	29	1	1	320.76	641.52	15	1	0.26890756302521	-6.25	1	-0.378787878787879	2	33
NT5C1B	0	13	0	1	272.58	545.16	15	1	1	NA	1	0	1	13
NT5C2	0	17	1	3	560.34	1120.68	15	1	0.19047619047619	-Inf	1	-0.25	4	17
NT5C3A	0	14	0	1	299.97	599.94	15	1	1	NA	1	0	1	14
NT5C3B	2	11	1	7	249.15	498.3	15	1	1	0.214285714285714	1	0.0288461538461539	8	13
NT5DC1	2	16	2	2	461.01	922.02	15	1	0.135475051264525	-7	1	-0.388888888888889	4	18
NT5DC2	0	17	2	7	459.03	918.06	15	1	0.110769230769231	-Inf	0.98538656216834	-0.222222222222222	9	17
NT5DC3	0	12	0	3	487.74	975.48	15	1	1	NA	1	0	3	12
NT5M	0	10	0	2	181.17	362.34	15	1	1	NA	1	0	2	10
NTAN1	2	4	1	0	293.04	586.08	15	1	0.428571428571428	-Inf	1	-0.666666666666667	1	6
NTF3	8	13	0	0	328.68	657.36	15	1	1	NA	1	NA	0	21
NTHL1	4	5	0	2	253.11	506.22	15	1	0.490909090909091	1	1	0.444444444444444	2	9
NTL	8	35	3	5	814.77	1629.54	15	1	0.346397282317182	-1.625	1	-0.188953488372093	8	43
NTM	1	7	1	7	285.78	571.56	15	1	1	0	1	0	8	8
NTMT1	0	7	0	1	152.79	305.58	15	1	1	NA	1	0	1	7
NTN3	0	7	2	10	477.18	954.36	15	1	0.508771929824562	-Inf	1	-0.166666666666667	12	7
NTN4	9	24	4	10	603.57	1207.14	15	1	1	-0.0666666666666667	1	-0.012987012987013	14	33
NTN4L	7	24	3	2	632.61	1265.22	15	1	0.118601986249045	-4.14285714285714	1	-0.374193548387097	5	31
NTNG1	4	6	0	1	239.58	479.16	15	1	1	1	1	0.4	1	10
NTNG2	6	22	3	10	644.16	1288.32	15	1	1	-0.1	1	-0.0164835164835165	13	28
NTPCR	4	7	1	0	189.09	378.18	15	1	0.416666666666667	-Inf	1	-0.636363636363636	1	11
NTRK1	0	5	0	5	148.17	296.34	15	1	1	NA	1	0	5	5
NTRK2	2	16	0	1	380.49	760.98	15	1	1	1	1	0.111111111111111	1	18
NTRK3	2	12	0	0	1237.83	2475.66	15	1	1	NA	1	NA	0	14
NTS	3	4	0	0	162.36	324.72	15	1	1	NA	1	NA	0	7
NTSR1	2	7	0	7	368.28	736.56	15	1	0.475	1	1	0.222222222222222	7	9
NUAK1	3	15	1	4	608.85	1217.7	15	1	1	-0.25	1	-0.0333333333333334	5	18
NUAK2	10	29	7	12	406.89	813.78	15	1	0.539609669954422	-0.691666666666667	1	-0.112010796221323	19	39
NUB1	4	31	2	6	606.87	1213.74	15	1	0.307758903782428	-1.58333333333333	1	-0.135714285714286	8	35
NUBP1	3	11	1	2	228.36	456.72	15	1	1	-0.833333333333333	1	-0.119047619047619	3	14
NUBPL	6	16	1	3	272.25	544.5	15	1	1	0.111111111111111	1	0.0227272727272727	4	22
NUCB2	1	15	1	3	449.79	899.58	15	1	0.368421052631579	-4	1	-0.1875	4	16
NUDC	4	13	1	7	306.9	613.8	15	1	1	0.535714285714286	1	0.110294117647059	8	17
NUDCD1	14	20	3	1	572.22	1144.44	15	1	0.306780464675201	-3.28571428571429	1	-0.338235294117647	4	34
NUDCD2	4	4	1	1	141.57	283.14	15	1	1	0	1	0	2	8
NUDCD3	0	3	2	4	209.55	419.1	15	1	0.5	-Inf	1	-0.333333333333333	6	3
NUDT1	6	5	0	1	155.43	310.86	15	1	1	1	1	0.545454545454545	1	11
NUDT12	13	22	4	3	501.6	1003.2	15	1	0.413318720122314	-1.25641025641026	1	-0.2	7	35
NUDT13	10	15	2	4	339.57	679.14	15	1	1	0.25	1	0.0666666666666667	6	25
NUDT14	4	7	0	3	217.8	435.6	15	1	0.505494505494506	1	1	0.363636363636364	3	11
NUDT15	1	3	2	0	63.03	126.06	15	1	0.4	-Inf	1	-0.75	2	4
NUDT19	17	14	3	1	317.46	634.92	15	1	0.618983957219251	-1.47058823529412	1	-0.201612903225806	4	31
NUDT2	4	7	0	1	147.51	295.02	15	1	1	1	1	0.363636363636364	1	11
NUDT21	0	11	0	0	187.44	374.88	15	1	1	NA	1	NA	0	11
NUDT3	0	8	1	1	135.63	271.26	15	1	0.2	-Inf	1	-0.5	2	8
NUDT4	1	2	0	0	62.37	124.74	15	1	1	NA	1	NA	0	3
NUDT5	1	6	1	1	218.79	437.58	15	1	0.416666666666667	-5	1	-0.357142857142857	2	7
NUDT6	8	8	1	2	189.09	378.18	15	1	1	0.5	1	0.166666666666667	3	16
NUDT7	10	11	1	0	258.72	517.44	15	1	1	-Inf	1	-0.523809523809524	1	21
NUF2	5	13	0	1	435.27	870.54	15	1	1	1	1	0.277777777777778	1	18
NUFIP1	22	30	6	3	457.05	914.1	15	1	0.278650930489667	-1.72727272727273	1	-0.243589743589744	9	52
NUFIP2	7	7	0	2	590.7	1181.4	15	1	0.475	1	1	0.5	2	14
NUGGC	104	33	13	17	909.15	1818.3	15	1	0.000802332283307214	0.757352941176471	0.236198796573611	0.325790754257907	30	137
NUMB	2	17	2	5	632.61	1265.22	15	1	0.287023411371238	-2.4	1	-0.180451127819549	7	19
NUMBL	3	4	2	0	197.34	394.68	15	1	0.444444444444445	-Inf	1	-0.571428571428571	2	7
NUP107	13	46	4	7	886.38	1772.76	15	1	0.442936033739289	-1.02197802197802	1	-0.143297380585516	11	59
NUP133	9	39	4	9	1141.8	2283.6	15	1	0.446703108097	-0.925925925925926	1	-0.120192307692308	13	48
NUP153	30	30	5	4	859.32	1718.64	15	1	1	-0.25	1	-0.0555555555555556	9	60
NUP155	12	34	6	2	1231.89	2463.78	15	1	0.0123836286823039	-7.5	0.61231737012987	-0.489130434782609	8	46
NUP160	17	64	10	27	1289.31	2578.62	15	1	0.4858251307262	-0.394335511982571	1	-0.0603937270603938	37	81
NUP188	8	52	9	17	1712.04	3424.08	15	1	0.0371017991696359	-2.44117647058824	0.788413232354762	-0.212820512820513	26	60
NUP205	13	62	3	8	1983.63	3967.26	15	1	0.421554692412165	-0.788461538461539	1	-0.0993939393939394	11	75
NUP210	28	66	10	17	1820.94	3641.88	15	1	0.487969167487716	-0.386554621848739	1	-0.0724980299448384	27	94
NUP210L	85	113	16	19	1962.18	3924.36	15	1	0.85362096927601	-0.119504643962848	1	-0.0278499278499278	35	198
NUP214	35	93	13	22	2051.28	4102.56	15	1	0.297210261631729	-0.57012987012987	1	-0.0979910714285714	35	128
NUP37	8	5	0	0	323.73	647.46	15	1	1	NA	1	NA	0	13
NUP50	17	21	1	0	470.25	940.5	15	1	0.461538461538462	-Inf	1	-0.552631578947368	1	38
NUP54	1	22	1	3	532.29	1064.58	15	1	0.279202279202279	-6.33333333333333	1	-0.206521739130435	4	23
NUP58	1	17	1	3	568.92	1137.84	15	1	0.337662337662338	-4.66666666666667	1	-0.194444444444444	4	18
NUP62	8	21	4	6	533.61	1067.22	15	1	0.692696791468388	-0.75	1	-0.124137931034483	10	29
NUP85	9	27	0	3	615.78	1231.56	15	1	1	1	1	0.25	3	36
NUP88	4	29	2	6	587.4	1174.8	15	1	0.57773039159432	-1.41666666666667	1	-0.128787878787879	8	33
NUP93	5	36	2	5	861.63	1723.26	15	1	0.267182723693706	-1.88	1	-0.163763066202091	7	41
NUP98	23	88	3	20	1736.13	3472.26	15	1	0.564990046884116	0.426086956521739	1	0.0767724245985116	23	111
NUR2L	4	5	2	4	381.81	763.62	15	1	1	0.375	1	0.111111111111111	6	9
NUS1	0	6	0	1	177.21	354.42	15	1	1	NA	1	0	1	6
NUSAP1	19	19	4	3	458.7	917.4	15	1	1	-0.333333333333333	1	-0.0714285714285714	7	38
NVL	27	24	2	3	910.14	1820.28	15	1	0.664236706689537	0.407407407407407	1	0.129411764705882	5	51
NWD2	8	76	11	15	1691.58	3383.16	15	1	0.00039878259736651	-5.96666666666667	0.164755839006111	-0.327838827838828	26	84
NXF1	2	20	1	4	281.16	562.32	15	1	0.473504273504273	-1.5	1	-0.109090909090909	5	22
NXN	0	11	0	4	302.28	604.56	15	1	1	NA	1	0	4	11
NXNL2	4	3	0	0	155.43	310.86	15	1	1	NA	1	NA	0	7
NXPE3	4	15	3	2	556.38	1112.76	15	1	0.126482213438735	-4.625	1	-0.389473684210526	5	19
NXPH1	1	3	0	2	261.36	522.72	15	1	1	1	1	0.25	2	4
NXPH2	2	10	0	1	245.52	491.04	15	1	1	1	1	0.166666666666667	1	12
NXPH3	0	11	1	2	241.56	483.12	15	1	0.214285714285714	-Inf	1	-0.333333333333333	3	11
NXPH4	6	7	0	1	207.9	415.8	15	1	1	1	1	0.461538461538462	1	13
NXT2	0	9	0	1	135.63	271.26	15	1	1	NA	1	0	1	9
NYAP2	0	22	1	5	708.84	1417.68	15	1	0.214285714285714	-Inf	1	-0.166666666666667	6	22
NYX	3	23	2	9	471.24	942.48	15	1	0.622731975673152	-0.703703703703704	1	-0.0664335664335664	11	26
OAF	1	12	0	4	195.03	390.06	15	1	1	1	1	0.0769230769230769	4	13
OARD1	3	20	0	2	150.48	300.96	15	1	1	1	1	0.130434782608696	2	23
OAT	4	21	1	9	435.6	871.2	15	1	1	0.416666666666667	1	0.06	10	25
OAZ1	0	2	0	0	168.3	336.6	15	1	1	NA	1	NA	0	2
OAZ2	0	8	0	2	139.59	279.18	15	1	1	NA	1	0	2	8
OBSCN	150	324	65	87	8015.7	16031.4	15	1	0.0140896684853113	-0.613793103448276	0.628451090139802	-0.111175882744837	152	474
OBSL1	64	73	48	41	2197.8	4395.6	15	1	0.340792102031307	-0.335365853658537	1	-0.0721725580250964	89	137
OC3	1	7	0	3	99.99	199.98	15	1	1	1	1	0.125	3	8
OCA2	11	21	3	3	526.02	1052.04	15	1	0.649736423730232	-0.909090909090909	1	-0.15625	6	32
OCEL1	3	1	1	2	30.69	61.38	15	1	0.485714285714286	0.833333333333333	1	0.416666666666667	3	4
OCIAD1	5	14	3	3	292.38	584.76	15	1	0.344189723320158	-1.8	1	-0.236842105263158	6	19
OCLN	2	7	2	11	398.31	796.62	15	1	1	0.363636363636364	1	0.0683760683760684	13	9
OCM	1	2	1	0	108.9	217.8	15	1	1	-Inf	1	-0.666666666666667	1	3
OCM2	3	3	0	0	108.9	217.8	15	1	1	NA	1	NA	0	6
OCRL	6	23	2	8	856.68	1713.36	15	1	1	0.0416666666666666	1	0.00689655172413792	10	29
OCSTAMP	22	31	9	3	471.9	943.8	15	1	0.0543549412570047	-3.22727272727273	0.846060006968071	-0.334905660377358	12	53
ODF2	17	26	1	4	814.11	1628.22	15	1	0.637225632831553	0.617647058823529	1	0.195348837209302	5	43
ODF2L	31	25	4	2	633.6	1267.2	15	1	0.688584387297117	-0.612903225806452	1	-0.113095238095238	6	56
OFCC1	19	17	2	3	467.94	935.88	15	1	0.662796004259419	0.403508771929825	1	0.127777777777778	5	36
OFD1	33	25	12	2	986.04	1972.08	15	1	0.0649849446217921	-3.54545454545455	0.884435842948953	-0.288177339901478	14	58
OGDH	3	21	1	15	879.12	1758.24	15	1	0.637597111281322	0.533333333333333	1	0.0625	16	24
OGDHL	4	30	1	6	1004.85	2009.7	15	1	1	-0.25	1	-0.0252100840336134	7	34
OGFOD1	10	18	1	4	435.6	871.2	15	1	0.6431219873934	0.55	1	0.157142857142857	5	28
OGFOD2	8	16	7	6	287.1	574.2	15	1	0.300254537073224	-1.33333333333333	1	-0.205128205128205	13	24
OGFOD3	15	8	2	3	322.74	645.48	15	1	0.353072853072853	0.644444444444444	1	0.252173913043478	5	23
OGFR	52	26	4	1	653.4	1306.8	15	1	1	-1	1	-0.133333333333333	5	78
OGFRL1	8	9	2	0	402.93	805.86	15	1	0.473684210526316	-Inf	1	-0.529411764705882	2	17
OGG1	6	3	4	4	187.44	374.88	15	1	0.637186343068696	0.5	1	0.166666666666667	8	9
OGN	3	11	1	0	290.07	580.14	15	1	0.266666666666667	-Inf	1	-0.785714285714286	1	14
OGT	1	44	1	4	1023.33	2046.66	15	1	0.191836734693877	-10	1	-0.177777777777778	5	45
OIP5	10	5	0	1	153.12	306.24	15	1	0.375	1	1	0.666666666666667	1	15
OIT3	3	19	0	5	548.46	1096.92	15	1	1	1	1	0.136363636363636	5	22
OLA1	2	10	0	1	383.79	767.58	15	1	1	1	1	0.166666666666667	1	12
OLFM1	0	6	0	4	430.65	861.3	15	1	1	NA	1	0	4	6
OLFM3	0	28	2	4	454.41	908.82	15	1	0.0267379679144385	-Inf	0.761210061313465	-0.333333333333333	6	28
OLFM4	8	7	1	2	147.51	295.02	15	1	1	0.5625	1	0.2	3	15
OLFML1	5	17	6	5	394.02	788.04	15	1	0.117113920293782	-3.08	1	-0.318181818181818	11	22
OLFML3	3	21	0	2	323.73	647.46	15	1	1	1	1	0.125	2	24
OLFR1019L2	16	12	6	5	321.75	643.5	15	1	1	0.1	1	0.025974025974026	11	28
OLFR4	8	15	2	4	309.87	619.74	15	1	1	0.0625	1	0.0144927536231884	6	23
OLFR52I1L	10	15	5	7	312.84	625.68	15	1	1	-0.0714285714285714	1	-0.0166666666666667	12	25
OLIG2	0	5	1	2	168.3	336.6	15	1	0.375	-Inf	1	-0.333333333333333	3	5
OMA1	14	19	7	1	525.69	1051.38	15	1	0.0448253131179961	-8.5	0.822543273817637	-0.450757575757576	8	33
OMD	13	25	4	2	413.82	827.64	15	1	0.18569660628651	-2.84615384615385	1	-0.324561403508772	6	38
OMG	6	20	0	4	435.6	871.2	15	1	0.556869184455391	1	1	0.230769230769231	4	26
ONECUT2	2	2	1	1	107.91	215.82	15	1	1	0	1	0	2	4
ONECUT3	0	8	0	1	356.4	712.8	15	1	1	NA	1	0	1	8
OPA1	4	32	1	2	995.28	1990.56	15	1	0.345223766276398	-3	1	-0.222222222222222	3	36
OPCML	2	6	1	4	247.17	494.34	15	1	1	0.25	1	0.05	5	8
OPHN1	2	19	3	8	774.18	1548.36	15	1	0.309823414905451	-2.5625	1	-0.177489177489177	11	21
OPN1MSW	1	14	2	10	348.15	696.3	15	1	0.569230769230769	-1.8	1	-0.1	12	15
OPN3	3	9	2	7	392.04	784.08	15	1	1	0.142857142857143	1	0.0277777777777778	9	12
OPN4	18	17	0	2	561.33	1122.66	15	1	0.486486486486486	1	1	0.514285714285714	2	35
OPN4-1	8	13	2	1	535.59	1071.18	15	1	0.550395256916996	-2.25	1	-0.285714285714286	3	21
OPN5	1	8	0	2	354.42	708.84	15	1	1	1	1	0.111111111111111	2	9
OPN5L1	9	18	1	3	438.57	877.14	15	1	1	0.333333333333333	1	0.0833333333333333	4	27
OPN5L2	1	17	0	2	345.51	691.02	15	1	1	1	1	0.0555555555555556	2	18
OPNP	15	17	6	3	345.51	691.02	15	1	0.453729526900259	-1.26666666666667	1	-0.197916666666667	9	32
OPNVA	8	13	0	0	385.11	770.22	15	1	1	NA	1	NA	0	21
OPRD1	1	6	3	6	280.83	561.66	15	1	0.584615384615385	-2	1	-0.19047619047619	9	7
OPRK1	1	19	0	0	378.18	756.36	15	1	1	NA	1	NA	0	20
OPRL1	0	15	0	2	365.31	730.62	15	1	1	NA	1	0	2	15
OPRM1	0	7	0	2	376.2	752.4	15	1	1	NA	1	0	2	7
OPTC	9	11	10	5	316.47	632.94	15	1	0.30635649916977	-1.44444444444444	1	-0.216666666666667	15	20
OPTN	10	18	2	1	551.43	1102.86	15	1	0.54349276974416	-2.6	1	-0.309523809523809	3	28
OR10AC1	9	18	4	10	367.62	735.24	15	1	1	0.2	1	0.0476190476190476	14	27
OR51M1L	6	18	4	7	316.8	633.6	15	1	0.688923913879747	-0.714285714285714	1	-0.113636363636364	11	24
OR52B2	2	15	3	8	321.75	643.5	15	1	0.353072853072853	-1.8125	1	-0.155080213903743	11	17
OR52R1-OR52R1L1-OR52R1L2-OR52R1L3	3	0	1	0	86.46	172.92	15	1	1	NA	1	0	1	3
OR5AS1	11	18	3	3	311.85	623.7	15	1	0.664460065551147	-0.636363636363636	1	-0.120689655172414	6	29
OR8D4	10	22	5	11	312.84	625.68	15	1	1	0	1	0	16	32
ORAI2	0	13	0	3	256.41	512.82	15	1	1	NA	1	0	3	13
ORAOV1	6	6	2	0	117.48	234.96	15	1	0.472527472527473	-Inf	1	-0.5	2	12
ORC1	35	48	7	2	850.41	1700.82	15	1	0.0741868464497489	-3.8	0.913861472365723	-0.356091030789826	9	83
ORC2	13	30	3	3	541.53	1083.06	15	1	0.377296154354434	-1.30769230769231	1	-0.197674418604651	6	43
ORC3	17	27	1	7	700.92	1401.84	15	1	0.236267599190818	0.773109243697479	1	0.261363636363636	8	44
ORC4	10	19	2	2	425.37	850.74	15	1	0.609970674486804	-0.9	1	-0.155172413793103	4	29
ORC5	12	22	3	10	498.96	997.92	15	1	0.503307987971325	0.45	1	0.122171945701357	13	34
ORC6	6	7	1	2	244.86	489.72	15	1	1	0.416666666666667	1	0.128205128205128	3	13
ORMDL1	1	5	0	0	152.46	304.92	15	1	1	NA	1	NA	0	6
ORMDL2	1	3	0	0	54.78	109.56	15	1	1	NA	1	NA	0	4
ORMDL3	0	3	0	0	152.46	304.92	15	1	1	NA	1	NA	0	3
OSBP2	3	18	4	16	636.9	1273.8	15	1	0.696516403833477	-0.5	1	-0.0571428571428572	20	21
OSBPL10	5	25	1	11	689.7	1379.4	15	1	0.655203243136491	0.545454545454545	1	0.0833333333333333	12	30
OSBPL11	7	25	4	5	692.34	1384.68	15	1	0.21698561810319	-1.85714285714286	1	-0.225694444444444	9	32
OSBPL1A	24	50	6	12	1247.07	2494.14	15	1	1	-0.0416666666666667	1	-0.00900900900900897	18	74
OSBPL2	3	19	3	2	477.18	954.36	15	1	0.056001486436269	-8.5	0.846060006968071	-0.463636363636364	5	22
OSBPL3	6	29	3	4	840.51	1681.02	15	1	0.155460783188639	-2.625	1	-0.257142857142857	7	35
OSBPL5	6	33	1	6	870.21	1740.42	15	1	1	0.0833333333333334	1	0.010989010989011	7	39
OSBPL6	6	23	3	3	946.44	1892.88	15	1	0.161850957391754	-2.83333333333333	1	-0.293103448275862	6	29
OSBPL7	2	9	4	8	294.69	589.38	15	1	0.64040536122916	-1.25	1	-0.151515151515151	12	11
OSBPL8	5	24	2	8	857.34	1714.68	15	1	1	-0.2	1	-0.0275862068965517	10	29
OSBPL9	4	24	2	2	672.54	1345.08	15	1	0.150444938820912	-5	1	-0.357142857142857	4	28
OSCP1	3	12	1	1	353.76	707.52	15	1	0.426470588235294	-3	1	-0.3	2	15
OSER1	13	10	3	0	286.11	572.22	15	1	0.261538461538462	-Inf	1	-0.434782608695652	3	23
OSGEPL1	13	22	2	0	411.84	823.68	15	1	0.157657657657658	-Inf	1	-0.628571428571429	2	35
OSGIN1	6	27	1	2	494.01	988.02	15	1	0.488235294117647	-1.25	1	-0.151515151515151	3	33
OSMR	30	24	5	3	810.81	1621.62	15	1	1	-0.333333333333333	1	-0.0694444444444444	8	54
OSR1	1	10	1	0	258.39	516.78	15	1	0.166666666666667	-Inf	1	-0.909090909090909	1	11
OSR2	0	3	0	2	263.67	527.34	15	1	1	NA	1	0	2	3
OSTC	0	4	0	0	148.5	297	15	1	1	NA	1	NA	0	4
OSTF1	0	3	0	0	98.01	196.02	15	1	1	NA	1	NA	0	3
OSTM1	0	8	1	2	198	396	15	1	0.272727272727273	-Inf	1	-0.333333333333333	3	8
OSTN	6	6	4	1	165	330	15	1	0.338235294117647	-3	1	-0.3	5	12
OTC	14	14	9	3	351.45	702.9	15	1	0.178839273944947	-2	1	-0.25	12	28
OTOA	35	38	2	5	1348.71	2697.42	15	1	0.441575255191178	0.565714285714286	1	0.193737769080235	7	73
OTOF	24	88	16	42	2048.64	4097.28	15	1	0.445966690392096	-0.396825396825397	1	-0.061576354679803	58	112
OTOG	162	136	39	18	3512.85	7025.7	15	1	0.0579920050474069	-0.818930041152263	0.857798407992894	-0.140586365241964	57	298
OTOL1	7	14	3	12	314.82	629.64	15	1	0.468192773114909	0.5	1	0.133333333333333	15	21
OTOP1	7	25	4	1	570.24	1140.48	15	1	0.0207434325081384	-13.2857142857143	0.709272607289605	-0.58125	5	32
OTOP2	6	25	4	15	589.05	1178.1	15	1	1	-0.111111111111111	1	-0.0169779286926995	19	31
OTOP3	10	28	4	8	596.97	1193.94	15	1	0.717724444761604	-0.4	1	-0.0701754385964912	12	38
OTOR	1	2	0	0	131.67	263.34	15	1	1	NA	1	NA	0	3
OTOS	3	4	1	0	87.12	174.24	15	1	1	-Inf	1	-0.571428571428571	1	7
OTP	0	3	0	0	99.66	199.32	15	1	1	NA	1	NA	0	3
OTUD1	1	7	4	1	249.48	498.96	15	1	0.0318570318570319	-27	0.781533281533282	-0.675	5	8
OTUD3	14	16	6	5	362.34	724.68	15	1	0.733717618847438	-0.371428571428571	1	-0.0787878787878787	11	30
OTUD4	20	42	3	9	1113.09	2226.18	15	1	0.743049600586511	0.3	1	0.0725806451612903	12	62
OTUD7A	12	23	3	5	905.85	1811.7	15	1	1	-0.15	1	-0.0321428571428571	8	35
OTUD7B	11	37	7	15	789.69	1579.38	15	1	0.556876566540667	-0.56969696969697	1	-0.0890151515151515	22	48
OTX1	0	1	0	1	52.47	104.94	15	1	1	NA	1	0	1	1
OTX2	1	6	1	4	228.03	456.06	15	1	1	-0.5	1	-0.0571428571428572	5	7
OVCH2	32	27	2	8	807.51	1615.02	15	1	0.0839851949201849	0.7890625	0.949431371776132	0.342372881355932	10	59
OVOL2	5	2	2	1	213.51	427.02	15	1	1	0.2	1	0.0476190476190477	3	7
OVST	55	45	12	8	1585.98	3171.96	15	1	0.806704901268758	-0.227272727272727	1	-0.0499999999999999	20	100
OVSTL	51	49	2	9	1410.42	2820.84	15	1	0.0553630158787619	0.786492374727669	0.846060006968071	0.328181818181818	11	100
OXCT1	2	14	1	1	505.56	1011.12	15	1	0.313725490196078	-6	1	-0.375	2	16
OXGR1	10	19	4	2	340.56	681.12	15	1	0.190689149560117	-2.8	1	-0.32183908045977	6	29
OXGR1L	6	12	0	2	314.16	628.32	15	1	1	1	1	0.333333333333333	2	18
OXNAD1	6	10	3	3	313.83	627.66	15	1	0.655019902697921	-0.666666666666667	1	-0.125	6	16
OXR1	16	23	3	2	794.31	1588.62	15	1	0.637847971653984	-1.15625	1	-0.18974358974359	5	39
OXSM	7	12	1	1	457.38	914.76	15	1	1	-0.714285714285714	1	-0.131578947368421	2	19
OXSR1	1	24	2	5	522.72	1045.44	15	1	0.112903225806452	-8.6	0.99134365547716	-0.245714285714286	7	25
OXTR	2	9	1	6	383.46	766.92	15	1	1	0.25	1	0.038961038961039	7	11
P2RX1	1	20	1	7	384.12	768.24	15	1	0.482758620689655	-1.85714285714286	1	-0.0773809523809524	8	21
P2RX2	5	18	7	6	335.28	670.56	15	1	0.07143020204003	-3.2	0.908058284769907	-0.321070234113712	13	23
P2RX4	4	21	1	3	364.98	729.96	15	1	0.552608311229001	-0.75	1	-0.09	4	25
P2RX6	8	11	2	2	360.36	720.72	15	1	1	-0.375	1	-0.0789473684210527	4	19
P2RX7	44	11	5	5	556.38	1112.76	15	1	0.103177906805708	0.75	0.983165897366278	0.3	10	55
P2RY1	0	18	0	3	360.36	720.72	15	1	1	NA	1	0	3	18
P2RY10	3	11	0	2	335.61	671.22	15	1	1	1	1	0.214285714285714	2	14
P2RY13	9	14	2	3	340.56	681.12	15	1	1	-0.037037037037037	1	-0.00869565217391305	5	23
P2RY14	4	25	3	2	334.62	669.24	15	1	0.047621614628256	-8.375	0.828231827900648	-0.462068965517241	5	29
P2RY2	2	8	3	6	354.42	708.84	15	1	0.628482972136223	-1	1	-0.133333333333333	9	10
P2RY6	1	13	1	6	319.77	639.54	15	1	1	-1.16666666666667	1	-0.0714285714285714	7	14
P2RY8	2	16	0	2	354.42	708.84	15	1	1	1	1	0.111111111111111	2	18
P3H1	4	52	1	4	567.6	1135.2	15	1	0.3579220684915	-2.25	1	-0.128571428571429	5	56
P3H2	6	37	4	4	590.04	1180.08	15	1	0.0378950772975913	-5.16666666666667	0.789311843512415	-0.36046511627907	8	43
P3H3	6	40	7	9	936.54	1873.08	15	1	0.0275095703249927	-4.18518518518519	0.761210061313465	-0.307065217391304	16	46
P3H4	1	4	0	4	122.1	244.2	15	1	1	1	1	0.2	4	5
P4HA1	5	19	1	2	547.14	1094.28	15	1	0.545299145299145	-0.9	1	-0.125	3	24
P4HA2	2	13	0	3	507.87	1015.74	15	1	1	1	1	0.133333333333333	3	15
P4HA3	8	10	5	6	402.27	804.54	15	1	1	-0.0416666666666667	1	-0.0101010101010101	11	18
P4HB	2	11	1	2	393.69	787.38	15	1	0.489285714285714	-1.75	1	-0.179487179487179	3	13
P4HTM	12	21	0	3	384.45	768.9	15	1	0.536134453781513	1	1	0.363636363636364	3	33
PA2G4	1	17	0	1	337.59	675.18	15	1	1	1	1	0.0555555555555556	1	18
PAAF1	3	8	0	2	105.6	211.2	15	1	1	1	1	0.272727272727273	2	11
PABPC1	0	13	0	3	567.93	1135.86	15	1	1	NA	1	0	3	13
PABPC1L	8	24	3	10	671.88	1343.76	15	1	1	0.1	1	0.0192307692307692	13	32
PABPC4	2	24	2	2	615.78	1231.56	15	1	0.0749863163656267	-11	0.91607777179465	-0.423076923076923	4	26
PABPN1L	6	15	3	4	269.28	538.56	15	1	0.646457889936151	-0.875	1	-0.142857142857143	7	21
PACRG	5	4	1	1	266.64	533.28	15	1	1	0.2	1	0.0555555555555556	2	9
PACRGL	5	7	0	0	236.61	473.22	15	1	1	NA	1	NA	0	12
PACS2	2	21	1	8	828.3	1656.6	15	1	1	-0.3125	1	-0.0241545893719807	9	23
PACSIN1	3	5	1	5	285.12	570.24	15	1	0.580419580419581	0.666666666666667	1	0.208333333333333	6	8
PACSIN2	4	12	2	2	462.33	924.66	15	1	0.54922600619195	-2	1	-0.25	4	16
PACSIN3	2	11	2	4	428.01	856.02	15	1	0.557275541795666	-1.75	1	-0.179487179487179	6	13
PADI1	6	24	2	18	573.87	1147.74	15	1	0.450091626850872	0.555555555555556	1	0.1	20	30
PADI2	14	29	17	11	545.16	1090.32	15	1	0.0277190139983374	-2.2012987012987	0.761210061313465	-0.28156146179402	28	43
PADIL	14	16	12	13	577.17	1154.34	15	1	1	-0.054945054945055	1	-0.0133333333333333	25	30
PAFAH1B1	0	3	0	0	406.89	813.78	15	1	1	NA	1	NA	0	3
PAFAH1B2	0	15	1	3	230.01	460.02	15	1	0.210526315789474	-Inf	1	-0.25	4	15
PAFAH2	13	11	10	8	287.76	575.52	15	1	1	-0.0576923076923077	1	-0.013888888888889	18	24
PAH	2	18	1	1	442.53	885.06	15	1	0.25974025974026	-8	1	-0.4	2	20
PAICS	0	13	0	2	416.46	832.92	15	1	1	NA	1	0	2	13
PAIP1	9	22	0	2	405.24	810.48	15	1	1	1	1	0.290322580645161	2	31
PAIP2	0	7	0	2	126.72	253.44	15	1	1	NA	1	0	2	7
PAK1IP1	16	12	1	3	351.45	702.9	15	1	0.319243604004449	0.75	1	0.321428571428571	4	28
PAK2	0	15	0	9	520.74	1041.48	15	1	1	NA	1	0	9	15
PAK3	0	14	2	4	592.68	1185.36	15	1	0.0789473684210527	-Inf	0.933295530697459	-0.333333333333333	6	14
PAK4	1	11	1	1	200.31	400.62	15	1	0.274725274725275	-10	1	-0.416666666666667	2	12
PAK5	2	24	1	10	715.77	1431.54	15	1	1	-0.2	1	-0.013986013986014	11	26
PAK6	3	23	4	5	692.01	1384.02	15	1	0.0551370209323491	-5.13333333333333	0.846060006968071	-0.329059829059829	9	26
PALB2	86	63	18	10	1157.64	2315.28	15	1	0.676176083386887	-0.318604651162791	1	-0.0656759348034516	28	149
PALLD	7	23	4	4	784.08	1568.16	15	1	0.194958715831581	-2.28571428571429	1	-0.266666666666667	8	30
PALLDL	5	10	0	3	194.04	388.08	15	1	0.522058823529412	1	1	0.333333333333333	3	15
PALM	3	4	4	3	198.33	396.66	15	1	1	-0.777777777777778	1	-0.142857142857143	7	7
PALMD	9	29	3	6	543.51	1087.02	15	1	0.67429743626339	-0.611111111111111	1	-0.0964912280701754	9	38
PAM	20	34	5	1	970.86	1941.72	15	1	0.0731028330616137	-7.5	0.913861472365723	-0.462962962962963	6	54
PAN2	6	59	4	15	1229.91	2459.82	15	1	0.223086188094725	-1.62222222222222	1	-0.118218623481781	19	65
PANK1	0	13	0	1	370.26	740.52	15	1	1	NA	1	0	1	13
PANK4	2	19	0	8	735.9	1471.8	15	1	1	1	1	0.0952380952380952	8	21
PANX1	2	12	1	10	402.93	805.86	15	1	1	0.4	1	0.0519480519480519	11	14
PANX2	17	30	7	6	913.11	1826.22	15	1	0.340002620602652	-1.05882352941176	1	-0.176759410801964	13	47
PANX3	6	19	0	2	394.35	788.7	15	1	1	1	1	0.24	2	25
PAOX	14	28	0	1	391.05	782.1	15	1	1	1	1	0.333333333333333	1	42
PAPD4	40	19	1	1	495.99	991.98	15	1	1	0.525	1	0.177966101694915	2	59
PAPD5	6	14	1	5	528.66	1057.32	15	1	1	0.533333333333333	1	0.133333333333333	6	20
PAPD7	2	9	1	1	465.3	930.6	15	1	0.423076923076923	-3.5	1	-0.318181818181818	2	11
PAPLN	39	55	19	10	1344.09	2688.18	15	1	0.0328096184763269	-1.67948717948718	0.784275503573749	-0.240278796771827	29	94
PAPOLA	1	17	0	1	728.97	1457.94	15	1	1	1	1	0.0555555555555556	1	18
PAPOLG	16	26	4	4	733.92	1467.84	15	1	0.697404916362385	-0.625	1	-0.119047619047619	8	42
PAPPA	9	36	5	9	1064.25	2128.5	15	1	0.285232137060681	-1.22222222222222	1	-0.157142857142857	14	45
PAPPA2	17	61	11	19	1348.05	2696.1	15	1	0.142663866732444	-1.07739938080495	1	-0.148717948717949	30	78
PAPSS1	7	34	4	3	636.57	1273.14	15	1	0.0392401523137491	-5.47619047619048	0.794052121283243	-0.400696864111498	7	41
PAPSS2	5	33	1	3	636.57	1273.14	15	1	0.473733583489681	-1.2	1	-0.118421052631579	4	38
PAQR3	4	10	0	3	267.63	535.26	15	1	0.541176470588235	1	1	0.285714285714286	3	14
PAQR5	9	7	6	7	329.67	659.34	15	1	0.715249186552235	0.333333333333333	1	0.100961538461538	13	16
PAQR7	3	8	1	7	342.21	684.42	15	1	0.602683178534572	0.619047619047619	1	0.147727272727273	8	11
PAQR8	4	25	3	6	342.21	684.42	15	1	0.322489179300325	-2.125	1	-0.195402298850575	9	29
PAQR9	0	17	1	0	321.09	642.18	15	1	0.0555555555555556	-Inf	0.846060006968071	-1	1	17
PARD3	17	32	11	5	1344.42	2688.84	15	1	0.0220236650423298	-3.14117647058824	0.721018759249189	-0.340561224489796	16	49
PARD3B	19	33	2	2	1129.59	2259.18	15	1	0.625786163522013	-0.736842105263158	1	-0.134615384615385	4	52
PARD6B	2	16	0	1	346.5	693	15	1	1	1	1	0.111111111111111	1	18
PARD6G	6	13	1	2	317.79	635.58	15	1	1	-0.0833333333333333	1	-0.0175438596491228	3	19
PARG	24	35	8	7	902.55	1805.1	15	1	0.398221825706877	-0.666666666666667	1	-0.126553672316384	15	59
PARK2	5	3	1	1	156.09	312.18	15	1	1	0.4	1	0.125	2	8
PARK7	3	10	1	0	188.1	376.2	15	1	0.285714285714286	-Inf	1	-0.769230769230769	1	13
PARL	2	8	1	3	271.26	542.52	15	1	1	-0.333333333333333	1	-0.05	4	10
PARM1	17	19	1	4	215.49	430.98	15	1	0.362940653698035	0.720588235294118	1	0.272222222222222	5	36
PARN	8	20	1	3	627.99	1255.98	15	1	1	0.166666666666667	1	0.0357142857142857	4	28
PARP12	22	23	3	1	589.05	1178.1	15	1	0.609205384281372	-2.13636363636364	1	-0.261111111111111	4	45
PARP14	152	86	19	18	3198.03	6396.06	15	1	0.149759665463768	0.402777777777778	1	0.12514194867136	37	238
PARP16	2	15	3	6	301.62	603.24	15	1	0.302219519610824	-2.75	1	-0.215686274509804	9	17
PARP3	7	17	5	9	430.32	860.64	15	1	0.728083756726693	-0.349206349206349	1	-0.0654761904761905	14	24
PARP4	33	30	13	12	1149.39	2298.78	15	1	1	0.0151515151515151	1	0.00380952380952382	25	63
PARP6	1	21	1	10	528.33	1056.66	15	1	1	-1.1	1	-0.0454545454545455	11	22
PARP8	9	18	1	0	603.57	1207.14	15	1	0.357142857142857	-Inf	1	-0.666666666666667	1	27
PARP9	48	41	12	2	768.24	1536.48	15	1	0.0387196773296736	-4.125	0.790772428712623	-0.317817014446228	14	89
PARS2	13	25	6	4	457.05	914.1	15	1	0.163942699553083	-1.88461538461538	1	-0.257894736842105	10	38
PARVA	4	12	0	8	381.81	763.62	15	1	0.262187088274045	1	1	0.25	8	16
PARVG	12	11	0	1	319.77	639.54	15	1	1	1	1	0.521739130434783	1	23
PASD1	18	34	2	7	807.18	1614.36	15	1	0.704419777231877	0.46031746031746	1	0.123931623931624	9	52
PASK	80	59	14	9	1318.35	2636.7	15	1	0.822954338452952	-0.147222222222222	1	-0.0331560838285894	23	139
PATJ	35	79	11	7	1869.12	3738.24	15	1	0.0165902264665601	-2.5469387755102	0.673222397514319	-0.304093567251462	18	114
PATL2	6	30	4	5	672.21	1344.42	15	1	0.0934533064276026	-3	0.958791526417971	-0.277777777777778	9	36
PAWR	3	6	1	0	192.06	384.12	15	1	0.4	-Inf	1	-0.666666666666667	1	9
PAX1	1	3	0	1	91.08	182.16	15	1	1	1	1	0.25	1	4
PAX2	6	3	1	0	198.33	396.66	15	1	1	-Inf	1	-0.333333333333333	1	9
PAX3	1	3	1	3	164.34	328.68	15	1	1	0	1	0	4	4
PAX5	1	7	2	4	303.6	607.2	15	1	0.538461538461538	-2.5	1	-0.208333333333333	6	8
PAX6	0	4	0	4	424.71	849.42	15	1	1	NA	1	0	4	4
PAX7	6	13	1	1	376.53	753.06	15	1	1	-1.16666666666667	1	-0.184210526315789	2	19
PAX9	0	3	0	0	85.47	170.94	15	1	1	NA	1	NA	0	3
PAXBP1	3	14	3	3	811.14	1622.28	15	1	0.278552111504057	-3.66666666666667	1	-0.323529411764706	6	17
PAXIP1	5	47	2	7	1051.38	2102.76	15	1	0.273361282641941	-1.68571428571429	1	-0.126068376068376	9	52
PAXX	7	7	0	0	129.03	258.06	15	1	1	NA	1	NA	0	14
PBDC1	2	5	2	3	69.63	139.26	15	1	1	-0.666666666666667	1	-0.114285714285714	5	7
PBK	7	7	5	3	194.7	389.4	15	1	0.674922600619195	-0.666666666666667	1	-0.125	8	14
PBLD	10	13	5	1	253.44	506.88	15	1	0.168582375478927	-5.5	1	-0.398550724637681	6	23
PBX3	4	9	3	1	383.13	766.26	15	1	0.25	-5.75	1	-0.442307692307692	4	13
PCASP1	11	17	2	5	783.75	1567.5	15	1	0.688886344304129	0.381818181818182	1	0.107142857142857	7	28
PCASP2	8	9	5	4	533.61	1067.22	15	1	1	-0.40625	1	-0.0849673202614379	9	17
PCASP3	10	26	5	5	629.64	1259.28	15	1	0.256738012661645	-1.6	1	-0.222222222222222	10	36
PCBD1	0	7	0	0	103.95	207.9	15	1	1	NA	1	NA	0	7
PCBD2	1	3	0	0	107.91	215.82	15	1	1	NA	1	NA	0	4
PCBP2	2	6	0	2	348.15	696.3	15	1	1	1	1	0.25	2	8
PCBP3	1	3	0	3	350.13	700.26	15	1	1	1	1	0.25	3	4
PCBP4	0	1	0	2	86.79	173.58	15	1	1	NA	1	0	2	1
PCCA	4	15	2	2	443.19	886.38	15	1	0.27046866177301	-2.75	1	-0.289473684210526	4	19
PCCB	5	20	1	6	484.11	968.22	15	1	1	0.333333333333333	1	0.0571428571428572	7	25
PCDH1	7	35	6	20	1134.87	2269.74	15	1	0.539984242918042	-0.5	1	-0.0641025641025641	26	42
PCDH10	11	27	1	1	972.84	1945.68	15	1	0.515384615384615	-1.45454545454545	1	-0.210526315789474	2	38
PCDH11X	9	33	8	2	925.65	1851.3	15	1	0.00096932519108368	-13.6666666666667	0.248251522554939	-0.585714285714286	10	42
PCDH12	24	72	21	29	1100.22	2200.44	15	1	0.0395714378239573	-1.17241379310345	0.794548741720226	-0.17	50	96
PCDH15	8	22	2	4	512.82	1025.64	15	1	1	-0.375	1	-0.0666666666666667	6	30
PCDH17	4	55	0	4	911.46	1822.92	15	1	1	1	1	0.0677966101694915	4	59
PCDH18	5	47	2	5	1131.57	2263.14	15	1	0.190108020870126	-2.76	1	-0.18956043956044	7	52
PCDH19	14	68	3	7	1123.32	2246.64	15	1	0.385689359852612	-1.08163265306122	1	-0.129268292682927	10	82
PCDH20	11	43	6	4	880.44	1760.88	15	1	0.0168362155058098	-4.86363636363636	0.674707602339182	-0.396296296296296	10	54
PCDH7	6	58	1	1	989.34	1978.68	15	1	0.202331002331002	-8.66666666666667	1	-0.40625	2	64
PCDH8	8	55	5	9	957.66	1915.32	15	1	0.0526298033763453	-2.81944444444444	0.843251957917679	-0.23015873015873	14	63
PCDH9	7	31	1	1	1003.86	2007.72	15	1	0.364102564102564	-3.42857142857143	1	-0.315789473684211	2	38
PCDHAC2	3	36	2	6	882.09	1764.18	15	1	0.19568835527358	-3	1	-0.173076923076923	8	39
PCDHGC3	2	1	1	0	139.92	279.84	15	1	1	-Inf	1	-0.333333333333333	1	3
PCGF2	0	6	0	5	179.19	358.38	15	1	1	NA	1	0	5	6
PCGF5	0	10	0	0	237.93	475.86	15	1	1	NA	1	NA	0	10
PCGF6	1	6	0	0	228.36	456.72	15	1	1	NA	1	NA	0	7
PCID2	1	17	0	5	360.36	720.72	15	1	1	1	1	0.0555555555555556	5	18
PCIF1	2	17	1	5	700.92	1401.84	15	1	1	-0.7	1	-0.0614035087719298	6	19
PCK1	1	25	2	1	616.77	1233.54	15	1	0.0216201423097975	-49	0.721018759249189	-0.628205128205128	3	26
PCLO	95	130	6	14	4294.29	8588.58	15	1	0.348293620869118	0.413533834586466	1	0.122222222222222	20	225
PCM1	40	71	11	10	2033.13	4066.26	15	1	0.221216606753763	-0.9525	1	-0.163449163449163	21	111
PCMT1	1	4	0	1	208.56	417.12	15	1	1	1	1	0.2	1	5
PCMT1L	0	15	3	5	246.51	493.02	15	1	0.0316205533596838	-Inf	0.778718235934639	-0.375	8	15
PCMTD1	0	8	0	1	355.41	710.82	15	1	1	NA	1	0	1	8
PCMTD2	1	5	1	0	358.38	716.76	15	1	0.285714285714286	-Inf	1	-0.833333333333333	1	6
PCNA	0	10	0	3	239.25	478.5	15	1	1	NA	1	0	3	10
PCNP	0	2	0	1	159.06	318.12	15	1	1	NA	1	0	1	2
PCNT	85	63	9	4	1691.91	3383.82	15	1	0.560340289458358	-0.667647058823529	1	-0.117983367983368	13	148
PCNX1	7	51	2	7	2255.88	4511.76	15	1	0.596536428230011	-1.08163265306122	1	-0.101532567049808	9	58
PCNX2	25	64	12	14	1837.44	3674.88	15	1	0.0979332837987299	-1.19428571428571	0.971353639774823	-0.180639585133967	26	89
PCNX4	13	40	2	7	1112.76	2225.52	15	1	1	0.120879120879121	1	0.0230607966457023	9	53
PCOLCE2	1	20	2	0	384.45	768.9	15	1	0.0118577075098814	-Inf	0.596226042284133	-0.952380952380952	2	21
PCSK1	11	86	7	12	682.11	1364.22	15	1	0.0108662415464126	-3.56060606060606	0.585928868752023	-0.255018990775909	19	97
PCSK2	7	24	3	7	628.65	1257.3	15	1	0.683353124203951	-0.469387755102041	1	-0.0741935483870968	10	31
PCSK4	24	18	14	15	564.63	1129.26	15	1	0.47960106130947	0.3	1	0.0886699507389162	29	42
PCSK5	5	9	0	0	359.7	719.4	15	1	1	NA	1	NA	0	14
PCSK6	12	29	9	18	784.74	1569.48	15	1	0.791584991743213	-0.208333333333333	1	-0.040650406504065	27	41
PCSK7	10	29	6	15	763.29	1526.58	15	1	1	-0.16	1	-0.0293040293040293	21	39
PCSK9	15	39	11	19	646.47	1292.94	15	1	0.463491020607112	-0.505263157894737	1	-0.0888888888888889	30	54
PCTP	2	5	0	1	166.32	332.64	15	1	1	1	1	0.285714285714286	1	7
PCTPL	3	19	2	8	254.76	509.52	15	1	0.636749165739711	-0.583333333333333	1	-0.0636363636363637	10	22
PCYOX1	14	17	4	5	382.8	765.6	15	1	1	0.0285714285714286	1	0.00716845878136202	9	31
PCYOX1L	15	30	0	0	435.93	871.86	15	1	1	NA	1	NA	0	45
PCYT1A	12	21	5	5	586.41	1172.82	15	1	0.480919342399475	-0.75	1	-0.136363636363636	10	33
PCYT1B	0	11	0	3	325.71	651.42	15	1	1	NA	1	0	3	11
PCYT2	0	8	0	0	348.81	697.62	15	1	1	NA	1	NA	0	8
PDAP1	0	11	0	3	175.89	351.78	15	1	1	NA	1	0	3	11
PDC	2	10	1	0	247.5	495	15	1	0.230769230769231	-Inf	1	-0.833333333333333	1	12
PDCD1	3	16	0	4	245.19	490.38	15	1	1	1	1	0.157894736842105	4	19
PDCD10	0	8	0	0	210.87	421.74	15	1	1	NA	1	NA	0	8
PDCD11	90	66	9	8	1816.98	3633.96	15	1	0.798248613727505	0.175	1	0.0475113122171945	17	156
PDCD1LG2	12	16	2	2	318.78	637.56	15	1	1	-0.333333333333333	1	-0.0714285714285715	4	28
PDCD2	7	11	0	4	263.01	526.02	15	1	0.263157894736842	1	1	0.388888888888889	4	18
PDCD2L	14	16	1	0	355.08	710.16	15	1	0.483870967741936	-Inf	1	-0.533333333333333	1	30
PDCD4	2	15	0	2	463.32	926.64	15	1	1	1	1	0.117647058823529	2	17
PDCD5	1	3	0	0	125.73	251.46	15	1	1	NA	1	NA	0	4
PDCD6	1	6	1	2	141.9	283.8	15	1	1	-2	1	-0.19047619047619	3	7
PDCD6IP	7	30	3	6	849.42	1698.84	15	1	0.384370566604926	-1.14285714285714	1	-0.144144144144144	9	37
PDCD7	2	18	2	2	248.82	497.64	15	1	0.114906832298137	-8	1	-0.4	4	20
PDCL	0	9	1	1	297.99	595.98	15	1	0.181818181818182	-Inf	1	-0.5	2	9
PDCL2	9	9	5	5	373.89	747.78	15	1	1	0	1	0	10	18
PDCL3	0	10	1	1	236.61	473.22	15	1	0.166666666666667	-Inf	1	-0.5	2	10
PDDC1	0	11	1	2	217.14	434.28	15	1	0.214285714285714	-Inf	1	-0.333333333333333	3	11
PDE10A	6	14	2	4	729.63	1459.26	15	1	1	-0.166666666666667	1	-0.0333333333333333	6	20
PDE11A	4	21	1	1	679.14	1358.28	15	1	0.341880341880342	-4.25	1	-0.34	2	25
PDE12	11	29	1	5	384.12	768.24	15	1	1	0.472727272727273	1	0.108333333333333	6	40
PDE1A	5	10	2	2	609.18	1218.36	15	1	0.602683178534572	-1	1	-0.166666666666667	4	15
PDE1C	11	9	3	3	534.27	1068.54	15	1	1	0.181818181818182	1	0.05	6	20
PDE3A	32	42	0	1	991.98	1983.96	15	1	1	1	1	0.432432432432432	1	74
PDE3B	14	23	2	5	835.56	1671.12	15	1	1	0.342857142857143	1	0.0926640926640927	7	37
PDE4DIP	72	108	34	26	2131.8	4263.6	15	1	0.0350789179215633	-0.961538461538461	0.788199921465956	-0.166666666666667	60	180
PDE5A	2	23	3	4	845.46	1690.92	15	1	0.0565906562847609	-7.625	0.846060006968071	-0.348571428571429	7	25
PDE6B	0	30	0	14	828.63	1657.26	15	1	1	NA	1	0	14	30
PDE6C	4	23	1	4	855.36	1710.72	15	1	1	-0.4375	1	-0.0518518518518519	5	27
PDE6D	0	3	2	0	149.82	299.64	15	1	0.1	-Inf	0.971353639774823	-1	2	3
PDE6G	0	3	0	2	72.93	145.86	15	1	1	NA	1	0	2	3
PDE6H	0	1	0	3	85.14	170.28	15	1	1	NA	1	0	3	1
PDE7A	1	10	1	2	402.93	805.86	15	1	0.395604395604396	-4	1	-0.242424242424242	3	11
PDE7B	4	11	0	1	437.58	875.16	15	1	1	1	1	0.266666666666667	1	15
PDE8A	1	23	0	1	803.88	1607.76	15	1	1	1	1	0.0416666666666667	1	24
PDE8B	14	27	4	2	762.3	1524.6	15	1	0.184810478122011	-2.85714285714286	1	-0.32520325203252	6	41
PDE9A	0	15	0	3	513.81	1027.62	15	1	1	NA	1	0	3	15
PDGFB	3	11	1	7	237.27	474.54	15	1	1	0.476190476190476	1	0.0892857142857143	8	14
PDGFC	2	9	0	3	309.87	619.74	15	1	1	1	1	0.181818181818182	3	11
PDGFD	1	9	1	1	348.48	696.96	15	1	0.318181818181818	-8	1	-0.4	2	10
PDGFRA	3	37	1	6	1077.12	2154.24	15	1	0.487623692989095	-1.05555555555556	1	-0.0678571428571429	7	40
PDGFRB	10	55	8	21	1055.34	2110.68	15	1	0.25518348310242	-1.0952380952381	1	-0.122015915119363	29	65
PDGFRL	6	10	1	2	353.1	706.2	15	1	1	0.166666666666667	1	0.0416666666666667	3	16
PDHA1	0	9	0	1	371.25	742.5	15	1	1	NA	1	0	1	9
PDHB	1	17	2	3	263.34	526.68	15	1	0.107284020327499	-10.3333333333333	0.983875031494079	-0.344444444444444	5	18
PDHX	3	18	3	2	463.98	927.96	15	1	0.062420188507145	-8	0.878102185642472	-0.457142857142857	5	21
PDIA3	3	11	0	3	447.81	895.62	15	1	1	1	1	0.214285714285714	3	14
PDIA4	3	21	0	1	606.54	1213.08	15	1	1	1	1	0.125	1	24
PDIA5	1	22	0	3	388.08	776.16	15	1	1	1	1	0.0434782608695652	3	23
PDIK1L	0	16	0	4	338.58	677.16	15	1	1	NA	1	0	4	16
PDK1	1	15	0	1	394.02	788.04	15	1	1	1	1	0.0625	1	16
PDK3	0	7	0	1	378.51	757.02	15	1	1	NA	1	0	1	7
PDK4	0	16	0	2	363	726	15	1	1	NA	1	0	2	16
PDLIM1	5	32	1	5	408.21	816.42	15	1	1	-0.28	1	-0.0315315315315315	6	37
PDLIM3	2	10	0	1	320.76	641.52	15	1	1	1	1	0.166666666666667	1	12
PDLIM4	2	12	2	3	297	594	15	1	0.27218782249742	-3	1	-0.257142857142857	5	14
PDLIM5	19	32	8	8	836.55	1673.1	15	1	0.39457467502344	-0.684210526315789	1	-0.127450980392157	16	51
PDLIM7	10	32	5	14	818.07	1636.14	15	1	1	-0.142857142857143	1	-0.025062656641604	19	42
PDPK1	1	15	3	3	545.16	1090.32	15	1	0.0457963089542037	-14	0.82527502709988	-0.4375	6	16
PDRG1	4	4	2	3	131.67	263.34	15	1	1	0.333333333333333	1	0.1	5	8
PDS5A	4	32	1	6	1322.31	2644.62	15	1	1	-0.333333333333333	1	-0.0317460317460317	7	36
PDS5B	0	36	2	6	1400.85	2801.7	15	1	0.0295983086680761	-Inf	0.771992783106328	-0.25	8	36
PDSS1	1	11	0	3	333.63	667.26	15	1	1	1	1	0.0833333333333333	3	12
PDSS2	14	9	6	0	176.88	353.76	15	1	0.137476316786662	-Inf	1	-0.391304347826087	6	23
PDX1	0	4	0	0	172.26	344.52	15	1	1	NA	1	NA	0	4
PDXDC1	9	23	3	0	772.2	1544.4	15	1	0.0336134453781513	-Inf	0.784747167725891	-0.71875	3	32
PDXK	1	14	0	1	349.47	698.94	15	1	1	1	1	0.0666666666666667	1	15
PDXP	0	7	1	2	171.93	343.86	15	1	0.3	-Inf	1	-0.333333333333333	3	7
PDYN	5	3	2	2	206.25	412.5	15	1	1	0.4	1	0.125	4	8
PDZD11	0	3	0	3	98.67	197.34	15	1	1	NA	1	0	3	3
PDZD2	69	104	13	3	2539.02	5078.04	15	1	0.00255210915097794	-5.53140096618357	0.35018916597864	-0.413656069364162	16	173
PDZD3	14	14	4	10	388.08	776.16	15	1	0.321410590981117	0.6	1	0.214285714285714	14	28
PDZD7	5	13	2	11	381.15	762.3	15	1	0.667185761957731	0.527272727272727	1	0.123931623931624	13	18
PDZD8	18	36	3	7	1107.48	2214.96	15	1	1	0.142857142857143	1	0.0333333333333333	10	54
PDZK1	12	17	2	2	514.8	1029.6	15	1	1	-0.416666666666667	1	-0.0862068965517241	4	29
PDZK1IP1	5	4	0	3	89.1	178.2	15	1	0.204545454545455	1	1	0.555555555555556	3	9
PDZRN3	1	31	1	9	772.2	1544.4	15	1	0.423925667828107	-2.44444444444444	1	-0.06875	10	32
PEAK1	24	58	8	14	1773.09	3546.18	15	1	0.604715388282836	-0.380952380952381	1	-0.0709534368070954	22	82
PEBP1	2	13	1	5	154.11	308.22	15	1	1	-0.3	1	-0.0333333333333333	6	15
PEBP4	3	8	5	4	191.73	383.46	15	1	0.361848059061681	-2.33333333333333	1	-0.282828282828283	9	11
PECAM1	11	18	4	5	725.67	1451.34	15	1	1	-0.309090909090909	1	-0.0651340996168582	9	29
PEF1	2	3	3	3	164.01	328.02	15	1	1	-0.5	1	-0.1	6	5
PELI1	7	11	0	3	813.78	1627.56	15	1	0.521052631578947	1	1	0.388888888888889	3	18
PELO	2	28	1	3	374.55	749.1	15	1	0.321524064171123	-3.66666666666667	1	-0.183333333333333	4	30
PEMT	2	5	0	4	190.74	381.48	15	1	0.490909090909091	1	1	0.285714285714286	4	7
PENK	0	9	1	1	219.78	439.56	15	1	0.181818181818182	-Inf	1	-0.5	2	9
PEPD	3	12	2	3	487.08	974.16	15	1	0.559791021671827	-1.66666666666667	1	-0.2	5	15
PER2	4	53	2	5	1292.94	2585.88	15	1	0.125061060868162	-4.3	1	-0.215538847117794	7	57
PER3	61	44	6	2	1128.93	2257.86	15	1	0.46908135102024	-1.16393442622951	1	-0.169047619047619	8	105
PERM1	24	26	17	14	630.96	1261.92	15	1	0.649131679171304	-0.31547619047619	1	-0.0683870967741935	31	50
PERP1	2	9	0	2	187.77	375.54	15	1	1	1	1	0.181818181818182	2	11
PERP2	4	4	1	2	195.03	390.06	15	1	1	0.5	1	0.166666666666667	3	8
PEX1	23	34	6	2	1174.14	2348.28	15	1	0.125230454144624	-3.43478260869565	1	-0.346491228070175	8	57
PEX10	4	9	2	3	285.12	570.24	15	1	1	-0.5	1	-0.0923076923076923	5	13
PEX11A	7	11	1	0	243.54	487.08	15	1	0.421052631578948	-Inf	1	-0.611111111111111	1	18
PEX11G	10	12	2	4	254.43	508.86	15	1	0.672984020810108	0.4	1	0.121212121212121	6	22
PEX12	7	11	7	10	311.85	623.7	15	1	1	-0.1	1	-0.022875816993464	17	18
PEX13	5	14	1	0	371.58	743.16	15	1	0.3	-Inf	1	-0.736842105263158	1	19
PEX14	4	7	0	1	363.33	726.66	15	1	1	1	1	0.363636363636364	1	11
PEX16	3	10	4	2	295.02	590.04	15	1	0.12874097007224	-5.66666666666667	1	-0.435897435897436	6	13
PEX2	14	6	0	1	301.95	603.9	15	1	0.333333333333333	1	1	0.7	1	20
PEX26	5	14	3	0	230.34	460.68	15	1	0.0363636363636363	-Inf	0.788199921465956	-0.736842105263158	3	19
PEX3	2	11	0	1	363.33	726.66	15	1	1	1	1	0.153846153846154	1	13
PEX5	7	18	4	6	628.98	1257.96	15	1	0.688923913879747	-0.714285714285714	1	-0.12	10	25
PEX5L	3	16	3	2	576.18	1152.36	15	1	0.0784867306606437	-7	0.930584321290736	-0.442105263157895	5	19
PEX7	2	11	3	3	277.2	554.4	15	1	0.262125902992776	-4.5	1	-0.346153846153846	6	13
PFDN1	0	3	0	0	121.11	242.22	15	1	1	NA	1	NA	0	3
PFDN4	0	5	0	3	134.64	269.28	15	1	1	NA	1	0	3	5
PFDN5	9	15	1	1	163.35	326.7	15	1	1	-0.666666666666667	1	-0.125	2	24
PFKFB3	5	32	2	4	498.63	997.26	15	1	0.247638709321845	-2.2	1	-0.198198198198198	6	37
PFKFB4L	0	11	0	4	414.48	828.96	15	1	1	NA	1	0	4	11
PFKL	2	16	11	9	515.13	1030.26	15	1	0.00636557421874441	-8.77777777777778	0.467685236262114	-0.438888888888889	20	18
PFKP	3	18	0	3	807.51	1615.02	15	1	1	1	1	0.142857142857143	3	21
PGA3	4	19	0	0	380.16	760.32	15	1	1	NA	1	NA	0	23
PGA5	13	12	1	9	325.38	650.76	15	1	0.0280064599406351	0.897435897435897	0.761210061313465	0.42	10	25
PGAM1	1	5	0	3	123.42	246.84	15	1	1	1	1	0.166666666666667	3	6
PGAM5	0	15	0	1	233.64	467.28	15	1	1	NA	1	0	1	15
PGAP1	17	30	2	2	887.04	1774.08	15	1	0.622889155662265	-0.764705882352941	1	-0.138297872340426	4	47
PGAP2	0	3	1	5	220.11	440.22	15	1	1	-Inf	1	-0.166666666666667	6	3
PGBD5	2	15	1	1	460.02	920.04	15	1	0.298245614035088	-6.5	1	-0.382352941176471	2	17
PGC	11	21	8	6	388.74	777.48	15	1	0.198847173889715	-1.54545454545455	1	-0.227678571428571	14	32
PGD	1	13	1	4	476.52	953.04	15	1	0.467836257309942	-2.25	1	-0.128571428571429	5	14
PGF	0	6	0	3	128.37	256.74	15	1	1	NA	1	0	3	6
PGGHG	31	36	4	5	581.13	1162.26	15	1	1	0.0709677419354838	1	0.0182421227197347	9	67
PGGT1B	20	25	3	1	807.51	1615.02	15	1	0.329678679982631	-2.75	1	-0.305555555555556	4	45
PGK1	3	19	2	2	413.82	827.64	15	1	0.154849498327759	-5.33333333333333	1	-0.363636363636364	4	22
PGM1	1	21	2	7	528.66	1057.32	15	1	0.194883203559511	-5	1	-0.176767676767677	9	22
PGM2	2	19	1	3	580.14	1160.28	15	1	0.421739130434783	-2.16666666666667	1	-0.154761904761905	4	21
PGM2L1	3	17	6	4	301.62	603.24	15	1	0.0301296903995554	-7.5	0.771992783106328	-0.45	10	20
PGM3	15	33	3	6	537.57	1075.14	15	1	1	-0.1	1	-0.0208333333333333	9	48
PGM5	2	8	0	0	268.62	537.24	15	1	1	NA	1	NA	0	10
PGPEP1	0	11	0	3	196.68	393.36	15	1	1	NA	1	0	3	11
PGPEP1L	2	5	0	2	201.63	403.26	15	1	1	1	1	0.285714285714286	2	7
PGR	2	20	0	3	540.54	1081.08	15	1	1	1	1	0.0909090909090909	3	22
PGRMC1	1	4	3	0	179.52	359.04	15	1	0.142857142857143	-Inf	1	-0.8	3	5
PGRMC2	0	2	0	0	104.28	208.56	15	1	1	NA	1	NA	0	2
PGS1	4	21	2	3	508.2	1016.4	15	1	0.254347185381668	-2.5	1	-0.24	5	25
PHACTR1	7	17	1	1	494.01	988.02	15	1	0.529230769230769	-1.42857142857143	1	-0.208333333333333	2	24
PHACTR2	8	16	5	4	624.36	1248.72	15	1	0.425139043381535	-1.5	1	-0.222222222222222	9	24
PHACTR3	8	8	3	2	600.93	1201.86	15	1	1	-0.5	1	-0.1	5	16
PHACTR4	7	33	1	8	440.22	880.44	15	1	1	0.410714285714286	1	0.0638888888888889	9	40
PHAX	2	11	2	5	366.63	733.26	15	1	0.586790505675955	-1.2	1	-0.131868131868132	7	13
PHB	0	3	0	1	270.27	540.54	15	1	1	NA	1	0	1	3
PHB2	0	4	0	1	189.75	379.5	15	1	1	NA	1	0	1	4
PHC1	20	25	4	6	1012.44	2024.88	15	1	1	0.166666666666667	1	0.0444444444444444	10	45
PHC3	9	33	7	8	975.15	1950.3	15	1	0.0937343828643915	-2.20833333333333	0.958791526417971	-0.252380952380952	15	42
PHEX	8	18	3	2	739.53	1479.06	15	1	0.31731906704098	-2.375	1	-0.292307692307692	5	26
PHF10	6	13	1	1	516.12	1032.24	15	1	1	-1.16666666666667	1	-0.184210526315789	2	19
PHF12	2	16	3	8	943.47	1886.94	15	1	0.338638373121132	-2	1	-0.161616161616162	11	18
PHF13	1	15	2	2	256.74	513.48	15	1	0.087719298245614	-14	0.951277979139867	-0.4375	4	16
PHF14	0	11	0	2	535.59	1071.18	15	1	1	NA	1	0	2	11
PHF19	7	35	5	8	543.84	1087.68	15	1	0.128537562889219	-2.125	1	-0.217948717948718	13	42
PHF2	0	21	1	7	969.54	1939.08	15	1	0.275862068965517	-Inf	1	-0.125	8	21
PHF20	16	25	8	6	1050.72	2101.44	15	1	0.350235612062457	-1.08333333333333	1	-0.181184668989547	14	41
PHF20L1	1	15	1	1	1003.86	2007.72	15	1	0.215686274509804	-14	1	-0.4375	2	16
PHF21A	4	5	2	2	651.42	1302.84	15	1	1	-0.25	1	-0.0555555555555556	4	9
PHF24	1	9	1	1	175.23	350.46	15	1	0.318181818181818	-8	1	-0.4	2	10
PHF3	44	57	13	8	2049.63	4099.26	15	1	0.152484974563949	-1.10511363636364	1	-0.183404054691183	21	101
PHF6	0	2	0	0	248.49	496.98	15	1	1	NA	1	NA	0	2
PHGDH	5	4	3	5	240.24	480.48	15	1	0.637186343068696	0.52	1	0.180555555555556	8	9
PHIP	4	41	2	6	1618.65	3237.3	15	1	0.219464331451013	-2.41666666666667	1	-0.161111111111111	8	45
PHKA1	2	36	7	21	1080.75	2161.5	15	1	0.0302696998797927	-5	0.77242130560063	-0.197368421052632	28	38
PHKA2	3	64	3	14	1174.14	2348.28	15	1	0.0941360132208119	-3.57142857142857	0.960983694935281	-0.131694468832309	17	67
PHKB	10	41	4	9	1158.3	2316.6	15	1	0.456620521944125	-0.822222222222222	1	-0.111613876319759	13	51
PHKG1	0	18	1	5	385.11	770.22	15	1	0.25	-Inf	1	-0.166666666666667	6	18
PHLDA2	0	6	0	0	130.68	261.36	15	1	1	NA	1	NA	0	6
PHLDA3	1	5	2	7	113.19	226.38	15	1	1	-0.428571428571429	1	-0.0555555555555556	9	6
PHLDB1	36	73	6	6	1353.66	2707.32	15	1	0.337917429946877	-1.02777777777778	1	-0.169724770642202	12	109
PHLDB2	8	46	0	4	1320.66	2641.32	15	1	1	1	1	0.148148148148148	4	54
PHLPP1-PHLPP2	1	5	1	1	135.63	271.26	15	1	0.464285714285714	-4	1	-0.333333333333333	2	6
PHLPP2	20	59	5	8	2067.78	4135.56	15	1	0.329630241975136	-0.84375	1	-0.131450827653359	13	79
PHOSPHO1	0	7	0	2	265.32	530.64	15	1	1	NA	1	0	2	7
PHOX2B	8	5	2	0	179.52	359.04	15	1	0.523809523809524	-Inf	1	-0.384615384615385	2	13
PHPT1	1	1	0	0	43.56	87.12	15	1	1	NA	1	NA	0	2
PHTF1	10	18	1	4	721.38	1442.76	15	1	0.6431219873934	0.55	1	0.157142857142857	5	28
PHTF2	7	24	0	4	692.01	1384.02	15	1	0.562032085561497	1	1	0.225806451612903	4	31
PHYH	6	13	0	3	338.58	677.16	15	1	0.532467532467532	1	1	0.315789473684211	3	19
PHYHD1	9	10	6	1	286.44	572.88	15	1	0.178260869565217	-5.66666666666667	1	-0.383458646616541	7	19
PHYHIPL	0	10	0	0	353.1	706.2	15	1	1	NA	1	NA	0	10
PHYKPL	16	26	3	2	439.23	878.46	15	1	0.381187257120394	-1.4375	1	-0.219047619047619	5	42
PI15	3	11	0	0	277.2	554.4	15	1	1	NA	1	NA	0	14
PI16	35	20	6	1	695.97	1391.94	15	1	0.406130611611618	-2.42857142857143	1	-0.220779220779221	7	55
PI3	2	0	1	0	21.78	43.56	15	1	1	NA	1	0	1	2
PI4K2A	0	12	0	3	343.53	687.06	15	1	1	NA	1	0	3	12
PI4K2B	1	18	1	4	412.5	825	15	1	0.380434782608696	-3.5	1	-0.147368421052632	5	19
PI4KA	4	42	2	9	1320.66	2641.32	15	1	0.326362895628039	-1.33333333333333	1	-0.0948616600790514	11	46
PI4KB	9	51	2	5	1079.76	2159.52	15	1	0.322633921876603	-1.26666666666667	1	-0.135714285714286	7	60
PIANP	6	6	1	6	300.3	600.6	15	1	0.173275383027705	0.833333333333333	1	0.357142857142857	7	12
PIAS1	1	15	0	7	497.97	995.94	15	1	1	1	1	0.0625	7	16
PIAS2	4	21	0	3	499.95	999.9	15	1	1	1	1	0.16	3	25
PIBF1	4	17	2	4	587.07	1174.14	15	1	0.587534204925509	-1.125	1	-0.142857142857143	6	21
PICALM	2	19	0	4	657.03	1314.06	15	1	1	1	1	0.0952380952380952	4	21
PICK1	3	17	2	3	400.29	800.58	15	1	0.252230378317335	-2.77777777777778	1	-0.25	5	20
PIEZO1	12	32	11	26	1348.38	2696.76	15	1	0.810442232160401	-0.128205128205128	1	-0.0245700245700246	37	44
PIEZO2	22	69	0	7	2571.69	5143.38	15	1	0.343860515060032	1	1	0.241758241758242	7	91
PIF1	9	19	2	6	467.61	935.22	15	1	1	0.296296296296296	1	0.0714285714285715	8	28
PIGA	3	18	4	5	453.09	906.18	15	1	0.153315649867374	-3.8	1	-0.301587301587302	9	21
PIGB	21	22	8	10	435.93	871.86	15	1	0.785933620990818	0.161904761904762	1	0.0439276485788114	18	43
PIGC	2	19	2	10	295.02	590.04	15	1	0.609970674486804	-0.9	1	-0.0714285714285714	12	21
PIGF	5	4	0	0	141.24	282.48	15	1	1	NA	1	NA	0	9
PIGG	16	21	4	8	872.52	1745.04	15	1	0.737726494998139	0.34375	1	0.0990990990990991	12	37
PIGH	1	3	0	0	144.87	289.74	15	1	1	NA	1	NA	0	4
PIGK	9	20	1	1	376.53	753.06	15	1	1	-1.22222222222222	1	-0.189655172413793	2	29
PIGL	15	8	5	1	276.21	552.42	15	1	0.632815460401667	-1.66666666666667	1	-0.181159420289855	6	23
PIGM	11	24	2	4	353.43	706.86	15	1	1	-0.0909090909090908	1	-0.019047619047619	6	35
PIGP	1	4	0	0	133.65	267.3	15	1	1	NA	1	NA	0	5
PIGQ	4	21	5	2	571.23	1142.46	15	1	0.0100556886569122	-12.125	0.5818356433428	-0.554285714285714	7	25
PIGR	71	71	12	7	1138.5	2277	15	1	0.333738151417222	-0.714285714285714	1	-0.131578947368421	19	142
PIGS	5	26	7	13	442.86	885.72	15	1	0.177903913943446	-1.8	1	-0.188709677419355	20	31
PIGT	4	39	3	9	485.76	971.52	15	1	0.167619752303437	-2.25	1	-0.156976744186047	12	43
PIGU	3	17	0	1	416.46	832.92	15	1	1	1	1	0.15	1	20
PIGV	28	36	12	9	491.04	982.08	15	1	0.322107735976968	-0.714285714285714	1	-0.133928571428571	21	64
PIGW	16	22	4	2	448.14	896.28	15	1	0.387127336645204	-1.75	1	-0.245614035087719	6	38
PIGZ	16	29	1	0	544.17	1088.34	15	1	0.369565217391304	-Inf	1	-0.644444444444444	1	45
PIH1D2	9	4	4	4	217.47	434.94	15	1	0.645820433436533	0.555555555555556	1	0.192307692307692	8	13
PIH1D3	2	5	2	0	190.08	380.16	15	1	0.166666666666667	-Inf	1	-0.714285714285714	2	7
PIK3AP1	12	23	4	4	788.7	1577.4	15	1	0.44327406488197	-0.916666666666667	1	-0.157142857142857	8	35
PIK3C2A	13	68	6	9	1646.37	3292.74	15	1	0.0701049594724941	-2.48717948717949	0.900177511524473	-0.239506172839506	15	81
PIK3C2B	1	26	6	11	911.13	1822.26	15	1	0.00922742063739765	-13.1818181818182	0.565270798227953	-0.315904139433551	17	27
PIK3C2G	62	30	4	6	1005.51	2011.02	15	1	0.159649313983422	0.67741935483871	1	0.273913043478261	10	92
PIK3C3	1	27	2	4	863.28	1726.56	15	1	0.0735294117647059	-12.5	0.913861472365723	-0.297619047619048	6	28
PIK3CA	0	31	0	2	1058.31	2116.62	15	1	1	NA	1	0	2	31
PIK3CB	3	37	1	6	1056.33	2112.66	15	1	0.487623692989095	-1.05555555555556	1	-0.0678571428571429	7	40
PIK3CD	6	40	4	11	1036.53	2073.06	15	1	0.242852489672445	-1.42424242424242	1	-0.136231884057971	15	46
PIK3CG	11	42	1	9	1175.13	2350.26	15	1	0.67116944827173	0.575757575757576	1	0.107547169811321	10	53
PIK3R1	6	12	1	0	750.42	1500.84	15	1	0.368421052631579	-Inf	1	-0.666666666666667	1	18
PIK3R2	4	14	5	5	688.38	1376.76	15	1	0.209625157451244	-2.5	1	-0.277777777777778	10	18
PIK3R3	1	10	2	2	459.36	918.72	15	1	0.153846153846154	-9	1	-0.409090909090909	4	11
PIK3R4	7	46	4	6	1349.7	2699.4	15	1	0.0629990036106577	-3.38095238095238	0.878646123461792	-0.267924528301887	10	53
PIK3R5	10	30	10	14	870.87	1741.74	15	1	0.177883366406577	-1.14285714285714	1	-0.166666666666667	24	40
PIK3R6	23	32	6	16	730.95	1461.9	15	1	0.301696136442918	0.478260869565217	1	0.145454545454545	22	55
PIKFYVE	12	78	6	8	2097.81	4195.62	15	1	0.0148194032460768	-3.875	0.641111817849989	-0.295238095238095	14	90
PIM3	0	17	0	1	277.2	554.4	15	1	1	NA	1	0	1	17
PIN4	0	2	1	1	92.07	184.14	15	1	1	-Inf	1	-0.5	2	2
PINX1	14	19	2	4	400.95	801.9	15	1	1	0.321428571428571	1	0.0909090909090909	6	33
PIP4K2A	9	6	4	4	487.41	974.82	15	1	0.685018172028537	0.333333333333333	1	0.1	8	15
PIP5K1A	4	63	0	2	785.73	1571.46	15	1	1	1	1	0.0597014925373134	2	67
PIP5K1B	4	13	0	1	535.59	1071.18	15	1	1	1	1	0.235294117647059	1	17
PIP5K1C	1	13	1	5	591.36	1182.72	15	1	0.521052631578947	-1.6	1	-0.0952380952380952	6	14
PIPOX	4	9	10	11	233.64	467.28	15	1	0.477378246360691	-1.04545454545455	1	-0.168498168498168	21	13
PIRT	2	10	0	2	140.58	281.16	15	1	1	1	1	0.166666666666667	2	12
PISD	13	3	3	1	116.82	233.64	15	1	1	0.307692307692308	1	0.0625	4	16
PIT54	9	22	3	7	493.02	986.04	15	1	1	-0.0476190476190477	1	-0.00967741935483868	10	31
PITHD1	4	4	0	0	74.58	149.16	15	1	1	NA	1	NA	0	8
PITPNA	3	8	1	1	308.22	616.44	15	1	1	-1.66666666666667	1	-0.227272727272727	2	11
PITPNB	0	9	0	1	263.67	527.34	15	1	1	NA	1	0	1	9
PITPNC1	5	5	0	1	349.47	698.94	15	1	1	1	1	0.5	1	10
PITPNM2	3	41	4	6	1285.68	2571.36	15	1	0.0171032321975718	-8.11111111111111	0.67478445727067	-0.331818181818182	10	44
PITPNM3	9	20	0	1	885.06	1770.12	15	1	1	1	1	0.310344827586207	1	29
PITRM1	14	43	2	4	1019.37	2038.74	15	1	0.638783783849417	-0.535714285714286	1	-0.087719298245614	6	57
PITX1	0	3	0	2	214.17	428.34	15	1	1	NA	1	0	2	3
PITX2	0	8	0	5	297.66	595.32	15	1	1	NA	1	0	5	8
PITX3	0	12	0	7	287.76	575.52	15	1	1	NA	1	0	7	12
PIWIL1	5	40	2	4	859.32	1718.64	15	1	0.185921843297911	-3	1	-0.222222222222222	6	45
PJA2	69	32	1	2	689.37	1378.74	15	1	0.248506348020911	0.768115942028985	1	0.34983498349835	3	101
PKD1	58	154	31	55	4224.66	8449.32	15	1	0.162492834225304	-0.496551724137931	1	-0.0868802106186924	86	212
PKD1L2	55	81	14	12	2480.94	4961.88	15	1	0.279054338307474	-0.718181818181818	1	-0.134049773755656	26	136
PKD2	5	35	2	9	762.96	1525.92	15	1	0.635308628539297	-0.555555555555556	1	-0.0568181818181818	11	40
PKD2L1	12	41	4	4	843.81	1687.62	15	1	0.189200065152197	-2.41666666666667	1	-0.273584905660377	8	53
PKD2L2	33	20	3	3	617.43	1234.86	15	1	0.669245439724384	0.393939393939394	1	0.122641509433962	6	53
PKDCCA	1	6	0	0	332.64	665.28	15	1	1	NA	1	NA	0	7
PKDCCB	0	17	1	1	277.2	554.4	15	1	0.105263157894737	-Inf	0.983379501385042	-0.5	2	17
PKHD1	151	140	24	13	3728.34	7456.68	15	1	0.162580348240153	-0.711665817626083	1	-0.129748305006037	37	291
PKIB	2	3	0	0	132	264	15	1	1	NA	1	NA	0	5
PKIG	1	2	1	4	76.23	152.46	15	1	1	0.5	1	0.133333333333333	5	3
PKM	1	34	0	8	544.5	1089	15	1	1	1	1	0.0285714285714286	8	35
PKN2	4	32	3	3	960.3	1920.6	15	1	0.0477796844934201	-7	0.828593091717788	-0.388888888888889	6	36
PKN3	8	32	2	4	997.26	1994.52	15	1	0.597523983328812	-1	1	-0.133333333333333	6	40
PKNOX1	0	5	0	0	316.8	633.6	15	1	1	NA	1	NA	0	5
PKNOX2	1	23	0	0	383.13	766.26	15	1	1	NA	1	NA	0	24
PKP1	6	28	1	8	708.18	1416.36	15	1	1	0.416666666666667	1	0.065359477124183	9	34
PKP2	25	38	0	2	791.67	1583.34	15	1	0.519230769230769	1	1	0.396825396825397	2	63
PKP3	3	29	1	6	683.43	1366.86	15	1	0.562801668064826	-0.611111111111111	1	-0.0491071428571428	7	32
PKP4	14	32	3	6	1182.06	2364.12	15	1	1	-0.142857142857143	1	-0.0289855072463768	9	46
PLA1A	18	16	3	1	452.43	904.86	15	1	0.613086770981508	-1.66666666666667	1	-0.220588235294118	4	34
PLA2G10	4	7	1	0	138.27	276.54	15	1	0.416666666666667	-Inf	1	-0.636363636363636	1	11
PLA2G10L	6	8	7	5	153.45	306.9	15	1	0.695097590523624	-0.866666666666667	1	-0.154761904761905	12	14
PLA2G12B	2	8	0	1	197.01	394.02	15	1	1	1	1	0.2	1	10
PLA2G15	1	12	0	1	366.96	733.92	15	1	1	1	1	0.0769230769230769	1	13
PLA2G2A	5	7	1	6	106.92	213.84	15	1	0.333075335397317	0.766666666666667	1	0.273809523809524	7	12
PLA2G2E	15	7	0	1	138.93	277.86	15	1	0.347826086956522	1	1	0.681818181818182	1	22
PLA2G2E-PLA2G5	12	2	5	0	137.61	275.22	15	1	1	-Inf	1	-0.142857142857143	5	14
PLA2G4A	2	20	2	1	742.5	1485	15	1	0.0565217391304347	-19	0.846060006968071	-0.575757575757576	3	22
PLA2G6	12	23	6	9	701.58	1403.16	15	1	0.754427932514379	-0.277777777777778	1	-0.0571428571428572	15	35
PLA2G7	3	14	4	2	321.75	643.5	15	1	0.0450038138825325	-8.33333333333333	0.822543273817637	-0.490196078431372	6	17
PLA2R1	29	56	3	3	1431.54	2863.08	15	1	0.661334049627752	-0.931034482758621	1	-0.158823529411765	6	85
PLAA	10	30	5	1	790.02	1580.04	15	1	0.0104729257606024	-14	0.585928868752023	-0.583333333333333	6	40
PLAC8L1	9	8	1	2	144.54	289.08	15	1	1	0.555555555555556	1	0.196078431372549	3	17
PLAC9	4	1	1	0	96.03	192.06	15	1	1	-Inf	1	-0.2	1	5
PLAG1	0	2	0	1	496.98	993.96	15	1	1	NA	1	0	1	2
PLAGL1	4	17	1	2	772.2	1544.4	15	1	0.521245059288538	-1.125	1	-0.142857142857143	3	21
PLAGL2	4	19	1	5	488.73	977.46	15	1	1	0.05	1	0.00724637681159421	6	23
PLAT	12	18	4	3	539.55	1079.1	15	1	0.437278834812042	-1	1	-0.171428571428571	7	30
PLAU	28	29	3	2	425.7	851.4	15	1	1	-0.553571428571429	1	-0.108771929824561	5	57
PLBD1	3	18	4	8	513.48	1026.96	15	1	0.377410085279941	-2	1	-0.19047619047619	12	21
PLBD2	8	12	0	5	264	528	15	1	0.139920948616601	1	1	0.4	5	20
PLCB1	3	30	3	8	1137.51	2275.02	15	1	0.15443830134698	-2.75	1	-0.181818181818182	11	33
PLCB2	24	33	10	8	1229.25	2458.5	15	1	0.417168613070652	-0.71875	1	-0.134502923976608	18	57
PLCB4	6	33	1	7	1270.17	2540.34	15	1	1	0.214285714285714	1	0.0288461538461539	8	39
PLCD1	4	13	0	4	762.96	1525.92	15	1	0.545530492898914	1	1	0.235294117647059	4	17
PLCD3	11	28	1	5	609.51	1219.02	15	1	1	0.490909090909091	1	0.115384615384615	6	39
PLCD4	6	21	9	13	692.01	1384.02	15	1	0.216514251037428	-1.42307692307692	1	-0.186868686868687	22	27
PLCE1	27	55	10	8	2136.75	4273.5	15	1	0.10468399031454	-1.5462962962963	0.983379501385042	-0.226287262872629	18	82
PLCG1	6	38	2	18	1201.53	2403.06	15	1	1	0.296296296296296	1	0.0363636363636363	20	44
PLCG2	8	34	3	5	1245.75	2491.5	15	1	0.350626865121197	-1.55	1	-0.18452380952381	8	42
PLCH1	56	89	12	18	1680.03	3360.06	15	1	1	-0.0595238095238095	1	-0.0137931034482759	30	145
PLCH2	31	50	9	13	1638.45	3276.9	15	1	0.810812076866931	-0.116625310173697	1	-0.0263748597081931	22	81
PLCL1	10	43	3	6	1047.42	2094.84	15	1	0.380725906940403	-1.15	1	-0.144654088050314	9	53
PLCL2	10	26	1	1	1025.64	2051.28	15	1	0.500711237553343	-1.6	1	-0.222222222222222	2	36
PLCXD1	7	15	2	2	333.63	667.26	15	1	0.590635451505017	-1.14285714285714	1	-0.181818181818182	4	22
PLCXD2	4	21	1	4	336.27	672.54	15	1	1	-0.3125	1	-0.04	5	25
PLCZ1	16	11	1	2	678.48	1356.96	15	1	0.564532019704434	0.65625	1	0.259259259259259	3	27
PLD1	9	41	3	11	1027.62	2055.24	15	1	0.715372654351685	-0.242424242424242	1	-0.0342857142857143	14	50
PLD4	18	10	3	1	507.87	1015.74	15	1	1	-0.666666666666667	1	-0.107142857142857	4	28
PLD6	2	12	1	6	210.54	421.08	15	1	1	0	1	0	7	14
PLEK	4	9	0	5	347.82	695.64	15	1	0.277777777777778	1	1	0.307692307692308	5	13
PLEK2	2	11	0	2	352.44	704.88	15	1	1	1	1	0.153846153846154	2	13
PLEKHA1	2	8	2	1	407.88	815.76	15	1	0.202797202797203	-7	1	-0.466666666666667	3	10
PLEKHA2	4	14	3	6	413.82	827.64	15	1	0.652660383095166	-0.75	1	-0.111111111111111	9	18
PLEKHA3	6	12	1	0	285.78	571.56	15	1	0.368421052631579	-Inf	1	-0.666666666666667	1	18
PLEKHA5	19	35	4	1	1145.43	2290.86	15	1	0.0703958903688209	-6.36842105263158	0.902952600161178	-0.448148148148148	5	54
PLEKHA6	5	35	6	20	1094.61	2189.22	15	1	0.319268456636016	-1.1	1	-0.105769230769231	26	40
PLEKHA7	15	46	10	5	1009.47	2018.94	15	1	0.0042582360879705	-5.13333333333333	0.454065685553736	-0.420765027322404	15	61
PLEKHA8	3	8	2	1	409.53	819.06	15	1	0.505494505494505	-4.33333333333333	1	-0.393939393939394	3	11
PLEKHB2	4	12	2	2	220.77	441.54	15	1	0.54922600619195	-2	1	-0.25	4	16
PLEKHD1	9	23	2	5	519.75	1039.5	15	1	1	-0.0222222222222221	1	-0.0044642857142857	7	32
PLEKHF1	1	12	0	2	271.26	542.52	15	1	1	1	1	0.0769230769230769	2	13
PLEKHF2	2	11	0	5	247.5	495	15	1	1	1	1	0.153846153846154	5	13
PLEKHG1	35	69	11	3	1581.03	3162.06	15	1	0.00230281514226	-6.22857142857143	0.334879262253954	-0.449175824175824	14	104
PLEKHG3	1	4	3	3	216.81	433.62	15	1	0.545454545454546	-3	1	-0.3	6	5
PLEKHG4	51	93	17	32	1899.81	3799.62	15	1	1	0.03125	1	0.00722789115646261	49	144
PLEKHG5	13	54	2	4	777.81	1555.62	15	1	0.596242980075034	-1.07692307692308	1	-0.139303482587065	6	67
PLEKHH1	36	42	6	9	1434.51	2869.02	15	1	0.780084833371428	0.222222222222222	1	0.0615384615384615	15	78
PLEKHH3	10	13	7	9	499.62	999.24	15	1	1	-0.0111111111111111	1	-0.00271739130434784	16	23
PLEKHJ1	0	6	0	1	117.48	234.96	15	1	1	NA	1	0	1	6
PLEKHM1	36	88	8	8	1015.74	2031.48	15	1	0.149472565948844	-1.44444444444444	1	-0.209677419354839	16	124
PLEKHM2	8	26	12	15	1023.66	2047.32	15	1	0.104569819147532	-1.6	0.983379501385042	-0.209150326797386	27	34
PLEKHM3	19	26	0	2	796.62	1593.24	15	1	0.50786308973173	1	1	0.422222222222222	2	45
PLEKHN1	8	9	6	8	529.32	1058.64	15	1	1	0.15625	1	0.0420168067226891	14	17
PLEKHO1	2	10	1	3	332.64	665.28	15	1	1	-0.666666666666667	1	-0.0833333333333333	4	12
PLEKHO2	26	22	5	5	561	1122	15	1	1	0.153846153846154	1	0.0416666666666666	10	48
PLEKHS1	26	14	0	3	457.38	914.76	15	1	0.0551008832347459	1	0.846060006968071	0.65	3	40
PLG	10	32	1	3	794.97	1589.94	15	1	1	-0.0666666666666667	1	-0.0119047619047619	4	42
PLGL	23	29	3	5	834.57	1669.14	15	1	1	0.243478260869565	1	0.0673076923076923	8	52
PLIN1	9	13	3	3	378.51	757.02	15	1	1	-0.444444444444444	1	-0.0909090909090909	6	22
PLIN3	18	27	7	8	631.95	1263.9	15	1	0.764925363780618	-0.3125	1	-0.0666666666666667	15	45
PLIN3L	22	29	7	4	438.57	877.14	15	1	0.319784569971853	-1.30681818181818	1	-0.204991087344028	11	51
PLIN4	2	12	1	2	260.04	520.08	15	1	0.464705882352941	-2	1	-0.19047619047619	3	14
PLK1	0	22	0	3	499.29	998.58	15	1	1	NA	1	0	3	22
PLK2	6	17	1	0	600.93	1201.86	15	1	0.291666666666667	-Inf	1	-0.739130434782609	1	23
PLK3	4	19	3	12	553.41	1106.82	15	1	1	-0.1875	1	-0.0260869565217391	15	23
PLK4	12	32	2	9	951.39	1902.78	15	1	0.709331176777462	0.407407407407407	1	0.0909090909090909	11	44
PLLP	4	6	0	1	134.64	269.28	15	1	1	1	1	0.4	1	10
PLOD1	5	27	4	3	714.45	1428.9	15	1	0.0369890338930587	-6.2	0.788413232354762	-0.415178571428571	7	32
PLP1	0	8	0	3	239.58	479.16	15	1	1	NA	1	0	3	8
PLPP1	4	12	0	1	325.38	650.76	15	1	1	1	1	0.25	1	16
PLPP2	3	8	0	0	196.02	392.04	15	1	1	NA	1	NA	0	11
PLPP3	0	5	0	4	293.37	586.74	15	1	1	NA	1	0	4	5
PLPP4	2	6	2	1	281.16	562.32	15	1	0.490909090909091	-5	1	-0.416666666666667	3	8
PLPP5	5	14	3	1	233.64	467.28	15	1	0.102766798418972	-7.4	0.982102341185271	-0.486842105263158	4	19
PLPP7	6	8	0	10	269.28	538.56	15	1	0.0238714374869982	1	0.748072489277835	0.428571428571429	10	14
PLPPR1	8	12	1	0	284.13	568.26	15	1	0.428571428571429	-Inf	1	-0.6	1	20
PLPPR3	2	7	2	8	389.07	778.14	15	1	1	0.125	1	0.0222222222222222	10	9
PLPPR4	1	31	0	7	687.06	1374.12	15	1	1	1	1	0.03125	7	32
PLPPR5	6	12	5	1	318.78	637.56	15	1	0.0608041843739784	-9	0.871782064889388	-0.5	6	18
PLRG1	1	17	0	2	511.83	1023.66	15	1	1	1	1	0.0555555555555556	2	18
PLS1	6	18	0	7	624.36	1248.72	15	1	0.292832491942614	1	1	0.25	7	24
PLS3	2	18	1	3	608.85	1217.7	15	1	0.436758893280632	-2	1	-0.15	4	20
PLTP	4	14	7	4	436.92	873.84	15	1	0.0481603038850731	-5.125	0.829468895324472	-0.414141414141414	11	18
PLVAP	12	7	2	1	326.37	652.74	15	1	1	-0.166666666666667	1	-0.0350877192982456	3	19
PLXDC1	7	10	8	10	357.39	714.78	15	1	1	-0.142857142857143	1	-0.0326797385620915	18	17
PLXDC2	20	9	2	2	370.59	741.18	15	1	0.586021505376344	0.55	1	0.189655172413793	4	29
PLXNA1	6	71	4	33	1899.48	3798.96	15	1	0.725451962167858	-0.434343434343434	1	-0.0301860301860302	37	77
PLXNA2	21	101	13	31	2028.84	4057.68	15	1	0.125522135007791	-1.01689708141321	1	-0.123323397913562	44	122
PLXNA4	6	20	3	2	491.04	982.08	15	1	0.131256952169077	-4	1	-0.369230769230769	5	26
PLXNB1	20	85	5	19	2179.98	4359.96	15	1	0.782069191343759	-0.118421052631579	1	-0.0178571428571429	24	105
PLXNB2	25	58	2	8	1858.23	3716.46	15	1	0.718054163801978	0.42	1	0.101204819277108	10	83
PLXNC1	33	46	5	10	1414.38	2828.76	15	1	0.582110722449141	0.303030303030303	1	0.0843881856540085	15	79
PLXND1	10	41	2	12	890.67	1781.34	15	1	1	0.316666666666667	1	0.0532212885154062	14	51
PM20D1	8	21	3	6	504.24	1008.48	15	1	1	-0.3125	1	-0.0574712643678161	9	29
PM20D2	6	13	4	0	431.31	862.62	15	1	0.0237154150197629	-Inf	0.748072489277835	-0.684210526315789	4	19
PMCH	14	3	2	0	252.78	505.56	15	1	1	-Inf	1	-0.176470588235294	2	17
PMEPA1	8	5	0	0	196.02	392.04	15	1	1	NA	1	NA	0	13
PMFBP1	29	15	0	3	477.84	955.68	15	1	0.0503237742830712	1	0.838961264636285	0.659090909090909	3	44
PML	5	3	1	3	146.52	293.04	15	1	0.545454545454546	0.8	1	0.375	4	8
PMLL	51	25	15	9	758.67	1517.34	15	1	0.80531517153831	0.183006535947712	1	0.0460526315789473	24	76
PMM1	1	5	0	4	211.86	423.72	15	1	1	1	1	0.166666666666667	4	6
PMM2	0	12	0	5	223.74	447.48	15	1	1	NA	1	0	5	12
PMP22	1	4	0	0	156.42	312.84	15	1	1	NA	1	NA	0	5
PMPCA	6	28	0	11	437.58	875.16	15	1	0.311055289954893	1	1	0.176470588235294	11	34
PMPCB	4	19	3	9	469.92	939.84	15	1	0.669740888568998	-0.583333333333333	1	-0.0760869565217391	12	23
PMS1	28	34	8	3	922.68	1845.36	15	1	0.112293786254031	-2.23809523809524	0.990055515037369	-0.275659824046921	11	62
PMS2	26	22	1	0	838.53	1677.06	15	1	1	-Inf	1	-0.458333333333333	1	48
PNAT10	3	16	1	2	288.09	576.18	15	1	0.47012987012987	-1.66666666666667	1	-0.175438596491228	3	19
PNAT3	6	20	1	3	288.09	576.18	15	1	1	-0.111111111111111	1	-0.0192307692307692	4	26
PNISR	5	10	3	3	809.16	1618.32	15	1	0.631062951496388	-1	1	-0.166666666666667	6	15
PNLDC1	15	15	7	1	529.65	1059.3	15	1	0.105572665444832	-6	0.983805342817882	-0.375	8	30
PNLIP	25	15	2	5	463.32	926.64	15	1	0.118521169291894	0.76	1	0.339285714285714	7	40
PNLIPRP3	10	18	1	1	463.98	927.96	15	1	1	-0.8	1	-0.142857142857143	2	28
PNN	6	23	1	2	624.03	1248.06	15	1	0.536290322580645	-0.916666666666667	1	-0.126436781609195	3	29
PNO1	7	9	0	1	196.02	392.04	15	1	1	1	1	0.4375	1	16
PNOC	2	2	4	4	97.35	194.7	15	1	1	0	1	0	8	4
PNP	1	0	0	2	143.22	286.44	15	1	0.333333333333333	1	1	1	2	1
PNPLA1	29	29	4	4	904.53	1809.06	15	1	1	0	1	0	8	58
PNPLA2	4	23	0	6	415.47	830.94	15	1	1	1	1	0.148148148148148	6	27
PNPLA3	10	16	0	0	440.22	880.44	15	1	1	NA	1	NA	0	26
PNPLA7	34	63	11	10	1540.11	3080.22	15	1	0.147020639347349	-1.03823529411765	1	-0.173294059891998	21	97
PNPLA8	18	30	3	1	796.95	1593.9	15	1	0.290627020038785	-4	1	-0.375	4	48
PNPO	2	2	3	3	87.45	174.9	15	1	1	0	1	0	6	4
PNPT1	10	25	1	2	723.03	1446.06	15	1	1	-0.25	1	-0.0476190476190476	3	35
PNRC2	8	3	0	0	140.58	281.16	15	1	1	NA	1	NA	0	11
POC1A	6	17	2	2	323.73	647.46	15	1	0.558290598290598	-1.83333333333333	1	-0.239130434782609	4	23
POC5	13	15	5	3	486.09	972.18	15	1	0.690565274547477	-0.923076923076923	1	-0.160714285714286	8	28
PODN	1	17	1	3	530.64	1061.28	15	1	0.337662337662338	-4.66666666666667	1	-0.194444444444444	4	18
PODXL	20	12	9	6	380.16	760.32	15	1	1	0.1	1	0.025	15	32
PODXL2	17	21	6	12	618.42	1236.84	15	1	0.562795015718596	0.382352941176471	1	0.114035087719298	18	38
POF1B	7	17	2	1	457.38	914.76	15	1	0.25025641025641	-3.85714285714286	1	-0.375	3	24
POFUT1	5	27	6	4	259.38	518.76	15	1	0.0109407033064814	-7.1	0.585928868752023	-0.44375	10	32
POFUT2	6	18	3	3	434.61	869.22	15	1	0.328700265251989	-2	1	-0.25	6	24
POGLUT1	3	13	3	7	361.02	722.04	15	1	0.644268774703557	-0.857142857142857	1	-0.1125	10	16
POGZ	5	37	2	2	1311.75	2623.5	15	1	0.103937249134418	-6.4	0.983379501385042	-0.380952380952381	4	42
POLA1	34	47	13	13	1512.39	3024.78	15	1	0.50296792783381	-0.382352941176471	1	-0.0802469135802469	26	81
POLD3	8	32	9	4	460.35	920.7	15	1	0.00187648502057724	-8	0.318681117594161	-0.492307692307692	13	40
POLDIP2	0	28	1	3	274.89	549.78	15	1	0.125	-Inf	1	-0.25	4	28
POLDIP3	1	15	1	2	413.82	827.64	15	1	0.298245614035088	-6.5	1	-0.270833333333333	3	16
POLE	26	83	10	22	2219.91	4439.82	15	1	0.489327858450782	-0.451048951048951	1	-0.0739678899082569	32	109
POLE2	6	26	3	3	502.92	1005.84	15	1	0.131065487102639	-3.33333333333333	1	-0.3125	6	32
POLE3	0	7	0	1	132.66	265.32	15	1	1	NA	1	0	1	7
POLG	12	37	10	16	1038.84	2077.68	15	1	0.286749101972741	-0.927083333333333	1	-0.139717425431711	26	49
POLG2	2	11	2	2	303.27	606.54	15	1	0.21890756302521	-4.5	1	-0.346153846153846	4	13
POLH	19	25	7	6	643.5	1287	15	1	0.540771473498863	-0.535087719298246	1	-0.106643356643357	13	44
POLK	24	25	4	1	700.59	1401.18	15	1	0.352571217166112	-3.16666666666667	1	-0.310204081632653	5	49
POLL	7	25	3	11	539.88	1079.76	15	1	1	0.025974025974026	1	0.00446428571428573	14	32
POLN	28	19	1	5	774.18	1548.36	15	1	0.0802453927870132	0.864285714285714	0.937475435512484	0.429078014184397	6	47
POLQ	8	14	2	4	431.31	862.62	15	1	1	0.125	1	0.0303030303030303	6	22
POLR1A	30	68	5	10	1624.26	3248.52	15	1	1	-0.133333333333333	1	-0.0272108843537415	15	98
POLR1B	10	58	8	15	1062.93	2125.86	15	1	0.0653850232530891	-2.09333333333333	0.884435842948953	-0.20076726342711	23	68
POLR1C	1	16	0	4	309.21	618.42	15	1	1	1	1	0.0588235294117647	4	17
POLR1D	0	9	2	1	100.98	201.96	15	1	0.0454545454545455	-Inf	0.822543273817637	-0.666666666666667	3	9
POLR2B	0	45	0	1	1156.98	2313.96	15	1	1	NA	1	0	1	45
POLR2C	0	10	0	4	244.86	489.72	15	1	1	NA	1	0	4	10
POLR2D	0	4	0	3	135.96	271.92	15	1	1	NA	1	0	3	4
POLR2E	0	5	0	4	132.33	264.66	15	1	1	NA	1	0	4	5
POLR2F	0	3	0	3	115.5	231	15	1	1	NA	1	0	3	3
POLR2H	0	2	0	1	38.94	77.88	15	1	1	NA	1	0	1	2
POLR2J	0	4	0	0	95.7	191.4	15	1	1	NA	1	NA	0	4
POLR3A	1	54	3	7	1362.57	2725.14	15	1	0.0100584898971996	-22.1428571428571	0.5818356433428	-0.281818181818182	10	55
POLR3B	1	40	0	11	1132.89	2265.78	15	1	1	1	1	0.024390243902439	11	41
POLR3D	0	5	3	8	152.13	304.26	15	1	0.508928571428571	-Inf	1	-0.272727272727273	11	5
POLR3E	4	26	1	2	695.97	1391.94	15	1	0.399560117302053	-2.25	1	-0.2	3	30
POLR3F	1	8	0	3	293.37	586.74	15	1	1	1	1	0.111111111111111	3	9
POLR3G	3	11	0	3	214.83	429.66	15	1	1	1	1	0.214285714285714	3	14
POLR3H	2	8	1	2	204.93	409.86	15	1	1	-1	1	-0.133333333333333	3	10
POLRMT	32	40	8	16	1200.87	2401.74	15	1	0.473834814587835	0.375	1	0.111111111111111	24	72
POMC	1	1	0	2	161.7	323.4	15	1	1	1	1	0.5	2	2
POMGNT1	4	27	2	6	653.4	1306.8	15	1	0.583375707214717	-1.25	1	-0.120967741935484	8	31
POMGNT2	5	22	3	9	573.21	1146.42	15	1	0.682453351184001	-0.466666666666667	1	-0.0648148148148148	12	27
POMK	2	8	1	1	346.17	692.34	15	1	0.454545454545455	-3	1	-0.3	2	10
POMP	1	3	0	0	139.59	279.18	15	1	1	NA	1	NA	0	4
POMT1	13	36	5	5	776.16	1552.32	15	1	0.256337511390829	-1.76923076923077	1	-0.23469387755102	10	49
POMT2	12	38	4	6	682.11	1364.22	15	1	0.433278275489443	-1.11111111111111	1	-0.16	10	50
PON2	4	16	3	0	327.03	654.06	15	1	0.0197628458498024	-Inf	0.69334271185944	-0.8	3	20
POP1	21	32	7	4	969.87	1939.74	15	1	0.188391596036725	-1.66666666666667	1	-0.240137221269297	11	53
POP4	12	22	0	2	204.27	408.54	15	1	0.542857142857143	1	1	0.352941176470588	2	34
POPDC2	4	16	6	3	352.44	704.88	15	1	0.0316777675098515	-7	0.778718235934639	-0.466666666666667	9	20
POPDC3	2	6	2	1	302.94	605.88	15	1	0.490909090909091	-5	1	-0.416666666666667	3	8
POR	3	13	4	5	574.2	1148.4	15	1	0.204909506969004	-2.46666666666667	1	-0.256944444444444	9	16
POT1	32	36	5	6	803.88	1607.76	15	1	1	0.0625	1	0.0160427807486631	11	68
POU1F1	7	10	1	0	368.28	736.56	15	1	0.444444444444444	-Inf	1	-0.588235294117647	1	17
POU2AF1	4	21	0	5	512.49	1024.98	15	1	1	1	1	0.16	5	25
POU2F1	2	6	0	4	741.84	1483.68	15	1	0.515151515151515	1	1	0.25	4	8
POU2F3	1	13	1	5	501.93	1003.86	15	1	0.521052631578947	-1.6	1	-0.0952380952380952	6	14
POU3F1	0	1	2	2	237.27	474.54	15	1	1	-Inf	1	-0.5	4	1
POU3F2	6	2	0	0	217.14	434.28	15	1	1	NA	1	NA	0	8
POU3F3	3	1	1	1	265.65	531.3	15	1	1	0.666666666666667	1	0.25	2	4
POU4F3	0	4	0	4	511.17	1022.34	15	1	1	NA	1	0	4	4
Pou5f3	3	13	0	0	252.45	504.9	15	1	1	NA	1	NA	0	16
POU6F2	1	8	0	0	377.19	754.38	15	1	1	NA	1	NA	0	9
PP2D1	47	35	6	0	749.43	1498.86	15	1	0.0771059743823292	-Inf	0.922367800589409	-0.426829268292683	6	82
PPA2	4	12	0	2	271.92	543.84	15	1	1	1	1	0.25	2	16
PPARA	3	8	0	1	464.31	928.62	15	1	1	1	1	0.272727272727273	1	11
PPARD	0	6	0	4	439.56	879.12	15	1	1	NA	1	0	4	6
PPARG	1	8	1	1	471.24	942.48	15	1	0.345454545454545	-7	1	-0.388888888888889	2	9
PPARGC1A	1	18	0	1	744.48	1488.96	15	1	1	1	1	0.0526315789473684	1	19
PPARGC1B	57	60	2	3	916.41	1832.82	15	1	1	0.298245614035088	1	0.0871794871794871	5	117
PPAT	2	11	1	3	480.15	960.3	15	1	1	-0.833333333333333	1	-0.0961538461538461	4	13
PPCDC	5	16	3	1	208.89	417.78	15	1	0.0807905138339921	-8.6	0.940348603641547	-0.511904761904762	4	21
PPCS	0	6	0	0	138.27	276.54	15	1	1	NA	1	NA	0	6
PPDPF	4	7	1	1	88.11	176.22	15	1	1	-0.75	1	-0.136363636363636	2	11
PPEF1	35	26	2	6	662.31	1324.62	15	1	0.132350427498727	0.752380952380952	1	0.323770491803279	8	61
PPEF2	7	27	2	4	706.86	1413.72	15	1	0.601603020024073	-0.928571428571429	1	-0.127450980392157	6	34
PPFIA1	7	41	2	3	1177.77	2355.54	15	1	0.195811735434377	-2.9047619047619	1	-0.254166666666667	5	48
PPFIA2	11	44	4	2	1109.46	2218.92	15	1	0.0280217483279535	-7	0.761210061313465	-0.466666666666667	6	55
PPFIA4	5	46	10	38	1182.39	2364.78	15	1	0.164155770053855	-1.42105263157895	1	-0.110294117647059	48	51
PPFIBP1	17	27	2	1	1079.1	2158.2	15	1	0.557076780758557	-2.17647058823529	1	-0.28030303030303	3	44
PPFIBP2	7	28	5	3	944.46	1888.92	15	1	0.0276862848734957	-5.66666666666667	0.761210061313465	-0.425	8	35
PPIB	0	8	0	2	146.85	293.7	15	1	1	NA	1	0	2	8
PPIC	0	8	0	0	172.26	344.52	15	1	1	NA	1	NA	0	8
PPID	3	8	1	0	339.24	678.48	15	1	0.333333333333333	-Inf	1	-0.727272727272727	1	11
PPIE	0	23	1	1	296.01	592.02	15	1	0.0799999999999999	-Inf	0.936566440349175	-0.5	2	23
PPIF	2	4	1	0	183.81	367.62	15	1	0.428571428571428	-Inf	1	-0.666666666666667	1	6
PPIG	5	16	2	2	705.21	1410.42	15	1	0.548458498023715	-2.2	1	-0.261904761904762	4	21
PPIH	0	8	0	0	158.4	316.8	15	1	1	NA	1	NA	0	8
PPIL3	0	4	0	0	160.38	320.76	15	1	1	NA	1	NA	0	4
PPIL4	4	22	2	5	465.63	931.26	15	1	0.584260289210234	-1.2	1	-0.131868131868132	7	26
PPIL6	13	8	6	3	294.03	588.06	15	1	1	-0.230769230769231	1	-0.0476190476190476	9	21
PPIP5K1	22	37	1	4	1417.35	2834.7	15	1	0.64627506652229	0.579545454545455	1	0.172881355932203	5	59
PPIP5K2	4	38	0	3	1157.31	2314.62	15	1	1	1	1	0.0952380952380952	3	42
PPL	12	63	6	30	1706.43	3412.86	15	1	1	-0.05	1	-0.00666666666666665	36	75
PPM1A	0	11	0	3	379.17	758.34	15	1	1	NA	1	0	3	11
PPM1D	6	18	1	2	442.2	884.4	15	1	1	-0.5	1	-0.0833333333333333	3	24
PPM1E	13	22	4	2	632.61	1265.22	15	1	0.211806454425197	-2.38461538461538	1	-0.295238095238095	6	35
PPM1F	1	11	5	2	374.88	749.76	15	1	0.00954592363261094	-26.5	0.573230339530418	-0.630952380952381	7	12
PPM1G	0	2	0	0	28.71	57.42	15	1	1	NA	1	NA	0	2
PPM1H	7	21	1	3	463.32	926.64	15	1	1	0	1	0	4	28
PPM1J	8	27	0	0	378.18	756.36	15	1	1	NA	1	NA	0	35
PPM1L	0	15	1	3	228.36	456.72	15	1	0.210526315789474	-Inf	1	-0.25	4	15
PPM1M	12	11	2	1	384.45	768.9	15	1	1	-0.833333333333333	1	-0.144927536231884	3	23
PPME1	0	23	0	3	287.1	574.2	15	1	1	NA	1	0	3	23
PPP1CB	0	8	0	3	307.56	615.12	15	1	1	NA	1	0	3	8
PPP1CC	0	11	4	4	302.61	605.22	15	1	0.0180598555211558	-Inf	0.677255339142531	-0.5	8	11
PPP1R14C	11	1	1	0	158.4	316.8	15	1	1	-Inf	1	-0.0833333333333334	1	12
PPP1R14D	0	4	0	0	129.69	259.38	15	1	1	NA	1	NA	0	4
PPP1R15B	14	15	5	7	374.55	749.1	15	1	0.743703208140659	0.23469387755102	1	0.0660919540229885	12	29
PPP1R16B	5	23	0	3	566.28	1132.56	15	1	1	1	1	0.178571428571429	3	28
PPP1R17	1	8	0	0	157.41	314.82	15	1	1	NA	1	NA	0	9
PPP1R1C	0	5	0	0	141.57	283.14	15	1	1	NA	1	NA	0	5
PPP1R2	0	6	1	1	177.54	355.08	15	1	0.25	-Inf	1	-0.5	2	6
PPP1R21	4	20	2	6	738.54	1477.08	15	1	0.624768261030775	-0.666666666666667	1	-0.0833333333333333	8	24
PPP1R26	67	66	26	19	1337.49	2674.98	15	1	0.490142978260174	-0.347996857816182	1	-0.0740183792815371	45	133
PPP1R36	18	11	6	1	387.09	774.18	15	1	0.383902593295383	-2.66666666666667	1	-0.236453201970443	7	29
PPP1R3A	54	35	5	3	1166.22	2332.44	15	1	1	-0.0802469135802468	1	-0.0182584269662921	8	89
PPP1R3C	2	5	3	3	312.18	624.36	15	1	0.592074592074592	-1.5	1	-0.214285714285714	6	7
PPP1R3D	5	8	2	0	303.93	607.86	15	1	0.2	-Inf	1	-0.615384615384615	2	13
PPP1R3E	1	2	0	2	452.43	904.86	15	1	1	1	1	0.333333333333333	2	3
PPP1R3G	4	8	1	2	202.29	404.58	15	1	1	0	1	0	3	12
PPP1R42	11	11	3	0	306.9	613.8	15	1	0.23	-Inf	1	-0.5	3	22
PPP1R7	2	19	2	3	338.25	676.5	15	1	0.154849498327759	-5.33333333333333	1	-0.304761904761905	5	21
PPP1R8	11	16	2	1	467.94	935.88	15	1	0.564532019704434	-1.90909090909091	1	-0.259259259259259	3	27
PPP1R9A	5	18	6	4	860.97	1721.94	15	1	0.0494129279446298	-4.4	0.837400931738441	-0.382608695652174	10	23
PPP1R9B	23	51	4	10	1346.4	2692.8	15	1	1	0.11304347826087	1	0.0250965250965251	14	74
PPP2CA	0	5	0	0	273.24	546.48	15	1	1	NA	1	NA	0	5
PPP2CB	1	7	1	2	273.24	546.48	15	1	0.490909090909091	-2.5	1	-0.208333333333333	3	8
PPP2R2A	0	8	0	1	446.49	892.98	15	1	1	NA	1	0	1	8
PPP2R2B	0	22	0	2	431.64	863.28	15	1	1	NA	1	0	2	22
PPP2R2C	7	10	0	2	474.54	949.08	15	1	0.508771929824561	1	1	0.411764705882353	2	17
PPP2R2D	7	5	0	1	463.98	927.96	15	1	0.461538461538462	1	1	0.583333333333333	1	12
PPP2R3A	26	28	3	3	1116.72	2233.44	15	1	1	-0.0769230769230769	1	-0.0185185185185185	6	54
PPP2R3B	5	11	1	2	509.85	1019.7	15	1	1	-0.1	1	-0.0208333333333333	3	16
PPP2R3C	0	14	1	2	430.32	860.64	15	1	0.176470588235294	-Inf	1	-0.333333333333333	3	14
PPP2R5A	0	7	1	4	453.42	906.84	15	1	0.416666666666667	-Inf	1	-0.2	5	7
PPP2R5C	0	4	0	2	502.59	1005.18	15	1	1	NA	1	0	2	4
PPP2R5D	2	17	0	8	431.64	863.28	15	1	1	1	1	0.105263157894737	8	19
PPP2R5E	0	3	0	2	463.32	926.64	15	1	1	NA	1	0	2	3
PPP3CB	0	7	0	1	482.79	965.58	15	1	1	NA	1	0	1	7
PPP3CC	1	20	1	4	490.71	981.42	15	1	0.353846153846154	-4	1	-0.152380952380952	5	21
PPP3R1	0	2	0	0	168.3	336.6	15	1	1	NA	1	NA	0	2
PPP4R1	15	27	4	4	922.35	1844.7	15	1	0.458820331186573	-0.8	1	-0.142857142857143	8	42
PPP4R2	2	7	1	3	391.71	783.42	15	1	1	-0.166666666666667	1	-0.0277777777777778	4	9
PPP4R3A	1	22	0	3	804.54	1609.08	15	1	1	1	1	0.0434782608695652	3	23
PPP4R3B	3	27	0	0	766.26	1532.52	15	1	1	NA	1	NA	0	30
PPP4R4	7	17	1	6	846.78	1693.56	15	1	0.641701795917591	0.595238095238095	1	0.148809523809524	7	24
PPP6C	0	15	0	2	162.36	324.72	15	1	1	NA	1	0	2	15
PPP6R3	1	21	1	6	871.2	1742.4	15	1	0.431034482758621	-2.5	1	-0.0974025974025974	7	22
PPRC1	33	39	15	26	928.62	1857.24	15	1	0.429153927052457	0.318181818181818	1	0.092479674796748	41	72
PPT1	5	18	3	0	263.01	526.02	15	1	0.0215384615384615	-Inf	0.721018759249189	-0.782608695652174	3	23
PPTC7	0	7	0	2	271.59	543.18	15	1	1	NA	1	0	2	7
PPWD1	2	25	1	6	575.85	1151.7	15	1	0.511196524064171	-1.08333333333333	1	-0.0687830687830688	7	27
PQLC1	0	5	2	1	260.04	520.08	15	1	0.107142857142857	-Inf	0.983875031494079	-0.666666666666667	3	5
PQLC2	11	22	2	8	296.34	592.68	15	1	0.696329089128093	0.5	1	0.133333333333333	10	33
PQLC2L	11	13	3	4	330.99	661.98	15	1	1	0.113636363636364	1	0.0297619047619048	7	24
PRADC1	1	5	0	6	131.67	263.34	15	1	1	1	1	0.166666666666667	6	6
PRAM1	24	26	2	6	414.81	829.62	15	1	0.276163216612526	0.638888888888889	1	0.23	8	50
PRC1	3	19	2	6	515.13	1030.26	15	1	0.589350623833382	-1.11111111111111	1	-0.113636363636364	8	22
PRCC	9	17	3	7	334.29	668.58	15	1	1	0.19047619047619	1	0.0461538461538462	10	26
PRCP	17	26	14	16	526.35	1052.7	15	1	0.632758133449394	-0.338235294117647	1	-0.0713178294573644	30	43
PRDM1	0	16	0	6	782.1	1564.2	15	1	1	NA	1	0	6	16
PRDM10	1	36	3	7	1191.96	2383.92	15	1	0.0260701370784627	-14.4285714285714	0.761210061313465	-0.272972972972973	10	37
PRDM11	6	43	0	9	1493.58	2987.16	15	1	0.575990013479313	1	1	0.122448979591837	9	49
PRDM12	1	9	0	5	339.24	678.48	15	1	1	1	1	0.1	5	10
PRDM13	1	5	1	3	312.51	625.02	15	1	1	-0.666666666666667	1	-0.0833333333333333	4	6
PRDM14	1	12	0	3	288.09	576.18	15	1	1	1	1	0.0769230769230769	3	13
PRDM16	5	15	5	4	919.05	1838.1	15	1	0.20467538458543	-2.75	1	-0.305555555555556	9	20
PRDM4	2	30	0	9	784.74	1569.48	15	1	1	1	1	0.0625	9	32
PRDM5	4	15	3	1	595.98	1191.96	15	1	0.0671936758893281	-10.25	0.884435842948953	-0.539473684210526	4	19
PRDM6	0	7	0	0	389.07	778.14	15	1	1	NA	1	NA	0	7
PRDX1	0	10	0	1	198	396	15	1	1	NA	1	0	1	10
PRDX3	1	4	0	0	183.48	366.96	15	1	1	NA	1	NA	0	5
PRDX4	3	6	1	3	229.68	459.36	15	1	1	0.333333333333333	1	0.0833333333333333	4	9
PRDX6	3	15	1	1	178.53	357.06	15	1	0.368421052631579	-4	1	-0.333333333333333	2	18
PRELID1	1	6	1	2	124.41	248.82	15	1	1	-2	1	-0.19047619047619	3	7
PRELID3A	0	7	0	1	180.51	361.02	15	1	1	NA	1	0	1	7
PRELID3B	2	12	0	0	193.05	386.1	15	1	1	NA	1	NA	0	14
PRELP	1	8	2	6	288.75	577.5	15	1	0.576470588235294	-1.66666666666667	1	-0.138888888888889	8	9
PREP	5	25	3	2	703.89	1407.78	15	1	0.0665430395031913	-6.5	0.884435842948953	-0.433333333333333	5	30
PREX1	17	54	5	12	1686.63	3373.26	15	1	0.75604340257781	-0.323529411764706	1	-0.0546810273405137	17	71
PREX2	10	35	1	4	1388.64	2777.28	15	1	1	0.125	1	0.0222222222222222	5	45
PRG4	42	38	12	12	1078.11	2156.22	15	1	1	0.0952380952380952	1	0.025	24	80
PRICKLE2	16	56	3	16	834.57	1669.14	15	1	0.75325420286117	0.34375	1	0.064327485380117	19	72
PRICKLE4	11	13	8	8	342.21	684.42	15	1	1	-0.181818181818182	1	-0.0416666666666667	16	24
PRIM1	10	13	4	3	302.61	605.22	15	1	0.674584929757343	-0.733333333333333	1	-0.136645962732919	7	23
PRIMA1	2	5	0	0	123.75	247.5	15	1	1	NA	1	NA	0	7
PRKAA1	0	11	2	1	479.82	959.64	15	1	0.032967032967033	-Inf	0.784275503573749	-0.666666666666667	3	11
PRKAA2	1	37	1	11	516.45	1032.9	15	1	0.426122448979592	-2.36363636363636	1	-0.0570175438596491	12	38
PRKAB2	0	11	0	4	272.25	544.5	15	1	1	NA	1	0	4	11
PRKACB	1	6	0	2	394.02	788.04	15	1	1	1	1	0.142857142857143	2	7
PRKAG1-PRKAG2	0	4	1	1	327.69	655.38	15	1	0.333333333333333	-Inf	1	-0.5	2	4
PRKAG3	0	6	1	2	140.58	281.16	15	1	0.333333333333333	-Inf	1	-0.333333333333333	3	6
PRKAR1A	0	10	0	3	326.7	653.4	15	1	1	NA	1	0	3	10
PRKAR1B	6	19	1	0	381.48	762.96	15	1	0.269230769230769	-Inf	1	-0.76	1	25
PRKAR2A	3	17	0	3	318.12	636.24	15	1	1	1	1	0.15	3	20
PRKAR2B	2	10	0	0	307.89	615.78	15	1	1	NA	1	NA	0	12
PRKCA	1	13	0	3	578.16	1156.32	15	1	1	1	1	0.0714285714285714	3	14
PRKCB	1	20	1	6	606.54	1213.08	15	1	0.444444444444444	-2.33333333333333	1	-0.0952380952380952	7	21
PRKCD	0	24	0	3	676.17	1352.34	15	1	1	NA	1	0	3	24
PRKCE	1	5	0	1	601.92	1203.84	15	1	1	1	1	0.166666666666667	1	6
PRKCH	1	31	0	7	669.24	1338.48	15	1	1	1	1	0.03125	7	32
PRKCI	0	13	0	1	299.97	599.94	15	1	1	NA	1	0	1	13
PRKCQ	2	21	2	2	707.85	1415.7	15	1	0.0917948717948718	-9.5	0.953786405978059	-0.41304347826087	4	23
PRKCZ	3	19	0	6	557.37	1114.74	15	1	1	1	1	0.136363636363636	6	22
PRKD1	2	7	0	1	440.55	881.1	15	1	1	1	1	0.222222222222222	1	9
PRKDC	93	155	32	16	4040.19	8080.38	15	1	0.000222055659769083	-2.33333333333333	0.111675492225535	-0.291666666666667	48	248
PRKG2	6	25	3	3	769.23	1538.46	15	1	0.140410463939876	-3.16666666666667	1	-0.306451612903226	6	31
PRKRIP1	1	9	0	1	188.1	376.2	15	1	1	1	1	0.1	1	10
PRKX	0	3	1	1	316.8	633.6	15	1	0.4	-Inf	1	-0.5	2	3
PRL	2	11	0	0	224.73	449.46	15	1	1	NA	1	NA	0	13
PRLHR	1	13	0	0	341.55	683.1	15	1	1	NA	1	NA	0	14
PRLHR2	6	25	2	4	360.36	720.72	15	1	0.591342679577974	-1.08333333333333	1	-0.139784946236559	6	31
PRLHRL	4	2	4	8	307.56	615.12	15	1	0.321266968325792	0.75	1	0.333333333333333	12	6
PRLL	4	3	1	0	174.57	349.14	15	1	1	-Inf	1	-0.428571428571429	1	7
PRLR	24	21	0	3	827.64	1655.28	15	1	0.234042553191489	1	1	0.533333333333333	3	45
PRMT3	14	13	0	1	207.57	415.14	15	1	1	1	1	0.518518518518518	1	27
PRMT7	11	27	6	5	679.8	1359.6	15	1	0.156184622675575	-1.94545454545455	1	-0.255980861244019	11	38
PRMT8	0	3	2	7	170.28	340.56	15	1	1	-Inf	1	-0.222222222222222	9	3
PRMT9	11	31	3	4	835.56	1671.12	15	1	0.391555335642421	-1.11363636363636	1	-0.166666666666667	7	42
PRNP	4	13	2	1	206.91	413.82	15	1	0.201754385964912	-5.5	1	-0.431372549019608	3	17
PROC	10	8	0	0	429.66	859.32	15	1	1	NA	1	NA	0	18
PROCA1	11	8	4	7	142.23	284.46	15	1	0.449725137431284	0.584415584415584	1	0.215311004784689	11	19
PROCR	3	6	1	1	113.85	227.7	15	1	1	-1	1	-0.166666666666667	2	9
PRODH	14	16	3	3	435.93	871.86	15	1	1	-0.142857142857143	1	-0.0333333333333333	6	30
PROK1	0	2	1	0	63.36	126.72	15	1	0.333333333333333	-Inf	1	-1	1	2
PROKR2	1	18	1	4	394.02	788.04	15	1	0.380434782608696	-3.5	1	-0.147368421052632	5	19
PROM1	8	28	6	2	861.3	1722.6	15	1	0.00796844251481981	-9.5	0.529186532206378	-0.527777777777778	8	36
PROM1L	31	14	10	13	523.05	1046.1	15	1	0.0660998425426313	0.652605459057072	0.884435842948953	0.254106280193237	23	45
PROM2	13	24	1	3	816.75	1633.5	15	1	1	0.384615384615385	1	0.101351351351351	4	37
PRORSD1P	1	8	0	0	143.55	287.1	15	1	1	NA	1	NA	0	9
PROS1	10	18	1	5	633.27	1266.54	15	1	0.637873781325656	0.64	1	0.19047619047619	6	28
PROSC	1	7	1	4	216.15	432.3	15	1	1	-0.75	1	-0.075	5	8
PROSER1	5	20	1	4	918.72	1837.44	15	1	1	0	1	0	5	25
PROSER2	20	31	4	4	453.42	906.84	15	1	0.703691705653427	-0.55	1	-0.107843137254902	8	51
PROX1	0	3	0	1	162.36	324.72	15	1	1	NA	1	0	1	3
PROX2	29	31	15	15	614.46	1228.92	15	1	1	-0.0689655172413792	1	-0.0166666666666667	30	60
PROZ	9	18	3	5	403.92	807.84	15	1	1	-0.2	1	-0.0416666666666667	8	27
PRPF18	1	14	0	2	317.79	635.58	15	1	1	1	1	0.0666666666666667	2	15
PRPF19	0	26	0	4	389.4	778.8	15	1	1	NA	1	0	4	26
PRPF3	0	33	0	10	664.29	1328.58	15	1	1	NA	1	0	10	33
PRPF38A	0	19	0	2	309.87	619.74	15	1	1	NA	1	0	2	19
PRPF38B	2	11	1	2	484.44	968.88	15	1	0.489285714285714	-1.75	1	-0.179487179487179	3	13
PRPF39	0	30	3	9	610.83	1221.66	15	1	0.0191637630662021	-Inf	0.683149554847669	-0.25	12	30
PRPF4	1	13	1	6	464.64	929.28	15	1	1	-1.16666666666667	1	-0.0714285714285714	7	14
PRPF40A	2	27	1	10	855.36	1710.72	15	1	1	-0.35	1	-0.0219435736677116	11	29
PRPF4B	2	29	1	6	982.74	1965.48	15	1	0.467164532954007	-1.41666666666667	1	-0.0783410138248848	7	31
PRPF6	0	62	0	23	909.15	1818.3	15	1	1	NA	1	0	23	62
PRPF8	0	110	1	30	2309.67	4619.34	15	1	0.219858156028368	-Inf	1	-0.032258064516129	31	110
PRPH	1	9	0	7	185.13	370.26	15	1	1	1	1	0.1	7	10
PRPH2	1	14	1	2	351.45	702.9	15	1	0.313725490196079	-6	1	-0.266666666666667	3	15
PRPS1-PRPS2	0	12	0	6	304.59	609.18	15	1	1	NA	1	0	6	12
PRPSAP1	0	22	1	7	380.16	760.32	15	1	0.266666666666666	-Inf	1	-0.125	8	22
PRPSAP2	0	14	0	1	366.3	732.6	15	1	1	NA	1	0	1	14
PRR11	16	18	5	4	325.38	650.76	15	1	0.720512781204783	-0.40625	1	-0.0849673202614379	9	34
PRR15L	1	2	1	3	96.03	192.06	15	1	1	0.333333333333333	1	0.0833333333333333	4	3
PRR16	6	13	2	1	264.33	528.66	15	1	0.527272727272727	-3.33333333333333	1	-0.350877192982456	3	19
PRR29	17	15	5	2	396.33	792.66	15	1	0.438304701462596	-1.20588235294118	1	-0.183035714285714	7	32
PRR33	27	35	8	2	496.65	993.3	15	1	0.0432168084632188	-4.18518518518519	0.818982480424487	-0.364516129032258	10	62
PRR35	25	26	6	11	843.48	1686.96	15	1	0.40476162040578	0.432727272727273	1	0.137254901960784	17	51
PRR5	5	17	3	0	399.96	799.92	15	1	0.0243478260869565	-Inf	0.755471107633844	-0.772727272727273	3	22
PRR5L	3	14	1	1	363.33	726.66	15	1	0.385964912280702	-3.66666666666667	1	-0.323529411764706	2	17
PRRC1	13	16	1	2	445.5	891	15	1	1	0.384615384615385	1	0.114942528735632	3	29
PRRC2B	20	87	25	19	2223.54	4447.08	15	1	8.96255704118047e-06	-4.72368421052632	0.0216356126974097	-0.381265930331351	44	107
PRRC2C	51	151	27	28	3194.07	6388.14	15	1	0.0014595007941404	-1.85504201680672	0.279621818813882	-0.238433843384338	55	202
PRRG1	3	3	0	3	258.39	516.78	15	1	0.464285714285714	1	1	0.5	3	6
PRRG3	2	6	2	2	230.01	460.02	15	1	0.547474747474747	-2	1	-0.25	4	8
PRRG4	11	7	1	3	225.72	451.44	15	1	0.293233082706767	0.787878787878788	1	0.361111111111111	4	18
PRRT1B	1	1	0	1	50.16	100.32	15	1	1	1	1	0.5	1	2
PRRT3	14	12	12	12	264.33	528.66	15	1	1	0.142857142857143	1	0.0384615384615384	24	26
PRRX1	0	7	0	3	235.29	470.58	15	1	1	NA	1	0	3	7
PRRX2	9	6	3	5	219.78	439.56	15	1	0.400323058285099	0.6	1	0.225	8	15
PRSS23	1	12	1	0	369.27	738.54	15	1	0.142857142857143	-Inf	1	-0.923076923076923	1	13
PRSS55	10	12	0	3	334.29	668.58	15	1	0.25	1	1	0.454545454545455	3	22
PRSS56	17	16	8	12	496.98	993.96	15	1	0.57121145357503	0.372549019607843	1	0.115151515151515	20	33
PRSS57	7	3	1	1	140.25	280.5	15	1	1	0.571428571428571	1	0.2	2	10
PRTFDC1	1	4	1	0	209.22	418.44	15	1	0.333333333333333	-Inf	1	-0.8	1	5
PRTG	15	58	9	10	1192.95	2385.9	15	1	0.0366069313569359	-2.48	0.788199921465956	-0.268204758471521	19	73
PRUNE1	10	21	1	4	368.61	737.22	15	1	1	0.475	1	0.12258064516129	5	31
PRUNE2	165	103	14	4	2916.87	5833.74	15	1	0.21281597369319	-1.18484848484849	1	-0.162106135986733	18	268
PSAP	7	21	0	5	496.65	993.3	15	1	0.559063943101763	1	1	0.25	5	28
PSAT1	4	19	1	0	333.3	666.6	15	1	0.208333333333333	-Inf	1	-0.826086956521739	1	23
PSCA	17	4	1	0	113.19	226.38	15	1	1	-Inf	1	-0.19047619047619	1	21
PSD	11	24	7	10	643.17	1286.34	15	1	0.543898478895157	-0.527272727272727	1	-0.0974789915966386	17	35
PSD2	10	27	6	3	821.37	1642.74	15	1	0.0473747811290045	-4.4	0.828231827900648	-0.396396396396396	9	37
PSD3	27	33	13	9	1038.84	2077.68	15	1	0.321844161111614	-0.765432098765432	1	-0.140909090909091	22	60
PSEN1	1	16	1	0	461.34	922.68	15	1	0.111111111111111	-Inf	0.98538656216834	-0.941176470588235	1	17
PSEN2	5	22	0	8	454.41	908.82	15	1	0.31522462357377	1	1	0.185185185185185	8	27
PSIP1	16	13	1	1	550.44	1100.88	15	1	1	0.1875	1	0.0517241379310345	2	29
PSKH1	6	28	0	5	441.21	882.42	15	1	0.573570099885889	1	1	0.176470588235294	5	34
PSMA1	0	20	0	7	250.47	500.94	15	1	1	NA	1	0	7	20
PSMA3	0	15	0	6	246.51	493.02	15	1	1	NA	1	0	6	15
PSMA4	1	8	0	3	258.39	516.78	15	1	1	1	1	0.111111111111111	3	9
PSMA5	0	17	0	3	229.35	458.7	15	1	1	NA	1	0	3	17
PSMA6	0	9	0	2	219.45	438.9	15	1	1	NA	1	0	2	9
PSMA7	0	9	0	0	214.83	429.66	15	1	1	NA	1	NA	0	9
PSMB1	1	7	0	2	220.77	441.54	15	1	1	1	1	0.125	2	8
PSMB2	2	9	0	2	229.68	459.36	15	1	1	1	1	0.181818181818182	2	11
PSMB3	0	10	1	3	202.95	405.9	15	1	0.285714285714286	-Inf	1	-0.25	4	10
PSMB4	1	8	0	2	171.93	343.86	15	1	1	1	1	0.111111111111111	2	9
PSMB7	0	6	1	2	206.58	413.16	15	1	0.333333333333333	-Inf	1	-0.333333333333333	3	6
PSMC1	0	19	0	5	435.6	871.2	15	1	1	NA	1	0	5	19
PSMC2	1	22	0	2	428.67	857.34	15	1	1	1	1	0.0434782608695652	2	23
PSMC3	0	11	0	3	383.13	766.26	15	1	1	NA	1	0	3	11
PSMC3IP	1	7	1	2	98.34	196.68	15	1	0.490909090909091	-2.5	1	-0.208333333333333	3	8
PSMC5	0	25	0	6	376.53	753.06	15	1	1	NA	1	0	6	25
PSMC6	0	20	0	4	393.69	787.38	15	1	1	NA	1	0	4	20
PSMD1	1	23	0	8	616.11	1232.22	15	1	1	1	1	0.0416666666666667	8	24
PSMD10	1	6	1	1	154.44	308.88	15	1	0.416666666666667	-5	1	-0.357142857142857	2	7
PSMD11	0	16	0	2	395.01	790.02	15	1	1	NA	1	0	2	16
PSMD12	1	12	1	2	433.95	867.9	15	1	0.35	-5	1	-0.256410256410256	3	13
PSMD13	0	15	1	1	320.76	641.52	15	1	0.117647058823529	-Inf	1	-0.5	2	15
PSMD2	1	37	0	15	729.63	1459.26	15	1	1	1	1	0.0263157894736842	15	38
PSMD3	69	52	8	14	848.1	1696.2	15	1	0.102974275988249	0.56935817805383	0.983165897366278	0.206611570247934	22	121
PSMD5	4	27	1	3	477.18	954.36	15	1	0.476604278074866	-1.25	1	-0.120967741935484	4	31
PSMD6	0	28	3	2	355.74	711.48	15	1	0.00183284457478006	-Inf	0.316034771679933	-0.6	5	28
PSMD7	3	10	0	3	308.22	616.44	15	1	1	1	1	0.230769230769231	3	13
PSMD9	4	13	0	1	133.65	267.3	15	1	1	1	1	0.235294117647059	1	17
PSME3	3	11	0	2	251.79	503.58	15	1	1	1	1	0.214285714285714	2	14
PSME4	4	72	2	6	1673.76	3347.52	15	1	0.0985626151823513	-5	0.971353639774823	-0.197368421052632	8	76
PSMF1	8	12	4	3	225.39	450.78	15	1	0.661835748792271	-1	1	-0.171428571428571	7	20
PSMG1	4	7	1	3	206.58	413.16	15	1	1	0.416666666666667	1	0.113636363636364	4	11
PSMG2	5	14	2	3	265.98	531.96	15	1	0.608036890645586	-0.866666666666667	1	-0.136842105263158	5	19
PSMG3	3	2	1	1	155.76	311.52	15	1	1	0.333333333333333	1	0.1	2	5
PSMG4	0	3	0	1	87.78	175.56	15	1	1	NA	1	0	1	3
PSPC1	3	12	1	0	524.7	1049.4	15	1	0.25	-Inf	1	-0.8	1	15
PSPH	0	7	0	2	224.73	449.46	15	1	1	NA	1	0	2	7
PSTK	16	13	6	2	315.81	631.62	15	1	0.431026377421064	-1.4375	1	-0.198275862068966	8	29
PSTPIP1	6	20	5	3	383.46	766.92	15	1	0.0789348368194144	-4.55555555555556	0.933295530697459	-0.394230769230769	8	26
PSTPIP2	3	17	0	2	320.76	641.52	15	1	1	1	1	0.15	2	20
PTAFR	7	8	1	0	344.52	689.04	15	1	1	-Inf	1	-0.533333333333333	1	15
PTAR1	1	3	0	0	211.2	422.4	15	1	1	NA	1	NA	0	4
PTBP1	0	9	0	3	542.52	1085.04	15	1	1	NA	1	0	3	9
PTBP2	1	26	0	7	529.98	1059.96	15	1	1	1	1	0.037037037037037	7	27
PTBP3	57	33	9	4	892.98	1785.96	15	1	0.76610569891093	-0.302631578947368	1	-0.058974358974359	13	90
PTCD2	18	17	2	1	388.08	776.16	15	1	1	-0.888888888888889	1	-0.152380952380952	3	35
PTCD3	21	30	6	3	621.06	1242.12	15	1	0.275637457725785	-1.85714285714286	1	-0.254901960784314	9	51
PTCH1	5	44	2	12	1346.07	2692.14	15	1	0.646152535708874	-0.466666666666667	1	-0.0408163265306122	14	49
PTCH2	5	30	4	10	832.59	1665.18	15	1	0.254175648944678	-1.4	1	-0.142857142857143	14	35
PTCHD1	0	9	1	1	853.05	1706.1	15	1	0.181818181818182	-Inf	1	-0.5	2	9
PTCHD3-PTCHD3L	48	47	9	5	782.43	1564.86	15	1	0.399244327318419	-0.7625	1	-0.137593984962406	14	95
PTCHD4	1	10	0	1	553.41	1106.82	15	1	1	1	1	0.0909090909090909	1	11
PTDSS1	1	14	0	0	414.15	828.3	15	1	1	NA	1	NA	0	15
PTDSS2	1	13	0	3	417.12	834.24	15	1	1	1	1	0.0714285714285714	3	14
PTEN	1	4	0	0	316.47	632.94	15	1	1	NA	1	NA	0	5
PTER	7	12	5	0	346.5	693	15	1	0.0372670807453417	-Inf	0.789146779993463	-0.631578947368421	5	19
PTGDS	4	12	1	0	182.49	364.98	15	1	0.294117647058824	-Inf	1	-0.75	1	16
PTGER2	7	7	3	11	287.43	574.86	15	1	0.236460717009916	0.727272727272727	1	0.285714285714286	14	14
PTGER3	6	9	3	13	333.63	667.26	15	1	0.252412503425706	0.653846153846154	1	0.2125	16	15
PTGER4	4	32	0	3	470.25	940.5	15	1	1	1	1	0.111111111111111	3	36
PTGES	1	3	2	4	145.53	291.06	15	1	1	-0.5	1	-0.0833333333333333	6	4
PTGES2	4	13	3	5	350.46	700.92	15	1	0.639558976492615	-0.95	1	-0.139705882352941	8	17
PTGFRN	11	38	7	5	890.67	1781.34	15	1	0.0298574804719666	-3.83636363636364	0.771992783106328	-0.358843537414966	12	49
PTGR1	3	17	2	0	326.7	653.4	15	1	0.0432900432900433	-Inf	0.818982480424487	-0.85	2	20
PTGR2	4	10	7	3	343.86	687.72	15	1	0.0953021941041865	-4.83333333333333	0.960983694935281	-0.414285714285714	10	14
PTGS1	5	14	2	12	561.33	1122.66	15	1	0.669745283760857	0.533333333333333	1	0.120300751879699	14	19
PTGS2	4	16	0	0	597.96	1195.92	15	1	1	NA	1	NA	0	20
PTH	8	6	0	1	118.8	237.6	15	1	0.466666666666667	1	1	0.571428571428571	1	14
PTH1R	2	6	0	6	528.33	1056.66	15	1	0.472527472527472	1	1	0.25	6	8
PTHLH	4	12	1	1	176.22	352.44	15	1	0.490196078431373	-2	1	-0.25	2	16
PTHRL	5	22	6	16	527.01	1054.02	15	1	0.509503436908971	-0.65	1	-0.0875420875420875	22	27
PTN	1	8	0	1	164.34	328.68	15	1	1	1	1	0.111111111111111	1	9
PTP4A1	0	2	1	0	172.26	344.52	15	1	0.333333333333333	-Inf	1	-1	1	2
PTP4A2	0	7	0	2	166.32	332.64	15	1	1	NA	1	0	2	7
PTP4A3	0	4	0	2	170.28	340.56	15	1	1	NA	1	0	2	4
PTPA	2	14	0	9	310.53	621.06	15	1	0.52	1	1	0.125	9	16
PTPDC1	10	23	4	6	736.56	1473.12	15	1	0.703690808179533	-0.533333333333333	1	-0.096969696969697	10	33
PTPMT1	2	4	1	0	126.72	253.44	15	1	0.428571428571428	-Inf	1	-0.666666666666667	1	6
PTPN1	1	11	0	2	410.85	821.7	15	1	1	1	1	0.0833333333333333	2	12
PTPN11	5	25	1	4	633.27	1266.54	15	1	1	-0.25	1	-0.0333333333333334	5	30
PTPN12	26	26	6	5	817.74	1635.48	15	1	1	-0.2	1	-0.0454545454545454	11	52
PTPN13	33	101	17	14	2507.01	5014.02	15	1	0.00196187980907074	-2.71645021645022	0.324382045143615	-0.302118440057776	31	134
PTPN14	6	16	4	0	602.91	1205.82	15	1	0.0140468227424749	-Inf	0.628451090139802	-0.727272727272727	4	22
PTPN2	3	9	2	3	366.3	732.6	15	1	0.600032320620556	-1	1	-0.15	5	12
PTPN21	8	47	4	6	1208.79	2417.58	15	1	0.0777960174035684	-2.91666666666667	0.927455919491027	-0.254545454545455	10	55
PTPN22	27	44	2	2	1312.41	2624.82	15	1	0.637813155621375	-0.62962962962963	1	-0.119718309859155	4	71
PTPN23	6	36	5	20	801.9	1603.8	15	1	0.734428773117593	-0.5	1	-0.0571428571428572	25	42
PTPN4	0	20	2	2	920.7	1841.4	15	1	0.0217391304347826	-Inf	0.721018759249189	-0.5	4	20
PTPN5	6	18	1	1	552.42	1104.84	15	1	0.473846153846154	-2	1	-0.25	2	24
PTPN6	2	29	0	3	601.59	1203.18	15	1	1	1	1	0.0645161290322581	3	31
PTPN7	4	15	5	8	324.72	649.44	15	1	0.426935483870968	-1.34375	1	-0.174089068825911	13	19
PTPN9	2	9	2	7	464.64	929.28	15	1	1	-0.285714285714286	1	-0.0404040404040404	9	11
PTPRB	23	57	3	8	1881	3762	15	1	1	0.0706521739130435	1	0.0147727272727273	11	80
PTPRC	51	29	5	3	1076.13	2152.26	15	1	1	0.0522875816993464	1	0.0125	8	80
PTPRD	29	37	3	0	1168.86	2337.72	15	1	0.0946673283200367	-Inf	0.960983694935281	-0.560606060606061	3	66
PTPRE	3	20	1	6	690.03	1380.06	15	1	1	-0.111111111111111	1	-0.0124223602484472	7	23
PTPRF	6	55	1	16	1771.11	3542.22	15	1	1	0.427083333333333	1	0.0395371263259402	17	61
PTPRG	7	29	4	12	1237.83	2475.66	15	1	0.719457875773088	-0.380952380952381	1	-0.0555555555555556	16	36
PTPRJ	36	29	8	10	766.26	1532.52	15	1	0.436758183300486	0.355555555555556	1	0.109401709401709	18	65
PTPRM	0	16	0	3	443.52	887.04	15	1	1	NA	1	0	3	16
PTPRN2	8	14	0	2	365.31	730.62	15	1	0.536231884057971	1	1	0.363636363636364	2	22
PTPRO	12	27	4	5	1229.25	2458.5	15	1	0.456581818792394	-0.8	1	-0.136752136752137	9	39
PTPRQ	153	171	36	21	5524.2	11048.4	15	1	0.0310761113586398	-0.915966386554622	0.774976578716492	-0.159356725146199	57	324
PTPRR	5	15	4	1	517.77	1035.54	15	1	0.0403162055335969	-11	0.798931947804628	-0.55	5	20
PTPRS	3	45	3	16	1817.97	3635.94	15	1	0.340583225152315	-1.8125	1	-0.0953947368421053	19	48
PTPRT	16	35	14	9	1230.9	2461.8	15	1	0.0222816899088606	-2.40277777777778	0.721018759249189	-0.294970161977835	23	51
PTPRU	16	57	14	25	1414.71	2829.42	15	1	0.122728848433832	-0.995	1	-0.139796276782578	39	73
PTPRVP	61	104	25	32	2221.89	4443.78	15	1	0.430595577503316	-0.331967213114754	1	-0.0688995215311005	57	165
PTPRZ1	35	55	5	3	2232.78	4465.56	15	1	0.265306417530937	-1.61904761904762	1	-0.236111111111111	8	90
PTRF	1	22	1	4	358.38	716.76	15	1	0.330687830687831	-4.5	1	-0.156521739130435	5	23
PTRH2	0	2	0	1	104.94	209.88	15	1	1	NA	1	0	1	2
PTRHD1	2	4	0	2	56.43	112.86	15	1	1	1	1	0.333333333333333	2	6
PTS	3	6	0	2	147.51	295.02	15	1	1	1	1	0.333333333333333	2	9
PTTG1	23	14	0	0	191.07	382.14	15	1	1	NA	1	NA	0	37
PTTG1IP	7	10	0	1	331.98	663.96	15	1	1	1	1	0.411764705882353	1	17
PTX3	6	22	2	5	426.69	853.38	15	1	0.647844009683963	-0.466666666666667	1	-0.0714285714285714	7	28
PUDP	4	6	0	3	190.41	380.82	15	1	0.496503496503497	1	1	0.4	3	10
PUF60	0	21	1	6	522.72	1045.44	15	1	0.25	-Inf	1	-0.142857142857143	7	21
PUM1	0	46	0	12	1143.45	2286.9	15	1	1	NA	1	0	12	46
PUM2	0	24	1	2	980.1	1960.2	15	1	0.111111111111111	-Inf	0.98538656216834	-0.333333333333333	3	24
PUM3	16	20	4	0	624.03	1248.06	15	1	0.106029106029106	-Inf	0.983805342817882	-0.555555555555556	4	36
PURG	3	16	0	1	329.01	658.02	15	1	1	1	1	0.157894736842105	1	19
PUS1	83	55	28	16	1391.28	2782.56	15	1	0.725409831940544	-0.159638554216867	1	-0.0349143610013175	44	138
PUS10	8	28	0	4	579.15	1158.3	15	1	0.565816828974724	1	1	0.222222222222222	4	36
PUS3	7	24	1	0	443.85	887.7	15	1	0.25	-Inf	1	-0.774193548387097	1	31
PUS7L	19	20	11	6	588.72	1177.44	15	1	0.383626626756265	-0.929824561403509	1	-0.159879336349925	17	39
PUSL1	30	28	4	7	643.17	1286.34	15	1	0.512968629084415	0.466666666666667	1	0.153605015673981	11	58
PVALB	0	2	1	0	104.28	208.56	15	1	0.333333333333333	-Inf	1	-1	1	2
PWP1	11	19	2	4	458.7	917.4	15	1	1	0.136363636363636	1	0.0333333333333333	6	30
PWP2	14	38	8	9	898.92	1797.84	15	1	0.142658257067157	-1.41269841269841	1	-0.201357466063348	17	52
PWWP2A	3	14	3	1	702.24	1404.48	15	1	0.0526315789473685	-13	0.843251957917679	-0.573529411764706	4	17
PWWP2B	27	53	12	9	888.03	1776.06	15	1	0.0765464106775455	-1.61728395061728	0.921151721712836	-0.233928571428571	21	80
PXDC1	1	9	0	3	197.67	395.34	15	1	1	1	1	0.1	3	10
PXDN	6	41	5	11	1479.06	2958.12	15	1	0.128070499903457	-2.10606060606061	1	-0.184840425531915	16	47
PXDNL	12	63	6	20	1378.74	2757.48	15	1	0.552196648737466	-0.575	1	-0.0707692307692308	26	75
PXK	4	14	1	0	511.17	1022.34	15	1	0.263157894736842	-Inf	1	-0.777777777777778	1	18
PXMP4	2	8	2	4	173.58	347.16	15	1	0.604395604395604	-1	1	-0.133333333333333	6	10
PXYLP1	13	21	8	8	570.9	1141.8	15	1	0.542730475873933	-0.615384615384615	1	-0.117647058823529	16	34
PYCR1	0	15	0	2	269.28	538.56	15	1	1	NA	1	0	2	15
PYCRL	0	2	0	2	79.86	159.72	15	1	1	NA	1	0	2	2
PYGB	7	28	6	23	799.26	1598.52	15	1	1	-0.0434782608695652	1	-0.00689655172413792	29	35
PYGL	1	21	9	32	686.73	1373.46	15	1	0.144641381144167	-4.90625	1	-0.174057649667406	41	22
PYGO1	3	15	2	5	398.64	797.28	15	1	0.596837944664032	-1	1	-0.119047619047619	7	18
PYROXD1	9	10	1	3	494.34	988.68	15	1	0.603613777526821	0.62962962962963	1	0.223684210526316	4	19
QDPR	1	5	2	2	220.77	441.54	15	1	0.5	-4	1	-0.333333333333333	4	6
QKI	0	4	0	1	261.03	522.06	15	1	1	NA	1	0	1	4
QRFP	2	1	3	2	66.66	133.32	15	1	1	0.25	1	0.0666666666666667	5	3
QRFPR	1	13	2	2	413.49	826.98	15	1	0.107843137254902	-12	0.983875031494079	-0.428571428571429	4	14
QRICH1	1	19	0	7	775.17	1550.34	15	1	1	1	1	0.05	7	20
QRICH2	3	5	3	5	152.79	305.58	15	1	1	0	1	0	8	8
QRSL1	6	29	4	0	497.97	995.94	15	1	0.00255316044789729	-Inf	0.35018916597864	-0.828571428571429	4	35
QSER1	16	35	6	6	878.79	1757.58	15	1	0.314013213745245	-1.1875	1	-0.186274509803922	12	51
QSOX1	14	28	8	11	546.81	1093.62	15	1	0.571355662923298	-0.454545454545455	1	-0.087719298245614	19	42
QSOX2	15	19	5	7	617.1	1234.2	15	1	1	0.0952380952380952	1	0.0245098039215686	12	34
QTRT2	17	18	2	2	350.46	700.92	15	1	1	-0.0588235294117647	1	-0.0142857142857143	4	35
R3HCC1	21	29	18	13	628.65	1257.3	15	1	0.177493439579589	-0.912087912087912	1	-0.160645161290323	31	50
R3HCC1L	29	35	16	13	613.14	1226.28	15	1	0.502086592574757	-0.485411140583554	1	-0.0985991379310345	29	64
R3HDM1	7	26	4	5	1105.83	2211.66	15	1	0.208577154624123	-1.97142857142857	1	-0.232323232323232	9	33
R3HDM2	6	35	2	3	1041.48	2082.96	15	1	0.203021111008977	-2.88888888888889	1	-0.253658536585366	5	41
R3HDM4	2	4	3	6	221.1	442.2	15	1	1	0	1	0	9	6
R3HDML	2	6	3	6	243.87	487.74	15	1	1	-0.5	1	-0.0833333333333333	9	8
RAB10	0	9	0	1	157.08	314.16	15	1	1	NA	1	0	1	9
RAB10L	2	5	0	0	212.52	425.04	15	1	1	NA	1	NA	0	7
RAB11A	0	9	0	1	214.83	429.66	15	1	1	NA	1	0	1	9
RAB11B	0	15	0	3	203.61	407.22	15	1	1	NA	1	0	3	15
RAB11FIP1	61	62	16	9	1254.66	2509.32	15	1	0.272129866125292	-0.806921675774135	1	-0.144065040650407	25	123
RAB11FIP2	4	14	5	2	505.89	1011.78	15	1	0.0581235697940504	-7.75	0.858692151057757	-0.492063492063492	7	18
RAB11FIP4	11	19	4	1	609.84	1219.68	15	1	0.141104388969664	-5.90909090909091	1	-0.433333333333333	5	30
RAB11FIP5	44	37	24	20	835.23	1670.46	15	1	1	-0.00909090909090904	1	-0.00224466891133557	44	81
RAB12	0	1	0	1	167.97	335.94	15	1	1	NA	1	0	1	1
RAB14	0	3	0	1	232.65	465.3	15	1	1	NA	1	0	1	3
RAB17	5	17	0	1	200.64	401.28	15	1	1	1	1	0.227272727272727	1	22
RAB18	0	9	1	2	182.49	364.98	15	1	0.25	-Inf	1	-0.333333333333333	3	9
RAB18L	4	11	1	1	161.7	323.4	15	1	0.514705882352941	-1.75	1	-0.233333333333333	2	15
RAB19	1	5	1	5	173.25	346.5	15	1	1	0	1	0	6	6
RAB1B	0	2	0	0	196.35	392.7	15	1	1	NA	1	NA	0	2
RAB20	1	4	1	3	223.74	447.48	15	1	1	-0.333333333333333	1	-0.05	4	5
RAB21	0	2	1	1	170.28	340.56	15	1	1	-Inf	1	-0.5	2	2
RAB22A	0	1	1	1	181.17	362.34	15	1	1	-Inf	1	-0.5	2	1
RAB23	2	4	0	2	235.62	471.24	15	1	1	1	1	0.333333333333333	2	6
RAB24	0	1	0	4	29.04	58.08	15	1	1	NA	1	0	4	1
RAB25	2	1	1	3	156.09	312.18	15	1	0.485714285714286	0.833333333333333	1	0.416666666666667	4	3
RAB26	1	10	0	2	179.85	359.7	15	1	1	1	1	0.0909090909090909	2	11
RAB27A	0	9	1	4	219.78	439.56	15	1	0.357142857142857	-Inf	1	-0.2	5	9
RAB28	0	3	0	1	220.77	441.54	15	1	1	NA	1	0	1	3
RAB2A	0	5	0	2	195.69	391.38	15	1	1	NA	1	0	2	5
RAB2B	1	6	1	5	137.61	275.22	15	1	1	-0.2	1	-0.0238095238095238	6	7
RAB31	0	4	0	0	181.17	362.34	15	1	1	NA	1	NA	0	4
RAB32	2	9	1	2	216.81	433.62	15	1	1	-1.25	1	-0.151515151515151	3	11
RAB33B	0	8	0	1	198.66	397.32	15	1	1	NA	1	0	1	8
RAB37	0	4	1	3	83.16	166.32	15	1	1	-Inf	1	-0.25	4	4
RAB38	6	8	2	2	260.37	520.74	15	1	1	-0.333333333333333	1	-0.0714285714285715	4	14
RAB39A	0	4	0	0	154.77	309.54	15	1	1	NA	1	NA	0	4
RAB39B	0	1	0	2	188.1	376.2	15	1	1	NA	1	0	2	1
RAB3B	7	8	0	0	274.23	548.46	15	1	1	NA	1	NA	0	15
RAB3GAP1	12	35	5	1	972.51	1945.02	15	1	0.0102425876010781	-13.5833333333333	0.585928868752023	-0.578014184397163	6	47
RAB3GAP2	16	46	2	5	1292.61	2585.22	15	1	1	-0.15	1	-0.0276497695852534	7	62
RAB3IL1	11	26	2	2	411.84	823.68	15	1	0.579460847240051	-1.36363636363636	1	-0.202702702702703	4	37
RAB3IP	3	7	0	3	457.38	914.76	15	1	0.527972027972028	1	1	0.3	3	10
RAB40B	0	12	0	2	266.97	533.94	15	1	1	NA	1	0	2	12
RAB40C	0	8	0	3	232.32	464.64	15	1	1	NA	1	0	3	8
RAB41	0	8	1	0	247.17	494.34	15	1	0.111111111111111	-Inf	0.98538656216834	-1	1	8
RAB41-RAB6A	0	5	0	0	140.25	280.5	15	1	1	NA	1	NA	0	5
RAB42	3	3	3	7	155.1	310.2	15	1	0.606643356643357	0.571428571428571	1	0.2	10	6
RAB43	0	4	1	0	144.54	289.08	15	1	0.2	-Inf	1	-1	1	4
RAB44	125	61	14	10	1864.17	3728.34	15	1	0.491883601888417	0.3168	1	0.0887096774193548	24	186
RAB4A	0	3	0	3	185.79	371.58	15	1	1	NA	1	0	3	3
RAB5A	0	4	0	0	213.84	427.68	15	1	1	NA	1	NA	0	4
RAB5C	0	10	0	3	214.83	429.66	15	1	1	NA	1	0	3	10
RAB7B	2	10	3	6	201.3	402.6	15	1	0.610791685095091	-1.5	1	-0.166666666666667	9	12
RAB8A	0	6	1	1	205.92	411.84	15	1	0.25	-Inf	1	-0.5	2	6
RAB9A	1	6	0	1	199.98	399.96	15	1	1	1	1	0.142857142857143	1	7
RAB9B	4	6	0	3	199.98	399.96	15	1	0.496503496503497	1	1	0.4	3	10
RABEP1	4	24	2	3	854.04	1708.08	15	1	0.216174537364749	-3	1	-0.257142857142857	5	28
RABEPK	11	26	4	6	241.56	483.12	15	1	0.704240104725525	-0.575757575757576	1	-0.102702702702703	10	37
RABGAP1	6	11	3	2	631.62	1263.24	15	1	0.609022556390977	-1.75	1	-0.247058823529412	5	17
RABGAP1L	10	18	9	2	900.24	1800.48	15	1	0.0138141478519676	-7.1	0.628451090139802	-0.461038961038961	11	28
RABGGTB	3	11	0	0	289.08	578.16	15	1	1	NA	1	NA	0	14
RABL2L	3	4	2	1	170.61	341.22	15	1	1	-1.66666666666667	1	-0.238095238095238	3	7
RABL6	14	24	2	2	758.01	1516.02	15	1	0.628339140534262	-0.714285714285714	1	-0.131578947368421	4	38
RAC2	0	4	0	3	191.07	382.14	15	1	1	NA	1	0	3	4
RAC3	0	9	0	0	359.04	718.08	15	1	1	NA	1	NA	0	9
RACGAP1	6	38	2	6	625.68	1251.36	15	1	0.592625910061836	-1.11111111111111	1	-0.113636363636364	8	44
RACGAP1L	7	21	11	3	358.71	717.42	15	1	0.00220649781565419	-10	0.334726684582354	-0.535714285714286	14	28
RACK1	0	12	0	17	252.78	505.56	15	1	1	NA	1	0	17	12
RAD1	3	14	1	0	297	594	15	1	0.222222222222222	-Inf	1	-0.823529411764706	1	17
RAD17	28	23	1	1	618.75	1237.5	15	1	1	0.178571428571429	1	0.0490196078431373	2	51
RAD18	35	17	5	7	532.95	1065.9	15	1	0.112835026386422	0.653061224489796	0.99134365547716	0.256410256410256	12	52
RAD21	1	20	0	3	627.66	1255.32	15	1	1	1	1	0.0476190476190476	3	21
RAD21L1	26	26	5	6	562.32	1124.64	15	1	1	0.166666666666667	1	0.0454545454545455	11	52
RAD23B	3	7	2	1	355.08	710.16	15	1	0.510489510489511	-3.66666666666667	1	-0.366666666666667	3	10
RAD50	22	59	3	8	1299.87	2599.74	15	1	1	-0.00568181818181812	1	-0.00112233445566778	11	81
RAD51	0	12	0	4	307.89	615.78	15	1	1	NA	1	0	4	12
RAD51AP2	37	12	1	0	540.87	1081.74	15	1	1	-Inf	1	-0.244897959183674	1	49
RAD51B	6	13	5	4	281.16	562.32	15	1	0.408695652173913	-1.70833333333333	1	-0.239766081871345	9	19
RAD51C	2	17	2	3	324.39	648.78	15	1	0.179277244494636	-4.66666666666667	1	-0.294736842105263	5	19
RAD51D	11	11	3	2	299.64	599.28	15	1	1	-0.5	1	-0.1	5	22
RAD52	7	14	3	0	413.16	826.32	15	1	0.0592885375494071	-Inf	0.865311545612266	-0.666666666666667	3	21
RAD54L	9	31	7	9	737.55	1475.1	15	1	0.18863042522299	-1.67901234567901	1	-0.2125	16	40
RAD9B	15	17	2	6	300.3	600.6	15	1	0.42843248106406	0.622222222222222	1	0.21875	8	32
RADIL	11	32	6	21	760.65	1521.3	15	1	1	0.168831168831169	1	0.0335917312661499	27	43
RAE1	0	10	0	1	365.31	730.62	15	1	1	NA	1	0	1	10
RAF1	1	10	0	6	641.52	1283.04	15	1	1	1	1	0.0909090909090909	6	11
RAG1	19	35	4	12	1031.58	2063.16	15	1	0.552927721618617	0.385964912280702	1	0.101851851851852	16	54
RAG2	6	22	7	6	529.65	1059.3	15	1	0.0693245341304526	-3.27777777777778	0.895874868259703	-0.324175824175824	13	28
RAI14	14	29	4	1	956.34	1912.68	15	1	0.05861575981835	-7.28571428571429	0.861744483565755	-0.474418604651163	5	43
RAI2	3	13	1	14	325.71	651.42	15	1	0.599555061179088	0.69047619047619	1	0.120833333333333	15	16
RALA	0	8	0	1	204.93	409.86	15	1	1	NA	1	0	1	8
RALB	0	1	0	3	204.93	409.86	15	1	1	NA	1	0	3	1
RALBP1	1	23	1	9	648.45	1296.9	15	1	0.508021390374332	-1.55555555555556	1	-0.0583333333333333	10	24
RALGAPA1	17	65	8	8	2468.4	4936.8	15	1	0.0250772631023989	-2.82352941176471	0.761210061313465	-0.292682926829268	16	82
RALGAPA2	23	62	4	12	1790.58	3581.16	15	1	1	0.101449275362319	1	0.0205882352941176	16	85
RALGAPB	2	39	5	7	1477.08	2954.16	15	1	0.00446413812413765	-12.9285714285714	0.458402469160589	-0.367886178861789	12	41
RALGDS	1	45	2	15	730.62	1461.24	15	1	0.174661932462038	-5	1	-0.0959079283887468	17	46
RALGPS1	7	20	1	1	426.69	853.38	15	1	0.482758620689655	-1.85714285714286	1	-0.240740740740741	2	27
RALYL	9	8	0	1	309.87	619.74	15	1	1	1	1	0.529411764705882	1	17
RAMP1	3	7	2	0	143.55	287.1	15	1	0.151515151515152	-Inf	1	-0.7	2	10
RAMP3	1	6	1	0	138.27	276.54	15	1	0.25	-Inf	1	-0.857142857142857	1	7
RAN	0	5	0	1	214.83	429.66	15	1	1	NA	1	0	1	5
RANBP1	2	7	0	1	202.95	405.9	15	1	1	1	1	0.222222222222222	1	9
RANBP10	0	21	1	5	535.26	1070.52	15	1	0.222222222222222	-Inf	1	-0.166666666666667	6	21
RANBP17	7	13	0	1	486.09	972.18	15	1	1	1	1	0.35	1	20
RANBP3	1	15	1	3	506.55	1013.1	15	1	0.368421052631579	-4	1	-0.1875	4	16
RANBP3L	34	26	8	1	608.85	1217.7	15	1	0.0793200287599111	-5.11764705882353	0.935492698701991	-0.322222222222222	9	60
RANBP9	0	17	1	2	552.75	1105.5	15	1	0.15	-Inf	1	-0.333333333333333	3	17
RAP1B	0	2	0	0	183.15	366.3	15	1	1	NA	1	NA	0	2
RAP1GDS1L	6	13	4	1	502.92	1005.84	15	1	0.122200263504611	-7.66666666666667	1	-0.48421052631579	5	19
RAP2A	0	3	0	0	135.96	271.92	15	1	1	NA	1	NA	0	3
RAP2B	0	1	0	2	178.86	357.72	15	1	1	NA	1	0	2	1
RAP2C	0	3	0	1	161.04	322.08	15	1	1	NA	1	0	1	3
RAPGEF1	8	21	0	6	779.79	1559.58	15	1	0.29936666748811	1	1	0.275862068965517	6	29
RAPGEF2	14	55	2	5	1768.47	3536.94	15	1	0.633599101706376	-0.571428571428571	1	-0.082815734989648	7	69
RAPGEF3	4	13	3	13	377.52	755.04	15	1	1	0.25	1	0.0477941176470588	16	17
RAPGEF5	4	24	1	6	661.32	1322.64	15	1	1	0	1	0	7	28
RAPGEF6	2	52	3	16	1644.39	3288.78	15	1	0.107026315127214	-3.875	0.983875031494079	-0.120857699805068	19	54
RAPSN	1	19	0	2	416.79	833.58	15	1	1	1	1	0.05	2	20
RARA-RARB	1	11	0	2	401.94	803.88	15	1	1	1	1	0.0833333333333333	2	12
RARRES1	11	10	2	3	241.89	483.78	15	1	1	0.393939393939394	1	0.123809523809524	5	21
RARS	5	27	0	6	640.53	1281.06	15	1	0.570149539189787	1	1	0.15625	6	32
RARS2	17	29	7	5	541.2	1082.4	15	1	0.205239735006142	-1.38823529411765	1	-0.213768115942029	12	46
RASA1	2	27	10	42	841.17	1682.34	15	1	0.195818856131558	-2.21428571428571	1	-0.123342175066313	52	29
RASA3	3	37	2	7	840.18	1680.36	15	1	0.223593044988578	-2.52380952380952	1	-0.147222222222222	9	40
RASA4	15	21	6	9	683.1	1366.2	15	1	1	0.0666666666666667	1	0.0166666666666667	15	36
RASAL1	8	7	7	6	305.91	611.82	15	1	1	-0.0208333333333333	1	-0.00512820512820511	13	15
RASAL2	3	38	1	4	1061.94	2123.88	15	1	0.379416000245121	-2.16666666666667	1	-0.126829268292683	5	41
RASD1	0	6	2	5	238.59	477.18	15	1	0.461538461538462	-Inf	1	-0.285714285714286	7	6
RASD2	0	6	0	1	264.33	528.66	15	1	1	NA	1	0	1	6
RASEF	8	26	1	0	678.48	1356.96	15	1	0.257142857142857	-Inf	1	-0.764705882352941	1	34
RASGEF1A	5	15	0	3	494.01	988.02	15	1	1	1	1	0.25	3	20
RASGEF1B	2	21	2	2	468.27	936.54	15	1	0.0917948717948718	-9.5	0.953786405978059	-0.41304347826087	4	23
RASGEF1C	3	18	3	6	830.61	1661.22	15	1	0.328700265251989	-2	1	-0.19047619047619	9	21
RASGRP1	8	24	1	0	744.15	1488.3	15	1	0.272727272727273	-Inf	1	-0.75	1	32
RASGRP3	1	23	1	8	670.23	1340.46	15	1	0.477272727272727	-1.875	1	-0.0694444444444444	9	24
RASL10A	1	8	0	6	204.27	408.54	15	1	1	1	1	0.111111111111111	6	9
RASL10B	0	4	1	0	184.47	368.94	15	1	0.2	-Inf	1	-1	1	4
RASL11A	1	5	1	7	202.95	405.9	15	1	1	0.285714285714286	1	0.0416666666666667	8	6
RASL11AL	0	3	0	1	248.49	496.98	15	1	1	NA	1	0	1	3
RASL11B	1	6	0	0	187.44	374.88	15	1	1	NA	1	NA	0	7
RASL12	4	6	2	5	238.26	476.52	15	1	1	0.4	1	0.114285714285714	7	10
RASSF10	3	5	0	0	273.57	547.14	15	1	1	NA	1	NA	0	8
RASSF2	3	21	0	2	295.02	590.04	15	1	1	1	1	0.125	2	24
RASSF3	7	7	0	4	236.61	473.22	15	1	0.119281045751634	1	1	0.5	4	14
RASSF5	2	19	0	3	260.04	520.08	15	1	1	1	1	0.0952380952380952	3	21
RASSF6	7	18	1	5	338.58	677.16	15	1	1	0.485714285714286	1	0.113333333333333	6	25
RASSF9	8	15	1	0	415.8	831.6	15	1	0.375	-Inf	1	-0.652173913043478	1	23
RAVER2	9	14	7	6	490.05	980.1	15	1	0.493239401804474	-0.814814814814815	1	-0.147157190635451	13	23
RAX	3	9	1	2	205.92	411.84	15	1	1	-0.5	1	-0.0833333333333333	3	12
RAX2	4	3	2	2	125.4	250.8	15	1	1	0.25	1	0.0714285714285714	4	7
RB1	13	24	1	5	559.02	1118.04	15	1	0.645475714243067	0.630769230769231	1	0.184684684684685	6	37
RBBP4	0	16	2	3	416.46	832.92	15	1	0.0476190476190476	-Inf	0.828231827900648	-0.4	5	16
RBBP5	16	37	5	12	760.98	1521.96	15	1	1	0.0364583333333334	1	0.00776914539400664	17	53
RBBP6	20	40	5	2	1719.63	3439.26	15	1	0.0927296316581383	-4	0.958259121672713	-0.380952380952381	7	60
RBBP7	3	13	3	5	393.03	786.06	15	1	0.36176409402954	-1.6	1	-0.1875	8	16
RBBP8NL	32	38	6	11	654.06	1308.12	15	1	0.587267713703336	0.352272727272727	1	0.104201680672269	17	70
RBFA	21	10	1	5	333.63	667.26	15	1	0.0305710121886593	0.904761904761905	0.773114333163925	0.510752688172043	6	31
RBFOX2	4	4	2	3	396	792	15	1	1	0.333333333333333	1	0.1	5	8
RBFOX3	0	4	0	2	198	396	15	1	1	NA	1	0	2	4
RBKS	0	2	4	0	290.4	580.8	15	1	0.0666666666666666	-Inf	0.884435842948953	-1	4	2
RBL1	13	26	5	1	955.68	1911.36	15	1	0.0306811736193472	-9	0.773114333163925	-0.5	6	39
RBL2	4	37	9	4	1052.37	2104.74	15	1	6.81491902337858e-05	-19.8125	0.0456978181178775	-0.594746716697936	13	41
RBM11	8	13	0	5	244.53	489.06	15	1	0.280510793554272	1	1	0.380952380952381	5	21
RBM12	3	28	0	6	827.97	1655.94	15	1	1	1	1	0.0967741935483871	6	31
RBM15	2	37	1	6	672.54	1345.08	15	1	0.397957839262187	-2.08333333333333	1	-0.0915750915750916	7	39
RBM17	0	14	1	4	398.97	797.94	15	1	0.263157894736842	-Inf	1	-0.2	5	14
RBM18	0	6	1	4	151.8	303.6	15	1	0.454545454545455	-Inf	1	-0.2	5	6
RBM19	22	56	7	4	933.57	1867.14	15	1	0.0347656762348886	-3.45454545454545	0.788199921465956	-0.354312354312354	11	78
RBM20	23	35	5	10	1162.59	2325.18	15	1	0.770433839816461	0.239130434782609	1	0.0632183908045977	15	58
RBM22	0	24	0	6	398.97	797.94	15	1	1	NA	1	0	6	24
RBM24	0	6	1	2	151.14	302.28	15	1	0.333333333333333	-Inf	1	-0.333333333333333	3	6
RBM25	2	23	1	4	838.2	1676.4	15	1	0.433497536945813	-1.875	1	-0.12	5	25
RBM27	4	36	5	3	979.11	1958.22	15	1	0.00322028419134993	-14	0.40070958958344	-0.525	8	40
RBM33	10	49	0	5	1117.71	2235.42	15	1	1	1	1	0.169491525423729	5	59
RBM34	26	21	3	4	337.59	675.18	15	1	0.691546429892712	0.394230769230769	1	0.124620060790274	7	47
RBM38	1	12	0	1	176.55	353.1	15	1	1	1	1	0.0769230769230769	1	13
RBM41	8	26	5	5	394.35	788.7	15	1	0.131125440496429	-2.25	1	-0.264705882352941	10	34
RBM43	11	15	2	3	365.31	730.62	15	1	1	0.0909090909090909	1	0.0230769230769231	5	26
RBM44	55	39	8	5	990.99	1981.98	15	1	1	-0.134545454545455	1	-0.030278232405892	13	94
RBM45	3	17	1	0	472.56	945.12	15	1	0.19047619047619	-Inf	1	-0.85	1	20
RBM46	0	16	0	0	471.24	942.48	15	1	1	NA	1	NA	0	16
RBM47	1	25	4	16	593.01	1186.02	15	1	0.151197078396269	-5.25	1	-0.161538461538462	20	26
RBM48	17	8	4	1	315.48	630.96	15	1	1	-0.882352941176471	1	-0.12	5	25
RBM5	1	43	1	6	855.03	1710.06	15	1	0.258039215686274	-6.16666666666667	1	-0.12012987012987	7	44
RBM7	2	13	1	0	281.49	562.98	15	1	0.1875	-Inf	1	-0.866666666666667	1	15
RBMX	0	15	1	1	377.19	754.38	15	1	0.117647058823529	-Inf	1	-0.5	2	15
RBMX2	7	13	2	1	454.41	908.82	15	1	0.537549407114625	-2.71428571428571	1	-0.316666666666667	3	20
RBP	4	6	0	2	236.61	473.22	15	1	0.515151515151515	1	1	0.4	2	10
RBP1	0	6	3	1	133.65	267.3	15	1	0.0333333333333333	-Inf	0.784275503573749	-0.75	4	6
RBP2	3	3	1	0	139.59	279.18	15	1	1	-Inf	1	-0.5	1	6
RBP3	22	39	12	2	1194.6	2389.2	15	1	0.000935202874991803	-9.63636363636364	0.248251522554939	-0.496487119437939	14	61
RBP4	2	8	0	3	195.03	390.06	15	1	1	1	1	0.2	3	10
RBP4A	1	6	0	1	198	396	15	1	1	1	1	0.142857142857143	1	7
RBP5	1	7	0	0	116.82	233.64	15	1	1	NA	1	NA	0	8
RBP7	1	4	0	2	133.65	267.3	15	1	1	1	1	0.2	2	5
RBPJ	2	11	0	1	447.48	894.96	15	1	1	1	1	0.153846153846154	1	13
RBPJL	39	26	11	8	561	1122	15	1	1	0.0833333333333334	1	0.0210526315789473	19	65
RBPMS	0	2	0	4	112.53	225.06	15	1	1	NA	1	0	4	2
RBSN	18	29	2	0	744.81	1489.62	15	1	0.16156462585034	-Inf	1	-0.617021276595745	2	47
RC3H1	3	33	1	6	1112.76	2225.52	15	1	0.522688598979013	-0.833333333333333	1	-0.0595238095238095	7	36
RC3H2	1	19	2	6	1180.08	2360.16	15	1	0.188034188034188	-5.33333333333333	1	-0.2	8	20
RCAN1	1	4	0	1	164.34	328.68	15	1	1	1	1	0.2	1	5
RCAN2	0	8	0	1	196.02	392.04	15	1	1	NA	1	0	1	8
RCBTB1	2	36	4	12	587.07	1174.14	15	1	0.0562760953437979	-5	0.846060006968071	-0.197368421052632	16	38
RCBTB2	1	21	0	5	546.48	1092.96	15	1	1	1	1	0.0454545454545455	5	22
RCC1	0	16	3	9	358.71	717.42	15	1	0.0671550671550672	-Inf	0.884435842948953	-0.25	12	16
RCC1L	10	23	2	7	419.43	838.86	15	1	1	0.342857142857143	1	0.0808080808080808	9	33
RCC2	2	10	2	6	363.99	727.98	15	1	1	-0.666666666666667	1	-0.0833333333333333	8	12
RCCD1	7	9	2	2	161.04	322.08	15	1	1	-0.285714285714286	1	-0.0625	4	16
RCHY1	2	7	1	0	187.77	375.54	15	1	0.3	-Inf	1	-0.777777777777778	1	9
RCL1	4	12	1	1	325.38	650.76	15	1	0.490196078431373	-2	1	-0.25	2	16
RCN1L	2	8	1	3	256.08	512.16	15	1	1	-0.333333333333333	1	-0.05	4	10
RCN2	3	6	0	1	232.32	464.64	15	1	1	1	1	0.333333333333333	1	9
RCOR1	0	5	0	1	363	726	15	1	1	NA	1	0	1	5
RCSD1	13	18	1	5	390.06	780.12	15	1	0.376093004769475	0.723076923076923	1	0.252688172043011	6	31
RD3	7	9	3	1	241.56	483.12	15	1	0.582043343653251	-2.85714285714286	1	-0.3125	4	16
RD3L	6	11	0	1	195.36	390.72	15	1	1	1	1	0.352941176470588	1	17
RDH10	2	13	0	2	273.57	547.14	15	1	1	1	1	0.133333333333333	2	15
RDH12	6	4	2	0	280.83	561.66	15	1	0.515151515151515	-Inf	1	-0.4	2	10
RDH14	5	17	1	0	308.88	617.76	15	1	0.260869565217391	-Inf	1	-0.772727272727273	1	22
RDH16	12	9	3	3	231.33	462.66	15	1	1	0.25	1	0.0714285714285714	6	21
RDH7L	11	14	0	0	319.77	639.54	15	1	1	NA	1	NA	0	25
RDH8	29	29	8	3	1012.44	2024.88	15	1	0.201844006569488	-1.66666666666667	1	-0.227272727272727	11	58
RDM1	7	8	3	1	249.48	498.96	15	1	0.582043343653251	-2.42857142857143	1	-0.283333333333333	4	15
RDX	0	15	0	5	578.16	1156.32	15	1	1	NA	1	0	5	15
REC114	6	11	2	2	231.66	463.32	15	1	0.617710944026733	-0.833333333333333	1	-0.147058823529412	4	17
RECK	3	38	1	3	938.19	1876.38	15	1	0.320312762173227	-3.22222222222222	1	-0.176829268292683	4	41
RECQL	21	27	1	1	655.38	1310.76	15	1	1	-0.285714285714286	1	-0.0625	2	48
RECQL5	29	31	5	9	1051.38	2102.76	15	1	0.553237985614839	0.406130268199234	1	0.126190476190476	14	60
REEP1-REEP4	6	4	1	2	213.84	427.68	15	1	0.559440559440559	0.666666666666667	1	0.266666666666667	3	10
REEP2	5	8	0	1	271.26	542.52	15	1	1	1	1	0.384615384615385	1	13
REEP3	4	10	2	0	244.86	489.72	15	1	0.125	-Inf	1	-0.714285714285714	2	14
REEP5	0	6	0	0	120.12	240.24	15	1	1	NA	1	NA	0	6
REEP6	2	4	1	1	76.89	153.78	15	1	1	-1	1	-0.166666666666667	2	6
REG4	8	3	0	4	146.85	293.7	15	1	0.0256410256410257	1	0.761210061313465	0.727272727272727	4	11
REL	11	27	2	6	584.76	1169.52	15	1	1	0.181818181818182	1	0.0394736842105263	8	38
RELL1	5	10	2	2	278.85	557.7	15	1	0.602683178534572	-1	1	-0.166666666666667	4	15
RELN	23	111	9	11	3037.32	6074.64	15	1	0.00785689953061469	-2.94861660079051	0.529186532206378	-0.278358208955224	20	134
REM1	4	3	4	1	233.31	466.62	15	1	0.575757575757576	-2	1	-0.228571428571429	5	7
REN	6	15	2	10	300.3	600.6	15	1	0.677561963435156	0.5	1	0.119047619047619	12	21
REPS1	27	24	1	7	916.08	1832.16	15	1	0.0547155512601946	0.873015873015873	0.846060006968071	0.404411764705882	8	51
RER1	0	2	0	1	195.03	390.06	15	1	1	NA	1	0	1	2
RERE	7	48	3	13	1297.23	2594.46	15	1	0.683569588597714	-0.582417582417582	1	-0.0602272727272727	16	55
RERG	5	7	0	1	227.7	455.4	15	1	1	1	1	0.416666666666667	1	12
REST	31	33	3	4	886.05	1772.1	15	1	1	0.201612903225806	1	0.0558035714285715	7	64
RET	5	44	1	4	1122	2244	15	1	0.458561712057828	-1.2	1	-0.0979591836734694	5	49
REV1	15	33	1	3	1090.98	2181.96	15	1	1	0.266666666666667	1	0.0625	4	48
REV3L	68	91	20	20	3404.94	6809.88	15	1	0.477272786772811	-0.338235294117647	1	-0.0723270440251572	40	159
REXO1	19	26	5	5	1178.76	2357.52	15	1	0.732509977094009	-0.368421052631579	1	-0.0777777777777778	10	45
REXO2	0	7	0	0	185.13	370.26	15	1	1	NA	1	NA	0	7
REXO4	22	21	3	4	396	792	15	1	1	0.284090909090909	1	0.0830564784053157	7	43
REXO5	23	26	2	4	729.63	1459.26	15	1	0.677885316065116	0.434782608695652	1	0.136054421768708	6	49
RFC1	20	51	5	8	1139.49	2278.98	15	1	0.51508841791951	-0.59375	1	-0.102925243770314	13	71
RFC2	1	13	2	5	314.16	628.32	15	1	0.247368421052632	-4.2	1	-0.214285714285714	7	14
RFC3	2	20	1	0	343.86	687.72	15	1	0.130434782608696	-Inf	1	-0.909090909090909	1	22
RFC4	2	14	1	1	355.74	711.48	15	1	0.313725490196078	-6	1	-0.375	2	16
RFC5	0	13	0	3	213.18	426.36	15	1	1	NA	1	0	3	13
RFFL	18	16	5	7	398.97	797.94	15	1	0.738110124610408	0.365079365079365	1	0.112745098039216	12	34
RFK	4	4	0	1	117.48	234.96	15	1	1	1	1	0.5	1	8
RFLNA	1	9	0	0	165.66	331.32	15	1	1	NA	1	NA	0	10
RFLNB	1	1	0	1	145.53	291.06	15	1	1	1	1	0.5	1	2
RFNG	1	3	0	1	223.74	447.48	15	1	1	1	1	0.25	1	4
RFT1	7	20	4	6	523.71	1047.42	15	1	0.441730401988532	-0.904761904761905	1	-0.140740740740741	10	27
RFTN1	10	22	8	2	580.14	1160.28	15	1	0.0103633659474481	-7.8	0.585928868752023	-0.4875	10	32
RFTN2	4	16	2	4	659.67	1319.34	15	1	0.595951874212744	-1	1	-0.133333333333333	6	20
RFX3	17	13	4	0	734.58	1469.16	15	1	0.144471278247369	-Inf	1	-0.433333333333333	4	30
RFX4	4	13	2	3	758.34	1516.68	15	1	0.585326953748006	-1.16666666666667	1	-0.164705882352941	5	17
RFX6	11	27	3	1	825.33	1650.66	15	1	0.1	-6.36363636363636	0.971353639774823	-0.460526315789474	4	38
RFX7	26	78	5	5	1325.28	2650.56	15	1	0.132073955103643	-2	1	-0.25	10	104
RFX8	15	12	2	1	519.09	1038.18	15	1	1	-0.6	1	-0.111111111111111	3	27
RFXANK	5	8	2	6	244.2	488.4	15	1	0.655658754729962	0.466666666666667	1	0.134615384615385	8	13
RFXAP	0	3	1	2	105.93	211.86	15	1	1	-Inf	1	-0.333333333333333	3	3
RGCCL	2	3	0	1	100.98	201.96	15	1	1	1	1	0.4	1	5
RGI3L1	8	32	9	22	876.81	1753.62	15	1	0.412223079064136	-0.636363636363636	1	-0.0903225806451613	31	40
RGL1	9	31	7	9	818.73	1637.46	15	1	0.18863042522299	-1.67901234567901	1	-0.2125	16	40
RGMA	2	30	0	4	400.62	801.24	15	1	1	1	1	0.0625	4	32
RGMB	6	18	2	1	319.77	639.54	15	1	0.201025641025641	-5	1	-0.416666666666667	3	24
RGN	3	14	2	2	297	594	15	1	0.228070175438597	-3.66666666666667	1	-0.323529411764706	4	17
RGNL	5	11	4	2	297.99	595.98	15	1	0.177797434763379	-3.4	1	-0.354166666666667	6	16
RGP1	1	20	1	4	358.71	717.42	15	1	0.353846153846154	-4	1	-0.152380952380952	5	21
RGR	7	6	1	0	293.04	586.08	15	1	1	-Inf	1	-0.461538461538462	1	13
RGS1	2	5	3	4	198	396	15	1	1	-0.875	1	-0.142857142857143	7	7
RGS10	1	7	0	2	173.91	347.82	15	1	1	1	1	0.125	2	8
RGS12	10	51	3	4	1519.65	3039.3	15	1	0.1220359894078	-2.825	1	-0.26463700234192	7	61
RGS14	4	21	2	8	486.75	973.5	15	1	1	-0.3125	1	-0.04	10	25
RGS16	2	13	0	2	201.96	403.92	15	1	1	1	1	0.133333333333333	2	15
RGS17	2	4	0	0	188.1	376.2	15	1	1	NA	1	NA	0	6
RGS18	0	4	1	0	232.65	465.3	15	1	0.2	-Inf	1	-1	1	4
RGS19	4	2	0	4	129.69	259.38	15	1	0.0761904761904763	1	0.919736921581953	0.666666666666667	4	6
RGS2	0	10	0	1	173.58	347.16	15	1	1	NA	1	0	1	10
RGS20	0	8	0	1	217.8	435.6	15	1	1	NA	1	0	1	8
RGS21	1	5	1	0	136.62	273.24	15	1	0.285714285714286	-Inf	1	-0.833333333333333	1	6
RGS22	44	37	16	2	1345.41	2690.82	15	1	0.00713994241978919	-5.72727272727273	0.495282212683078	-0.345679012345679	18	81
RGS3	16	45	12	17	981.09	1962.18	15	1	0.222623307520677	-0.985294117647059	1	-0.151498021481063	29	61
RGS4	3	10	3	7	207.9	415.8	15	1	1	-0.428571428571429	1	-0.0692307692307692	10	13
RGS5	0	3	0	1	134.97	269.94	15	1	1	NA	1	0	1	3
RGS6	6	13	1	4	467.28	934.56	15	1	1	0.458333333333333	1	0.11578947368421	5	19
RGS7BP	10	11	2	3	345.84	691.68	15	1	1	0.266666666666667	1	0.0761904761904761	5	21
RGS8	1	2	0	0	179.19	358.38	15	1	1	NA	1	NA	0	3
RGS9	13	27	5	5	588.72	1177.44	15	1	0.462681410622275	-1.07692307692308	1	-0.175	10	40
RGS9BP	4	12	0	0	235.62	471.24	15	1	1	NA	1	NA	0	16
RGSL1	62	40	11	18	1091.31	2182.62	15	1	0.0350362183805646	0.60573476702509	0.788199921465956	0.228532792427316	29	102
RHAG	10	17	0	2	422.73	845.46	15	1	0.532019704433498	1	1	0.37037037037037	2	27
RHBDD1	7	24	5	3	315.81	631.62	15	1	0.0793657434524307	-4.71428571428571	0.935492698701991	-0.399193548387097	8	31
RHBDD2	18	13	0	5	187.77	375.54	15	1	0.0454545454545455	1	0.822543273817637	0.580645161290323	5	31
RHBDF2	5	12	1	11	566.28	1132.56	15	1	0.35438507852301	0.781818181818182	1	0.21078431372549	12	17
RHBDL3	1	6	1	3	366.3	732.6	15	1	1	-1	1	-0.107142857142857	4	7
RHBG	5	6	5	4	207.57	415.14	15	1	1	-0.5	1	-0.101010101010101	9	11
RHCG	0	22	1	6	463.32	926.64	15	1	0.241379310344828	-Inf	1	-0.142857142857143	7	22
RHNO1	17	21	7	6	240.57	481.14	15	1	0.749033630178879	-0.441176470588235	1	-0.0910931174089069	13	38
RHO	0	13	0	3	348.48	696.96	15	1	1	NA	1	0	3	13
RHOB	0	14	0	6	194.7	389.4	15	1	1	NA	1	0	6	14
RHOBTB1	5	23	1	1	689.04	1378.08	15	1	0.36551724137931	-3.6	1	-0.321428571428571	2	28
RHOBTB2	1	8	0	13	615.12	1230.24	15	1	0.409090909090909	1	1	0.111111111111111	13	9
RHOD	9	11	3	3	211.2	422.4	15	1	1	-0.222222222222222	1	-0.05	6	20
RHOF	2	9	1	2	185.79	371.58	15	1	1	-1.25	1	-0.151515151515151	3	11
RHOG	0	2	1	1	179.85	359.7	15	1	1	-Inf	1	-0.5	2	2
RHOGL	0	10	0	0	190.08	380.16	15	1	1	NA	1	NA	0	10
RHOH	0	6	1	2	190.08	380.16	15	1	0.333333333333333	-Inf	1	-0.333333333333333	3	6
RHOJ	4	8	0	0	246.51	493.02	15	1	1	NA	1	NA	0	12
RHOT1	2	12	2	3	626.67	1253.34	15	1	0.27218782249742	-3	1	-0.257142857142857	5	14
RHOU	0	3	0	3	188.1	376.2	15	1	1	NA	1	0	3	3
RHOV	0	14	0	0	229.68	459.36	15	1	1	NA	1	NA	0	14
RHPN1	6	17	2	15	625.02	1250.04	15	1	0.42843248106406	0.622222222222222	1	0.143222506393862	17	23
RHPN2	4	20	2	2	674.85	1349.7	15	1	0.191452991452991	-4	1	-0.333333333333333	4	24
RIBC2	14	11	1	1	360.69	721.38	15	1	1	0.214285714285714	1	0.0600000000000001	2	25
RIC1	11	33	4	5	1556.28	3112.56	15	1	0.252013047256794	-1.4	1	-0.194444444444444	9	44
RIC3	17	17	4	2	370.92	741.84	15	1	0.664241164241164	-1	1	-0.166666666666667	6	34
RIC8A	4	24	2	8	534.6	1069.2	15	1	0.644000882390975	-0.5	1	-0.0571428571428572	10	28
RICTOR	6	42	4	3	1662.87	3325.74	15	1	0.0159611014217008	-8.33333333333333	0.657510218975864	-0.446428571428571	7	48
RIDA	1	4	0	0	115.83	231.66	15	1	1	NA	1	NA	0	5
RIF1	124	141	22	26	2251.26	4502.52	15	1	1	0.0378411910669976	1	0.00959119496855348	48	265
RILP	13	19	10	8	399.3	798.6	15	1	0.38168396541093	-0.826923076923077	1	-0.149305555555556	18	32
RILPL1	2	11	0	2	371.25	742.5	15	1	1	1	1	0.153846153846154	2	13
RILPL2	1	2	0	0	164.01	328.02	15	1	1	NA	1	NA	0	3
RIMBP2	31	41	7	11	1518.66	3037.32	15	1	0.795850591203009	0.158357771260997	1	0.0416666666666667	18	72
RIMKLB	2	7	2	3	344.85	689.7	15	1	0.58041958041958	-1.33333333333333	1	-0.177777777777778	5	9
RIMS1	7	12	3	2	689.04	1378.08	15	1	0.614624505928854	-1.57142857142857	1	-0.231578947368421	5	19
RIMS2	13	29	3	7	1455.96	2911.92	15	1	1	0.0439560439560439	1	0.00952380952380955	10	42
RIMS3	2	1	1	4	255.09	510.18	15	1	0.464285714285714	0.875	1	0.466666666666667	5	3
RIMS4	0	7	2	2	236.28	472.56	15	1	0.109090909090909	-Inf	0.98538656216834	-0.5	4	7
RIN2	22	31	0	4	908.16	1816.32	15	1	0.151072124756335	1	1	0.415094339622642	4	53
RIN3	13	33	3	2	884.4	1768.8	15	1	0.309017223910841	-2.80769230769231	1	-0.317391304347826	5	46
RINT1	12	41	4	3	1156.32	2312.64	15	1	0.074053566932462	-3.55555555555556	0.913861472365723	-0.345013477088949	7	53
RIOK1	19	22	5	6	557.37	1114.74	15	1	1	0.0350877192982456	1	0.00886917960088696	11	41
RIOK2	13	23	4	4	517.77	1035.54	15	1	0.690257934279787	-0.769230769230769	1	-0.138888888888889	8	36
RIOK3	9	12	0	6	510.18	1020.36	15	1	0.070659775007601	1	0.905375248770429	0.428571428571429	6	21
RIPK1	17	44	6	5	685.08	1370.16	15	1	0.156383280174386	-2.10588235294118	1	-0.266766020864382	11	61
RIPK3	20	19	3	2	460.35	920.7	15	1	1	-0.425	1	-0.0871794871794872	5	39
RIPK4	3	25	4	8	781.77	1563.54	15	1	0.167977575098318	-3.16666666666667	1	-0.226190476190476	12	28
RIPPLY3	6	0	1	0	130.68	261.36	15	1	1	NA	1	0	1	6
RIT1	0	7	0	1	194.37	388.74	15	1	1	NA	1	0	1	7
RLBP1	6	22	2	4	313.83	627.66	15	1	0.608715566315514	-0.833333333333333	1	-0.119047619047619	6	28
RLF	57	70	5	7	2001.45	4002.9	15	1	1	0.12280701754386	1	0.0321522309711286	12	127
RLN3	2	4	1	1	162.03	324.06	15	1	1	-1	1	-0.166666666666667	2	6
RLTPR	16	38	19	21	1326.6	2653.2	15	1	0.0880876431636411	-1.14880952380952	0.951689130777703	-0.178703703703704	40	54
RMDN1	2	11	0	0	269.61	539.22	15	1	1	NA	1	NA	0	13
RMDN2	10	9	5	2	412.83	825.66	15	1	0.657608695652174	-1.25	1	-0.18796992481203	7	19
RMDN3	1	19	1	2	370.92	741.84	15	1	0.24901185770751	-8.5	1	-0.283333333333333	3	20
RMI1	33	33	2	1	613.8	1227.6	15	1	1	-1	1	-0.166666666666667	3	66
RMI2	2	2	1	1	79.53	159.06	15	1	1	0	1	0	2	4
RMND1	9	14	0	1	442.53	885.06	15	1	1	1	1	0.391304347826087	1	23
RMND5A	0	14	1	6	341.22	682.44	15	1	0.333333333333333	-Inf	1	-0.142857142857143	7	14
RNASEH1	10	12	0	0	274.23	548.46	15	1	1	NA	1	NA	0	22
RNASEH2B	6	8	2	1	254.1	508.2	15	1	0.576470588235294	-1.66666666666667	1	-0.238095238095238	3	14
RNASEL	48	29	14	8	716.76	1433.52	15	1	1	-0.0572916666666667	1	-0.012987012987013	22	77
RND2	0	5	1	1	163.02	326.04	15	1	0.285714285714286	-Inf	1	-0.5	2	5
RND3	0	5	0	1	165	330	15	1	1	NA	1	0	1	5
RNF103	8	27	1	3	646.8	1293.6	15	1	1	-0.125	1	-0.0214285714285714	4	35
RNF11	1	1	0	0	150.15	300.3	15	1	1	NA	1	NA	0	2
RNF111	5	31	2	8	976.14	1952.28	15	1	0.636094601593134	-0.55	1	-0.0611111111111111	10	36
RNF113A	0	16	2	3	265.32	530.64	15	1	0.0476190476190476	-Inf	0.828231827900648	-0.4	5	16
RNF114	1	14	0	1	180.51	361.02	15	1	1	1	1	0.0666666666666667	1	15
RNF121	1	18	0	5	303.93	607.86	15	1	1	1	1	0.0526315789473684	5	19
RNF122	2	2	1	0	141.9	283.8	15	1	1	-Inf	1	-0.5	1	4
RNF126	2	11	0	3	225.72	451.44	15	1	1	1	1	0.153846153846154	3	13
RNF128	3	11	2	2	270.6	541.2	15	1	0.532679738562091	-2.66666666666667	1	-0.285714285714286	4	14
RNF13	6	9	0	0	361.35	722.7	15	1	1	NA	1	NA	0	15
RNF130	2	13	0	3	382.8	765.6	15	1	1	1	1	0.133333333333333	3	15
RNF138	1	2	0	1	209.22	418.44	15	1	1	1	1	0.333333333333333	1	3
RNF139	12	33	1	8	630.3	1260.6	15	1	0.428432734167446	0.65625	1	0.155555555555556	9	45
RNF14	7	20	0	6	470.25	940.5	15	1	0.300801395489938	1	1	0.259259259259259	6	27
RNF141	1	9	0	2	240.57	481.14	15	1	1	1	1	0.1	2	10
RNF144A	11	10	1	1	343.53	687.06	15	1	1	0.0909090909090909	1	0.0238095238095238	2	21
RNF144B	8	10	2	0	271.26	542.52	15	1	0.473684210526316	-Inf	1	-0.555555555555556	2	18
RNF145	9	25	4	6	703.89	1407.78	15	1	0.448916769870885	-0.851851851851852	1	-0.135294117647059	10	34
RNF149	1	18	1	5	290.4	580.8	15	1	0.43	-2.6	1	-0.114035087719298	6	19
RNF150	0	5	0	2	267.3	534.6	15	1	1	NA	1	0	2	5
RNF151	2	12	0	4	285.12	570.24	15	1	1	1	1	0.142857142857143	4	14
RNF152	0	11	1	10	201.96	403.92	15	1	1	-Inf	1	-0.0909090909090909	11	11
RNF157	2	8	4	9	380.82	761.64	15	1	0.660019614253024	-0.777777777777778	1	-0.107692307692308	13	10
RNF165	5	17	3	4	450.45	900.9	15	1	0.356806212278476	-1.55	1	-0.201298701298701	7	22
RNF166	1	1	1	1	176.88	353.76	15	1	1	0	1	0	2	2
RNF168	32	24	6	1	604.89	1209.78	15	1	0.228094814373415	-3.5	1	-0.285714285714286	7	56
RNF169	18	21	4	15	535.92	1071.84	15	1	0.0865844014515312	0.688888888888889	0.951277979139867	0.251012145748988	19	39
RNF17	64	62	9	10	1545.39	3090.78	15	1	0.810385407980574	0.128125	1	0.0342522974101921	19	126
RNF180	4	3	2	0	100.98	201.96	15	1	0.5	-Inf	1	-0.428571428571429	2	7
RNF186	13	18	1	2	336.6	673.2	15	1	1	0.307692307692308	1	0.0860215053763441	3	31
RNF19A	6	55	7	6	804.87	1609.74	15	1	0.000987247148520055	-9.69444444444444	0.248251522554939	-0.440100882723834	13	61
RNF19B	2	36	0	7	526.02	1052.04	15	1	1	1	1	0.0526315789473684	7	38
RNF2	3	16	2	2	362.34	724.68	15	1	0.193675889328063	-4.33333333333333	1	-0.342105263157895	4	19
RNF20	5	49	9	10	938.52	1877.04	15	1	0.000874442806669907	-7.82	0.24410961674588	-0.381091617933723	19	54
RNF207	11	31	2	3	456.39	912.78	15	1	0.60696742178144	-0.878787878787879	1	-0.138095238095238	5	42
RNF213	247	193	32	44	5442.69	10885.38	15	1	0.0252148409120967	0.431726168568274	0.761210061313465	0.140311004784689	76	440
RNF214	2	22	0	3	472.89	945.78	15	1	1	1	1	0.0833333333333333	3	24
RNF216	24	42	8	14	898.59	1797.18	15	1	1	0	1	0	22	66
RNF217	1	7	1	1	252.45	504.9	15	1	0.377777777777778	-6	1	-0.375	2	8
RNF219	9	26	2	1	679.47	1358.94	15	1	0.195590327169275	-4.77777777777778	1	-0.40952380952381	3	35
RNF220	2	8	2	3	387.75	775.5	15	1	0.56043956043956	-1.66666666666667	1	-0.2	5	10
RNF222	7	12	2	3	212.19	424.38	15	1	1	-0.142857142857143	1	-0.0315789473684211	5	19
RNF223	12	8	7	4	362.34	724.68	15	1	1	-0.166666666666667	1	-0.0363636363636364	11	20
RNF25	15	29	3	11	376.86	753.72	15	1	0.51329050735285	0.472727272727273	1	0.126623376623377	14	44
RNF26	4	10	3	5	241.23	482.46	15	1	1	-0.5	1	-0.0892857142857143	8	14
RNF32	10	8	2	2	366.3	732.6	15	1	1	0.2	1	0.0555555555555556	4	18
RNF34	6	14	2	1	347.49	694.98	15	1	0.268774703557312	-3.66666666666667	1	-0.366666666666667	3	20
RNF38	8	18	2	3	477.18	954.36	15	1	1	-0.5	1	-0.0923076923076923	5	26
RNF4	1	5	0	0	192.06	384.12	15	1	1	NA	1	NA	0	6
RNF41	0	8	0	3	314.82	629.64	15	1	1	NA	1	0	3	8
RNF43	21	29	5	7	800.25	1600.5	15	1	1	0.0136054421768708	1	0.0033333333333333	12	50
RNF44	0	2	0	0	122.76	245.52	15	1	1	NA	1	NA	0	2
RNF6	20	28	2	11	683.1	1366.2	15	1	0.108557117538829	0.745454545454545	0.985224113668503	0.262820512820513	13	48
RNF8	8	19	3	3	468.27	936.54	15	1	0.375208565072302	-1.375	1	-0.203703703703704	6	27
RNFT1	4	8	2	2	386.1	772.2	15	1	0.604395604395604	-1	1	-0.166666666666667	4	12
RNFT2	11	23	3	5	544.5	1089	15	1	1	-0.254545454545455	1	-0.0514705882352941	8	34
RNGTT	1	22	0	5	573.87	1147.74	15	1	1	1	1	0.0434782608695652	5	23
RNH1	2	18	1	5	452.43	904.86	15	1	1	-0.8	1	-0.0666666666666667	6	20
RNLS	7	10	0	0	351.78	703.56	15	1	1	NA	1	NA	0	17
RNMT	4	11	1	2	358.71	717.42	15	1	1	-0.375	1	-0.0666666666666667	3	15
RNPC3	7	17	1	2	436.26	872.52	15	1	1	-0.214285714285714	1	-0.0416666666666666	3	24
RNPEP	2	16	3	10	488.73	977.46	15	1	0.625403887917792	-1.4	1	-0.11965811965812	13	18
RNPEPL1	0	19	0	4	576.84	1153.68	15	1	1	NA	1	0	4	19
RNPS1	5	25	1	8	330.66	661.32	15	1	1	0.375	1	0.0555555555555556	9	30
ROBO2	4	23	1	4	784.08	1568.16	15	1	1	-0.4375	1	-0.0518518518518519	5	27
ROBO3	22	44	4	4	591.36	1182.72	15	1	0.439986332469474	-1	1	-0.166666666666667	8	66
ROBO4	57	65	10	8	921.03	1842.06	15	1	0.614725911826658	-0.425438596491228	1	-0.0883424408014572	18	122
ROCK1	25	35	6	13	1453.32	2906.64	15	1	0.59104538999381	0.353846153846154	1	0.100877192982456	19	60
ROM1	6	10	3	1	361.35	722.7	15	1	0.284829721362229	-4	1	-0.375	4	16
ROMO1	0	3	0	0	79.2	158.4	15	1	1	NA	1	NA	0	3
ROPN1L	11	15	3	3	216.81	433.62	15	1	1	-0.363636363636364	1	-0.0769230769230769	6	26
ROR1	0	40	1	7	888.03	1776.06	15	1	0.166666666666667	-Inf	1	-0.125	8	40
ROR2	2	33	1	0	889.02	1778.04	15	1	0.0833333333333333	-Inf	0.949431371776132	-0.942857142857143	1	35
RORA	1	3	0	1	467.28	934.56	15	1	1	1	1	0.25	1	4
ROS1	84	84	8	8	2307.69	4615.38	15	1	1	0	1	0	16	168
RP11-762I7.5	1	11	5	3	232.32	464.64	15	1	0.0180598555211558	-17.3333333333333	0.677255339142531	-0.541666666666667	8	12
RP1L1	74	66	17	12	1625.91	3251.82	15	1	0.683359996762502	-0.263513513513514	1	-0.0576354679802955	29	140
RP2	0	9	3	0	313.83	627.66	15	1	0.00454545454545454	-Inf	0.458402469160589	-1	3	9
RP9	2	12	0	0	208.89	417.78	15	1	1	NA	1	NA	0	14
RPA1	7	23	0	5	594.99	1189.98	15	1	0.558500086251509	1	1	0.233333333333333	5	30
RPA2	2	17	0	1	261.36	522.72	15	1	1	1	1	0.105263157894737	1	19
RPA3	0	3	0	1	106.92	213.84	15	1	1	NA	1	0	1	3
RPAIN	3	10	1	5	177.87	355.74	15	1	1	0.333333333333333	1	0.0641025641025641	6	13
RPAP1	32	49	16	11	1423.62	2847.24	15	1	0.116550607535755	-1.22727272727273	1	-0.197530864197531	27	81
RPAP2	12	31	1	3	573.87	1147.74	15	1	1	0.138888888888889	1	0.0290697674418605	4	43
RPAP3	21	27	3	4	664.29	1328.58	15	1	1	0.0357142857142857	1	0.00892857142857145	7	48
RPE	0	8	0	0	139.26	278.52	15	1	1	NA	1	NA	0	8
RPE65	3	29	4	17	528.66	1057.32	15	1	0.415375896212791	-1.27450980392157	1	-0.0967261904761905	21	32
RPESL	2	12	1	0	204.93	409.86	15	1	0.2	-Inf	1	-0.857142857142857	1	14
RPF1	3	13	0	1	257.73	515.46	15	1	1	1	1	0.1875	1	16
RPF2	2	14	0	2	297.66	595.32	15	1	1	1	1	0.125	2	16
RPGRIP1L	58	37	8	8	1271.16	2542.32	15	1	0.422520196344522	0.362068965517241	1	0.110526315789474	16	95
RPH3A	8	24	6	18	540.87	1081.74	15	1	1	0	1	0	24	32
RPH3AL	10	15	3	7	354.42	708.84	15	1	0.709399332591769	0.357142857142857	1	0.1	10	25
RPIA	0	9	0	4	214.83	429.66	15	1	1	NA	1	0	4	9
RPL10A	1	7	1	10	217.47	434.94	15	1	1	0.3	1	0.0340909090909091	11	8
RPL11	0	12	0	0	174.57	349.14	15	1	1	NA	1	NA	0	12
RPL12	0	2	0	3	154.77	309.54	15	1	1	NA	1	0	3	2
RPL13	2	7	0	3	209.88	419.76	15	1	1	1	1	0.222222222222222	3	9
RPL14	3	5	0	2	119.79	239.58	15	1	1	1	1	0.375	2	8
RPL15	0	9	0	2	202.95	405.9	15	1	1	NA	1	0	2	9
RPL18A	2	7	0	1	162.36	324.72	15	1	1	1	1	0.222222222222222	1	9
RPL19	0	7	0	0	185.79	371.58	15	1	1	NA	1	NA	0	7
RPL22	0	2	0	0	41.25	82.5	15	1	1	NA	1	NA	0	2
RPL23	0	10	0	2	111.21	222.42	15	1	1	NA	1	0	2	10
RPL23A	0	22	0	5	146.19	292.38	15	1	1	NA	1	0	5	22
RPL24	0	3	0	2	149.49	298.98	15	1	1	NA	1	0	2	3
RPL26L1	0	9	0	3	144.54	289.08	15	1	1	NA	1	0	3	9
RPL27	0	8	0	2	135.63	271.26	15	1	1	NA	1	0	2	8
RPL29	1	1	0	2	70.29	140.58	15	1	1	1	1	0.5	2	2
RPL3	3	24	1	4	399.96	799.92	15	1	0.511957730812013	-1	1	-0.0888888888888889	5	27
RPL30	0	4	0	3	107.91	215.82	15	1	1	NA	1	0	3	4
RPL31	0	9	0	2	124.74	249.48	15	1	1	NA	1	0	2	9
RPL34	0	8	1	0	116.82	233.64	15	1	0.111111111111111	-Inf	0.98538656216834	-1	1	8
RPL35A	0	4	0	2	104.94	209.88	15	1	1	NA	1	0	2	4
RPL36	0	2	1	0	91.74	183.48	15	1	0.333333333333333	-Inf	1	-1	1	2
RPL36A	0	5	0	3	93.06	186.12	15	1	1	NA	1	0	3	5
RPL37	5	4	0	0	79.86	159.72	15	1	1	NA	1	NA	0	9
RPL38	0	1	0	1	64.68	129.36	15	1	1	NA	1	0	1	1
RPL3L	4	17	2	4	403.59	807.18	15	1	0.587534204925509	-1.125	1	-0.142857142857143	6	21
RPL4	6	17	0	6	359.37	718.74	15	1	0.295358090185676	1	1	0.260869565217391	6	23
RPL5	2	11	0	2	280.83	561.66	15	1	1	1	1	0.153846153846154	2	13
RPL6	8	12	0	4	273.24	546.48	15	1	0.262187088274045	1	1	0.4	4	20
RPL7	1	13	1	2	244.53	489.06	15	1	0.330882352941176	-5.5	1	-0.261904761904762	3	14
RPL7A	0	11	0	2	263.34	526.68	15	1	1	NA	1	0	2	11
RPL7L1	16	7	0	4	241.23	482.46	15	1	0.0188034188034188	1	0.683149554847669	0.695652173913043	4	23
RPL8	0	14	0	3	240.57	481.14	15	1	1	NA	1	0	3	14
RPL9	3	11	0	2	180.84	361.68	15	1	1	1	1	0.214285714285714	2	14
RPLP1	1	5	0	2	94.05	188.1	15	1	1	1	1	0.166666666666667	2	6
RPLP2	0	7	0	0	79.86	159.72	15	1	1	NA	1	NA	0	7
RPN2	5	30	3	8	618.42	1236.84	15	1	0.374384858416524	-1.25	1	-0.12987012987013	11	35
RPP14	2	3	1	2	122.43	244.86	15	1	1	0.25	1	0.0666666666666667	3	5
RPP25	4	9	3	1	165.66	331.32	15	1	0.25	-5.75	1	-0.442307692307692	4	13
RPP25L	3	14	1	0	184.14	368.28	15	1	0.222222222222222	-Inf	1	-0.823529411764706	1	17
RPP30	14	15	4	5	349.14	698.28	15	1	1	0.142857142857143	1	0.0383141762452108	9	29
RPRD1A	16	13	2	3	367.62	735.24	15	1	0.648093841642229	0.458333333333333	1	0.151724137931034	5	29
RPRD1B	0	21	0	3	321.42	642.84	15	1	1	NA	1	0	3	21
RPRD2	24	109	8	26	1379.73	2759.46	15	1	0.47015810520735	-0.397435897435897	1	-0.05484298982751	34	133
RPRML	0	3	2	3	110.88	221.76	15	1	0.464285714285714	-Inf	1	-0.4	5	3
RPS10	0	9	2	2	168.63	337.26	15	1	0.0769230769230769	-Inf	0.922367800589409	-0.5	4	9
RPS11	0	8	0	3	152.46	304.92	15	1	1	NA	1	0	3	8
RPS12	0	3	0	1	135.63	271.26	15	1	1	NA	1	0	1	3
RPS14	0	13	0	2	150.48	300.96	15	1	1	NA	1	0	2	13
RPS15	0	2	0	1	110.88	221.76	15	1	1	NA	1	0	1	2
RPS16	0	5	0	4	129.69	259.38	15	1	1	NA	1	0	4	5
RPS17	0	4	0	0	91.08	182.16	15	1	1	NA	1	NA	0	4
RPS19BP1	3	2	1	0	60.39	120.78	15	1	1	-Inf	1	-0.4	1	5
RPS2	0	25	0	7	279.51	559.02	15	1	1	NA	1	0	7	25
RPS20	0	10	1	2	117.81	235.62	15	1	0.230769230769231	-Inf	1	-0.333333333333333	3	10
RPS21	0	2	0	0	83.16	166.32	15	1	1	NA	1	NA	0	2
RPS23	0	5	0	0	118.8	237.6	15	1	1	NA	1	NA	0	5
RPS24	0	2	0	0	129.69	259.38	15	1	1	NA	1	NA	0	2
RPS25	1	7	0	0	92.07	184.14	15	1	1	NA	1	NA	0	8
RPS27A	0	4	0	0	144.21	288.42	15	1	1	NA	1	NA	0	4
RPS27L	1	1	0	0	72.93	145.86	15	1	1	NA	1	NA	0	2
RPS28	0	3	0	2	69.3	138.6	15	1	1	NA	1	0	2	3
RPS3	0	8	0	1	239.25	478.5	15	1	1	NA	1	0	1	8
RPS3A	0	10	0	1	252.78	505.56	15	1	1	NA	1	0	1	10
RPS4X	0	13	0	5	234.63	469.26	15	1	1	NA	1	0	5	13
RPS6KA1L	10	33	1	7	765.27	1530.54	15	1	0.668462389581179	0.528571428571429	1	0.107558139534884	8	43
RPS6KA2	2	22	2	3	695.97	1391.94	15	1	0.126520988589954	-6.33333333333333	1	-0.316666666666667	5	24
RPS6KA3	1	19	0	1	709.83	1419.66	15	1	1	1	1	0.05	1	20
RPS6KA5	0	18	0	1	758.01	1516.02	15	1	1	NA	1	0	1	18
RPS6KB1	1	7	0	2	474.21	948.42	15	1	1	1	1	0.125	2	8
RPS6KC1	15	30	4	4	1042.8	2085.6	15	1	0.436312933919972	-1	1	-0.166666666666667	8	45
RPS6KL1	12	19	4	10	441.87	883.74	15	1	0.737848673347726	0.366666666666667	1	0.101382488479263	14	31
RPS7	0	6	0	0	193.05	386.1	15	1	1	NA	1	NA	0	6
RPS8	0	16	0	2	205.59	411.18	15	1	1	NA	1	0	2	16
RPSA	0	17	0	0	294.03	588.06	15	1	1	NA	1	NA	0	17
RPTC15L	0	3	0	0	126.06	252.12	15	1	1	NA	1	NA	0	3
RPUSD1	3	10	4	10	300.96	601.92	15	1	1	-0.333333333333333	1	-0.0549450549450549	14	13
RPUSD4	9	11	2	0	270.6	541.2	15	1	0.476190476190476	-Inf	1	-0.55	2	20
RRAD	1	6	2	0	231.99	463.98	15	1	0.0833333333333333	-Inf	0.949431371776132	-0.857142857142857	2	7
RRAGA	0	13	0	3	301.95	603.9	15	1	1	NA	1	0	3	13
RRAGC	0	7	0	0	317.79	635.58	15	1	1	NA	1	NA	0	7
RRAGD	2	9	0	2	376.53	753.06	15	1	1	1	1	0.181818181818182	2	11
RRAS2	5	8	6	3	201.96	403.92	15	1	0.386996904024768	-2.2	1	-0.282051282051282	9	13
RRBP1	14	39	5	10	990	1980	15	1	0.745446884557969	-0.392857142857143	1	-0.0691823899371069	15	53
RREB1	17	42	3	9	1504.8	3009.6	15	1	1	0.176470588235294	1	0.038135593220339	12	59
RRM1	2	50	5	20	778.14	1556.28	15	1	0.0333250174939097	-5.25	0.784275503573749	-0.161538461538462	25	52
RRM2B	3	15	1	4	332.64	665.28	15	1	1	-0.25	1	-0.0333333333333334	5	18
RRN3	8	20	1	0	610.83	1221.66	15	1	0.310344827586207	-Inf	1	-0.714285714285714	1	28
RRP12	33	52	12	22	1164.9	2329.8	15	1	0.835033034558238	0.140495867768595	1	0.0352941176470588	34	85
RRP15	8	5	1	0	239.25	478.5	15	1	1	-Inf	1	-0.384615384615385	1	13
RRP1B	26	27	7	8	706.53	1413.06	15	1	1	0.0913461538461539	1	0.0238993710691824	15	53
RRP36	17	11	4	0	217.8	435.6	15	1	0.271968854282536	-Inf	1	-0.392857142857143	4	28
RRP7A	6	10	3	3	231.99	463.98	15	1	0.655019902697921	-0.666666666666667	1	-0.125	6	16
RRP8	8	14	4	3	247.83	495.66	15	1	0.402857545586181	-1.33333333333333	1	-0.207792207792208	7	22
RRS1	4	7	0	1	128.04	256.08	15	1	1	1	1	0.363636363636364	1	11
RS1	4	10	0	5	222.75	445.5	15	1	0.530443756449948	1	1	0.285714285714286	5	14
RSAD2	8	18	0	0	401.94	803.88	15	1	1	NA	1	NA	0	26
RSF1	32	45	11	11	1447.38	2894.76	15	1	0.626444037519867	-0.40625	1	-0.0844155844155844	22	77
RSL1D1	18	12	3	3	439.56	879.12	15	1	0.677365447645334	0.333333333333333	1	0.1	6	30
RSL24D1	12	3	3	1	189.75	379.5	15	1	1	0.25	1	0.05	4	15
RSPH1	12	16	4	14	315.48	630.96	15	1	0.209861126609569	0.619047619047619	1	0.206349206349206	18	28
RSPH10B	46	34	3	4	894.96	1789.92	15	1	0.694116540366018	0.445652173913043	1	0.146428571428571	7	80
RSPH3	20	14	2	6	420.09	840.18	15	1	0.122982269323733	0.766666666666667	1	0.338235294117647	8	34
RSPH9	4	8	1	2	212.85	425.7	15	1	1	0	1	0	3	12
RSPO1	2	6	1	3	256.41	512.82	15	1	1	0	1	0	4	8
RSPO2	2	1	1	0	201.96	403.92	15	1	1	-Inf	1	-0.333333333333333	1	3
RSPO3	0	4	1	1	178.2	356.4	15	1	0.333333333333333	-Inf	1	-0.5	2	4
RSPO4	1	5	0	6	146.85	293.7	15	1	1	1	1	0.166666666666667	6	6
RSPRY1	5	25	5	6	570.24	1140.48	15	1	0.0980797351379924	-3.16666666666667	0.971353639774823	-0.287878787878788	11	30
RSRC1	6	3	3	0	137.61	275.22	15	1	0.509090909090909	-Inf	1	-0.333333333333333	3	9
RSRC2	0	17	0	2	361.68	723.36	15	1	1	NA	1	0	2	17
RSU1	13	10	7	4	329.34	658.68	15	1	1	-0.346153846153846	1	-0.0711462450592886	11	23
RTCA	0	9	0	2	347.49	694.98	15	1	1	NA	1	0	2	9
RTCB	0	20	0	4	475.53	951.06	15	1	1	NA	1	0	4	20
RTEL1	40	55	7	22	1497.54	2995.08	15	1	0.124821178318242	0.5625	1	0.17967332123412	29	95
RTF1	2	28	0	4	646.47	1292.94	15	1	1	1	1	0.0666666666666667	4	30
RTFDC1	3	12	1	0	152.46	304.92	15	1	0.25	-Inf	1	-0.8	1	15
RTKN2	35	27	5	3	624.69	1249.38	15	1	1	-0.285714285714286	1	-0.0604838709677419	8	62
RTN1	6	34	5	7	746.13	1492.26	15	1	0.0999481926023427	-3.04761904761905	0.971353639774823	-0.266666666666667	12	40
RTN4	0	4	0	1	186.78	373.56	15	1	1	NA	1	0	1	4
RTN4IP1	5	13	0	2	312.18	624.36	15	1	1	1	1	0.277777777777778	2	18
RTN4R	1	21	3	3	481.14	962.28	15	1	0.0222222222222223	-20	0.721018759249189	-0.454545454545455	6	22
RTN4RL1	1	11	1	5	441.21	882.42	15	1	1	-1.2	1	-0.0833333333333333	6	12
RTP2	24	10	8	7	204.6	409.2	15	1	0.331413522269997	0.523809523809524	1	0.172549019607843	15	34
RUBCN	9	49	9	10	966.9	1933.8	15	1	0.0100032489302381	-3.9	0.5818356433428	-0.318511796733212	19	58
RUBCNL	29	32	6	6	788.04	1576.08	15	1	1	-0.103448275862069	1	-0.0245901639344263	12	61
RUFY1	4	19	6	8	688.05	1376.1	15	1	0.132234234823713	-2.5625	1	-0.254658385093168	14	23
RUFY4	10	15	4	5	335.61	671.22	15	1	1	-0.2	1	-0.0444444444444444	9	25
RUNDC1	3	23	1	7	500.28	1000.56	15	1	1	-0.0952380952380953	1	-0.00961538461538461	8	26
RUNDC3B	0	9	1	1	410.19	820.38	15	1	0.181818181818182	-Inf	1	-0.5	2	9
RUNX1	8	13	2	4	454.08	908.16	15	1	1	0.1875	1	0.0476190476190476	6	21
RUNX2	5	17	1	1	542.52	1085.04	15	1	0.445652173913043	-2.4	1	-0.272727272727273	2	22
RUSC1	53	55	6	8	1063.26	2126.52	15	1	0.779275732232046	0.221698113207547	1	0.0621693121693122	14	108
RUSC2	30	74	8	5	1563.21	3126.42	15	1	0.0266924188003069	-2.94666666666667	0.761210061313465	-0.326923076923077	13	104
RUVBL1	0	16	0	0	405.9	811.8	15	1	1	NA	1	NA	0	16
RWDD1	0	6	1	1	238.59	477.18	15	1	0.25	-Inf	1	-0.5	2	6
RWDD2B	7	17	2	1	287.1	574.2	15	1	0.25025641025641	-3.85714285714286	1	-0.375	3	24
RWDD3	10	10	3	0	254.43	508.86	15	1	0.229249011857707	-Inf	1	-0.5	3	20
RXFP1	13	19	1	2	623.7	1247.4	15	1	1	0.269230769230769	1	0.0729166666666667	3	32
RXFP3	8	19	2	2	442.53	885.06	15	1	0.577308120133482	-1.375	1	-0.203703703703704	4	27
RXRA	1	12	1	22	374.55	749.1	15	1	1	0.454545454545455	1	0.0334448160535117	23	13
RXRG	2	15	6	20	442.86	885.72	15	1	0.446160791952952	-1.25	1	-0.113122171945701	26	17
RYBP	6	7	0	3	226.38	452.76	15	1	0.25	1	1	0.461538461538462	3	13
RYK	2	16	0	1	536.58	1073.16	15	1	1	1	1	0.111111111111111	1	18
RYR2	29	148	5	13	4887.63	9775.26	15	1	0.323102809946259	-0.962864721485411	1	-0.113935969868173	18	177
RYR3	29	134	4	9	4829.88	9659.76	15	1	0.269021474402094	-1.0536398467433	1	-0.12977819726286	13	163
S100A11	0	5	0	2	99.99	199.98	15	1	1	NA	1	0	2	5
S100A16	0	1	1	0	62.7	125.4	15	1	1	-Inf	1	-1	1	1
S100A4	0	1	2	1	46.53	93.06	15	1	1	-Inf	1	-0.666666666666667	3	1
S100A9	15	5	0	2	214.83	429.66	15	1	0.0909090909090909	1	0.953786405978059	0.75	2	20
S100B	0	2	0	2	92.07	184.14	15	1	1	NA	1	0	2	2
S100Z	1	2	3	0	99	198	15	1	0.4	-Inf	1	-0.666666666666667	3	3
S1PR1	1	19	0	5	376.2	752.4	15	1	1	1	1	0.05	5	20
S1PR3	2	13	0	0	377.19	754.38	15	1	1	NA	1	NA	0	15
S1PR4	2	14	0	0	404.91	809.82	15	1	1	NA	1	NA	0	16
SAAL1	2	12	0	0	460.68	921.36	15	1	1	NA	1	NA	0	14
SACM1L	3	19	0	3	571.56	1143.12	15	1	1	1	1	0.136363636363636	3	22
SACS	26	177	5	17	4485.36	8970.72	15	1	0.199001750388749	-1.00226244343891	1	-0.0991939095387371	22	203
SAFB	8	19	1	2	694.65	1389.3	15	1	1	-0.1875	1	-0.037037037037037	3	27
SAFB2	14	13	2	0	213.84	427.68	15	1	0.487684729064039	-Inf	1	-0.481481481481482	2	27
SAG	1	13	1	0	403.92	807.84	15	1	0.133333333333333	-Inf	1	-0.928571428571429	1	14
SALL1	5	39	1	4	1289.64	2579.28	15	1	0.495198449407515	-0.95	1	-0.0863636363636364	5	44
SALL3	10	36	1	2	1250.37	2500.74	15	1	0.542118975249674	-0.8	1	-0.115942028985507	3	46
SALL4	8	31	5	3	1073.49	2146.98	15	1	0.0277421118552128	-5.45833333333333	0.761210061313465	-0.419871794871795	8	39
SAMD11	9	24	4	13	661.65	1323.3	15	1	1	0.17948717948718	1	0.0374331550802139	17	33
SAMD13	1	4	0	1	101.97	203.94	15	1	1	1	1	0.2	1	5
SAMD15	8	3	1	1	89.76	179.52	15	1	1	0.625	1	0.227272727272727	2	11
SAMD3	19	13	1	2	442.2	884.4	15	1	0.564553093964859	0.657894736842105	1	0.260416666666667	3	32
SAMD4A	3	15	2	3	573.54	1147.08	15	1	0.290677286100627	-2.33333333333333	1	-0.233333333333333	5	18
SAMD7	8	23	2	5	538.56	1077.12	15	1	1	-0.15	1	-0.0276497695852534	7	31
SAMD8	4	17	2	2	410.52	821.04	15	1	0.23399209486166	-3.25	1	-0.30952380952381	4	21
SAMD9L	70	43	2	5	1570.14	3140.28	15	1	0.114426203450238	0.754285714285714	0.999366335487971	0.333754740834387	7	113
SAMHD1	11	8	0	1	440.22	880.44	15	1	0.45	1	1	0.578947368421053	1	19
SAMM50	2	9	2	2	458.37	916.74	15	1	0.516483516483517	-3.5	1	-0.318181818181818	4	11
SAP130	4	42	1	4	1003.53	2007.06	15	1	0.41646701233685	-1.625	1	-0.11304347826087	5	46
SAP18	0	2	0	0	105.6	211.2	15	1	1	NA	1	NA	0	2
SAP30	0	2	0	0	118.8	237.6	15	1	1	NA	1	NA	0	2
SAP30BP	0	2	1	0	218.79	437.58	15	1	0.333333333333333	-Inf	1	-1	1	2
SAPCD2	12	21	0	1	271.59	543.18	15	1	1	1	1	0.363636363636364	1	33
SAR1B	1	4	0	2	197.01	394.02	15	1	1	1	1	0.2	2	5
SARAF	15	6	0	1	210.87	421.74	15	1	0.318181818181818	1	1	0.714285714285714	1	21
SARDH-VAV2	11	65	12	35	1604.79	3209.58	15	1	0.155319086658177	-1.02597402597403	1	-0.110582306830907	47	76
SARM1	10	21	7	14	679.14	1358.28	15	1	1	-0.05	1	-0.010752688172043	21	31
SART3	6	68	11	23	866.25	1732.5	15	1	0.00312005792144541	-4.42028985507246	0.39641156959838	-0.242448330683625	34	74
SASH1	19	53	7	6	1444.08	2888.16	15	1	0.0977568653998641	-2.25438596491228	0.971353639774823	-0.27457264957265	13	72
SASH3	1	10	1	5	274.89	549.78	15	1	1	-1	1	-0.0757575757575757	6	11
SASS6	13	22	3	3	633.93	1267.86	15	1	0.662395682934836	-0.692307692307692	1	-0.128571428571429	6	35
SAT1	0	4	0	2	143.55	287.1	15	1	1	NA	1	0	2	4
SATB1	1	14	0	2	775.83	1551.66	15	1	1	1	1	0.0666666666666667	2	15
SATB2	4	7	0	0	698.28	1396.56	15	1	1	NA	1	NA	0	11
SAV1	1	13	1	4	381.15	762.3	15	1	0.467836257309942	-2.25	1	-0.128571428571429	5	14
SAXO2	11	10	4	5	450.78	901.56	15	1	1	0.272727272727273	1	0.0793650793650794	9	21
SAYSD1	1	6	0	0	84.48	168.96	15	1	1	NA	1	NA	0	7
SBDS	2	11	1	0	205.26	410.52	15	1	0.214285714285714	-Inf	1	-0.846153846153846	1	13
SBK2	3	12	0	2	314.82	629.64	15	1	1	1	1	0.2	2	15
SBK3	17	22	2	1	384.12	768.24	15	1	0.581271777003484	-1.58823529411765	1	-0.230769230769231	3	39
SBNO1	1	46	1	12	1391.94	2783.88	15	1	0.389265536723164	-2.83333333333333	1	-0.0556464811783961	13	47
SBNO2	16	39	3	17	1351.35	2702.7	15	1	0.249040009019363	0.569852941176471	1	0.140909090909091	20	55
SBSPONL	2	3	4	2	124.74	249.48	15	1	0.567099567099567	-2	1	-0.266666666666667	6	5
SC5D	2	5	2	7	286.11	572.22	15	1	1	0.285714285714286	1	0.0634920634920635	9	7
SCAF11	51	40	15	11	1292.94	2585.88	15	1	1	-0.0695187165775402	1	-0.0164835164835164	26	91
SCAF4	2	39	1	7	1041.15	2082.3	15	1	0.421406860616587	-1.78571428571429	1	-0.0762195121951219	8	41
SCAF8	12	40	3	6	1383.03	2766.06	15	1	0.675921575197378	-0.666666666666667	1	-0.102564102564103	9	52
SCAI	3	13	0	2	575.19	1150.38	15	1	1	1	1	0.1875	2	16
SCAMP1	1	10	1	3	336.6	673.2	15	1	0.476190476190476	-2.33333333333333	1	-0.159090909090909	4	11
SCAMP2	4	12	0	5	253.44	506.88	15	1	0.532163742690059	1	1	0.25	5	16
SCAMP3	2	15	1	2	262.02	524.04	15	1	0.403508771929824	-2.75	1	-0.215686274509804	3	17
SCAMP4	1	15	0	3	227.7	455.4	15	1	1	1	1	0.0625	3	16
SCAP	9	65	8	31	1283.04	2566.08	15	1	0.273904518075631	-0.863799283154122	1	-0.0835065835065835	39	74
SCAPER	29	40	8	5	1611.72	3223.44	15	1	0.233725328025719	-1.20689655172414	1	-0.195094760312152	13	69
SCARA5	1	11	1	10	386.1	772.2	15	1	1	-0.1	1	-0.00757575757575758	11	12
SCARB1	8	24	2	3	460.35	920.7	15	1	0.597381950323127	-1	1	-0.15	5	32
SCARB2	1	12	1	2	470.91	941.82	15	1	0.35	-5	1	-0.256410256410256	3	13
SCARF1	17	26	8	24	665.94	1331.88	15	1	0.222005525441095	0.490196078431373	1	0.145348837209302	32	43
SCARF2	11	35	4	17	925.98	1851.96	15	1	0.760109199481528	0.251336898395722	1	0.0486542443064182	21	46
SCD	2	18	3	2	348.48	696.96	15	1	0.0376623376623377	-12.5	0.789311843512415	-0.5	5	20
SCD5	0	16	0	4	251.13	502.26	15	1	1	NA	1	0	4	16
SCEL	17	15	2	1	369.27	738.54	15	1	1	-0.764705882352941	1	-0.135416666666667	3	32
SCFD1	6	21	2	2	626.67	1253.34	15	1	0.268298109010011	-2.5	1	-0.277777777777778	4	27
SCFD2	17	9	9	5	369.93	739.86	15	1	1	0.0470588235294118	1	0.0109890109890109	14	26
SCFN	36	18	7	4	402.6	805.2	15	1	1	0.125	1	0.0303030303030303	11	54
SCG2	14	20	4	4	621.72	1243.44	15	1	0.706149202426481	-0.428571428571429	1	-0.0882352941176471	8	34
SCG3	6	12	6	5	440.88	881.76	15	1	0.438437172391248	-1.4	1	-0.212121212121212	11	18
SCG5	7	15	1	0	225.72	451.44	15	1	0.347826086956522	-Inf	1	-0.681818181818182	1	22
SCHIP1	0	10	0	2	250.14	500.28	15	1	1	NA	1	0	2	10
SCIN	12	21	1	1	705.21	1410.42	15	1	1	-0.75	1	-0.136363636363636	2	33
SCLT1	25	19	5	6	678.15	1356.3	15	1	0.521116355012499	0.366666666666667	1	0.113636363636364	11	44
SCLY	12	28	10	5	394.68	789.36	15	1	0.0283698334604592	-3.66666666666667	0.761210061313465	-0.366666666666667	15	40
SCMH1	1	8	1	2	687.06	1374.12	15	1	0.454545454545454	-3	1	-0.222222222222222	3	9
SCML2	7	22	5	1	719.07	1438.14	15	1	0.0117918134995934	-14.7142857142857	0.596226042284133	-0.591954022988506	6	29
SCML4	14	12	5	3	396.33	792.66	15	1	1	-0.428571428571429	1	-0.0865384615384616	8	26
SCN11A	43	56	4	5	1695.87	3391.74	15	1	1	-0.0418604651162791	1	-0.0101010101010101	9	99
SCN1A	10	53	4	2	1889.91	3779.82	15	1	0.0133436080467229	-9.6	0.618176018064783	-0.507936507936508	6	63
SCN2A	1	37	0	6	1859.88	3719.76	15	1	1	1	1	0.0263157894736842	6	38
SCN2B	0	3	0	5	171.27	342.54	15	1	1	NA	1	0	5	3
SCN3A	12	44	2	1	1864.17	3728.34	15	1	0.137162016672306	-6.33333333333333	1	-0.452380952380952	3	56
SCN3B	0	7	0	1	213.84	427.68	15	1	1	NA	1	0	1	7
SCN4A	14	122	1	9	1845.03	3690.06	15	1	1	0.0317460317460317	1	0.00294117647058822	10	136
SCN4B	1	6	0	1	132.33	264.66	15	1	1	1	1	0.142857142857143	1	7
SCN5A	8	57	4	5	1979.01	3958.02	15	1	0.033308861229024	-4.7	0.784275503573749	-0.321367521367521	9	65
SCN8A	5	50	3	15	1955.25	3910.5	15	1	0.398300589094558	-1	1	-0.0757575757575757	18	55
SCN9A	19	53	1	7	1907.73	3815.46	15	1	0.671854378287532	0.601503759398496	1	0.138888888888889	8	72
SCNM1	11	16	2	3	156.75	313.5	15	1	1	0.0303030303030303	1	0.00740740740740736	5	27
SCNN1A	5	25	3	7	623.37	1246.74	15	1	0.387841260906276	-1.14285714285714	1	-0.133333333333333	10	30
SCNN1B	13	33	6	12	681.12	1362.24	15	1	0.764300513444612	-0.269230769230769	1	-0.0507246376811594	18	46
SCNN1D	9	24	5	7	638.55	1277.1	15	1	0.47027574735236	-0.904761904761905	1	-0.143939393939394	12	33
SCNN1G	4	23	3	6	625.35	1250.7	15	1	0.332704416077281	-1.875	1	-0.185185185185185	9	27
SCO1	1	6	0	0	207.57	415.14	15	1	1	NA	1	NA	0	7
SCOC	3	1	1	1	119.79	239.58	15	1	1	0.666666666666667	1	0.25	2	4
SCP2	14	13	0	1	527.67	1055.34	15	1	1	1	1	0.518518518518518	1	27
SCPEP1	1	11	1	4	383.79	767.58	15	1	0.514705882352941	-1.75	1	-0.116666666666667	5	12
SCRG1	5	1	0	0	96.03	192.06	15	1	1	NA	1	NA	0	6
SCRN1	1	12	2	0	410.85	821.7	15	1	0.0285714285714286	-Inf	0.761210061313465	-0.923076923076923	2	13
SCRN2	7	12	7	3	322.74	645.48	15	1	0.128135932033983	-3	1	-0.331578947368421	10	19
SCRN3	7	11	3	2	408.87	817.74	15	1	0.617522066034652	-1.35714285714286	1	-0.211111111111111	5	18
SCRT2	0	4	1	0	228.69	457.38	15	1	0.2	-Inf	1	-1	1	4
SCT	81	32	8	6	854.37	1708.74	15	1	0.352752408656843	0.473251028806584	1	0.145385587863464	14	113
SCTR	12	15	1	1	444.84	889.68	15	1	1	-0.25	1	-0.0555555555555556	2	27
SCUBE1	7	11	1	0	416.46	832.92	15	1	0.421052631578948	-Inf	1	-0.611111111111111	1	18
SCUBE2	6	19	4	6	850.08	1700.16	15	1	0.42066006688463	-1.11111111111111	1	-0.16	10	25
SCUBE3	0	13	1	11	628.32	1256.64	15	1	0.48	-Inf	1	-0.0833333333333333	12	13
SCX	0	2	1	4	156.09	312.18	15	1	1	-Inf	1	-0.2	5	2
SCYL2	12	33	0	4	925.65	1851.3	15	1	0.559931280560328	1	1	0.266666666666667	4	45
SCYL3	19	41	11	14	742.5	1485	15	1	0.323790297131928	-0.695488721804511	1	-0.123333333333333	25	60
SDAD1	13	30	0	2	664.29	1328.58	15	1	1	1	1	0.302325581395349	2	43
SDC1	5	10	1	1	285.12	570.24	15	1	1	-1	1	-0.166666666666667	2	15
SDC2	2	6	1	2	180.18	360.36	15	1	1	-0.5	1	-0.0833333333333333	3	8
SDC3	17	20	10	14	415.47	830.94	15	1	0.796443153534122	0.159663865546218	1	0.0427927927927928	24	37
SDC4	6	7	0	1	175.23	350.46	15	1	1	1	1	0.461538461538462	1	13
SDCBP	3	9	2	1	295.02	590.04	15	1	0.241758241758242	-5	1	-0.416666666666667	3	12
SDCCAG3	5	14	1	4	156.42	312.84	15	1	1	0.3	1	0.0631578947368421	5	19
SDCCAG8	15	19	5	3	717.75	1435.5	15	1	0.445379713672397	-1.11111111111111	1	-0.183823529411765	8	34
SDF2L1	2	6	1	0	157.08	314.16	15	1	0.333333333333333	-Inf	1	-0.75	1	8
SDF4	1	12	2	4	353.43	706.86	15	1	0.2218782249742	-5	1	-0.256410256410256	6	13
SDHA	1	30	1	3	637.56	1275.12	15	1	0.218487394957983	-9	1	-0.217741935483871	4	31
SDHAF3	2	4	2	0	67.32	134.64	15	1	0.428571428571429	-Inf	1	-0.666666666666667	2	6
SDHAF4	2	6	0	1	86.79	173.58	15	1	1	1	1	0.25	1	8
SDHC	1	4	2	1	92.73	185.46	15	1	0.464285714285714	-7	1	-0.466666666666667	3	5
SDHD	0	3	0	0	102.63	205.26	15	1	1	NA	1	NA	0	3
SDK1	11	98	5	16	1922.58	3845.16	15	1	0.137182471892497	-1.78409090909091	1	-0.137177806902578	21	109
SDK2	12	43	8	33	1219.02	2438.04	15	1	1	0.131313131313131	1	0.023059866962306	41	55
SDPR	5	16	5	9	301.95	603.9	15	1	0.473556476893518	-0.777777777777778	1	-0.119047619047619	14	21
SDR16C5	4	23	1	10	302.94	605.88	15	1	1	0.425	1	0.0572390572390572	11	27
SDR42E1	12	11	5	3	439.23	878.46	15	1	0.698001895109793	-0.527777777777778	1	-0.103260869565217	8	23
SDR42E2	16	10	1	1	450.45	900.9	15	1	1	0.375	1	0.115384615384615	2	26
SDR42E2L	4	10	1	1	396	792	15	1	1	-1.5	1	-0.214285714285714	2	14
SDSL	3	2	3	2	78.87	157.74	15	1	1	0	1	0	5	5
SEBOX	1	3	2	6	55.77	111.54	15	1	1	0	1	0	8	4
SEC11A	0	2	0	0	162.03	324.06	15	1	1	NA	1	NA	0	2
SEC11C	0	4	0	0	162.36	324.72	15	1	1	NA	1	NA	0	4
SEC13	1	16	0	4	303.93	607.86	15	1	1	1	1	0.0588235294117647	4	17
SEC14L1	3	21	1	4	708.84	1417.68	15	1	0.552608311229001	-0.75	1	-0.075	5	24
SEC14L5	3	23	1	6	654.39	1308.78	15	1	1	-0.277777777777778	1	-0.0274725274725275	7	26
SEC16A	73	100	19	19	2420.55	4841.1	15	1	0.470308206418167	-0.36986301369863	1	-0.0780346820809248	38	173
SEC16B	26	37	9	8	840.18	1680.36	15	1	0.420778139735109	-0.600961538461539	1	-0.11671335200747	17	63
SEC22A	0	6	1	2	305.91	611.82	15	1	0.333333333333333	-Inf	1	-0.333333333333333	3	6
SEC22B	0	10	0	3	172.59	345.18	15	1	1	NA	1	0	3	10
SEC22C	14	12	5	0	349.47	698.94	15	1	0.12844960008475	-Inf	1	-0.461538461538462	5	26
SEC23A	1	33	0	0	758.34	1516.68	15	1	1	NA	1	NA	0	34
SEC23B	1	40	3	7	760.32	1520.64	15	1	0.0205282112845138	-16.1428571428571	0.70665477455864	-0.275609756097561	10	41
SEC23IP	15	42	6	6	928.29	1856.58	15	1	0.164975151898807	-1.8	1	-0.236842105263158	12	57
SEC24A	14	38	1	8	1056	2112	15	1	0.430162103055389	0.660714285714286	1	0.158119658119658	9	52
SEC24B	21	19	2	0	562.32	1124.64	15	1	0.492450638792102	-Inf	1	-0.475	2	40
SEC24C	6	38	4	7	1135.53	2271.06	15	1	0.0990975281076423	-2.61904761904762	0.971353639774823	-0.227272727272727	11	44
SEC24D	7	2	1	1	87.12	174.24	15	1	0.490909090909091	0.714285714285714	1	0.277777777777778	2	9
SEC31A	17	53	4	13	1032.57	2065.14	15	1	1	0.0407239819004525	1	0.00756302521008403	17	70
SEC31B	23	36	9	7	1192.62	2385.24	15	1	0.260926645543931	-1.01242236024845	1	-0.172669491525424	16	59
SEC61A1-SEC61A2	2	17	2	2	469.92	939.84	15	1	0.124562394127612	-7.5	1	-0.394736842105263	4	19
SEC61A2	0	18	0	1	469.92	939.84	15	1	1	NA	1	0	1	18
SEC61G	0	5	0	0	68.31	136.62	15	1	1	NA	1	NA	0	5
SEC62	1	15	1	4	384.12	768.24	15	1	0.428571428571429	-2.75	1	-0.1375	5	16
SEC63	6	27	0	2	733.26	1466.52	15	1	1	1	1	0.181818181818182	2	33
SECISBP2	36	26	0	3	616.77	1233.54	15	1	0.0836538461538461	1	0.949431371776132	0.580645161290323	3	62
SEH1L	1	11	0	5	398.97	797.94	15	1	1	1	1	0.0833333333333333	5	12
SEL1L	6	31	0	2	759	1518	15	1	1	1	1	0.162162162162162	2	37
SEL1L3	23	38	1	3	1105.17	2210.34	15	1	1	0.449275362318841	1	0.127049180327869	4	61
SELE	29	16	3	5	283.8	567.6	15	1	0.24028687023037	0.668965517241379	1	0.269444444444444	8	45
SELENBP1	9	15	2	1	466.62	933.24	15	1	0.548717948717949	-2.33333333333333	1	-0.291666666666667	3	24
SELENBP1L3	5	32	3	2	532.95	1065.9	15	1	0.0397946084724006	-8.6	0.795233318314363	-0.464864864864865	5	37
SELENOF	4	5	0	0	154.44	308.88	15	1	1	NA	1	NA	0	9
SELENOH	0	4	1	1	44.88	89.76	15	1	0.333333333333333	-Inf	1	-0.5	2	4
SELENOI	8	14	4	5	401.61	803.22	15	1	0.703917768163065	-0.4	1	-0.0808080808080808	9	22
SELENOM	2	1	1	0	61.38	122.76	15	1	1	-Inf	1	-0.333333333333333	1	3
SELENON	9	18	1	0	504.57	1009.14	15	1	0.357142857142857	-Inf	1	-0.666666666666667	1	27
SELENOO	13	29	5	6	640.53	1281.06	15	1	0.478085783985405	-0.858974358974359	1	-0.145021645021645	11	42
SELENOP1	10	7	2	1	255.42	510.84	15	1	1	-0.4	1	-0.0784313725490196	3	17
SELENOP2	2	15	0	4	238.92	477.84	15	1	1	1	1	0.117647058823529	4	17
SELENOS	7	7	3	0	179.85	359.7	15	1	0.227941176470588	-Inf	1	-0.5	3	14
SELENOT	0	4	0	0	112.2	224.4	15	1	1	NA	1	NA	0	4
SELENOU	3	8	1	0	222.75	445.5	15	1	0.333333333333333	-Inf	1	-0.727272727272727	1	11
SEM1	0	3	0	1	62.7	125.4	15	1	1	NA	1	0	1	3
SEMA3C	6	22	0	2	747.45	1494.9	15	1	1	1	1	0.214285714285714	2	28
SEMA3D	10	30	2	4	768.9	1537.8	15	1	0.643521242376948	-0.5	1	-0.0833333333333333	6	40
SEMA3F	1	13	1	11	570.24	1140.48	15	1	1	-0.181818181818182	1	-0.0119047619047619	12	14
SEMA3G	10	35	6	22	706.86	1413.72	15	1	1	0.0454545454545454	1	0.00793650793650794	28	45
SEMA4B	8	22	6	11	591.36	1182.72	15	1	0.740862703401743	-0.5	1	-0.0862745098039216	17	30
SEMA4D	12	43	4	7	812.79	1625.58	15	1	0.440169705485242	-1.04761904761905	1	-0.145454545454545	11	55
SEMA5B	3	24	3	8	1082.07	2164.14	15	1	0.328687378222982	-2	1	-0.161616161616162	11	27
SEMA6A	4	39	1	11	1034.55	2069.1	15	1	1	0.113636363636364	1	0.00968992248062016	12	43
SEMA6B	2	4	1	4	239.25	478.5	15	1	1	0.5	1	0.133333333333333	5	6
SEMA6C	6	21	0	2	250.47	500.94	15	1	1	1	1	0.222222222222222	2	27
SEMA6D	6	33	2	5	1073.82	2147.64	15	1	0.587378233741893	-1.2	1	-0.131868131868132	7	39
SEMA7A	8	21	4	7	620.73	1241.46	15	1	0.704220661788324	-0.5	1	-0.0877742946708464	11	29
SENP1	10	48	6	19	966.57	1933.14	15	1	0.54785216590037	-0.515789473684211	1	-0.0675862068965517	25	58
SENP2	31	26	2	3	534.93	1069.86	15	1	0.65768268963601	0.440860215053763	1	0.143859649122807	5	57
SENP5	12	12	4	2	568.26	1136.52	15	1	0.656704980842912	-1	1	-0.166666666666667	6	24
SENP6	18	24	4	5	1173.48	2346.96	15	1	1	-0.0666666666666667	1	-0.0158730158730159	9	42
SENP7	45	39	5	2	1045.44	2090.88	15	1	0.451458440673005	-1.16666666666667	1	-0.178571428571429	7	84
SENP8	2	13	0	0	196.35	392.7	15	1	1	NA	1	NA	0	15
SEPHS1	0	9	0	3	389.07	778.14	15	1	1	NA	1	0	3	9
SEPSECS	9	18	2	5	482.13	964.26	15	1	1	0.2	1	0.0476190476190476	7	27
SEPT10	11	19	3	3	455.4	910.8	15	1	0.658246363061354	-0.727272727272727	1	-0.133333333333333	6	30
SEPT11	8	21	1	3	494.01	988.02	15	1	1	0.125	1	0.0258620689655172	4	29
SEPT2	0	10	0	3	328.68	657.36	15	1	1	NA	1	0	3	10
SEPT2L	0	5	0	0	312.84	625.68	15	1	1	NA	1	NA	0	5
SEPT3	5	16	3	11	381.81	763.62	15	1	1	0.127272727272727	1	0.0238095238095238	14	21
SEPT4	0	19	1	3	362.34	724.68	15	1	0.173913043478261	-Inf	1	-0.25	4	19
SEPT5	0	10	1	4	378.18	756.36	15	1	0.333333333333333	-Inf	1	-0.2	5	10
SEPT6	0	11	1	0	415.8	831.6	15	1	0.0833333333333334	-Inf	0.949431371776132	-1	1	11
SEPT7	4	10	2	2	412.83	825.66	15	1	0.568627450980392	-1.5	1	-0.214285714285714	4	14
SEPT9	2	7	2	5	317.79	635.58	15	1	1	-0.4	1	-0.0634920634920635	7	9
SERAC1	12	36	1	5	696.96	1393.92	15	1	1	0.4	1	0.0833333333333333	6	48
SERBP1	0	5	0	1	296.34	592.68	15	1	1	NA	1	0	1	5
SERHL2	10	11	3	6	288.09	576.18	15	1	0.690754622688656	0.45	1	0.142857142857143	9	21
SERINC1	0	24	0	3	457.38	914.76	15	1	1	NA	1	0	3	24
SERINC2	8	12	2	7	397.98	795.96	15	1	0.43108166196622	0.571428571428571	1	0.177777777777778	9	20
SERINC3	5	22	3	1	433.29	866.58	15	1	0.0431590656284761	-12.2	0.818982480424487	-0.564814814814815	4	27
SERINC4	17	29	4	5	417.12	834.24	15	1	0.718683671473716	-0.364705882352941	1	-0.0748792270531401	9	46
SERINC5	0	27	0	3	449.46	898.92	15	1	1	NA	1	0	3	27
SERPINA10	8	8	1	1	458.7	917.4	15	1	1	0	1	0	2	16
SERPINA3/4L	2	11	0	0	425.7	851.4	15	1	1	NA	1	NA	0	13
SERPINC1	5	24	0	5	451.44	902.88	15	1	1	1	1	0.172413793103448	5	29
SERPIND1	8	17	2	0	484.11	968.22	15	1	0.128205128205128	-Inf	1	-0.68	2	25
SERPINE2	0	9	2	1	430.98	861.96	15	1	0.0454545454545455	-Inf	0.822543273817637	-0.666666666666667	3	9
SERPINE3	24	13	6	6	396	792	15	1	0.497546681993718	0.458333333333333	1	0.148648648648649	12	37
SERPINF1	3	16	2	10	413.82	827.64	15	1	1	-0.0666666666666667	1	-0.0087719298245614	12	19
SERPINF2	24	17	6	6	512.82	1025.64	15	1	0.74322726952852	0.291666666666667	1	0.0853658536585366	12	41
SERPING1	7	9	3	6	260.04	520.08	15	1	0.691317808587966	0.357142857142857	1	0.104166666666667	9	16
SERPINH1	2	15	1	9	401.94	803.88	15	1	1	0.166666666666667	1	0.0176470588235294	10	17
SERPINI1	1	14	1	3	406.89	813.78	15	1	0.385964912280702	-3.66666666666667	1	-0.183333333333333	4	15
SERTAD2	3	4	1	5	313.83	627.66	15	1	0.559440559440559	0.733333333333333	1	0.261904761904762	6	7
SERTAD4	5	7	1	1	282.81	565.62	15	1	1	-0.4	1	-0.0833333333333333	2	12
SERTM1	0	7	1	0	106.92	213.84	15	1	0.125	-Inf	1	-1	1	7
SERTM2	1	2	0	1	92.07	184.14	15	1	1	1	1	0.333333333333333	1	3
SESN1	2	20	1	3	470.25	940.5	15	1	0.407692307692308	-2.33333333333333	1	-0.159090909090909	4	22
SESN2	2	14	2	8	427.02	854.04	15	1	0.625418060200669	-0.75	1	-0.075	10	16
SESN3	0	19	0	2	452.43	904.86	15	1	1	NA	1	0	2	19
SESTD1	2	19	0	1	689.04	1378.08	15	1	1	1	1	0.0952380952380952	1	21
SET	0	3	0	1	251.13	502.26	15	1	1	NA	1	0	1	3
SETBP1	23	39	3	2	1229.91	2459.82	15	1	0.368633025349443	-1.54347826086957	1	-0.229032258064516	5	62
SETD1B	17	62	14	29	1768.47	3536.94	15	1	0.197382635443924	-0.760649087221095	1	-0.110391521931116	43	79
SETD2	50	100	14	35	2103.09	4206.18	15	1	0.599802933174198	0.2	1	0.0476190476190476	49	150
SETD3	10	20	0	3	714.45	1428.9	15	1	0.536290322580645	1	1	0.333333333333333	3	30
SETD4	10	21	6	3	435.6	871.2	15	1	0.119811023216596	-3.2	1	-0.344086021505376	9	31
SETD5	3	35	5	11	1436.16	2872.32	15	1	0.0412561973805982	-4.3030303030303	0.798931947804628	-0.233552631578947	16	38
SETD7	1	21	0	5	350.13	700.26	15	1	1	1	1	0.0454545454545455	5	22
SETD9	11	14	1	1	240.9	481.8	15	1	1	-0.272727272727273	1	-0.06	2	25
SETDB1	14	48	0	3	1263.24	2526.48	15	1	1	1	1	0.225806451612903	3	62
SETDB2	62	50	6	9	966.57	1933.14	15	1	0.284570138961813	0.462365591397849	1	0.153571428571429	15	112
SETMAR	9	17	2	4	270.6	541.2	15	1	1	0.0555555555555556	1	0.0128205128205128	6	26
SETX	149	106	27	17	2744.28	5488.56	15	1	0.743249787419001	-0.129885511251481	1	-0.0293226381461675	44	255
SEZ6L	6	15	6	23	804.54	1609.08	15	1	0.738382178760644	0.347826086956522	1	0.0788177339901478	29	21
SF3A2	0	14	0	1	273.9	547.8	15	1	1	NA	1	0	1	14
SF3A3	0	25	0	3	474.21	948.42	15	1	1	NA	1	0	3	25
SF3B1	0	37	0	7	1279.74	2559.48	15	1	1	NA	1	0	7	37
SF3B3	0	1	4	1	446.82	893.64	15	1	0.333333333333333	-Inf	1	-0.8	5	1
SF3B4	0	5	0	1	136.95	273.9	15	1	1	NA	1	0	1	5
SF3B5	0	3	0	1	86.13	172.26	15	1	1	NA	1	0	1	3
SF3B6	0	9	0	2	124.74	249.48	15	1	1	NA	1	0	2	9
SFMBT1	3	36	1	5	859.32	1718.64	15	1	0.447961340984597	-1.4	1	-0.0897435897435897	6	39
SFMBT2	11	27	1	5	963.27	1926.54	15	1	1	0.509090909090909	1	0.12280701754386	6	38
SFN	0	1	0	6	232.98	465.96	15	1	1	NA	1	0	6	1
SFPQ	0	12	0	3	428.67	857.34	15	1	1	NA	1	0	3	12
SFR1	10	19	3	2	219.78	439.56	15	1	0.347561238571675	-1.85	1	-0.255172413793103	5	29
SFRP1	0	21	0	4	296.67	593.34	15	1	1	NA	1	0	4	21
SFRP2	1	12	0	3	274.23	548.46	15	1	1	1	1	0.0769230769230769	3	13
SFRP4	7	19	1	0	284.13	568.26	15	1	0.296296296296296	-Inf	1	-0.730769230769231	1	26
SFRP5	5	7	3	5	188.1	376.2	15	1	1	0.16	1	0.0416666666666667	8	12
SFSWAP	5	31	6	3	934.89	1869.78	15	1	0.00333505523224006	-11.4	0.408839692475765	-0.527777777777778	9	36
SFT2D1	4	4	0	1	169.95	339.9	15	1	1	1	1	0.5	1	8
SFT2D2	1	2	0	0	159.39	318.78	15	1	1	NA	1	NA	0	3
SFTPA1	4	5	1	0	151.47	302.94	15	1	1	-Inf	1	-0.555555555555556	1	9
SFTPA2	8	11	2	2	215.49	430.98	15	1	1	-0.375	1	-0.0789473684210527	4	19
SFXN1	2	6	0	0	319.77	639.54	15	1	1	NA	1	NA	0	8
SFXN3	5	6	0	3	209.55	419.1	15	1	0.258241758241758	1	1	0.454545454545455	3	11
SFXN4	16	20	3	3	301.62	603.24	15	1	1	-0.25	1	-0.0555555555555556	6	36
SGCA	3	2	4	3	120.78	241.56	15	1	1	0.111111111111111	1	0.0285714285714286	7	5
SGCB	0	17	0	6	304.92	609.84	15	1	1	NA	1	0	6	17
SGCD	10	8	3	0	295.02	590.04	15	1	0.257142857142857	-Inf	1	-0.444444444444444	3	18
SGCE	7	21	1	2	470.91	941.82	15	1	1	-0.5	1	-0.0833333333333333	3	28
SGCG	3	15	0	0	327.69	655.38	15	1	1	NA	1	NA	0	18
SGCZ	3	3	1	0	132	264	15	1	1	-Inf	1	-0.5	1	6
SGK1	0	11	0	4	402.6	805.2	15	1	1	NA	1	0	4	11
SGK2	4	21	1	5	423.72	847.44	15	1	1	-0.05	1	-0.00666666666666665	6	25
SGK3	1	15	1	5	486.09	972.18	15	1	0.480519480519481	-2	1	-0.104166666666667	6	16
SGMS1	7	18	0	1	497.97	995.94	15	1	1	1	1	0.28	1	25
SGMS2	1	10	0	2	361.35	722.7	15	1	1	1	1	0.0909090909090909	2	11
SGO1	41	13	7	3	593.34	1186.68	15	1	0.701056854606238	0.260162601626016	1	0.0592592592592593	10	54
SGO2	79	29	10	6	999.9	1999.8	15	1	0.383792591771264	0.388185654008439	1	0.106481481481482	16	108
SGPL1	7	30	2	10	555.39	1110.78	15	1	1	0.142857142857143	1	0.0225225225225225	12	37
SGPP2	5	24	5	2	329.01	658.02	15	1	0.0104795583922719	-11	0.585928868752023	-0.541871921182266	7	29
SGSH	7	12	6	8	401.28	802.56	15	1	1	-0.285714285714286	1	-0.0601503759398496	14	19
SGSM1	7	53	7	20	1083.72	2167.44	15	1	0.118540182768823	-1.65	1	-0.142592592592593	27	60
SGSM2	4	29	3	6	1040.16	2080.32	15	1	0.155460783188639	-2.625	1	-0.212121212121212	9	33
SGSM3	11	38	5	15	799.92	1599.84	15	1	1	-0.151515151515152	1	-0.0255102040816327	20	49
SGTA	1	25	1	4	276.87	553.74	15	1	0.301075268817204	-5.25	1	-0.161538461538462	5	26
SGTB	0	9	1	0	293.7	587.4	15	1	0.1	-Inf	0.971353639774823	-1	1	9
SH2B2	8	27	9	15	605.88	1211.76	15	1	0.253747171260986	-1.025	1	-0.146428571428571	24	35
SH2B3	3	11	4	11	436.92	873.84	15	1	1	-0.333333333333333	1	-0.0523809523809524	15	14
SH2D1A	4	10	1	2	130.68	261.36	15	1	1	-0.25	1	-0.0476190476190476	3	14
SH2D1B	6	7	0	2	133.65	267.3	15	1	0.485714285714286	1	1	0.461538461538462	2	13
SH2D2A	5	0	2	1	45.54	91.08	15	1	0.375	1	1	0.333333333333333	3	5
SH2D4A	7	27	1	2	451.44	902.88	15	1	0.52972972972973	-0.928571428571429	1	-0.127450980392157	3	34
SH2D4B	8	13	2	2	441.54	883.08	15	1	1	-0.625	1	-0.119047619047619	4	21
SH2D5	8	13	5	2	211.86	423.72	15	1	0.197705314009662	-3.0625	1	-0.333333333333333	7	21
SH3BGR	4	5	0	1	182.16	364.32	15	1	1	1	1	0.444444444444444	1	9
SH3BGRL2	1	1	1	1	105.27	210.54	15	1	1	0	1	0	2	2
SH3BGRL3	0	3	0	2	75.9	151.8	15	1	1	NA	1	0	2	3
SH3BP1	9	28	7	8	607.2	1214.4	15	1	0.183601574548339	-1.72222222222222	1	-0.223423423423423	15	37
SH3BP2	7	15	1	2	568.26	1136.52	15	1	1	-0.0714285714285714	1	-0.0151515151515151	3	22
SH3BP4	9	44	2	8	996.93	1993.86	15	1	1	-0.222222222222222	1	-0.030188679245283	10	53
SH3BP5	0	13	0	5	421.74	843.48	15	1	1	NA	1	0	5	13
SH3D19	25	13	8	7	988.68	1977.36	15	1	0.53123773637575	0.405714285714286	1	0.124561403508772	15	38
SH3GL1	1	13	0	6	330	660	15	1	1	1	1	0.0714285714285714	6	14
SH3GL2	0	6	0	2	383.13	766.26	15	1	1	NA	1	0	2	6
SH3GL3	3	8	1	0	335.61	671.22	15	1	0.333333333333333	-Inf	1	-0.727272727272727	1	11
SH3GLB1	0	11	1	1	337.92	675.84	15	1	0.153846153846154	-Inf	1	-0.5	2	11
SH3KBP1	10	17	1	4	639.54	1279.08	15	1	0.636749165739711	0.575	1	0.17037037037037	5	27
SH3PXD2A	6	40	4	5	924.66	1849.32	15	1	0.0467439558969065	-4.33333333333333	0.828231827900648	-0.314009661835749	9	46
SH3PXD2B	11	46	5	8	841.17	1682.34	15	1	0.156136284451036	-1.61363636363636	1	-0.191632928475034	13	57
SH3RF1	7	32	2	3	865.26	1730.52	15	1	0.267158252977878	-2.04761904761905	1	-0.220512820512821	5	39
SH3RF2	11	23	3	19	716.76	1433.52	15	1	0.205371784860086	0.669856459330143	1	0.18716577540107	22	34
SH3RF3	9	35	7	9	678.48	1356.96	15	1	0.100170622006868	-2.02469135802469	0.971912707092357	-0.232954545454545	16	44
SH3TC1	32	40	5	1	1280.73	2561.46	15	1	0.0961370280764656	-5.25	0.966978274069117	-0.388888888888889	6	72
SH3TC2	51	78	19	10	1316.04	2632.08	15	1	0.0132756820537008	-1.90588235294118	0.618176018064783	-0.259823576583801	29	129
SHANK2	12	39	1	6	1436.16	2872.32	15	1	1	0.458333333333333	1	0.092436974789916	7	51
SHB	19	15	7	0	458.37	916.74	15	1	0.0353334721113925	-Inf	0.788199921465956	-0.441176470588235	7	34
SHC1	1	20	4	10	505.56	1011.12	15	1	0.133603588062791	-7	1	-0.238095238095238	14	21
SHC2	2	19	0	2	287.76	575.52	15	1	1	1	1	0.0952380952380952	2	21
SHC4	27	38	1	1	623.7	1247.4	15	1	1	-0.407407407407407	1	-0.0846153846153846	2	65
SHCBP1	14	32	8	7	630.96	1261.92	15	1	0.130580696564505	-1.61224489795918	1	-0.228985507246377	15	46
SHF	4	13	0	2	321.42	642.84	15	1	1	1	1	0.235294117647059	2	17
SHH	5	9	0	0	323.4	646.8	15	1	1	NA	1	NA	0	14
SHISA2	0	8	0	2	160.71	321.42	15	1	1	NA	1	0	2	8
SHISA3	2	9	2	3	149.16	298.32	15	1	0.546703296703297	-2	1	-0.218181818181818	5	11
SHISA5	3	9	0	0	137.61	275.22	15	1	1	NA	1	NA	0	12
SHISA6	3	10	0	2	402.93	805.86	15	1	1	1	1	0.230769230769231	2	13
SHISA8	0	5	3	9	175.23	350.46	15	1	0.514705882352941	-Inf	1	-0.25	12	5
SHISA9	2	7	1	0	250.47	500.94	15	1	0.3	-Inf	1	-0.777777777777778	1	9
SHMT1	3	16	2	11	445.5	891	15	1	1	0.0303030303030303	1	0.0040485829959514	13	19
SHOC2	0	10	0	3	576.84	1153.68	15	1	1	NA	1	0	3	10
SHPK	9	24	4	3	465.3	930.6	15	1	0.186616182746214	-2.55555555555556	1	-0.298701298701299	7	33
SHPRH	28	69	3	9	1624.59	3249.18	15	1	1	0.178571428571429	1	0.038659793814433	12	97
SHQ1	20	32	10	5	617.1	1234.2	15	1	0.0772890343416346	-2.2	0.92272862957817	-0.282051282051282	15	52
SHROOM1	102	92	32	31	1288.98	2577.96	15	1	0.884784088241754	0.068943706514864	1	0.0178366879397808	63	194
SHROOM2	37	52	12	12	1766.49	3532.98	15	1	0.493321943684193	-0.405405405405405	1	-0.0842696629213483	24	89
SHROOM3	76	102	11	19	1889.25	3778.5	15	1	0.689583163564041	0.222991689750693	1	0.0602996254681648	30	178
SHTN1	8	10	2	0	581.13	1162.26	15	1	0.473684210526316	-Inf	1	-0.555555555555556	2	18
SI	44	29	3	3	1260.6	2521.2	15	1	0.681723321963162	0.340909090909091	1	0.102739726027397	6	73
SIAH3	2	8	2	1	207.9	415.8	15	1	0.202797202797203	-7	1	-0.466666666666667	3	10
SIDT1	4	25	3	10	766.92	1533.84	15	1	0.656654407938105	-0.875	1	-0.0928381962864722	13	29
SIDT2	4	10	1	15	651.75	1303.5	15	1	0.157088122605364	0.833333333333333	1	0.223214285714286	16	14
SIGIRR	11	16	3	11	411.84	823.68	15	1	0.3049227012544	0.603305785123967	1	0.193121693121693	14	27
SIGLEC1	50	39	34	31	1113.75	2227.5	15	1	0.743321099636672	0.144516129032258	1	0.0387208297320657	65	89
SIGLEC15	2	10	0	3	303.93	607.86	15	1	1	1	1	0.166666666666667	3	12
SIGMAR1	0	2	0	3	167.31	334.62	15	1	1	NA	1	0	3	2
SIIL	19	56	1	12	878.46	1756.92	15	1	0.282462868267563	0.754385964912281	1	0.176410256410256	13	75
SIK1	4	27	2	4	783.09	1566.18	15	1	0.244769836681602	-2.375	1	-0.204301075268817	6	31
SIK2	9	42	6	10	824.67	1649.34	15	1	0.165524982285333	-1.8	1	-0.198529411764706	16	51
SIK3	7	30	4	13	1240.8	2481.6	15	1	0.725734734549075	-0.318681318681319	1	-0.0461049284578696	17	37
SIL1	10	15	12	7	443.85	887.7	15	1	0.22314250965169	-1.57142857142857	1	-0.231578947368421	19	25
SIM1	8	28	2	2	685.41	1370.82	15	1	0.255881387460335	-2.5	1	-0.277777777777778	4	36
SIM2	7	20	1	3	817.08	1634.16	15	1	1	0.0476190476190477	1	0.00925925925925924	4	27
SIMC1	19	29	10	13	632.61	1265.22	15	1	0.800234703822978	-0.174089068825911	1	-0.0389492753623188	23	48
SIN3A	2	43	5	17	1261.92	2523.84	15	1	0.0340353590425612	-5.32352941176471	0.787252650978106	-0.182828282828283	22	45
SINHCAF	3	5	2	2	257.4	514.8	15	1	1	-0.666666666666667	1	-0.125	4	8
SIPA1L1	1	57	2	12	1768.14	3536.28	15	1	0.0946009389671361	-8.5	0.960983694935281	-0.125615763546798	14	58
SIPA1L2	2	55	1	6	1694.88	3389.76	15	1	0.297715053763441	-3.58333333333333	1	-0.107769423558897	7	57
SIRPA-TPPNR1L	17	12	14	8	269.94	539.88	15	1	0.778044116212857	-0.235294117647059	1	-0.0501567398119123	22	29
SIRT1	11	32	5	4	627.99	1255.98	15	1	0.113153266714784	-2.63636363636364	0.991849865569908	-0.299741602067183	9	43
SIRT3	2	18	2	1	329.67	659.34	15	1	0.0666290231507622	-17	0.884435842948953	-0.566666666666667	3	20
SIRT4	10	19	3	1	350.46	700.92	15	1	0.275659824046921	-4.7	1	-0.405172413793103	4	29
SIRT5	1	7	1	3	307.89	615.78	15	1	1	-1.33333333333333	1	-0.125	4	8
SIRT6	6	14	1	8	298.65	597.3	15	1	0.381639949256141	0.708333333333333	1	0.188888888888889	9	20
SIRT7	2	18	0	1	279.84	559.68	15	1	1	1	1	0.1	1	20
SIVA1	4	4	1	1	104.28	208.56	15	1	1	0	1	0	2	8
SIX2	1	12	0	2	268.29	536.58	15	1	1	1	1	0.0769230769230769	2	13
SKA2	4	5	2	0	215.82	431.64	15	1	0.454545454545455	-Inf	1	-0.555555555555556	2	9
SKA3	27	18	7	6	477.51	955.02	15	1	0.755445619266955	0.222222222222222	1	0.0615384615384615	13	45
SKAP1	7	6	1	4	261.36	522.72	15	1	0.313725490196079	0.785714285714286	1	0.338461538461538	5	13
SKAP2	1	9	0	0	324.72	649.44	15	1	1	NA	1	NA	0	10
SKI	7	3	3	1	356.4	712.8	15	1	1	-0.285714285714286	1	-0.05	4	10
SKIL	8	35	2	12	712.14	1424.28	15	1	1	0.270833333333333	1	0.0431893687707641	14	43
SKIV2L2	8	37	0	1	1006.17	2012.34	15	1	1	1	1	0.177777777777778	1	45
SKOR2	7	7	0	1	341.88	683.76	15	1	1	1	1	0.5	1	14
SKP1	1	6	0	0	176.22	352.44	15	1	1	NA	1	NA	0	7
SKP2	5	15	3	0	413.16	826.32	15	1	0.0316205533596838	-Inf	0.778718235934639	-0.75	3	20
SLA	3	9	1	5	275.22	550.44	15	1	1	0.4	1	0.0833333333333333	6	12
SLAIN1	3	12	0	1	442.53	885.06	15	1	1	1	1	0.2	1	15
SLAIN2	1	10	2	0	481.47	962.94	15	1	0.0384615384615385	-Inf	0.789311843512415	-0.909090909090909	2	11
SLAINL	10	25	5	5	652.41	1304.82	15	1	0.262943272854608	-1.5	1	-0.214285714285714	10	35
SLBP	2	9	2	1	235.62	471.24	15	1	0.175824175824176	-8	1	-0.484848484848485	3	11
SLC10A1	15	9	3	1	369.27	738.54	15	1	1	-0.8	1	-0.125	4	24
SLC10A2	4	15	0	1	362.34	724.68	15	1	1	1	1	0.210526315789474	1	19
SLC10A4	2	11	2	2	346.17	692.34	15	1	0.21890756302521	-4.5	1	-0.346153846153846	4	13
SLC10A7	6	9	1	1	343.2	686.4	15	1	1	-0.5	1	-0.1	2	15
SLC11A1-SLC11A2	12	12	0	11	551.43	1102.86	15	1	0.00547883772316149	1	0.467685236262114	0.5	11	24
SLC12A1	16	43	2	3	1184.04	2368.08	15	1	0.614751737553827	-0.791666666666667	1	-0.128813559322034	5	59
SLC12A3	26	43	22	16	979.11	1958.22	15	1	0.0669339408453765	-1.27403846153846	0.884435842948953	-0.202135774218154	38	69
SLC12A4	1	30	0	10	1077.78	2155.56	15	1	1	1	1	0.032258064516129	10	31
SLC12A5	0	50	1	17	1091.97	2183.94	15	1	0.264705882352941	-Inf	1	-0.0555555555555556	18	50
SLC12A7	5	34	1	5	1046.43	2092.86	15	1	1	-0.36	1	-0.0384615384615385	6	39
SLC12A8	18	38	4	4	723.69	1447.38	15	1	0.430250549554253	-1.11111111111111	1	-0.178571428571429	8	56
SLC12A9	8	41	9	27	806.85	1613.7	15	1	0.412823369865125	-0.708333333333333	1	-0.086734693877551	36	49
SLC13A1	4	17	0	4	598.95	1197.9	15	1	1	1	1	0.19047619047619	4	21
SLC13A2	11	27	1	4	591.03	1182.06	15	1	1	0.386363636363636	1	0.0894736842105263	5	38
SLC13A3	3	22	0	4	563.31	1126.62	15	1	1	1	1	0.12	4	25
SLC13A4	16	23	4	4	602.91	1205.82	15	1	0.707330238702054	-0.4375	1	-0.0897435897435898	8	39
SLC14A2Z	5	24	1	4	386.1	772.2	15	1	1	-0.2	1	-0.0275862068965517	5	29
SLC15A1	40	26	2	5	696.96	1393.92	15	1	0.126937276944144	0.74	1	0.32034632034632	7	66
SLC15A2	16	27	5	2	777.15	1554.3	15	1	0.115257337482129	-3.21875	1	-0.3421926910299	7	43
SLC15A4	6	28	1	3	554.4	1108.8	15	1	1	-0.555555555555556	1	-0.0735294117647059	4	34
SLC15A5	12	14	0	2	575.19	1150.38	15	1	0.492063492063492	1	1	0.461538461538462	2	26
SLC16A1	3	27	0	0	480.48	960.96	15	1	1	NA	1	NA	0	30
SLC16A12	9	16	2	0	481.14	962.28	15	1	0.156695156695157	-Inf	1	-0.64	2	25
SLC16A14	7	15	2	0	510.84	1021.68	15	1	0.130434782608696	-Inf	1	-0.681818181818182	2	22
SLC16A3	5	9	1	0	469.26	938.52	15	1	0.4	-Inf	1	-0.642857142857143	1	14
SLC16A4	16	17	6	2	519.75	1039.5	15	1	0.248780487804878	-2.1875	1	-0.265151515151515	8	33
SLC16A5	14	35	5	3	642.18	1284.36	15	1	0.101706762838838	-3.16666666666667	0.976611477696721	-0.339285714285714	8	49
SLC16A6	9	21	1	5	560.67	1121.34	15	1	0.654608911013086	0.533333333333333	1	0.133333333333333	6	30
SLC16A7	4	11	0	1	476.19	952.38	15	1	1	1	1	0.266666666666667	1	15
SLC16A8	5	20	4	9	538.56	1077.12	15	1	0.689282311373593	-0.777777777777778	1	-0.107692307692308	13	25
SLC16A9	11	15	1	1	502.92	1005.84	15	1	1	-0.363636363636364	1	-0.0769230769230769	2	26
SLC17A5	3	16	2	1	460.02	920.04	15	1	0.116883116883117	-9.66666666666667	1	-0.508771929824561	3	19
SLC17A6	1	20	0	0	539.22	1078.44	15	1	1	NA	1	NA	0	21
SLC17A8	8	23	2	3	644.49	1288.98	15	1	0.603439860792802	-0.916666666666667	1	-0.141935483870968	5	31
SLC17A9	1	16	1	4	413.16	826.32	15	1	0.411255411255411	-3	1	-0.141176470588235	5	17
SLC18A1	10	22	2	9	501.6	1003.2	15	1	0.698275697531118	0.511111111111111	1	0.130681818181818	11	32
SLC18A2	1	21	1	6	514.47	1028.94	15	1	0.431034482758621	-2.5	1	-0.0974025974025974	7	22
SLC18A3	2	29	1	5	376.2	752.4	15	1	0.421492921492921	-1.9	1	-0.102150537634409	6	31
SLC18B1	5	15	0	0	439.23	878.46	15	1	1	NA	1	NA	0	20
SLC19A1	14	22	4	6	409.53	819.06	15	1	1	-0.0476190476190477	1	-0.0111111111111111	10	36
SLC19A2	9	31	3	4	445.17	890.34	15	1	0.349615883698368	-1.58333333333333	1	-0.203571428571429	7	40
SLC19A3	9	16	2	2	431.97	863.94	15	1	0.622079070354932	-0.777777777777778	1	-0.14	4	25
SLC1A1	5	8	0	0	559.02	1118.04	15	1	1	NA	1	NA	0	13
SLC1A2	2	14	2	5	563.64	1127.28	15	1	0.557312252964427	-1.8	1	-0.160714285714286	7	16
SLC1A3	2	10	0	0	453.42	906.84	15	1	1	NA	1	NA	0	12
SLC1A4	3	15	2	1	388.74	777.48	15	1	0.12781954887218	-9	1	-0.5	3	18
SLC1A6	1	17	1	1	562.32	1124.64	15	1	0.194736842105263	-16	1	-0.444444444444444	2	18
SLC1A7	4	20	0	4	561.33	1122.66	15	1	1	1	1	0.166666666666667	4	24
SLC20A2	4	29	0	5	646.47	1292.94	15	1	1	1	1	0.121212121212121	5	33
SLC22A15	2	18	2	3	512.82	1025.64	15	1	0.166403162055336	-5	1	-0.3	5	20
SLC22A15L	5	21	3	1	432.3	864.6	15	1	0.0475095785440613	-11.6	0.828231827900648	-0.557692307692308	4	26
SLC22A16	13	12	1	6	568.92	1137.84	15	1	0.103749536522062	0.846153846153846	0.983379501385042	0.377142857142857	7	25
SLC22A18	6	17	0	4	410.85	821.7	15	1	0.545299145299145	1	1	0.260869565217391	4	23
SLC22A2	13	20	4	13	548.13	1096.26	15	1	0.351000212854229	0.526627218934911	1	0.158645276292335	17	33
SLC22A23	3	14	1	7	368.28	736.56	15	1	1	0.333333333333333	1	0.0514705882352941	8	17
SLC22A3	11	24	3	4	544.5	1089	15	1	0.668493911112653	-0.636363636363636	1	-0.114285714285714	7	35
SLC22A4	3	21	2	11	496.32	992.64	15	1	1	-0.272727272727273	1	-0.0288461538461539	13	24
SLC22A5	12	29	5	4	559.02	1118.04	15	1	0.242045619486958	-2.02083333333333	1	-0.262872628726287	9	41
SLC22A7	12	25	5	7	531.63	1063.26	15	1	0.728673957926183	-0.488095238095238	1	-0.0923423423423423	12	37
SLC23A1	5	14	4	16	414.81	829.62	15	1	0.716426555136233	0.3	1	0.0631578947368421	20	19
SLC23A2	1	18	0	1	652.41	1304.82	15	1	1	1	1	0.0526315789473684	1	19
SLC23A3	13	11	3	14	420.09	840.18	15	1	0.0250672007366438	0.818681318681319	0.761210061313465	0.365196078431372	17	24
SLC24A1	8	18	3	6	660.33	1320.66	15	1	1	-0.125	1	-0.0256410256410256	9	26
SLC24A3	4	16	0	0	554.73	1109.46	15	1	1	NA	1	NA	0	20
SLC24A5	14	16	6	0	499.95	999.9	15	1	0.0240107773314604	-Inf	0.748863261991544	-0.533333333333333	6	30
SLC25A1	1	13	1	5	278.52	557.04	15	1	0.521052631578947	-1.6	1	-0.0952380952380952	6	14
SLC25A10	0	14	0	4	226.05	452.1	15	1	1	NA	1	0	4	14
SLC25A13	16	36	8	9	847.44	1694.88	15	1	0.250837280935254	-1	1	-0.16289592760181	17	52
SLC25A14	0	9	0	2	221.1	442.2	15	1	1	NA	1	0	2	9
SLC25A15	3	16	1	9	298.98	597.96	15	1	1	0.407407407407407	1	0.0578947368421052	10	19
SLC25A16	1	6	1	0	288.09	576.18	15	1	0.25	-Inf	1	-0.857142857142857	1	7
SLC25A17	3	10	0	6	287.1	574.2	15	1	0.51702786377709	1	1	0.230769230769231	6	13
SLC25A19	3	10	1	1	317.46	634.92	15	1	0.476190476190476	-2.33333333333333	1	-0.269230769230769	2	13
SLC25A20	1	8	1	1	291.06	582.12	15	1	0.345454545454545	-7	1	-0.388888888888889	2	9
SLC25A21	5	5	0	0	248.49	496.98	15	1	1	NA	1	NA	0	10
SLC25A24	3	15	1	4	427.35	854.7	15	1	1	-0.25	1	-0.0333333333333334	5	18
SLC25A26	5	9	8	4	265.32	530.64	15	1	0.237743976309059	-2.6	1	-0.309523809523809	12	14
SLC25A29	1	13	0	3	287.76	575.52	15	1	1	1	1	0.0714285714285714	3	14
SLC25A3	0	9	0	1	320.1	640.2	15	1	1	NA	1	0	1	9
SLC25A30	4	15	0	2	257.4	514.8	15	1	1	1	1	0.210526315789474	2	19
SLC25A32	4	9	2	1	262.02	524.04	15	1	0.517857142857143	-3.5	1	-0.358974358974359	3	13
SLC25A33	0	8	0	2	317.79	635.58	15	1	1	NA	1	0	2	8
SLC25A34	2	6	4	2	158.73	317.46	15	1	0.277389277389277	-5	1	-0.416666666666667	6	8
SLC25A36	1	8	1	0	297.33	594.66	15	1	0.2	-Inf	1	-0.888888888888889	1	9
SLC25A37	0	10	0	8	257.4	514.8	15	1	1	NA	1	0	8	10
SLC25A38	10	12	1	1	286.11	572.22	15	1	1	-0.2	1	-0.0454545454545455	2	22
SLC25A40	13	8	5	1	333.63	667.26	15	1	0.627850410459106	-2.07692307692308	1	-0.214285714285714	6	21
SLC25A42	1	10	3	5	324.72	649.44	15	1	0.262125902992776	-5	1	-0.284090909090909	8	11
SLC25A43	0	11	1	1	293.7	587.4	15	1	0.153846153846154	-Inf	1	-0.5	2	11
SLC25A46	2	7	1	0	191.07	382.14	15	1	0.3	-Inf	1	-0.777777777777778	1	9
SLC25A47	1	19	1	1	293.04	586.08	15	1	0.177489177489177	-18	1	-0.45	2	20
SLC25A48	5	18	1	8	288.75	577.5	15	1	0.648220244716352	0.55	1	0.106280193236715	9	23
SLC25A5	0	5	0	5	266.31	532.62	15	1	1	NA	1	0	5	5
SLC25A6	0	8	0	3	259.38	518.76	15	1	1	NA	1	0	3	8
SLC26A1	4	34	3	5	706.86	1413.72	15	1	0.0890168796898926	-4.1	0.953357353910386	-0.269736842105263	8	38
SLC26A3	17	37	2	1	747.45	1494.9	15	1	0.255194805194805	-3.35294117647059	1	-0.351851851851852	3	54
SLC26A4	11	25	4	5	723.03	1446.06	15	1	0.453907970342278	-0.818181818181818	1	-0.138888888888889	9	36
SLC26A5	14	34	6	2	724.68	1449.36	15	1	0.0192436494323287	-6.28571428571429	0.683149554847669	-0.458333333333333	8	48
SLC26A8	30	46	9	6	783.09	1566.18	15	1	0.163190422746745	-1.3	1	-0.205263157894737	15	76
SLC26A9	12	32	3	6	796.95	1593.9	15	1	0.700983205090164	-0.333333333333333	1	-0.0606060606060606	9	44
SLC27A2	12	21	1	5	427.35	854.7	15	1	0.642588187479828	0.65	1	0.196969696969697	6	33
SLC27A6	17	28	2	0	810.15	1620.3	15	1	0.158186864014801	-Inf	1	-0.622222222222222	2	45
SLC28A2	23	26	3	7	653.4	1306.8	15	1	0.487968401977121	0.515527950310559	1	0.169387755102041	10	49
SLC28A3	17	18	1	1	597.96	1195.92	15	1	1	-0.0588235294117647	1	-0.0142857142857143	2	35
SLC29A1	1	13	3	8	444.51	889.02	15	1	0.287826086956522	-3.875	1	-0.201298701298701	11	14
SLC29A3	6	9	6	9	435.93	871.86	15	1	1	0	1	0	15	15
SLC29A4	6	12	5	9	405.57	811.14	15	1	1	-0.111111111111111	1	-0.0238095238095238	14	18
SLC2A1	2	19	0	2	480.15	960.3	15	1	1	1	1	0.0952380952380952	2	21
SLC2A10	20	26	8	8	570.24	1140.48	15	1	0.772796415274411	-0.3	1	-0.0652173913043478	16	46
SLC2A11	13	20	9	9	492.03	984.06	15	1	0.558962152693824	-0.538461538461539	1	-0.106060606060606	18	33
SLC2A11L1	8	25	1	3	486.09	972.18	15	1	1	-0.0416666666666667	1	-0.00757575757575757	4	33
SLC2A11L2	11	13	0	1	433.62	867.24	15	1	1	1	1	0.458333333333333	1	24
SLC2A11L3	10	17	2	3	494.01	988.02	15	1	1	-0.133333333333333	1	-0.0296296296296297	5	27
SLC2A11L4	6	16	2	3	495	990	15	1	0.615904868078781	-0.777777777777778	1	-0.127272727272727	5	22
SLC2A12	5	21	3	4	576.51	1153.02	15	1	0.320129361842376	-2.15	1	-0.236263736263736	7	26
SLC2A13	6	11	1	1	390.72	781.44	15	1	1	-0.833333333333333	1	-0.147058823529412	2	17
SLC2A14	9	20	0	1	478.17	956.34	15	1	1	1	1	0.310344827586207	1	29
SLC2A2	10	23	1	4	515.46	1030.92	15	1	1	0.425	1	0.103030303030303	5	33
SLC2A5	16	29	2	8	515.79	1031.58	15	1	0.469550064896791	0.546875	1	0.155555555555556	10	45
SLC2A6	9	26	3	11	494.67	989.34	15	1	1	0.212121212121212	1	0.0428571428571428	14	35
SLC2A8	10	17	1	1	470.25	940.5	15	1	1	-0.7	1	-0.12962962962963	2	27
SLC2A9	12	28	1	2	634.92	1269.84	15	1	1	-0.166666666666667	1	-0.0333333333333333	3	40
SLC2A9L	20	25	13	13	488.07	976.14	15	1	0.805383901312487	-0.25	1	-0.0555555555555556	26	45
SLC30A10	2	10	0	1	278.52	557.04	15	1	1	1	1	0.166666666666667	1	12
SLC30A2	0	4	0	2	99	198	15	1	1	NA	1	0	2	4
SLC30A5	9	18	3	6	408.21	816.42	15	1	1	0	1	0	9	27
SLC30A7	1	17	1	4	348.81	697.62	15	1	0.395256916996047	-3.25	1	-0.144444444444444	5	18
SLC30A8	8	5	1	2	247.5	495	15	1	0.55	0.6875	1	0.282051282051282	3	13
SLC30A9	6	14	5	4	603.9	1207.8	15	1	0.237062787287675	-1.91666666666667	1	-0.255555555555556	9	20
SLC31A1	1	5	1	1	183.15	366.3	15	1	0.464285714285714	-4	1	-0.333333333333333	2	6
SLC31A2	7	4	3	4	136.95	273.9	15	1	0.630467571644042	0.571428571428571	1	0.207792207792208	7	11
SLC32A1	1	14	0	9	415.47	830.94	15	1	1	1	1	0.0666666666666667	9	15
SLC33A1	2	20	1	3	460.02	920.04	15	1	0.407692307692308	-2.33333333333333	1	-0.159090909090909	4	22
SLC34A1	5	20	6	5	544.17	1088.34	15	1	0.0558820573379233	-3.8	0.846060006968071	-0.345454545454545	11	25
SLC34A2	8	17	1	2	668.25	1336.5	15	1	1	-0.0625	1	-0.0133333333333333	3	25
SLC35A1	9	24	3	5	330.33	660.66	15	1	0.671879687586098	-0.6	1	-0.102272727272727	8	33
SLC35A3	2	10	2	1	335.94	671.88	15	1	0.153846153846154	-9	1	-0.5	3	12
SLC35A4	8	10	3	4	319.77	639.54	15	1	1	0.0625	1	0.0158730158730159	7	18
SLC35A5	5	19	3	4	424.38	848.76	15	1	0.334589049561241	-1.85	1	-0.220238095238095	7	24
SLC35B1	1	14	0	3	249.15	498.3	15	1	1	1	1	0.0666666666666667	3	15
SLC35B2	6	17	3	12	414.81	829.62	15	1	1	0.291666666666667	1	0.0608695652173913	15	23
SLC35B3	3	11	1	0	366.3	732.6	15	1	0.266666666666667	-Inf	1	-0.785714285714286	1	14
SLC35C1	4	17	1	2	331.32	662.64	15	1	0.521245059288538	-1.125	1	-0.142857142857143	3	21
SLC35D1	2	12	0	1	220.44	440.88	15	1	1	1	1	0.142857142857143	1	14
SLC35D2	4	7	0	0	379.17	758.34	15	1	1	NA	1	NA	0	11
SLC35D3	9	4	3	1	307.56	615.12	15	1	1	-0.333333333333333	1	-0.0576923076923077	4	13
SLC35E1	1	14	1	3	268.95	537.9	15	1	0.385964912280702	-3.66666666666667	1	-0.183333333333333	4	15
SLC35E3	2	16	1	8	251.13	502.26	15	1	1	0	1	0	9	18
SLC35F2	5	13	1	4	355.41	710.82	15	1	1	0.35	1	0.0777777777777778	5	18
SLC35F3	2	7	0	1	231.66	463.32	15	1	1	1	1	0.222222222222222	1	9
SLC35F4	2	20	1	2	488.07	976.14	15	1	0.330434782608696	-4	1	-0.242424242424242	3	22
SLC35F5	3	18	0	1	476.19	952.38	15	1	1	1	1	0.142857142857143	1	21
SLC35G1	7	10	1	1	387.09	774.18	15	1	1	-0.428571428571429	1	-0.0882352941176471	2	17
SLC35G2	8	17	4	5	407.88	815.76	15	1	0.687045435098828	-0.7	1	-0.124444444444444	9	25
SLC36A1	2	16	3	11	469.92	939.84	15	1	0.631256952169077	-1.18181818181818	1	-0.103174603174603	14	18
SLC36A4	10	9	5	2	488.07	976.14	15	1	0.657608695652174	-1.25	1	-0.18796992481203	7	19
SLC37A1	4	24	2	1	523.71	1047.42	15	1	0.0878754171301445	-11	0.951277979139867	-0.523809523809524	3	28
SLC37A2	8	40	3	0	484.44	968.88	15	1	0.00792316926770708	-Inf	0.529186532206378	-0.833333333333333	3	48
SLC37A3	9	17	4	3	496.98	993.96	15	1	0.392567218345861	-1.51851851851852	1	-0.225274725274725	7	26
SLC37A4	2	18	1	2	412.5	825	15	1	0.356295878035009	-3.5	1	-0.233333333333333	3	20
SLC38A1	0	9	0	1	485.1	970.2	15	1	1	NA	1	0	1	9
SLC38A10	47	70	18	37	1719.3	3438.6	15	1	0.40100751431831	0.275445658424382	1	0.0744366744366745	55	117
SLC38A11	8	13	3	1	430.65	861.3	15	1	0.287826086956522	-3.875	1	-0.369047619047619	4	21
SLC38A2	3	18	1	1	483.12	966.24	15	1	0.324110671936759	-5	1	-0.357142857142857	2	21
SLC38A3	0	2	0	4	179.85	359.7	15	1	1	NA	1	0	4	2
SLC38A4	6	19	0	4	543.51	1087.02	15	1	0.552608311229001	1	1	0.24	4	25
SLC38A6	2	14	0	1	374.55	749.1	15	1	1	1	1	0.125	1	16
SLC38A8	9	25	8	16	344.19	688.38	15	1	0.770264361287726	-0.388888888888889	1	-0.0686274509803921	24	34
SLC38A9	3	19	2	2	554.4	1108.8	15	1	0.154849498327759	-5.33333333333333	1	-0.363636363636364	4	22
SLC39A10	15	32	4	4	850.41	1700.82	15	1	0.426415094339623	-1.13333333333333	1	-0.180851063829787	8	47
SLC39A11	0	13	1	7	292.05	584.1	15	1	0.380952380952381	-Inf	1	-0.125	8	13
SLC39A12	14	17	2	4	660.33	1320.66	15	1	0.679626150214385	0.392857142857143	1	0.118279569892473	6	31
SLC39A13	5	15	1	0	365.31	730.62	15	1	0.285714285714286	-Inf	1	-0.75	1	20
SLC39A14	3	14	5	6	453.75	907.5	15	1	0.199801808497461	-2.88888888888889	1	-0.27807486631016	11	17
SLC39A3	6	16	2	4	308.22	616.44	15	1	1	-0.333333333333333	1	-0.0606060606060606	6	22
SLC39A6	5	34	1	5	711.81	1423.62	15	1	1	-0.36	1	-0.0384615384615385	6	39
SLC39A8	2	18	1	2	385.11	770.22	15	1	0.356295878035009	-3.5	1	-0.233333333333333	3	20
SLC39A9	1	6	0	1	281.49	562.98	15	1	1	1	1	0.142857142857143	1	7
SLC40A1	1	16	1	1	563.64	1127.28	15	1	0.204678362573099	-15	1	-0.441176470588235	2	17
SLC41A2	2	8	0	4	547.14	1094.28	15	1	1	1	1	0.2	4	10
SLC41A3	2	15	0	2	447.81	895.62	15	1	1	1	1	0.117647058823529	2	17
SLC43A2	3	20	3	8	543.51	1087.02	15	1	0.362657855133155	-1.5	1	-0.142292490118577	11	23
SLC44A1	3	3	0	0	228.69	457.38	15	1	1	NA	1	NA	0	6
SLC44A3	10	15	3	4	589.05	1178.1	15	1	1	-0.125	1	-0.0285714285714285	7	25
SLC44A5	4	13	0	2	728.64	1457.28	15	1	1	1	1	0.235294117647059	2	17
SLC45A1	12	23	1	0	743.82	1487.64	15	1	0.361111111111111	-Inf	1	-0.657142857142857	1	35
SLC45A2	11	28	1	0	567.6	1135.2	15	1	0.3	-Inf	1	-0.717948717948718	1	39
SLC45A3	6	17	4	11	534.27	1068.54	15	1	1	-0.0303030303030303	1	-0.00579710144927537	15	23
SLC45A4	3	36	4	13	780.12	1560.24	15	1	0.182044025157233	-2.69230769230769	1	-0.158371040723982	17	39
SLC46A1	8	19	1	7	390.72	781.44	15	1	0.647844009683963	0.660714285714286	1	0.171296296296296	8	27
SLC46A2	14	35	3	5	449.46	898.92	15	1	0.684086144463503	-0.5	1	-0.0892857142857143	8	49
SLC46A3	16	15	1	2	460.35	920.7	15	1	1	0.53125	1	0.182795698924731	3	31
SLC47A1	17	27	9	7	522.72	1045.44	15	1	0.252203885732403	-1.04201680672269	1	-0.176136363636364	16	44
SLC47A2	8	28	10	12	565.95	1131.9	15	1	0.0830818652841993	-1.91666666666667	0.949431371776132	-0.232323232323232	22	36
SLC48A1	1	2	0	2	101.64	203.28	15	1	1	1	1	0.333333333333333	2	3
SLC4A1	1	12	4	11	342.21	684.42	15	1	0.333333333333333	-3.36363636363636	1	-0.18974358974359	15	13
SLC4A10	8	20	1	4	1069.53	2139.06	15	1	1	0.375	1	0.0857142857142857	5	28
SLC4A11	0	20	1	4	520.41	1040.82	15	1	0.2	-Inf	1	-0.2	5	20
SLC4A1AP	6	21	3	1	532.95	1065.9	15	1	0.0627363737486096	-9.5	0.878646123461792	-0.527777777777778	4	27
SLC4A2	6	16	7	22	913.77	1827.54	15	1	1	0.151515151515151	1	0.0313479623824451	29	22
SLC4A3	4	46	2	10	1198.23	2396.46	15	1	0.327919588927568	-1.3	1	-0.0866666666666667	12	50
SLC4A4	3	31	1	4	1019.7	2039.4	15	1	0.43616490984912	-1.58333333333333	1	-0.111764705882353	5	34
SLC4A5	28	63	2	2	1299.54	2599.08	15	1	0.588383390214368	-1.25	1	-0.192307692307692	4	91
SLC4A7	3	25	2	7	1012.77	2025.54	15	1	0.577251047839283	-1.38095238095238	1	-0.115079365079365	9	28
SLC4A8	29	47	5	15	1255.98	2511.96	15	1	0.307606340108455	0.459770114942529	1	0.131578947368421	20	76
SLC4A9	22	30	8	12	965.25	1930.5	15	1	1	0.0909090909090909	1	0.0230769230769231	20	52
SLC51A	3	14	5	5	306.9	613.8	15	1	0.101940249766337	-3.66666666666667	0.977868234376093	-0.323529411764706	10	17
SLC51AL	2	12	1	0	324.06	648.12	15	1	0.2	-Inf	1	-0.857142857142857	1	14
SLC51B	19	15	3	3	287.1	574.2	15	1	1	0.210526315789474	1	0.0588235294117647	6	34
SLC52A3	19	9	3	3	381.81	763.62	15	1	0.641022704966302	0.526315789473684	1	0.178571428571429	6	28
SLC5A10	4	8	1	7	246.84	493.68	15	1	0.602683178534572	0.714285714285714	1	0.208333333333333	8	12
SLC5A11	31	28	6	7	784.08	1568.16	15	1	0.764323853711875	0.225806451612903	1	0.0638852672750978	13	59
SLC5A3	0	20	0	7	706.86	1413.72	15	1	1	NA	1	0	7	20
SLC5A7	0	16	0	1	573.21	1146.42	15	1	1	NA	1	0	1	16
SLC5A8	1	25	2	6	601.92	1203.84	15	1	0.131016042780749	-7.33333333333333	1	-0.211538461538462	8	26
SLC5A9	7	34	2	6	660.33	1320.66	15	1	0.62793747046669	-0.619047619047619	1	-0.0792682926829268	8	41
SLC6A1	1	21	0	5	593.01	1186.02	15	1	1	1	1	0.0454545454545455	5	22
SLC6A11	0	23	0	2	614.79	1229.58	15	1	1	NA	1	0	2	23
SLC6A12	4	23	4	5	601.92	1203.84	15	1	0.0862619190663423	-3.6	0.951277979139867	-0.296296296296296	9	27
SLC6A13	7	21	1	5	598.95	1197.9	15	1	1	0.4	1	0.0833333333333333	6	28
SLC6A14	3	24	0	4	618.75	1237.5	15	1	1	1	1	0.111111111111111	4	27
SLC6A15	2	21	0	1	722.7	1445.4	15	1	1	1	1	0.0869565217391304	1	23
SLC6A17	0	32	0	7	701.58	1403.16	15	1	1	NA	1	0	7	32
SLC6A19	12	37	6	4	1094.61	2189.22	15	1	0.0537693243095579	-3.625	0.846060006968071	-0.355102040816327	10	49
SLC6A2	0	21	0	6	554.4	1108.8	15	1	1	NA	1	0	6	21
SLC6A20	7	36	3	13	585.42	1170.84	15	1	1	-0.186813186813187	1	-0.0247093023255814	16	43
SLC6A4	5	32	2	6	664.29	1328.58	15	1	0.590162456186279	-1.13333333333333	1	-0.114864864864865	8	37
SLC6A5	13	26	0	0	768.24	1536.48	15	1	1	NA	1	NA	0	39
SLC6A6	2	9	0	3	633.6	1267.2	15	1	1	1	1	0.181818181818182	3	11
SLC6A7	2	14	1	12	765.27	1530.54	15	1	1	0.416666666666667	1	0.0480769230769231	13	16
SLC6A9	5	13	2	7	437.58	875.16	15	1	1	0.257142857142857	1	0.0555555555555556	9	18
SLC7A1	4	28	4	14	618.75	1237.5	15	1	0.43568217510605	-1	1	-0.0972222222222222	18	32
SLC7A10	0	14	0	2	485.76	971.52	15	1	1	NA	1	0	2	14
SLC7A11	2	12	1	5	539.22	1078.44	15	1	1	-0.2	1	-0.0238095238095238	6	14
SLC7A13	5	24	3	1	484.11	968.22	15	1	0.0359237536656892	-13.4	0.788199921465956	-0.577586206896552	4	29
SLC7A14	5	57	2	16	764.28	1528.56	15	1	0.651671347810588	-0.425	1	-0.0304659498207885	18	62
SLC7A2	6	23	1	0	650.43	1300.86	15	1	0.233333333333333	-Inf	1	-0.793103448275862	1	29
SLC7A3	7	32	5	18	618.42	1236.84	15	1	0.747798995032428	-0.26984126984127	1	-0.0379041248606466	23	39
SLC7A5	3	15	1	5	488.4	976.8	15	1	1	0	1	0	6	18
SLC7A6	2	14	0	4	513.81	1027.62	15	1	1	1	1	0.125	4	16
SLC7A6OS	9	18	3	0	292.05	584.1	15	1	0.0541871921182267	-Inf	0.846060006968071	-0.666666666666667	3	27
SLC7A9	7	8	0	1	489.06	978.12	15	1	1	1	1	0.466666666666667	1	15
SLC8A3	3	21	15	23	358.38	716.76	15	1	0.0254456115846491	-3.56521739130435	0.761210061313465	-0.269736842105263	38	24
SLC8B1	7	19	2	7	297.99	595.98	15	1	1	0.224489795918367	1	0.047008547008547	9	26
SLC9A1	6	23	1	11	706.86	1413.72	15	1	0.65137216806023	0.651515151515151	1	0.123563218390805	12	29
SLC9A3	22	26	0	2	791.34	1582.68	15	1	0.497142857142857	1	1	0.458333333333333	2	48
SLC9A3R1	4	9	2	4	163.02	326.04	15	1	1	-0.125	1	-0.0256410256410256	6	13
SLC9A3R2	1	7	3	3	275.55	551.1	15	1	0.244755244755245	-6	1	-0.375	6	8
SLC9A6	0	25	1	5	541.53	1083.06	15	1	0.193548387096774	-Inf	1	-0.166666666666667	6	25
SLC9A7	2	15	1	9	573.21	1146.42	15	1	1	0.166666666666667	1	0.0176470588235294	10	17
SLC9A8	0	15	0	2	529.98	1059.96	15	1	1	NA	1	0	2	15
SLC9A9	9	15	2	3	484.11	968.22	15	1	1	-0.111111111111111	1	-0.025	5	24
SLC9B2	10	21	4	5	554.4	1108.8	15	1	0.693519370763953	-0.68	1	-0.121863799283154	9	31
SLCO1A2	27	3	3	1	241.56	483.12	15	1	0.409069346213559	0.666666666666667	1	0.15	4	30
SLCO1B1	9	26	1	1	675.51	1351.02	15	1	0.472972972972973	-1.88888888888889	1	-0.242857142857143	2	35
SLCO1B3	12	19	4	1	699.27	1398.54	15	1	0.149265766912826	-5.33333333333333	1	-0.412903225806452	5	31
SLCO1C1	16	17	0	0	567.27	1134.54	15	1	1	NA	1	NA	0	33
SLCO2A1	3	30	2	8	628.98	1257.96	15	1	0.574900425722888	-1.5	1	-0.109090909090909	10	33
SLCO2B1	15	29	5	22	709.5	1419	15	1	0.184310420235735	0.560606060606061	1	0.155723905723906	27	44
SLCO3A1	0	11	1	0	508.86	1017.72	15	1	0.0833333333333334	-Inf	0.949431371776132	-1	1	11
SLCO4A1	20	37	9	13	714.78	1429.56	15	1	0.795035707788607	-0.280769230769231	1	-0.058213716108453	22	57
SLCO4C1	18	25	1	2	648.78	1297.56	15	1	1	0.305555555555556	1	0.0852713178294574	3	43
SLCO5A1	6	24	4	1	720.39	1440.78	15	1	0.0169484215973779	-15	0.674707602339182	-0.6	5	30
SLF1	37	29	5	4	912.78	1825.56	15	1	1	0.0202702702702703	1	0.00505050505050497	9	66
SLF2	66	39	11	10	1150.38	2300.76	15	1	0.46310173878089	0.35	1	0.104761904761905	21	105
SLIRP	1	3	0	0	81.84	163.68	15	1	1	NA	1	NA	0	4
SLIT1	11	39	12	25	1333.53	2667.06	15	1	0.329276321790046	-0.701818181818182	1	-0.104324324324324	37	50
SLIT3	13	44	8	15	1442.76	2885.52	15	1	0.277489975222778	-0.805128205128205	1	-0.119755911517925	23	57
SLITRK1	2	23	0	0	686.07	1372.14	15	1	1	NA	1	NA	0	25
SLITRK2	10	29	1	7	824.67	1649.34	15	1	0.659322605746764	0.585714285714286	1	0.131410256410256	8	39
SLITRK4	1	18	3	2	829.62	1659.24	15	1	0.0183512140033879	-26	0.677255339142531	-0.547368421052632	5	19
SLK	32	49	3	5	1257.96	2515.92	15	1	1	0.08125	1	0.0200617283950617	8	81
SLMAP	4	17	3	1	814.77	1629.54	15	1	0.0525691699604743	-11.75	0.843251957917679	-0.55952380952381	4	21
SLTM	6	22	1	2	943.47	1886.94	15	1	0.54972191323693	-0.833333333333333	1	-0.119047619047619	3	28
SLX4IP	22	12	6	2	519.42	1038.84	15	1	0.696908718731568	-0.636363636363636	1	-0.102941176470588	8	34
SMAD1	0	23	1	3	461.34	922.68	15	1	0.148148148148148	-Inf	1	-0.25	4	23
SMAD2W-SMAD2Z	2	8	3	2	420.42	840.84	15	1	0.250749250749251	-5	1	-0.4	5	10
SMAD3	0	15	0	10	366.63	733.26	15	1	1	NA	1	0	10	15
SMAD5	0	10	0	4	461.34	922.68	15	1	1	NA	1	0	4	10
SMAD6	0	1	2	1	223.41	446.82	15	1	1	-Inf	1	-0.666666666666667	3	1
SMAD9	1	10	0	0	463.32	926.64	15	1	1	NA	1	NA	0	11
SMAP1	4	18	1	2	429.33	858.66	15	1	0.504347826086956	-1.25	1	-0.151515151515151	3	22
SMAP2	6	15	4	1	389.73	779.46	15	1	0.0549103070842202	-9	0.846060006968071	-0.514285714285714	5	21
SMARCA1	5	40	1	8	1023.66	2047.32	15	1	1	0	1	0	9	45
SMARCA2-SMARCA4	7	62	2	2	1640.43	3280.86	15	1	0.0717345166891761	-7.85714285714286	0.909549689440994	-0.398550724637681	4	69
SMARCAD1	56	52	2	4	995.94	1991.88	15	1	0.434290993112134	0.535714285714286	1	0.185185185185185	6	108
SMARCAL1	33	39	7	4	998.91	1997.82	15	1	0.340143813215988	-1.06818181818182	1	-0.178030303030303	11	72
SMARCB1	3	9	1	3	394.68	789.36	15	1	1	0	1	0	4	12
SMARCC1	4	46	1	10	1004.52	2009.04	15	1	1	-0.15	1	-0.0109090909090909	11	50
SMARCC2	0	8	0	6	245.85	491.7	15	1	1	NA	1	0	6	8
SMARCD1	0	11	0	3	405.57	811.14	15	1	1	NA	1	0	3	11
SMARCD2	0	23	0	1	396.33	792.66	15	1	1	NA	1	0	1	23
SMARCE1	1	11	1	3	408.87	817.74	15	1	0.45	-2.66666666666667	1	-0.166666666666667	4	12
SMC1B	35	33	4	2	845.79	1691.58	15	1	0.677114703308195	-0.885714285714286	1	-0.151960784313726	6	68
SMC2	81	43	5	4	1185.69	2371.38	15	1	0.719845929490231	0.33641975308642	1	0.0976702508960573	9	124
SMC3	2	36	0	5	1217.7	2435.4	15	1	1	1	1	0.0526315789473684	5	38
SMC4	34	50	4	10	1280.07	2560.14	15	1	0.556077796519437	0.411764705882353	1	0.119047619047619	14	84
SMC5	23	43	7	2	1036.53	2073.06	15	1	0.025313731919494	-5.54347826086957	0.761210061313465	-0.429292929292929	9	66
SMC6	29	36	2	3	1086.03	2172.06	15	1	1	0.172413793103448	1	0.0461538461538462	5	65
SMCHD1	44	46	9	10	1944.69	3889.38	15	1	1	0.0590909090909091	1	0.0152046783625731	19	90
SMCO3	5	5	0	1	223.74	447.48	15	1	1	1	1	0.5	1	10
SMCR8	37	53	9	20	912.12	1824.24	15	1	0.385715496108248	0.355405405405405	1	0.100766283524904	29	90
SMDT1	5	5	0	1	65.67	131.34	15	1	1	1	1	0.5	1	10
SMG1	9	121	6	2	3597	7194	15	1	1.44549651090712e-05	-39.3333333333333	0.0290785714777483	-0.680769230769231	8	130
SMG5	6	52	4	13	1014.09	2028.18	15	1	0.220473611941801	-1.66666666666667	1	-0.13184584178499	17	58
SMG6	19	44	11	19	1010.13	2020.26	15	1	0.636112894552221	-0.340720221606648	1	-0.0650793650793651	30	63
SMG7	2	27	0	0	1170.51	2341.02	15	1	1	NA	1	NA	0	29
SMG8	7	57	5	24	906.18	1812.36	15	1	0.506075119721776	-0.696428571428571	1	-0.0630387931034483	29	64
SMIM12	0	2	1	1	38.61	77.22	15	1	1	-Inf	1	-0.5	2	2
SMIM14	1	1	0	0	100.98	201.96	15	1	1	NA	1	NA	0	2
SMIM15	0	1	0	1	72.27	144.54	15	1	1	NA	1	0	1	1
SMIM18	1	3	0	1	97.02	194.04	15	1	1	1	1	0.25	1	4
SMIM19	1	1	0	1	85.8	171.6	15	1	1	1	1	0.5	1	2
SMIM28	9	9	3	2	175.23	350.46	15	1	1	-0.5	1	-0.1	5	18
SMIM4	1	3	0	2	64.68	129.36	15	1	1	1	1	0.25	2	4
SMIM5	2	2	0	0	82.17	164.34	15	1	1	NA	1	NA	0	4
SMIM8	4	3	1	3	119.46	238.92	15	1	0.545454545454546	0.75	1	0.321428571428571	4	7
SMIM9	9	3	0	1	116.82	233.64	15	1	0.307692307692307	1	1	0.75	1	12
SMN	6	12	1	0	218.46	436.92	15	1	0.368421052631579	-Inf	1	-0.666666666666667	1	18
SMNDC1	0	8	0	4	225.06	450.12	15	1	1	NA	1	0	4	8
SMOC1	27	29	2	5	665.94	1331.88	15	1	0.436832811981823	0.57037037037037	1	0.196428571428571	7	56
SMOC2	1	7	0	0	239.58	479.16	15	1	1	NA	1	NA	0	8
SMOX	1	18	1	5	530.64	1061.28	15	1	0.43	-2.6	1	-0.114035087719298	6	19
SMPD1	9	26	7	5	381.48	762.96	15	1	0.0746371894242787	-3.04444444444444	0.914637734923963	-0.326190476190476	12	35
SMPD2	3	2	3	1	150.15	300.3	15	1	1	-1	1	-0.15	4	5
SMPD3	6	29	2	4	834.57	1669.14	15	1	0.57773039159432	-1.41666666666667	1	-0.161904761904762	6	35
SMPDL3A	8	14	1	1	446.16	892.32	15	1	1	-0.75	1	-0.136363636363636	2	22
SMPDL3B	12	18	7	1	417.12	834.24	15	1	0.0422445906316874	-9.5	0.808070061686953	-0.475	8	30
SMPX	5	6	1	0	116.82	233.64	15	1	1	-Inf	1	-0.545454545454545	1	11
SMS	5	5	1	1	213.51	427.02	15	1	1	0	1	0	2	10
SMTN	28	30	15	11	1019.37	2038.74	15	1	0.483975552448535	-0.461038961038961	1	-0.0941644562334217	26	58
SMTNL2	23	13	1	0	446.16	892.32	15	1	1	-Inf	1	-0.361111111111111	1	36
SMU1	7	18	0	2	571.56	1143.12	15	1	1	1	1	0.28	2	25
SMURF1	1	24	1	2	718.74	1437.48	15	1	0.206349206349206	-11	1	-0.293333333333333	3	25
SMURF2	0	14	0	2	729.3	1458.6	15	1	1	NA	1	0	2	14
SMYD1	1	24	3	5	487.08	974.16	15	1	0.0359237536656891	-13.4	0.788199921465956	-0.335	8	25
SMYD2	4	13	2	1	275.22	550.44	15	1	0.201754385964912	-5.5	1	-0.431372549019608	3	17
SMYD3	5	9	1	1	301.29	602.58	15	1	1	-0.8	1	-0.142857142857143	2	14
SMYD4	30	18	7	8	612.81	1225.62	15	1	0.369934785625589	0.475	1	0.158333333333333	15	48
SMYD5	4	17	4	7	397.98	795.96	15	1	0.397040871623742	-1.42857142857143	1	-0.173160173160173	11	21
SNAI1	0	6	1	1	190.74	381.48	15	1	0.25	-Inf	1	-0.5	2	6
SNAI2	0	2	0	0	266.31	532.62	15	1	1	NA	1	NA	0	2
SNAP23	0	6	0	0	157.41	314.82	15	1	1	NA	1	NA	0	6
SNAP25	0	4	0	1	203.94	407.88	15	1	1	NA	1	0	1	4
SNAP29	1	4	0	1	182.16	364.32	15	1	1	1	1	0.2	1	5
SNAP47	1	20	5	4	415.8	831.6	15	1	0.00459770114942529	-24	0.458402469160589	-0.507936507936508	9	21
SNAPC1	6	10	2	2	236.94	473.88	15	1	1	-0.666666666666667	1	-0.125	4	16
SNAPC3	7	10	0	2	306.24	612.48	15	1	0.508771929824561	1	1	0.411764705882353	2	17
SNAPC4	72	75	15	16	1528.89	3057.78	15	1	1	0.0234375	1	0.00592495062541143	31	147
SNAPC5	1	1	0	1	64.35	128.7	15	1	1	1	1	0.5	1	2
SNCAIP	9	25	8	2	886.71	1773.42	15	1	0.00711128052382493	-10.1111111111111	0.495282212683078	-0.535294117647059	10	34
SNCG	0	9	0	0	128.7	257.4	15	1	1	NA	1	NA	0	9
SNED1	10	44	7	27	1328.25	2656.5	15	1	1	-0.140740740740741	1	-0.0206971677559913	34	54
SNF8	2	7	0	1	240.57	481.14	15	1	1	1	1	0.222222222222222	1	9
SNIP1	2	23	2	3	282.15	564.3	15	1	0.118773946360153	-6.66666666666667	1	-0.32	5	25
SNN	1	5	0	0	87.12	174.24	15	1	1	NA	1	NA	0	6
SNPH	4	7	1	6	317.13	634.26	15	1	0.595588235294118	0.708333333333333	1	0.220779220779221	7	11
SNRK	1	26	1	6	757.02	1514.04	15	1	0.374331550802139	-3.33333333333333	1	-0.105820105820106	7	27
SNRNP200	2	68	1	23	1633.5	3267	15	1	1	-0.478260869565217	1	-0.0130952380952381	24	70
SNRNP27	1	3	0	3	102.96	205.92	15	1	1	1	1	0.25	3	4
SNRNP35	5	12	1	3	263.34	526.68	15	1	1	0.2	1	0.0441176470588235	4	17
SNRNP40	0	21	0	5	305.91	611.82	15	1	1	NA	1	0	5	21
SNRNP48	2	6	0	1	236.28	472.56	15	1	1	1	1	0.25	1	8
SNRPA1	0	14	0	1	206.91	413.82	15	1	1	NA	1	0	1	14
SNRPB2	0	13	0	0	203.94	407.88	15	1	1	NA	1	NA	0	13
SNRPC	7	12	1	2	174.9	349.8	15	1	1	0.142857142857143	1	0.0350877192982456	3	19
SNRPD1	0	6	0	0	118.14	236.28	15	1	1	NA	1	NA	0	6
SNRPF	0	1	0	1	43.89	87.78	15	1	1	NA	1	0	1	1
SNRPL	0	8	0	1	217.14	434.28	15	1	1	NA	1	0	1	8
SNTA1	2	12	2	7	332.31	664.62	15	1	1	-0.714285714285714	1	-0.0793650793650794	9	14
SNTB1	4	18	3	1	384.45	768.9	15	1	0.0468227424749164	-12.5	0.828231827900648	-0.568181818181818	4	22
SNTG1	0	2	0	2	113.19	226.38	15	1	1	NA	1	0	2	2
SNTG2	3	6	0	3	429.66	859.32	15	1	0.509090909090909	1	1	0.333333333333333	3	9
SNTN	1	2	2	2	143.55	287.1	15	1	1	-1	1	-0.166666666666667	4	3
SNU13	0	8	0	0	126.72	253.44	15	1	1	NA	1	NA	0	8
SNUPN	10	17	5	4	255.09	510.18	15	1	0.442695166346446	-1.125	1	-0.185185185185185	9	27
SNW1	0	12	0	1	528.99	1057.98	15	1	1	NA	1	0	1	12
SNX1	1	19	2	3	465.3	930.6	15	1	0.0913043478260869	-11.6666666666667	0.953786405978059	-0.35	5	20
SNX10	10	12	5	3	233.64	467.28	15	1	0.681659170414793	-1	1	-0.170454545454545	8	22
SNX11	9	14	2	2	257.73	515.46	15	1	1	-0.555555555555556	1	-0.108695652173913	4	23
SNX12	0	6	0	0	106.92	213.84	15	1	1	NA	1	NA	0	6
SNX13	1	18	5	2	896.94	1793.88	15	1	0.00176345393736698	-44	0.308476652522021	-0.661654135338346	7	19
SNX19	30	48	15	15	908.16	1816.32	15	1	0.286123228215965	-0.6	1	-0.115384615384615	30	78
SNX2	2	7	1	0	482.13	964.26	15	1	0.3	-Inf	1	-0.777777777777778	1	9
SNX20	2	16	2	3	324.72	649.44	15	1	0.193675889328063	-4.33333333333333	1	-0.288888888888889	5	18
SNX21	5	7	1	1	278.52	557.04	15	1	1	-0.4	1	-0.0833333333333333	2	12
SNX22	2	9	1	5	150.15	300.3	15	1	1	0.1	1	0.0151515151515152	6	11
SNX24	3	5	1	0	191.07	382.14	15	1	0.444444444444444	-Inf	1	-0.625	1	8
SNX27	1	16	1	2	438.9	877.8	15	1	0.28421052631579	-7	1	-0.274509803921569	3	17
SNX29	20	24	3	1	841.5	1683	15	1	0.33806146572104	-2.6	1	-0.295454545454545	4	44
SNX3	1	4	0	2	107.91	215.82	15	1	1	1	1	0.2	2	5
SNX30	2	15	0	2	381.15	762.3	15	1	1	1	1	0.117647058823529	2	17
SNX33	1	4	3	8	439.89	879.78	15	1	1	-0.5	1	-0.0727272727272727	11	5
SNX4	1	16	0	5	401.28	802.56	15	1	1	1	1	0.0588235294117647	5	17
SNX5	3	18	1	3	394.02	788.04	15	1	0.526877470355731	-1	1	-0.107142857142857	4	21
SNX6	0	8	0	4	385.11	770.22	15	1	1	NA	1	0	4	8
SNX7	4	18	2	2	411.84	823.68	15	1	0.218394648829431	-3.5	1	-0.318181818181818	4	22
SNX8	0	12	4	1	437.58	875.16	15	1	0.00210084033613445	-Inf	0.329313543599257	-0.8	5	12
SNX9	3	19	0	3	591.69	1183.38	15	1	1	1	1	0.136363636363636	3	22
SOAT1	5	26	0	5	546.48	1092.96	15	1	1	1	1	0.161290322580645	5	31
SOBP	4	18	1	9	726.99	1453.98	15	1	1	0.5	1	0.0818181818181818	10	22
SOCS1	1	11	1	0	205.92	411.84	15	1	0.153846153846154	-Inf	1	-0.916666666666667	1	12
SOCS1L	4	3	3	3	222.75	445.5	15	1	1	0.25	1	0.0714285714285714	6	7
SOCS2	1	11	1	3	148.17	296.34	15	1	0.45	-2.66666666666667	1	-0.166666666666667	4	12
SOCS4	3	31	5	6	432.63	865.26	15	1	0.0140808629628524	-7.61111111111111	0.628451090139802	-0.366310160427807	11	34
SOCS5	3	20	0	4	531.63	1063.26	15	1	1	1	1	0.130434782608696	4	23
SOD1	4	12	1	4	153.45	306.9	15	1	1	0.25	1	0.05	5	16
SOD2	1	8	1	4	222.42	444.84	15	1	1	-1	1	-0.0888888888888889	5	9
SOHO-1	8	10	0	0	179.85	359.7	15	1	1	NA	1	NA	0	18
SOHYE2L	15	44	10	8	712.47	1424.94	15	1	0.0230451683084649	-2.66666666666667	0.735459686256967	-0.301318267419962	18	59
SON	162	166	22	22	3843.84	7687.68	15	1	1	-0.0246913580246915	1	-0.00609756097560976	44	328
SORBS1	18	59	9	8	2058.21	4116.42	15	1	0.0347179912158723	-2.6875	0.788199921465956	-0.295645530939649	17	77
SORBS2	38	51	10	8	1531.53	3063.06	15	1	0.436539423009447	-0.677631578947368	1	-0.128589263420724	18	89
SORCS1	11	42	3	4	1000.56	2001.12	15	1	0.3374689402251	-1.86363636363636	1	-0.221024258760108	7	53
SORCS3	9	48	3	0	1016.73	2033.46	15	1	0.00642898889538281	-Inf	0.467685236262114	-0.842105263157895	3	57
SORD	1	19	2	3	460.35	920.7	15	1	0.0913043478260869	-11.6666666666667	0.953786405978059	-0.35	5	20
SORL1	19	84	9	36	2075.04	4150.08	15	1	0.822578448579483	-0.105263157894737	1	-0.0155339805825243	45	103
SOS1	1	29	60	65	1232.88	2465.76	15	1	1.54123034730616e-06	-25.7692307692308	0.0062008834306618	-0.446666666666667	125	30
SOS2	3	49	3	9	1258.29	2516.58	15	1	0.0741650533152877	-4.44444444444444	0.913861472365723	-0.192307692307692	12	52
SOST	0	4	0	2	211.86	423.72	15	1	1	NA	1	0	2	4
SOSTDC1	0	4	0	1	204.93	409.86	15	1	1	NA	1	0	1	4
SOT3A1L	7	16	1	2	339.57	679.14	15	1	1	-0.142857142857143	1	-0.0289855072463768	3	23
SOUL	1	10	2	0	248.82	497.64	15	1	0.0384615384615385	-Inf	0.789311843512415	-0.909090909090909	2	11
SOWAHA	9	9	2	6	277.53	555.06	15	1	0.394508009153318	0.666666666666667	1	0.25	8	18
SOWAHB	3	11	6	3	227.04	454.08	15	1	0.0771032440436129	-6.33333333333333	0.922367800589409	-0.452380952380952	9	14
SOWAHC	4	5	0	3	185.13	370.26	15	1	0.490909090909091	1	1	0.444444444444444	3	9
SOWAHD	11	22	2	3	289.41	578.82	15	1	1	-0.333333333333333	1	-0.0666666666666667	5	33
SOX1	0	3	0	2	138.27	276.54	15	1	1	NA	1	0	2	3
SOX10	2	12	3	4	431.31	862.62	15	1	0.280013759889921	-3.5	1	-0.285714285714286	7	14
SOX11	4	9	0	1	397.98	795.96	15	1	1	1	1	0.307692307692308	1	13
SOX12	0	2	0	1	79.86	159.72	15	1	1	NA	1	0	1	2
SOX13	2	11	0	11	374.22	748.44	15	1	0.481884057971014	1	1	0.153846153846154	11	13
SOX14	0	3	0	0	192.06	384.12	15	1	1	NA	1	NA	0	3
SOX17	1	2	0	1	99.33	198.66	15	1	1	1	1	0.333333333333333	1	3
SOX18	0	4	0	5	364.65	729.3	15	1	1	NA	1	0	5	4
SOX3	0	7	0	3	286.77	573.54	15	1	1	NA	1	0	3	7
SOX30	10	8	2	2	448.8	897.6	15	1	1	0.2	1	0.0555555555555556	4	18
SOX5	5	13	0	0	485.1	970.2	15	1	1	NA	1	NA	0	18
SOX6	2	10	1	0	753.39	1506.78	15	1	0.230769230769231	-Inf	1	-0.833333333333333	1	12
SOX7	1	13	0	10	268.29	536.58	15	1	1	1	1	0.0714285714285714	10	14
SOX8	3	10	2	8	302.28	604.56	15	1	1	0.166666666666667	1	0.0307692307692308	10	13
SOX9	1	1	0	2	131.34	262.68	15	1	1	1	1	0.5	2	2
SP2	19	17	5	3	458.37	916.74	15	1	0.709517537084185	-0.491228070175439	1	-0.0972222222222222	8	36
SP3	11	14	2	4	754.05	1508.1	15	1	1	0.363636363636364	1	0.106666666666667	6	25
SP4	7	29	4	2	770.88	1541.76	15	1	0.0320703131999666	-7.28571428571429	0.784275503573749	-0.472222222222222	6	36
SP5	0	2	0	0	129.36	258.72	15	1	1	NA	1	NA	0	2
SP8	1	6	0	1	198.33	396.66	15	1	1	1	1	0.142857142857143	1	7
SPACA1	14	9	0	1	236.94	473.88	15	1	0.416666666666667	1	1	0.608695652173913	1	23
SPACA9	1	10	1	1	166.32	332.64	15	1	0.294871794871795	-9	1	-0.409090909090909	2	11
SPAG1	31	30	16	5	825.99	1651.98	15	1	0.071905368028036	-2.09677419354839	0.910388883446916	-0.253708040593286	21	61
SPAG16	11	16	2	1	333.96	667.92	15	1	0.564532019704434	-1.90909090909091	1	-0.259259259259259	3	27
SPAG17	98	63	13	9	2076.69	4153.38	15	1	1	0.0714285714285714	1	0.0177865612648221	22	161
SPAG5	31	40	15	16	684.75	1369.5	15	1	0.671841922265877	-0.209677419354839	1	-0.0472512494320764	31	71
SPAG6	5	5	1	3	400.62	801.24	15	1	0.58041958041958	0.666666666666667	1	0.25	4	10
SPAG8	9	3	1	2	158.07	316.14	15	1	0.241758241758242	0.833333333333333	1	0.416666666666667	3	12
SPAG9	5	36	3	10	1195.92	2391.84	15	1	0.382023426257965	-1.16	1	-0.108818011257036	13	41
SPAM1	15	20	4	2	567.27	1134.54	15	1	0.389926981390396	-1.66666666666667	1	-0.238095238095238	6	35
SPARC	1	7	1	3	270.6	541.2	15	1	1	-1.33333333333333	1	-0.125	4	8
SPARCL1	45	25	9	2	640.53	1281.06	15	1	0.320654126840317	-1.5	1	-0.175324675324675	11	70
SPATA1	42	19	5	4	561.33	1122.66	15	1	0.462926404219701	0.43452380952381	1	0.132969034608379	9	61
SPATA13	18	17	4	4	841.5	1683	15	1	1	0.0555555555555556	1	0.0142857142857142	8	35
SPATA16	27	23	5	4	559.68	1119.36	15	1	1	-0.0648148148148149	1	-0.0155555555555555	9	50
SPATA17	15	15	2	0	330.66	661.32	15	1	0.485887096774194	-Inf	1	-0.5	2	30
SPATA18	7	13	3	1	471.24	942.48	15	1	0.272068511198946	-4.57142857142857	1	-0.4	4	20
SPATA2	1	32	0	1	518.76	1037.52	15	1	1	1	1	0.0303030303030303	1	33
SPATA20	12	37	7	12	641.85	1283.7	15	1	0.370950650403885	-0.798611111111111	1	-0.123523093447905	19	49
SPATA22	20	16	1	1	346.5	693	15	1	1	0.2	1	0.0555555555555556	2	36
SPATA4	15	5	2	1	228.36	456.72	15	1	1	0.333333333333333	1	0.0833333333333334	3	20
SPATA5	21	35	8	7	737.22	1474.44	15	1	0.37602886785099	-0.904761904761905	1	-0.158333333333333	15	56
SPATA6	20	17	2	0	470.58	941.16	15	1	0.49527665317139	-Inf	1	-0.459459459459459	2	37
SPATA7	22	16	6	1	522.39	1044.78	15	1	0.226834424792451	-3.36363636363636	1	-0.278195488721804	7	38
SPATS2	6	12	2	4	403.26	806.52	15	1	1	0	1	0	6	18
SPATS2L	17	17	1	4	590.04	1180.08	15	1	0.348944085786191	0.75	1	0.3	5	34
SPC25	7	7	2	0	232.65	465.3	15	1	0.475	-Inf	1	-0.5	2	14
SPCS1	0	5	0	0	90.09	180.18	15	1	1	NA	1	NA	0	5
SPCS2	9	19	1	6	271.26	542.52	15	1	0.644457894392462	0.648148148148148	1	0.178571428571429	7	28
SPCS3	0	3	0	0	99.33	198.66	15	1	1	NA	1	NA	0	3
SPDEF	1	4	1	5	200.31	400.62	15	1	1	0.2	1	0.0333333333333334	6	5
SPDL1	13	19	2	2	619.74	1239.48	15	1	1	-0.461538461538461	1	-0.09375	4	32
SPDYA	5	13	1	0	308.88	617.76	15	1	0.315789473684211	-Inf	1	-0.722222222222222	1	18
SPECC1	6	40	2	6	1041.48	2082.96	15	1	0.588456012571062	-1.22222222222222	1	-0.119565217391304	8	46
SPEF2	92	80	9	2	2318.91	4637.82	15	1	0.114813152567741	-2.91304347826087	1	-0.283298097251586	11	172
SPEG	27	72	28	53	2207.7	4415.4	15	1	0.330649444128935	-0.408805031446541	1	-0.0729517396184063	81	99
SPEN	34	125	11	43	2900.04	5800.08	15	1	1	0.0595075239398085	1	0.0101327742837177	54	159
SPERT	18	15	3	3	322.74	645.48	15	1	1	0.166666666666667	1	0.0454545454545454	6	33
SPG11	68	90	29	15	2339.37	4678.74	15	1	0.0100748673950824	-1.55882352941176	0.5818356433428	-0.228711162255466	44	158
SPG20	13	41	2	5	608.85	1217.7	15	1	1	-0.261538461538461	1	-0.044973544973545	7	54
SPG21	0	12	1	6	307.89	615.78	15	1	0.368421052631579	-Inf	1	-0.142857142857143	7	12
SPG7	8	36	3	10	730.62	1461.24	15	1	0.700304593937133	-0.35	1	-0.048951048951049	13	44
SPHK1	2	3	3	8	267.3	534.6	15	1	1	0.4375	1	0.127272727272727	11	5
SPHKAP	36	67	9	12	1687.29	3374.58	15	1	0.619221499906722	-0.395833333333333	1	-0.0790568654646324	21	103
SPI1	1	10	0	0	264.33	528.66	15	1	1	NA	1	NA	0	11
SPIA1	34	19	1	1	564.3	1128.6	15	1	1	0.441176470588235	1	0.141509433962264	2	53
SPIA3	24	13	4	0	415.8	831.6	15	1	0.288318356867779	-Inf	1	-0.351351351351351	4	37
SPIA4	9	12	5	0	413.82	827.64	15	1	0.0424749163879599	-Inf	0.809908753242774	-0.571428571428571	5	21
SPIA5	15	15	1	1	418.77	837.54	15	1	1	0	1	0	2	30
SPIA9	13	11	3	1	428.67	857.34	15	1	0.613186813186813	-1.53846153846154	1	-0.208333333333333	4	24
SPIC	1	7	0	2	253.44	506.88	15	1	1	1	1	0.125	2	8
SPICE1	38	22	7	5	794.64	1589.28	15	1	0.753766284733045	0.189473684210526	1	0.0499999999999999	12	60
SPIK5	28	20	0	2	468.27	936.54	15	1	0.188571428571429	1	1	0.583333333333333	2	48
SPIK7	1	7	0	1	203.94	407.88	15	1	1	1	1	0.125	1	8
SPIN1W-SPIN1Z	0	2	1	0	182.16	364.32	15	1	0.333333333333333	-Inf	1	-1	1	2
SPINT1	3	15	1	6	504.9	1009.8	15	1	1	0.166666666666667	1	0.0238095238095238	7	18
SPINT4	9	6	2	2	239.58	479.16	15	1	1	0.333333333333333	1	0.1	4	15
SPIRE1	6	11	2	7	585.09	1170.18	15	1	0.667285209070106	0.476190476190476	1	0.130718954248366	9	17
SPIRE1L	36	27	9	9	589.05	1178.1	15	1	0.603090654461466	0.25	1	0.0714285714285714	18	63
SPIRE2	5	25	2	13	584.1	1168.2	15	1	1	0.230769230769231	1	0.0333333333333333	15	30
SPNS3	14	18	3	3	522.72	1045.44	15	1	1	-0.285714285714286	1	-0.0625	6	32
SPO11	10	9	0	0	382.14	764.28	15	1	1	NA	1	NA	0	19
SPOCK1	0	8	0	2	225.39	450.78	15	1	1	NA	1	0	2	8
SPOCK3	2	5	0	0	236.28	472.56	15	1	1	NA	1	NA	0	7
SPON1	0	15	0	3	490.05	980.1	15	1	1	NA	1	0	3	15
SPON2	5	11	1	1	327.69	655.38	15	1	1	-1.2	1	-0.1875	2	16
SPOP	0	15	0	2	370.92	741.84	15	1	1	NA	1	0	2	15
SPOPL	1	1	1	0	371.25	742.5	15	1	1	-Inf	1	-0.5	1	2
SPP1	9	18	4	6	302.94	605.88	15	1	0.715827791598255	-0.333333333333333	1	-0.0666666666666667	10	27
SPP2	8	6	2	4	179.19	358.38	15	1	0.628482972136223	0.625	1	0.238095238095238	6	14
SPPL2B	4	18	0	1	586.74	1173.48	15	1	1	1	1	0.181818181818182	1	22
SPR	5	9	3	2	159.39	318.78	15	1	0.602683178534572	-1.7	1	-0.242857142857143	5	14
SPRED1	4	9	0	1	419.76	839.52	15	1	1	1	1	0.307692307692308	1	13
SPRED2	0	6	1	2	412.83	825.66	15	1	0.333333333333333	-Inf	1	-0.333333333333333	3	6
SPRN	8	14	0	0	127.71	255.42	15	1	1	NA	1	NA	0	22
SPRTN	16	22	1	7	458.7	917.4	15	1	0.226300839164288	0.803571428571429	1	0.296052631578947	8	38
SPRY1	0	10	0	1	317.79	635.58	15	1	1	NA	1	0	1	10
SPRY2	7	23	2	1	310.86	621.72	15	1	0.17375366568915	-5.57142857142857	1	-0.433333333333333	3	30
SPRY3	1	7	1	4	284.79	569.58	15	1	1	-0.75	1	-0.075	5	8
SPRY4	1	8	1	5	297	594	15	1	1	-0.6	1	-0.0555555555555556	6	9
SPRYD7	0	9	2	0	182.16	364.32	15	1	0.0181818181818182	-Inf	0.677255339142531	-1	2	9
SPSB1	2	13	1	4	271.26	542.52	15	1	1	-0.625	1	-0.0666666666666667	5	15
SPSB4	9	8	1	3	272.25	544.5	15	1	0.586466165413534	0.703703703703704	1	0.279411764705882	4	17
SPTAN1	5	91	3	16	2446.29	4892.58	15	1	0.124931383663218	-2.4125	1	-0.105811403508772	19	96
SPTB	23	53	36	48	1825.56	3651.12	15	1	0.104648788434409	-0.728260869565217	0.983379501385042	-0.12593984962406	84	76
SPTBB4L	57	61	32	37	1608.75	3217.5	15	1	0.879626233872943	0.0744428639165481	1	0.0192827315155981	69	118
SPTBN1	3	72	1	10	2299.11	4598.22	15	1	0.427634320749875	-1.4	1	-0.0509090909090909	11	75
SPTLC1	5	12	1	1	429.66	859.32	15	1	1	-1.4	1	-0.205882352941176	2	17
SPTLC2	1	12	0	1	513.81	1027.62	15	1	1	1	1	0.0769230769230769	1	13
SPTLC3	0	11	0	2	549.45	1098.9	15	1	1	NA	1	0	2	11
SPTSSA	0	2	0	0	64.02	128.04	15	1	1	NA	1	NA	0	2
SPTSSB	2	2	1	3	104.94	209.88	15	1	1	0.666666666666667	1	0.25	4	4
SPTSSBL	4	3	0	0	80.19	160.38	15	1	1	NA	1	NA	0	7
SPTY2D1	15	36	0	5	679.14	1358.28	15	1	0.309299191374663	1	1	0.294117647058824	5	51
SPX	4	2	0	0	116.82	233.64	15	1	1	NA	1	NA	0	6
SQLE	8	27	1	4	561.66	1123.32	15	1	1	0.15625	1	0.0285714285714286	5	35
SQSTM1	6	20	5	6	379.17	758.34	15	1	0.243619226811336	-1.77777777777778	1	-0.223776223776224	11	26
SRA1	8	10	4	1	168.96	337.92	15	1	0.316770186335404	-4	1	-0.355555555555556	5	18
SRBD1	24	26	2	6	1065.57	2131.14	15	1	0.276163216612526	0.638888888888889	1	0.23	8	50
SRC	0	10	0	9	528.66	1057.32	15	1	1	NA	1	0	9	10
SRCIN1	2	7	1	7	478.83	957.66	15	1	1	0.5	1	0.0972222222222222	8	9
SRCRB4D	10	8	5	9	365.31	730.62	15	1	0.307521557557384	0.555555555555556	1	0.198412698412698	14	18
SRD5A1	3	5	1	0	198.99	397.98	15	1	0.444444444444444	-Inf	1	-0.625	1	8
SRD5A3	6	12	6	5	288.09	576.18	15	1	0.438437172391248	-1.4	1	-0.212121212121212	11	18
SREBF1	0	4	0	7	241.56	483.12	15	1	1	NA	1	0	7	4
SREBF2	11	43	7	17	1049.07	2098.14	15	1	0.398989877276446	-0.609625668449198	1	-0.087962962962963	24	54
SREK1	2	18	3	0	546.81	1093.62	15	1	0.00564652738565782	-Inf	0.467685236262114	-0.9	3	20
SREK1IP1	2	3	0	0	151.14	302.28	15	1	1	NA	1	NA	0	5
SRFBP1	22	13	4	3	350.13	700.26	15	1	1	0.212121212121212	1	0.0571428571428572	7	35
SRGAP1	16	27	2	9	1096.92	2193.84	15	1	0.300845950342398	0.625	1	0.190274841437632	11	43
SRGAP3	2	34	1	9	1051.71	2103.42	15	1	0.529644268774704	-0.888888888888889	1	-0.0444444444444445	10	36
SRGN	5	7	0	2	139.92	279.84	15	1	0.505494505494505	1	1	0.416666666666667	2	12
SRI	4	6	0	1	186.12	372.24	15	1	1	1	1	0.4	1	10
SRM	0	4	0	2	203.94	407.88	15	1	1	NA	1	0	2	4
SRP19	1	6	0	0	130.02	260.04	15	1	1	NA	1	NA	0	7
SRP54	0	14	1	2	499.95	999.9	15	1	0.176470588235294	-Inf	1	-0.333333333333333	3	14
SRP68	5	42	0	7	561	1122	15	1	1	1	1	0.106382978723404	7	47
SRP72	1	7	0	0	151.8	303.6	15	1	1	NA	1	NA	0	8
SRP9	1	4	0	1	86.13	172.26	15	1	1	1	1	0.2	1	5
SRPK1	11	27	1	2	627.99	1255.98	15	1	1	-0.227272727272727	1	-0.043859649122807	3	38
SRPRB	3	7	0	1	195.69	391.38	15	1	1	1	1	0.3	1	10
SRPX	0	20	4	8	427.35	854.7	15	1	0.0137652947719689	-Inf	0.628451090139802	-0.333333333333333	12	20
SRPX2	4	20	2	5	420.75	841.5	15	1	0.595904281110065	-1	1	-0.119047619047619	7	24
SRRD	6	10	1	6	126.72	253.44	15	1	0.36600627353084	0.722222222222222	1	0.232142857142857	7	16
SRRL	3	27	1	6	525.69	1051.38	15	1	1	-0.5	1	-0.0428571428571428	7	30
SRRM3	8	23	9	14	505.23	1010.46	15	1	0.378508176798927	-0.848214285714286	1	-0.133239831697055	23	31
SRRM4	9	14	3	2	536.58	1073.16	15	1	0.623931623931624	-1.33333333333333	1	-0.208695652173913	5	23
SRSF10	0	5	0	1	244.86	489.72	15	1	1	NA	1	0	1	5
SRSF11	2	14	0	3	409.2	818.4	15	1	1	1	1	0.125	3	16
SRSF2	1	7	0	1	214.83	429.66	15	1	1	1	1	0.125	1	8
SRSF3	7	10	2	0	338.58	677.16	15	1	0.210526315789474	-Inf	1	-0.588235294117647	2	17
SRSF4	4	8	2	2	478.17	956.34	15	1	0.604395604395604	-1	1	-0.166666666666667	4	12
SRSF5	0	7	0	2	264.33	528.66	15	1	1	NA	1	0	2	7
SRSF5A	0	9	0	1	277.2	554.4	15	1	1	NA	1	0	1	9
SRSF6	1	6	1	1	310.2	620.4	15	1	0.416666666666667	-5	1	-0.357142857142857	2	7
SS18	1	8	0	1	413.49	826.98	15	1	1	1	1	0.111111111111111	1	9
SS2	1	5	1	0	100.98	201.96	15	1	0.285714285714286	-Inf	1	-0.833333333333333	1	6
SSBP1	2	13	0	2	147.51	295.02	15	1	1	1	1	0.133333333333333	2	15
SSBP2	0	7	1	0	184.14	368.28	15	1	0.125	-Inf	1	-1	1	7
SSBP3-SSBP4	0	2	2	0	113.52	227.04	15	1	0.333333333333333	-Inf	1	-1	2	2
SSFA2	23	35	4	3	1159.62	2319.24	15	1	0.436805754734738	-1.02898550724638	1	-0.17487684729064	7	58
SSH1	21	60	13	14	1049.4	2098.8	15	1	0.0538594674809585	-1.6530612244898	0.846060006968071	-0.222222222222222	27	81
SSH2	41	57	15	16	1378.74	2757.48	15	1	0.539657693185272	-0.303353658536585	1	-0.06550362080316	31	98
SSNA1	2	5	2	4	113.85	227.7	15	1	1	-0.25	1	-0.0476190476190476	6	7
SSPO	27	34	28	32	1163.25	2326.5	15	1	0.855934420764736	-0.101851851851852	1	-0.0240437158469946	60	61
SSR1	1	13	1	0	271.59	543.18	15	1	0.133333333333333	-Inf	1	-0.928571428571429	1	14
SSR2	3	5	0	0	207.9	415.8	15	1	1	NA	1	NA	0	8
SSR3	0	14	0	4	175.23	350.46	15	1	1	NA	1	0	4	14
SST	0	2	0	1	70.29	140.58	15	1	1	NA	1	0	1	2
SSTR1	0	11	0	1	351.45	702.9	15	1	1	NA	1	0	1	11
SSTR2	1	16	3	2	368.28	736.56	15	1	0.0239234449760766	-23	0.748072489277835	-0.541176470588235	5	17
SSTR3	5	19	3	5	397.98	795.96	15	1	0.378462299040719	-1.28	1	-0.166666666666667	8	24
SSTR4	9	19	2	5	382.8	765.6	15	1	1	0.155555555555556	1	0.0357142857142858	7	28
SSTR5	0	12	0	3	367.29	734.58	15	1	1	NA	1	0	3	12
SSU72	6	10	1	6	293.37	586.74	15	1	0.36600627353084	0.722222222222222	1	0.232142857142857	7	16
SSX2IP	12	16	2	3	552.75	1105.5	15	1	1	0.111111111111111	1	0.0285714285714285	5	28
ST13	3	11	0	2	322.08	644.16	15	1	1	1	1	0.214285714285714	2	14
ST14	12	39	4	8	815.76	1631.52	15	1	0.481172669784815	-0.625	1	-0.0980392156862745	12	51
ST18	13	26	2	2	1034.22	2068.44	15	1	0.601815087918321	-1	1	-0.166666666666667	4	39
ST3GAL1	4	17	1	1	367.29	734.58	15	1	0.395256916996047	-3.25	1	-0.30952380952381	2	21
ST3GAL2L	1	7	2	3	266.31	532.62	15	1	0.51048951048951	-3.66666666666667	1	-0.275	5	8
ST3GAL3	12	8	1	2	484.44	968.88	15	1	0.55957086391869	0.666666666666667	1	0.266666666666667	3	20
ST3GAL5	7	17	4	5	389.73	779.46	15	1	0.437575939077608	-0.942857142857143	1	-0.152777777777778	9	24
ST3GAL6	4	7	1	0	349.47	698.94	15	1	0.416666666666667	-Inf	1	-0.636363636363636	1	11
ST5	15	60	9	9	1223.64	2447.28	15	1	0.0152107990964205	-3	0.642329698273754	-0.3	18	75
ST6GAL1	7	18	0	1	411.84	823.68	15	1	1	1	1	0.28	1	25
ST6GAL2	6	14	4	4	524.7	1049.4	15	1	0.400425661295227	-1.33333333333333	1	-0.2	8	20
ST6GALNAC1	32	29	11	5	677.82	1355.64	15	1	0.273241949034784	-0.99375	1	-0.162909836065574	16	61
ST6GALNAC2	7	9	3	5	274.89	549.78	15	1	1	0.228571428571429	1	0.0625	8	16
ST6GALNAC2L	9	7	5	5	214.5	429	15	1	1	0.222222222222222	1	0.0625	10	16
ST6GALNAC5	4	5	0	2	244.53	489.06	15	1	0.490909090909091	1	1	0.444444444444444	2	9
ST7	7	12	0	2	507.21	1014.42	15	1	0.533333333333333	1	1	0.368421052631579	2	19
ST7L	3	15	0	0	478.83	957.66	15	1	1	NA	1	NA	0	18
ST8SIA2	0	7	0	3	320.1	640.2	15	1	1	NA	1	0	3	7
ST8SIA3W-ST8SIA3Z	0	6	1	0	177.87	355.74	15	1	0.142857142857143	-Inf	1	-1	1	6
ST8SIA5	1	15	2	1	401.61	803.22	15	1	0.0505675954592363	-29	0.840481137782937	-0.604166666666667	3	16
ST8SIA6	1	8	2	0	375.21	750.42	15	1	0.0545454545454545	-Inf	0.846060006968071	-0.888888888888889	2	9
STAB1	77	111	17	28	2478.96	4957.92	15	1	0.737752368944723	0.124768089053803	1	0.0317966903073286	45	188
STAB2	58	114	14	21	2417.58	4835.16	15	1	0.55972571293314	-0.310344827586207	1	-0.0627906976744186	35	172
STAC	7	14	0	0	374.55	749.1	15	1	1	NA	1	NA	0	21
STAG1	0	21	0	4	1126.62	2253.24	15	1	1	NA	1	0	4	21
STAG2	1	35	0	6	1313.73	2627.46	15	1	1	1	1	0.0277777777777778	6	36
STAGL	27	45	7	2	1196.58	2393.16	15	1	0.0309857564080776	-4.83333333333333	0.774976578716492	-0.402777777777778	9	72
STAM	3	17	0	3	536.25	1072.5	15	1	1	1	1	0.15	3	20
STAM2	5	28	2	3	507.54	1015.08	15	1	0.222687083368198	-2.73333333333333	1	-0.248484848484849	5	33
STAMBP	7	23	2	0	597.96	1195.92	15	1	0.0725806451612903	-Inf	0.911545360143491	-0.766666666666667	2	30
STAMBPL1	5	9	2	3	413.82	827.64	15	1	1	-0.2	1	-0.0428571428571429	5	14
STAP1	14	18	1	0	305.91	611.82	15	1	0.454545454545455	-Inf	1	-0.5625	1	32
STARD13	5	27	3	5	1072.17	2144.34	15	1	0.319934487736345	-2.24	1	-0.21875	8	32
STARD3	3	23	2	10	428.34	856.68	15	1	0.642588187479828	-0.533333333333333	1	-0.0512820512820513	12	26
STARD3NL	6	4	0	1	232.65	465.3	15	1	0.454545454545455	1	1	0.6	1	10
STARD4	1	7	0	0	205.92	411.84	15	1	1	NA	1	NA	0	8
STARD5	2	4	1	1	171.93	343.86	15	1	1	-1	1	-0.166666666666667	2	6
STARD9	251	152	59	27	5076.39	10152.78	15	1	0.324002537917174	-0.323299395012542	1	-0.0632177275088003	86	403
STAT1	2	85	0	4	1422.63	2845.26	15	1	1	1	1	0.0229885057471264	4	87
STAT2	2	4	1	0	142.56	285.12	15	1	0.428571428571428	-Inf	1	-0.666666666666667	1	6
STAU2	12	18	1	2	557.37	1114.74	15	1	1	0.25	1	0.0666666666666667	3	30
STBD1	18	20	7	6	296.01	592.02	15	1	0.7553934017338	-0.296296296296296	1	-0.0647773279352227	13	38
STC1	5	8	3	6	351.45	702.9	15	1	1	0.2	1	0.0512820512820513	9	13
STC2	1	6	1	4	247.17	494.34	15	1	1	-0.5	1	-0.0571428571428572	5	7
STEAP1	10	18	5	0	339.57	679.14	15	1	0.0126529477196885	-Inf	0.61231737012987	-0.642857142857143	5	28
STEAP3	4	24	0	5	483.12	966.24	15	1	1	1	1	0.142857142857143	5	28
STEAP4	18	15	2	3	468.27	936.54	15	1	0.652509652509653	0.444444444444444	1	0.145454545454545	5	33
STIL	59	52	10	8	1259.61	2519.22	15	1	1	-0.101694915254237	1	-0.024024024024024	18	111
STIM1	5	21	4	10	629.31	1258.62	15	1	0.693519370763953	-0.68	1	-0.0934065934065934	14	26
STIM2	5	9	1	3	657.69	1315.38	15	1	1	0.4	1	0.107142857142857	4	14
STK10	5	32	4	9	955.68	1911.36	15	1	0.213773128380927	-1.84444444444444	1	-0.172557172557173	13	37
STK11	3	10	0	5	379.5	759	15	1	0.522058823529412	1	1	0.230769230769231	5	13
STK11IP	31	42	7	8	1078.44	2156.88	15	1	0.782021219198797	-0.185483870967742	1	-0.0420091324200914	15	73
STK17A	5	11	4	7	259.71	519.42	15	1	1	-0.257142857142857	1	-0.0511363636363636	11	16
STK17B	2	8	1	3	369.27	738.54	15	1	1	-0.333333333333333	1	-0.05	4	10
STK24	1	11	0	4	413.82	827.64	15	1	1	1	1	0.0833333333333333	4	12
STK25	0	14	0	3	412.83	825.66	15	1	1	NA	1	0	3	14
STK26	1	7	0	0	398.97	797.94	15	1	1	NA	1	NA	0	8
STK31	37	38	8	5	927.63	1855.26	15	1	0.55096943091131	-0.643243243243243	1	-0.122051282051282	13	75
STK32A	11	12	3	1	363.99	727.98	15	1	0.595555555555556	-2.27272727272727	1	-0.271739130434783	4	23
STK32C	12	23	4	3	437.58	875.16	15	1	0.397086431746252	-1.55555555555556	1	-0.228571428571429	7	35
STK35	3	20	0	3	232.65	465.3	15	1	1	1	1	0.130434782608696	3	23
STK36	69	63	22	21	1185.03	2370.06	15	1	1	0.0434782608695652	1	0.0110993657505285	43	132
STK38	1	15	0	2	461.34	922.68	15	1	1	1	1	0.0625	2	16
STK38L	1	14	0	0	463.98	927.96	15	1	1	NA	1	NA	0	15
STK39	0	18	0	2	451.11	902.22	15	1	1	NA	1	0	2	18
STK4	4	19	0	4	503.25	1006.5	15	1	1	1	1	0.173913043478261	4	23
STK40	0	9	1	0	426.36	852.72	15	1	0.1	-Inf	0.971353639774823	-1	1	9
STKLD1	22	21	9	4	627.66	1255.32	15	1	0.344543297045836	-1.14772727272727	1	-0.180679785330948	13	43
STMN1	0	2	0	1	147.51	295.02	15	1	1	NA	1	0	1	2
STMN2	0	4	0	0	178.2	356.4	15	1	1	NA	1	NA	0	4
STMN3	0	3	0	1	179.19	358.38	15	1	1	NA	1	0	1	3
STMND1	22	7	7	3	228.69	457.38	15	1	0.69618887338352	0.257575757575758	1	0.0586206896551724	10	29
STN1	10	14	3	2	359.37	718.74	15	1	0.632183908045977	-1.1	1	-0.183333333333333	5	24
STOM	3	7	1	0	278.19	556.38	15	1	0.363636363636364	-Inf	1	-0.7	1	10
STOML1	8	19	4	10	379.17	758.34	15	1	1	0.05	1	0.0105820105820106	14	27
STOML3	3	16	5	2	281.16	562.32	15	1	0.0138035877166312	-12.3333333333333	0.628451090139802	-0.556390977443609	7	19
STON1	5	2	0	0	144.54	289.08	15	1	1	NA	1	NA	0	7
STON2	8	29	4	4	878.13	1756.26	15	1	0.18081481464471	-2.625	1	-0.283783783783784	8	37
STOX1	74	33	14	3	829.62	1659.24	15	1	0.390315972172598	-1.08108108108108	1	-0.131940626717977	17	107
STRA6	15	21	10	7	529.32	1058.64	15	1	0.376999429400211	-1	1	-0.17156862745098	17	36
STRA8	4	6	0	1	301.62	603.24	15	1	1	1	1	0.4	1	10
STRAP	0	12	0	1	332.64	665.28	15	1	1	NA	1	0	1	12
STRBP	3	8	0	1	666.27	1332.54	15	1	1	1	1	0.272727272727273	1	11
STRIP1	0	26	0	9	759.66	1519.32	15	1	1	NA	1	0	9	26
STRIP2	5	25	9	19	774.18	1548.36	15	1	0.224374710479176	-1.36842105263158	1	-0.154761904761905	28	30
STRN	2	17	0	3	726.66	1453.32	15	1	1	1	1	0.105263157894737	3	19
STRN3	7	22	0	1	694.98	1389.96	15	1	1	1	1	0.241379310344828	1	29
STS	6	15	4	3	460.68	921.36	15	1	0.207459207459207	-2.33333333333333	1	-0.285714285714286	7	21
STT3B	0	14	0	4	715.11	1430.22	15	1	1	NA	1	0	4	14
STX11	1	14	2	5	275.55	551.1	15	1	0.227272727272727	-4.6	1	-0.219047619047619	7	15
STX12	0	4	0	0	233.31	466.62	15	1	1	NA	1	NA	0	4
STX17	8	7	3	1	298.98	597.96	15	1	0.602683178534572	-1.625	1	-0.216666666666667	4	15
STX18	8	7	0	0	286.11	572.22	15	1	1	NA	1	NA	0	15
STX19	6	12	2	3	289.08	578.16	15	1	1	-0.333333333333333	1	-0.0666666666666667	5	18
STX1A	2	7	2	5	205.59	411.18	15	1	1	-0.4	1	-0.0634920634920635	7	9
STX2	10	18	3	1	443.52	887.04	15	1	0.278781979977753	-4.4	1	-0.392857142857143	4	28
STX3	1	1	0	2	39.6	79.2	15	1	1	1	1	0.5	2	2
STX6	3	9	2	2	214.17	428.34	15	1	0.546703296703297	-2	1	-0.25	4	12
STX7	6	6	3	0	255.42	510.84	15	1	0.228571428571428	-Inf	1	-0.5	3	12
STX8	14	13	4	3	303.6	607.2	15	1	1	-0.238095238095238	1	-0.0529100529100529	7	27
STXBP1	2	8	0	11	495	990	15	1	0.214285714285714	1	1	0.2	11	10
STXBP3	3	23	2	7	589.05	1178.1	15	1	0.585530693215703	-1.19047619047619	1	-0.106837606837607	9	26
STXBP4	17	26	2	2	725.34	1450.68	15	1	1	-0.529411764705882	1	-0.104651162790698	4	43
STXBP6	4	3	1	1	174.24	348.48	15	1	1	0.25	1	0.0714285714285714	2	7
STYK1	5	18	3	5	421.74	843.48	15	1	0.393086715533879	-1.16	1	-0.157608695652174	8	23
STYX	0	6	0	5	200.97	401.94	15	1	1	NA	1	0	5	6
STYXL1	10	10	7	2	296.34	592.68	15	1	0.234075270057279	-2.5	1	-0.277777777777778	9	20
SUCLA2	0	13	2	3	430.65	861.3	15	1	0.0653594771241829	-Inf	0.884435842948953	-0.4	5	13
SUCLG1	1	7	1	1	319.11	638.22	15	1	0.377777777777778	-6	1	-0.375	2	8
SUCLG2	13	17	4	3	494.34	988.68	15	1	0.679995244511374	-0.743589743589744	1	-0.138095238095238	7	30
SUCNR1	19	16	1	2	311.19	622.38	15	1	0.594594594594595	0.578947368421053	1	0.20952380952381	3	35
SUCO	19	43	4	7	1215.06	2430.12	15	1	0.732805172897476	-0.293233082706767	1	-0.0571847507331378	11	62
SUDS3	4	9	1	0	271.92	543.84	15	1	0.357142857142857	-Inf	1	-0.692307692307692	1	13
SUFU	2	10	3	1	342.54	685.08	15	1	0.0631868131868133	-14	0.878646123461792	-0.583333333333333	4	12
SUGCT	2	6	0	1	220.77	441.54	15	1	1	1	1	0.25	1	8
SUGP1	6	23	2	11	655.05	1310.1	15	1	1	0.303030303030303	1	0.0530503978779841	13	29
SUGP2	14	62	4	9	1109.79	2219.58	15	1	0.289483703949628	-0.968253968253968	1	-0.123481781376518	13	76
SUGT1	4	12	3	3	313.83	627.66	15	1	0.334083872783563	-2	1	-0.25	6	16
SULF2	3	33	1	6	870.21	1740.42	15	1	0.522688598979013	-0.833333333333333	1	-0.0595238095238095	7	36
SULT	5	11	2	1	309.87	619.74	15	1	0.523219814241486	-3.4	1	-0.354166666666667	3	16
SULT1B-SULT1B1	13	21	2	1	288.09	576.18	15	1	0.554054054054054	-2.23076923076923	1	-0.284313725490196	3	34
SULT1C3	6	6	1	1	304.92	609.84	15	1	1	0	1	0	2	12
SULT1E1	8	18	1	0	292.05	584.1	15	1	0.333333333333333	-Inf	1	-0.692307692307692	1	26
SULT2B1L1	0	7	0	6	168.96	337.92	15	1	1	NA	1	0	6	7
SULT4A1	5	9	0	0	241.56	483.12	15	1	1	NA	1	NA	0	14
SULT6B1L	9	8	1	0	312.84	625.68	15	1	1	-Inf	1	-0.470588235294118	1	17
SUMF1	9	11	3	2	285.45	570.9	15	1	0.64472049689441	-0.833333333333333	1	-0.15	5	20
SUMF2	6	18	7	7	308.88	617.76	15	1	0.162601373211201	-2	1	-0.25	14	24
SUMO1	0	1	0	1	97.02	194.04	15	1	1	NA	1	0	1	1
SUMO2	0	2	0	0	88.11	176.22	15	1	1	NA	1	NA	0	2
SUMO3	2	2	0	2	87.12	174.24	15	1	0.466666666666667	1	1	0.5	2	4
SUN1	14	32	6	3	896.94	1793.88	15	1	0.0589759765191319	-3.57142857142857	0.864933215778763	-0.36231884057971	9	46
SUN2	7	22	5	13	486.09	972.18	15	1	1	-0.208791208791209	1	-0.0363984674329502	18	29
SUPT20H	1	14	2	0	754.38	1508.76	15	1	0.0220588235294118	-Inf	0.721018759249189	-0.933333333333333	2	15
SUPT3H	6	9	0	0	345.51	691.02	15	1	1	NA	1	NA	0	15
SUPT5H	0	25	0	1	380.49	760.98	15	1	1	NA	1	0	1	25
SUPT6H	0	64	0	28	1664.19	3328.38	15	1	1	NA	1	0	28	64
SUPT7L	0	18	1	4	408.87	817.74	15	1	0.217391304347826	-Inf	1	-0.2	5	18
SUPV3L1	5	21	5	8	672.87	1345.74	15	1	0.253470488365125	-1.625	1	-0.192307692307692	13	26
SURF1	7	19	1	2	287.1	574.2	15	1	1	-0.357142857142857	1	-0.0641025641025641	3	26
SURF2	8	6	1	2	235.62	471.24	15	1	0.576470588235294	0.625	1	0.238095238095238	3	14
SURF4	0	10	0	3	251.46	502.92	15	1	1	NA	1	0	3	10
SURF6	14	16	2	1	351.78	703.56	15	1	0.601173020527859	-1.28571428571429	1	-0.2	3	30
SUSD1	20	30	3	4	719.73	1439.46	15	1	1	-0.125	1	-0.0285714285714285	7	50
SUSD2	19	29	0	0	802.56	1605.12	15	1	1	NA	1	NA	0	48
SUSD3	11	10	0	6	286.11	572.22	15	1	0.053586027499071	1	0.846060006968071	0.523809523809524	6	21
SUSD4	8	22	1	5	419.76	839.52	15	1	1	0.45	1	0.1	6	30
SUSD5	30	30	1	2	612.48	1224.96	15	1	1	0.5	1	0.166666666666667	3	60
SUSD6	8	10	0	2	325.38	650.76	15	1	0.494736842105263	1	1	0.444444444444444	2	18
SUV39H2	11	13	1	1	448.14	896.28	15	1	1	-0.181818181818182	1	-0.0416666666666667	2	24
SUZ12	0	11	0	3	631.29	1262.58	15	1	1	NA	1	0	3	11
SV2B	4	38	3	7	698.94	1397.88	15	1	0.120105877688726	-3.07142857142857	1	-0.204761904761905	10	42
SV2C	1	17	1	3	386.76	773.52	15	1	0.337662337662338	-4.66666666666667	1	-0.194444444444444	4	18
SVEP1	66	157	17	17	3487.77	6975.54	15	1	0.0288366426523771	-1.37878787878788	0.763361588853858	-0.204035874439462	34	223
SVIL	12	49	2	9	1546.38	3092.76	15	1	1	0.0925925925925926	1	0.014903129657228	11	61
SVIP	3	1	0	0	75.57	151.14	15	1	1	NA	1	NA	0	4
SVOP	4	17	2	5	588.06	1176.12	15	1	0.62190635451505	-0.7	1	-0.0952380952380952	7	21
SVOPL	25	24	7	9	562.32	1124.64	15	1	0.774649126350741	0.253333333333333	1	0.0727040816326531	16	49
SWAP70	3	34	2	3	553.41	1106.82	15	1	0.0993877752542708	-6.55555555555556	0.971353639774823	-0.318918918918919	5	37
SWT1	36	22	3	4	837.21	1674.42	15	1	0.424046162016331	0.541666666666667	1	0.192118226600985	7	58
SYAP1	0	11	0	2	317.13	634.26	15	1	1	NA	1	0	2	11
SYCE3	0	2	0	1	92.07	184.14	15	1	1	NA	1	0	1	2
SYCP2	42	38	3	5	1105.17	2210.34	15	1	0.479358950338202	0.457142857142857	1	0.15	8	80
SYCP2L	84	33	11	10	805.86	1611.72	15	1	0.122295109839336	0.567857142857143	1	0.194139194139194	21	117
SYDE2	33	53	6	8	942.81	1885.62	15	1	0.774036375332382	-0.204545454545455	1	-0.0448504983388704	14	86
SYK	1	23	0	1	624.36	1248.72	15	1	1	1	1	0.0416666666666667	1	24
SYN2	4	8	3	2	403.92	807.84	15	1	0.592760180995475	-2	1	-0.266666666666667	5	12
SYN3	2	9	2	4	711.81	1423.62	15	1	0.584033613445378	-1.25	1	-0.151515151515151	6	11
SYNC	23	30	4	8	574.2	1148.4	15	1	0.747050346409147	0.347826086956522	1	0.10062893081761	12	53
SYNDIG1L	1	4	3	4	238.92	477.84	15	1	0.575757575757576	-2	1	-0.228571428571429	7	5
SYNE1	161	173	27	14	5903.7	11807.4	15	1	0.0460323640440959	-1.07231588287489	0.826801538708688	-0.176500657222141	41	334
SYNE2	195	205	33	27	6909.87	13819.74	15	1	0.407316615398818	-0.284900284900285	1	-0.0625000000000001	60	400
SYNE3	25	33	2	8	1006.83	2013.66	15	1	0.294347370533601	0.67	1	0.231034482758621	10	58
SYNGR1	7	5	0	1	196.02	392.04	15	1	0.461538461538462	1	1	0.583333333333333	1	12
SYNGR3	1	4	1	6	210.21	420.42	15	1	1	0.333333333333333	1	0.0571428571428572	7	5
SYNJ1	21	56	5	14	1593.9	3187.8	15	1	1	0.0476190476190477	1	0.00956937799043062	19	77
SYNJ2	20	58	7	10	1488.3	2976.6	15	1	0.2386114585688	-1.03	1	-0.155354449472097	17	78
SYNJ2BP	4	12	1	3	416.46	832.92	15	1	1	0	1	0	4	16
SYNM	35	56	10	6	1457.28	2914.56	15	1	0.099653315029732	-1.66666666666667	0.971353639774823	-0.240384615384615	16	91
SYNPO	16	18	8	12	531.63	1063.26	15	1	0.777759113332008	0.25	1	0.0705882352941176	20	34
SYNPO2	21	45	3	9	1219.02	2438.04	15	1	0.745435331858952	0.285714285714286	1	0.0681818181818182	12	66
SYNPO2L	16	32	4	15	770.22	1540.44	15	1	0.387203358038971	0.466666666666667	1	0.12280701754386	19	48
SYNPR	1	8	1	1	261.69	523.38	15	1	0.345454545454545	-7	1	-0.388888888888889	2	9
SYNRG	37	89	13	18	1917.3	3834.6	15	1	0.199987646959041	-0.737237237237237	1	-0.125704045058884	31	126
SYPL1	7	8	3	0	234.63	469.26	15	1	0.215686274509804	-Inf	1	-0.533333333333333	3	15
SYS1	0	6	0	2	136.95	273.9	15	1	1	NA	1	0	2	6
SYT1	0	13	0	3	420.75	841.5	15	1	1	NA	1	0	3	13
SYT10	3	10	0	1	470.91	941.82	15	1	1	1	1	0.230769230769231	1	13
SYT11	1	9	0	2	411.18	822.36	15	1	1	1	1	0.1	2	10
SYT12	4	5	2	11	313.17	626.34	15	1	0.177797434763379	0.772727272727273	1	0.290598290598291	13	9
SYT13	6	18	2	2	425.37	850.74	15	1	0.554578754578755	-2	1	-0.25	4	24
SYT14	21	7	6	3	805.86	1611.72	15	1	0.678776630454966	0.333333333333333	1	0.0833333333333334	9	28
SYT16	13	14	3	5	581.13	1162.26	15	1	0.700273030640105	0.353846153846154	1	0.106481481481481	8	27
SYT17	0	16	2	1	459.36	918.72	15	1	0.0175438596491228	-Inf	0.677255339142531	-0.666666666666667	3	16
SYT2	1	12	1	14	404.25	808.5	15	1	1	0.142857142857143	1	0.0102564102564103	15	13
SYT4	5	10	2	1	418.11	836.22	15	1	0.528186274509804	-3	1	-0.333333333333333	3	15
SYT6	6	16	2	1	516.78	1033.56	15	1	0.231304347826087	-4.33333333333333	1	-0.393939393939394	3	22
SYT8	7	16	9	4	392.04	784.08	15	1	0.0379398626339672	-4.14285714285714	0.789311843512415	-0.387959866220736	13	23
SYT9	12	10	0	0	534.6	1069.2	15	1	1	NA	1	NA	0	22
SYTL1	0	3	2	3	39.93	79.86	15	1	0.464285714285714	-Inf	1	-0.4	5	3
SYTL2	111	92	15	10	2027.52	4055.04	15	1	0.674068591110188	-0.243243243243243	1	-0.0532019704433497	25	203
SYTL2L	27	34	11	9	957.33	1914.66	15	1	0.447399568102286	-0.539094650205761	1	-0.107377049180328	20	61
SYTL3	13	27	5	3	543.51	1087.02	15	1	0.131742296363456	-2.46153846153846	1	-0.3	8	40
SYTL4	5	27	6	5	684.09	1368.18	15	1	0.0183846427408186	-5.48	0.677255339142531	-0.389204545454545	11	32
SYTL5	11	20	3	5	760.32	1520.64	15	1	1	-0.0909090909090908	1	-0.0201612903225806	8	31
SZRD1	0	7	0	3	134.64	269.28	15	1	1	NA	1	0	3	7
SZT2	33	164	14	28	3555.75	7111.5	15	1	0.0189525893108773	-1.48484848484848	0.683149554847669	-0.165820642978003	42	197
T	4	15	0	2	294.03	588.06	15	1	1	1	1	0.210526315789474	2	19
TA3	82	56	14	11	1568.16	3136.32	15	1	0.826328418486567	0.130820399113082	1	0.0342028985507246	25	138
TAB1	2	26	0	4	493.68	987.36	15	1	1	1	1	0.0714285714285714	4	28
TAB2	10	14	3	3	730.62	1461.24	15	1	1	-0.4	1	-0.0833333333333333	6	24
TAB3	6	13	0	3	701.25	1402.5	15	1	0.532467532467532	1	1	0.315789473684211	3	19
TAC1	2	7	1	1	76.89	153.78	15	1	0.490909090909091	-2.5	1	-0.277777777777778	2	9
TACC1	21	35	7	10	660.33	1320.66	15	1	0.783652547934602	-0.166666666666667	1	-0.0367647058823529	17	56
TACC2	197	154	44	42	3106.29	6212.58	15	1	0.46813503503397	0.181049069373942	1	0.0496256542768171	86	351
TACC3	35	35	2	5	885.06	1770.12	15	1	0.433374844333748	0.6	1	0.214285714285714	7	70
TACR1	3	20	0	1	298.98	597.96	15	1	1	1	1	0.130434782608696	1	23
TACR3	10	22	4	1	432.63	865.26	15	1	0.0574103515279986	-7.8	0.852328343103251	-0.4875	5	32
TADA1	0	15	2	1	300.96	601.92	15	1	0.0196078431372549	-Inf	0.692007797270955	-0.666666666666667	3	15
TADA2A	1	10	0	3	415.8	831.6	15	1	1	1	1	0.0909090909090909	3	11
TADA2B	0	12	0	3	376.86	753.72	15	1	1	NA	1	0	3	12
TADA3	1	10	0	8	305.91	611.82	15	1	1	1	1	0.0909090909090909	8	11
TAF10	0	12	0	1	114.51	229.02	15	1	1	NA	1	0	1	12
TAF11	0	5	0	2	130.02	260.04	15	1	1	NA	1	0	2	5
TAF12	0	9	0	1	109.56	219.12	15	1	1	NA	1	0	1	9
TAF13	0	1	0	3	88.44	176.88	15	1	1	NA	1	0	3	1
TAF15	3	12	0	3	468.6	937.2	15	1	1	1	1	0.2	3	15
TAF1A	20	7	1	0	199.65	399.3	15	1	1	-Inf	1	-0.259259259259259	1	27
TAF1B	18	24	3	1	569.25	1138.5	15	1	0.317952017648681	-3	1	-0.321428571428571	4	42
TAF1CZ	7	10	0	4	160.05	320.1	15	1	0.254970760233918	1	1	0.411764705882353	4	17
TAF1D	18	15	3	4	345.51	691.02	15	1	0.688929313929314	0.375	1	0.116883116883117	7	33
TAF2	7	43	4	8	1529.22	3058.44	15	1	0.199759563916263	-2.07142857142857	1	-0.193333333333333	12	50
TAF3	11	30	0	3	849.42	1698.84	15	1	0.561461794019933	1	1	0.268292682926829	3	41
TAF4	0	21	2	6	944.13	1888.26	15	1	0.0689655172413793	-Inf	0.89314784667752	-0.25	8	21
TAF4B	24	35	6	8	752.4	1504.8	15	1	1	-0.09375	1	-0.0217917675544794	14	59
TAF5	1	24	3	0	656.7	1313.4	15	1	0.00122100122100122	-Inf	0.254094564439392	-0.96	3	25
TAF5L	0	13	1	6	584.1	1168.2	15	1	0.35	-Inf	1	-0.142857142857143	7	13
TAF6-TAF6L	4	41	1	4	410.19	820.38	15	1	0.423361305669354	-1.5625	1	-0.111111111111111	5	45
TAF7	0	9	1	2	330.33	660.66	15	1	0.25	-Inf	1	-0.333333333333333	3	9
TAF8	2	12	3	9	290.07	580.14	15	1	0.634782608695652	-1	1	-0.107142857142857	12	14
TAF9	2	13	1	3	133.65	267.3	15	1	0.530443756449949	-1.16666666666667	1	-0.116666666666667	4	15
TAGAP	10	20	5	4	689.04	1378.08	15	1	0.265743514719845	-1.5	1	-0.222222222222222	9	30
TAGLN	0	2	0	2	67.65	135.3	15	1	1	NA	1	0	2	2
TAGLN3	0	5	0	1	198	396	15	1	1	NA	1	0	1	5
TAL1	1	8	0	3	168.63	337.26	15	1	1	1	1	0.111111111111111	3	9
TALDO1	1	10	3	1	302.61	605.22	15	1	0.0329670329670329	-29	0.784275503573749	-0.659090909090909	4	11
TAMM41	1	8	1	2	307.56	615.12	15	1	0.454545454545454	-3	1	-0.222222222222222	3	9
TANC1	37	61	7	8	1789.92	3579.84	15	1	0.574946954438863	-0.442567567567568	1	-0.0891156462585034	15	98
TANC2	21	58	7	31	2154.24	4308.48	15	1	0.366031795215862	0.376344086021505	1	0.0816122584943371	38	79
TANGO2	0	11	2	4	274.23	548.46	15	1	0.110294117647059	-Inf	0.98538656216834	-0.333333333333333	6	11
TANK	6	13	2	2	477.18	954.36	15	1	0.588932806324111	-1.16666666666667	1	-0.184210526315789	4	19
TAOK1	0	10	2	3	991.98	1983.96	15	1	0.0952380952380952	-Inf	0.960983694935281	-0.4	5	10
TAOK3	1	19	0	4	839.52	1679.04	15	1	1	1	1	0.05	4	20
TAP1	1	3	0	1	42.9	85.8	15	1	1	1	1	0.25	1	4
TAP2	33	29	7	10	615.45	1230.9	15	1	0.422469742609022	0.384848484848485	1	0.120493358633776	17	62
TAPBPL	28	16	3	6	452.43	904.86	15	1	0.139635530719956	0.714285714285714	1	0.303030303030303	9	44
TAPT1	1	15	1	3	497.64	995.28	15	1	0.368421052631579	-4	1	-0.1875	4	16
TARBP1	34	47	6	11	1289.64	2579.28	15	1	0.787214805061703	0.245989304812834	1	0.0668119099491648	17	81
TARDBP	1	5	0	1	377.85	755.7	15	1	1	1	1	0.166666666666667	1	6
TARP	25	7	1	3	170.28	340.56	15	1	0.0565317035905271	0.906666666666667	0.846060006968071	0.53125	4	32
TARS	6	24	0	0	703.89	1407.78	15	1	1	NA	1	NA	0	30
TARSL2	8	25	5	3	665.61	1331.22	15	1	0.0839607258092496	-4.20833333333333	0.949431371776132	-0.382575757575758	8	33
TAS1R1	23	51	3	4	896.28	1792.56	15	1	0.674855651787697	-0.66304347826087	1	-0.117760617760618	7	74
TAS1R3	23	40	9	6	823.68	1647.36	15	1	0.143703175476737	-1.60869565217391	1	-0.234920634920635	15	63
TAT	4	16	2	2	451.44	902.88	15	1	0.251270468661773	-3	1	-0.3	4	20
TATDN1	6	11	3	3	284.46	568.92	15	1	0.643020594965675	-0.833333333333333	1	-0.147058823529412	6	17
TATDN3	6	9	3	2	214.17	428.34	15	1	0.61687306501548	-1.25	1	-0.2	5	15
TAX1BP3	0	6	0	0	110.88	221.76	15	1	1	NA	1	NA	0	6
TBC1D13	0	20	0	3	363.99	727.98	15	1	1	NA	1	0	3	20
TBC1D14	7	24	2	5	691.68	1383.36	15	1	1	-0.371428571428571	1	-0.0599078341013825	7	31
TBC1D15	6	24	4	4	680.13	1360.26	15	1	0.170053132402079	-3	1	-0.3	8	30
TBC1D16	7	31	6	5	780.12	1560.24	15	1	0.046624741082143	-4.31428571428571	0.828231827900648	-0.361244019138756	11	38
TBC1D19	2	16	2	0	514.14	1028.28	15	1	0.0315789473684211	-Inf	0.778718235934639	-0.888888888888889	2	18
TBC1D2	17	31	7	7	944.46	1888.92	15	1	0.362628012588619	-0.823529411764706	1	-0.145833333333333	14	48
TBC1D20	0	9	2	3	312.51	625.02	15	1	0.10989010989011	-Inf	0.98538656216834	-0.4	5	9
TBC1D22A	10	14	4	2	463.98	927.96	15	1	0.377777777777778	-1.8	1	-0.25	6	24
TBC1D22B	5	27	1	14	498.63	997.26	15	1	0.648356290569573	0.614285714285714	1	0.0895833333333333	15	32
TBC1D23	11	68	3	8	1638.12	3276.24	15	1	0.367190600069354	-1.31818181818182	1	-0.133486766398159	11	79
TBC1D24	2	15	3	9	518.1	1036.2	15	1	0.622079070354932	-1.5	1	-0.132352941176471	12	17
TBC1D24L	19	27	9	14	623.37	1246.74	15	1	1	0.0864661654135338	1	0.0217391304347826	23	46
TBC1D2B	5	19	1	6	906.18	1812.36	15	1	1	0.366666666666667	1	0.0654761904761905	7	24
TBC1D30	12	50	3	6	780.12	1560.24	15	1	0.386916077908071	-1.08333333333333	1	-0.139784946236559	9	62
TBC1D31	23	30	2	7	1065.24	2130.48	15	1	0.291646836634867	0.627329192546584	1	0.211740041928721	9	53
TBC1D32	28	32	4	2	1051.71	2103.42	15	1	0.420164534918633	-1.28571428571429	1	-0.2	6	60
TBC1D4	6	38	3	0	1121.67	2243.34	15	1	0.00518038852913968	-Inf	0.463165107753452	-0.863636363636364	3	44
TBC1D7	7	9	0	0	271.26	542.52	15	1	1	NA	1	NA	0	16
TBC1D8	14	53	4	16	1102.53	2205.06	15	1	1	0.0535714285714286	1	0.008955223880597	20	67
TBC1D8B	10	40	4	0	1071.51	2143.02	15	1	0.00316520738274346	-Inf	0.397958886559516	-0.8	4	50
TBC1D9	5	42	2	5	1235.85	2471.7	15	1	0.220473893476113	-2.36	1	-0.179331306990881	7	47
TBC1D9B	3	43	3	6	1208.13	2416.26	15	1	0.0486866444691085	-6.16666666666667	0.833370237838852	-0.268115942028985	9	46
TBCA	0	3	0	0	99	198	15	1	1	NA	1	NA	0	3
TBCC	6	3	1	2	181.17	362.34	15	1	0.522727272727273	0.75	1	0.333333333333333	3	9
TBCCD1	7	13	7	2	396.99	793.98	15	1	0.0501749125437281	-5.5	0.838764987711203	-0.427777777777778	9	20
TBCE	7	16	5	4	496.32	992.64	15	1	0.23996748524001	-1.85714285714286	1	-0.251207729468599	9	23
TBCEL	0	12	1	4	411.18	822.36	15	1	0.294117647058824	-Inf	1	-0.2	5	12
TBCK	10	28	0	3	691.35	1382.7	15	1	0.563789868667917	1	1	0.263157894736842	3	38
TBK1	1	21	4	3	689.04	1378.08	15	1	0.00666077217801355	-27	0.478544763027521	-0.525974025974026	7	22
TBKBP1	0	6	3	2	217.8	435.6	15	1	0.0606060606060606	-Inf	0.870851370851371	-0.6	5	6
TBL1X	0	10	0	3	518.76	1037.52	15	1	1	NA	1	0	3	10
TBL1XR1	0	7	0	2	508.86	1017.72	15	1	1	NA	1	0	2	7
TBL3	15	55	6	13	797.94	1595.88	15	1	0.371754515722099	-0.692307692307692	1	-0.101503759398496	19	70
TBP	0	12	0	2	299.97	599.94	15	1	1	NA	1	0	2	12
TBPL2	5	13	5	6	321.75	643.5	15	1	0.431998286571	-1.16666666666667	1	-0.176767676767677	11	18
TBRG4	22	25	4	10	419.1	838.2	15	1	0.356516105682885	0.545454545454545	1	0.182370820668693	14	47
TBX1	2	8	2	3	266.64	533.28	15	1	0.56043956043956	-1.66666666666667	1	-0.2	5	10
TBX10	2	0	2	1	75.24	150.48	15	1	1	1	1	0.333333333333333	3	2
TBX15	1	12	0	1	524.7	1049.4	15	1	1	1	1	0.0769230769230769	1	13
TBX19	5	9	3	2	360.36	720.72	15	1	0.602683178534572	-1.7	1	-0.242857142857143	5	14
TBX20	0	13	0	1	370.26	740.52	15	1	1	NA	1	0	1	13
TBX22	3	5	1	3	319.44	638.88	15	1	1	0.444444444444444	1	0.125	4	8
TBX3	0	5	1	0	297.99	595.98	15	1	0.166666666666667	-Inf	1	-1	1	5
TBX4	0	20	0	7	485.1	970.2	15	1	1	NA	1	0	7	20
TBX5	0	24	1	4	450.12	900.24	15	1	0.172413793103448	-Inf	1	-0.2	5	24
TBXA2R	3	11	0	6	259.71	519.42	15	1	0.521052631578947	1	1	0.214285714285714	6	14
TBXAS1	9	10	1	1	346.83	693.66	15	1	1	-0.111111111111111	1	-0.0263157894736842	2	19
TC2N	8	10	1	2	485.1	970.2	15	1	1	0.375	1	0.111111111111111	3	18
TCAIM	4	11	2	3	485.1	970.2	15	1	0.612616099071208	-0.833333333333333	1	-0.133333333333333	5	15
TCEA1	0	8	0	0	268.62	537.24	15	1	1	NA	1	NA	0	8
TCEA2	5	15	4	4	304.92	609.84	15	1	0.371480693219823	-2	1	-0.25	8	20
TCEANC	13	11	2	0	357.39	714.78	15	1	0.492307692307692	-Inf	1	-0.458333333333333	2	24
TCEANC2	3	6	2	1	173.25	346.5	15	1	0.522727272727273	-3	1	-0.333333333333333	3	9
TCEB3	8	2	1	0	39.27	78.54	15	1	1	-Inf	1	-0.2	1	10
TCERG1	0	27	1	3	964.92	1929.84	15	1	0.129032258064516	-Inf	1	-0.25	4	27
TCERG1L	27	35	4	3	656.37	1312.74	15	1	0.692465222601068	-0.728395061728395	1	-0.135944700460829	7	62
TCF12	1	11	2	3	486.75	973.5	15	1	0.191176470588235	-6.33333333333333	1	-0.316666666666667	5	12
TCF15	1	3	0	3	150.81	301.62	15	1	1	1	1	0.25	3	4
TCF20	18	124	9	20	1923.9	3847.8	15	1	0.0227980989247779	-2.1	0.731843228782099	-0.183584264205925	29	142
TCF21	0	5	0	0	176.88	353.76	15	1	1	NA	1	NA	0	5
TCF24	2	6	2	6	153.45	306.9	15	1	1	0	1	0	8	8
TCF25	6	23	4	14	611.82	1223.64	15	1	1	-0.0952380952380953	1	-0.0153256704980843	18	29
TCF7	0	10	0	3	328.02	656.04	15	1	1	NA	1	0	3	10
TCF7L2	0	1	0	4	283.47	566.94	15	1	1	NA	1	0	4	1
TCFL5	12	22	0	1	513.81	1027.62	15	1	1	1	1	0.352941176470588	1	34
TCHP	16	22	11	11	368.28	736.56	15	1	0.598731212422652	-0.375	1	-0.0789473684210527	22	38
TCIRG1	5	10	3	3	292.38	584.76	15	1	0.631062951496388	-1	1	-0.166666666666667	6	15
TCP1	0	28	2	9	529.32	1058.64	15	1	0.0742240215924426	-Inf	0.913861472365723	-0.181818181818182	11	28
TCP11	22	26	6	5	469.59	939.18	15	1	0.741446960013703	-0.418181818181818	1	-0.0871212121212121	11	48
TCP11L1	11	20	9	7	511.83	1023.66	15	1	0.220270073083821	-1.33766233766234	1	-0.207661290322581	16	31
TCP11L2	6	10	1	2	505.23	1010.46	15	1	1	0.166666666666667	1	0.0416666666666667	3	16
TCTE1	25	16	7	4	452.43	904.86	15	1	1	-0.12	1	-0.0266075388026608	11	41
TCTEX1D4	6	17	4	3	207.24	414.48	15	1	0.181314470969644	-2.77777777777778	1	-0.31055900621118	7	23
TCTN1	18	20	8	5	543.84	1087.68	15	1	0.52301713338091	-0.777777777777778	1	-0.1417004048583	13	38
TCTN2	31	26	4	2	668.91	1337.82	15	1	0.684432179127746	-0.67741935483871	1	-0.12280701754386	6	57
TCTN3	18	19	8	2	508.86	1017.72	15	1	0.149759015920419	-3.22222222222222	1	-0.313513513513514	10	37
TDG	5	14	1	4	397.32	794.64	15	1	1	0.3	1	0.0631578947368421	5	19
TDH	3	13	0	2	370.26	740.52	15	1	1	1	1	0.1875	2	16
TDO2	3	15	0	0	402.93	805.86	15	1	1	NA	1	NA	0	18
TDP1	32	31	5	6	670.56	1341.12	15	1	1	0.192708333333333	1	0.0533910533910534	11	63
TDP2	4	11	2	0	342.54	685.08	15	1	0.110294117647059	-Inf	0.98538656216834	-0.733333333333333	2	15
TDRD1	30	46	7	7	1063.26	2126.52	15	1	0.558313551420045	-0.533333333333333	1	-0.105263157894737	14	76
TDRD12	57	21	3	1	1066.56	2133.12	15	1	1	-0.105263157894737	1	-0.0192307692307693	4	78
TDRD3	11	25	5	3	786.06	1572.12	15	1	0.117235112697393	-2.78787878787879	1	-0.319444444444444	8	36
TDRD5	30	40	4	8	730.62	1461.24	15	1	0.752708453504808	0.333333333333333	1	0.0952380952380952	12	70
TDRD6	131	154	19	14	2274.03	4548.06	15	1	0.269041463266652	-0.595419847328244	1	-0.116108452950558	33	285
TDRD7	29	43	4	9	1054.68	2109.36	15	1	0.758250580818078	0.340996168582375	1	0.0950854700854701	13	72
TDRD9	41	49	3	3	1323.63	2647.26	15	1	1	-0.195121951219512	1	-0.0444444444444445	6	90
TEAD1	21	17	3	2	515.79	1031.58	15	1	1	-0.214285714285714	1	-0.0473684210526315	5	38
TEAD3	0	3	0	5	201.3	402.6	15	1	1	NA	1	0	5	3
TEAD4	14	17	3	1	515.46	1030.92	15	1	0.337662337662338	-2.64285714285714	1	-0.298387096774194	4	31
TEC	2	25	0	1	624.69	1249.38	15	1	1	1	1	0.0740740740740741	1	27
TECPR1	13	41	7	5	1126.62	2253.24	15	1	0.0342231797888704	-3.41538461538462	0.788199921465956	-0.342592592592593	12	54
TECPR2	18	43	2	6	1453.32	2906.64	15	1	1	0.203703703703704	1	0.0450819672131147	8	61
TECRL	7	14	1	1	422.73	845.46	15	1	1	-1	1	-0.166666666666667	2	21
TECTA	18	115	20	80	2129.16	4258.32	15	1	0.211819985043528	-0.597222222222222	1	-0.0646616541353384	100	133
TECTB	5	13	1	0	325.71	651.42	15	1	0.315789473684211	-Inf	1	-0.722222222222222	1	18
TEF	0	3	1	1	286.11	572.22	15	1	0.4	-Inf	1	-0.5	2	3
TEK	18	55	0	0	1258.29	2516.58	15	1	1	NA	1	NA	0	73
TEKT1	7	11	2	0	411.84	823.68	15	1	0.189473684210526	-Inf	1	-0.611111111111111	2	18
TEKT2	3	15	1	5	426.69	853.38	15	1	1	0	1	0	6	18
TEKT3	13	19	3	15	465.96	931.92	15	1	0.117146264333711	0.707692307692308	1	0.239583333333333	18	32
TEKT4	6	12	6	3	441.54	883.08	15	1	0.126620900076278	-3	1	-0.333333333333333	9	18
TEKT5	3	20	1	2	357.39	714.78	15	1	0.407692307692308	-2.33333333333333	1	-0.202898550724638	3	23
TELO2	15	31	9	11	643.5	1287	15	1	0.407792885413806	-0.690909090909091	1	-0.123913043478261	20	46
TEN1	9	8	2	3	125.73	251.46	15	1	1	0.407407407407407	1	0.129411764705882	5	17
TENM1	8	99	4	21	2445.3	4890.6	15	1	0.239684162404448	-1.35714285714286	1	-0.0852336448598131	25	107
TENM2	1	84	2	18	2276.67	4553.34	15	1	0.0922330097087381	-8.33333333333333	0.954761944412066	-0.0882352941176471	20	85
TENM3	2	68	5	10	2251.26	4502.52	15	1	0.00154158536654249	-16	0.284493574108469	-0.304761904761905	15	70
TENM4	8	107	4	29	2511.63	5023.26	15	1	0.467098783790306	-0.844827586206897	1	-0.0516469038208169	33	115
TERAL2-VCP	0	28	0	9	786.06	1572.12	15	1	1	NA	1	0	9	28
TERB2	13	19	1	4	309.21	618.42	15	1	0.630277336159689	0.634615384615385	1	0.20625	5	32
TERF1	34	11	0	1	253.11	506.22	15	1	0.260869565217391	1	1	0.755555555555556	1	45
TERF2	16	35	0	6	453.09	906.18	15	1	0.170189625005911	1	1	0.313725490196078	6	51
TERF2IP	9	10	3	1	175.56	351.12	15	1	0.590062111801242	-2.33333333333333	1	-0.276315789473684	4	19
TERT	60	51	6	4	1285.02	2570.04	15	1	0.754281819563247	-0.275	1	-0.0594594594594594	10	111
TES	2	13	0	3	418.77	837.54	15	1	1	1	1	0.133333333333333	3	15
TESC	0	5	0	1	189.42	378.84	15	1	1	NA	1	0	1	5
TESK1	17	24	5	6	406.56	813.12	15	1	1	-0.176470588235294	1	-0.0399113082039911	11	41
TESK2	14	20	2	4	685.08	1370.16	15	1	1	0.285714285714286	1	0.0784313725490196	6	34
TESMIN	8	20	5	1	522.72	1045.44	15	1	0.0213717856441798	-11.5	0.721018759249189	-0.547619047619048	6	28
TESPA1	0	2	0	4	105.6	211.2	15	1	1	NA	1	0	4	2
TET1	42	76	8	7	2206.05	4412.1	15	1	0.25721082145802	-1.06802721088435	1	-0.177401129943503	15	118
TET2	48	94	12	9	1899.81	3799.62	15	1	0.0519039667901101	-1.61111111111111	0.843251957917679	-0.233400402414487	21	142
TET3	28	77	3	8	1538.46	3076.92	15	1	1	-0.03125	1	-0.00606060606060604	11	105
TEX10	8	35	2	5	916.41	1832.82	15	1	0.615717769741822	-0.75	1	-0.0996677740863787	7	43
TEX11	15	25	5	3	858.99	1717.98	15	1	0.250505024534397	-1.77777777777778	1	-0.25	8	40
TEX14	72	49	19	8	1488.96	2977.92	15	1	0.382965608756508	-0.616319444444444	1	-0.108662381389654	27	121
TEX2	19	36	5	11	1171.17	2342.34	15	1	1	0.138755980861244	1	0.0329545454545455	16	55
TEX264	4	13	1	9	313.83	627.66	15	1	0.620958751393534	0.638888888888889	1	0.135294117647059	10	17
TEX2L	21	44	17	18	785.07	1570.14	15	1	0.132943471150529	-0.978835978835979	1	-0.162637362637363	35	65
TEX30	2	7	2	1	223.74	447.48	15	1	0.236363636363636	-6	1	-0.444444444444444	3	9
TEX33	15	7	2	3	355.41	710.82	15	1	0.326148891366283	0.688888888888889	1	0.281818181818182	5	22
TEX36	2	7	1	0	179.19	358.38	15	1	0.3	-Inf	1	-0.777777777777778	1	9
TEX9	21	14	2	1	370.59	741.18	15	1	1	-0.333333333333333	1	-0.0666666666666667	3	35
TF	10	19	3	2	699.93	1399.86	15	1	0.347561238571675	-1.85	1	-0.255172413793103	5	29
TFAM	4	6	0	3	195.69	391.38	15	1	0.496503496503497	1	1	0.4	3	10
TFAP2A	0	6	0	0	230.34	460.68	15	1	1	NA	1	NA	0	6
TFAP2B	0	10	0	0	414.48	828.96	15	1	1	NA	1	NA	0	10
TFAP2C	0	5	0	3	254.1	508.2	15	1	1	NA	1	0	3	5
TFAP2D	0	8	0	0	393.03	786.06	15	1	1	NA	1	NA	0	8
TFAP2E	1	11	1	4	338.25	676.5	15	1	0.514705882352941	-1.75	1	-0.116666666666667	5	12
TFB1M	7	13	2	1	345.51	691.02	15	1	0.537549407114625	-2.71428571428571	1	-0.316666666666667	3	20
TFB2M	6	9	0	1	299.97	599.94	15	1	1	1	1	0.4	1	15
TFCP2L1	0	13	0	2	470.91	941.82	15	1	1	NA	1	0	2	13
TFDP1	1	13	0	1	411.84	823.68	15	1	1	1	1	0.0714285714285714	1	14
TFDP2	3	19	2	0	442.53	885.06	15	1	0.036231884057971	-Inf	0.788199921465956	-0.863636363636364	2	22
TFEB	2	8	3	11	435.27	870.54	15	1	1	-0.0909090909090908	1	-0.0142857142857143	14	10
TFEC	11	8	1	1	414.15	828.3	15	1	1	0.272727272727273	1	0.0789473684210527	2	19
TFF2	3	5	0	0	127.71	255.42	15	1	1	NA	1	NA	0	8
TFG	0	13	0	1	342.54	685.08	15	1	1	NA	1	0	1	13
TFIP11	4	44	0	8	754.05	1508.1	15	1	1	1	1	0.0833333333333333	8	48
TFPI	16	11	4	3	334.95	669.9	15	1	1	0.0833333333333334	1	0.0211640211640212	7	27
TFPI2	2	7	2	1	209.55	419.1	15	1	0.236363636363636	-6	1	-0.444444444444444	3	9
TFRC	11	32	6	9	769.23	1538.46	15	1	0.333572510190464	-0.939393939393939	1	-0.144186046511628	15	43
TGDS	8	15	2	1	329.01	658.02	15	1	0.538461538461538	-2.75	1	-0.318840579710145	3	23
TGFB2	6	9	1	0	349.8	699.6	15	1	0.4375	-Inf	1	-0.6	1	15
TGFB3	0	19	0	5	371.25	742.5	15	1	1	NA	1	0	5	19
TGFBI	1	25	1	10	639.54	1279.08	15	1	0.512012012012012	-1.5	1	-0.0524475524475524	11	26
TGFBR1	0	14	1	2	472.89	945.78	15	1	0.176470588235294	-Inf	1	-0.333333333333333	3	14
TGFBR2	0	11	0	5	532.29	1064.58	15	1	1	NA	1	0	5	11
TGFBR3	12	24	2	2	711.81	1423.62	15	1	0.601706970128023	-1	1	-0.166666666666667	4	36
TGFBRAP1	12	37	3	8	854.37	1708.74	15	1	1	-0.15625	1	-0.0278293135435992	11	49
TGIF1	3	8	0	2	262.02	524.04	15	1	1	1	1	0.272727272727273	2	11
TGIF2	5	10	2	2	191.73	383.46	15	1	0.602683178534572	-1	1	-0.166666666666667	4	15
TGM2	19	25	7	16	647.79	1295.58	15	1	0.429438139028106	0.424342105263158	1	0.127470355731225	23	44
TGM4	23	36	0	13	689.7	1379.4	15	1	0.00646582750200874	1	0.467685236262114	0.389830508474576	13	59
TGS1	30	30	5	3	851.73	1703.46	15	1	0.710150383015565	-0.666666666666667	1	-0.125	8	60
TH	2	17	2	6	487.08	974.16	15	1	0.558290598290598	-1.83333333333333	1	-0.144736842105263	8	19
THAP1	0	3	0	2	215.49	430.98	15	1	1	NA	1	0	2	3
THAP12	5	28	2	9	768.57	1537.14	15	1	1	-0.244444444444444	1	-0.0303030303030303	11	33
THAP4	11	39	1	6	885.06	1770.12	15	1	1	0.409090909090909	1	0.0771428571428572	7	50
THAP5	9	16	2	1	382.47	764.94	15	1	0.543345543345543	-2.55555555555556	1	-0.306666666666667	3	25
THBD	11	20	1	8	326.7	653.4	15	1	0.233181323738599	0.772727272727273	1	0.243727598566308	9	31
THBS2	2	43	1	3	1169.85	2339.7	15	1	0.229808944854538	-6.16666666666667	1	-0.205555555555556	4	45
THBS4	12	33	3	5	915.09	1830.18	15	1	0.672950380567367	-0.65	1	-0.108333333333333	8	45
THEMIS	16	22	2	1	605.88	1211.76	15	1	0.572795497185741	-1.75	1	-0.245614035087719	3	38
THEMIS2	21	18	1	0	473.55	947.1	15	1	1	-Inf	1	-0.461538461538462	1	39
THG1L	3	22	4	3	268.95	537.9	15	1	0.0258406776760503	-8.77777777777778	0.761210061313465	-0.451428571428571	7	25
THL	15	17	3	0	428.01	856.02	15	1	0.228571428571429	-Inf	1	-0.53125	3	32
THNSL2	15	29	4	1	491.04	982.08	15	1	0.0670769695482263	-6.73333333333333	0.884435842948953	-0.459090909090909	5	44
THOC1	5	23	2	7	657.36	1314.72	15	1	1	-0.314285714285714	1	-0.0436507936507936	9	28
THOC2	8	48	1	7	1495.23	2990.46	15	1	1	0.142857142857143	1	0.0178571428571428	8	56
THOC3	0	6	0	3	260.37	520.74	15	1	1	NA	1	0	3	6
THOC5	3	23	2	11	598.95	1197.9	15	1	1	-0.393939393939394	1	-0.0384615384615385	13	26
THOC7	1	5	1	0	190.41	380.82	15	1	0.285714285714286	-Inf	1	-0.833333333333333	1	6
THOP1	2	31	0	12	672.54	1345.08	15	1	1	1	1	0.0606060606060606	12	33
THPO	20	10	9	5	217.47	434.94	15	1	1	0.1	1	0.0238095238095237	14	30
THRAP3	10	34	3	3	957.33	1914.66	15	1	0.172915290075327	-2.4	1	-0.272727272727273	6	44
THRB	0	8	1	15	472.23	944.46	15	1	1	-Inf	1	-0.0625	16	8
THSD1	25	38	8	10	842.49	1684.98	15	1	0.788642568379626	-0.216	1	-0.0476190476190476	18	63
THSD4	8	24	1	5	631.62	1263.24	15	1	1	0.4	1	0.0833333333333333	6	32
THSD7A	10	34	2	1	972.84	1945.68	15	1	0.156028368794326	-5.8	1	-0.439393939393939	3	44
THSD7B	23	43	11	12	1035.54	2071.08	15	1	0.322519855554946	-0.713768115942029	1	-0.129776021080369	23	66
THT2L	15	24	2	4	570.9	1141.8	15	1	1	0.2	1	0.0512820512820513	6	39
THUMPD1	6	7	0	0	249.48	498.96	15	1	1	NA	1	NA	0	13
THUMPD2	22	27	10	9	489.06	978.12	15	1	0.598732140300017	-0.363636363636364	1	-0.0773361976369495	19	49
THUMPD3	7	26	0	3	421.74	843.48	15	1	1	1	1	0.212121212121212	3	33
THY1	0	2	1	1	136.62	273.24	15	1	1	-Inf	1	-0.5	2	2
THYN1	2	5	0	4	240.57	481.14	15	1	0.490909090909091	1	1	0.285714285714286	4	7
TIA1	0	13	0	6	360.69	721.38	15	1	1	NA	1	0	6	13
TIAM1	16	66	13	14	1685.97	3371.94	15	1	0.0055961255289287	-2.83035714285714	0.467685236262114	-0.286359530261969	27	82
TIAM2	14	70	3	7	1706.76	3413.52	15	1	0.380151948598396	-1.14285714285714	1	-0.133333333333333	10	84
TICAM1	58	35	9	8	759.33	1518.66	15	1	0.59001986705787	0.321120689655172	1	0.0942441492726123	17	93
TICRR	96	115	20	21	1734.48	3468.96	15	1	0.734159328218191	-0.140873015873016	1	-0.032828574731245	41	211
TIE1	3	70	3	16	1016.73	2033.46	15	1	0.100032524792055	-3.375	0.971353639774823	-0.116798846431146	19	73
TIFA	5	6	2	0	186.12	372.24	15	1	0.461538461538462	-Inf	1	-0.545454545454545	2	11
TIGAR	0	2	0	0	12.54	25.08	15	1	1	NA	1	NA	0	2
TIMD4	20	14	1	0	353.43	706.86	15	1	1	-Inf	1	-0.411764705882353	1	34
TIMELESS	12	15	5	3	370.59	741.18	15	1	0.443017494185459	-1.08333333333333	1	-0.180555555555556	8	27
TIMM17A	2	16	1	1	146.52	293.04	15	1	0.284210526315789	-7	1	-0.388888888888889	2	18
TIMM21	4	8	2	0	224.73	449.46	15	1	0.164835164835165	-Inf	1	-0.666666666666667	2	12
TIMM22	1	8	0	3	114.51	229.02	15	1	1	1	1	0.111111111111111	3	9
TIMM23B	0	5	0	1	153.45	306.9	15	1	1	NA	1	0	1	5
TIMM44	4	15	1	6	465.3	930.6	15	1	1	0.375	1	0.0676691729323308	7	19
TIMM9	0	5	0	1	89.1	178.2	15	1	1	NA	1	0	1	5
TIMMDC1	9	6	2	2	220.11	440.22	15	1	1	0.333333333333333	1	0.1	4	15
TIMP2	0	6	2	2	173.58	347.16	15	1	0.133333333333333	-Inf	1	-0.5	4	6
TIMP3	0	4	0	0	192.72	385.44	15	1	1	NA	1	NA	0	4
TIMP4	0	6	0	2	219.78	439.56	15	1	1	NA	1	0	2	6
TINAG	12	16	2	2	463.32	926.64	15	1	1	-0.333333333333333	1	-0.0714285714285715	4	28
TINAGL1	1	1	0	1	113.85	227.7	15	1	1	1	1	0.5	1	2
TIPARP	20	36	4	8	664.29	1328.58	15	1	1	0.1	1	0.0238095238095238	12	56
TIPIN	6	12	2	2	280.17	560.34	15	1	0.601913875598086	-1	1	-0.166666666666667	4	18
TIPRL	5	7	1	0	271.26	542.52	15	1	0.461538461538462	-Inf	1	-0.583333333333333	1	12
TJAP1	41	32	15	13	1063.26	2126.52	15	1	0.826808002551975	0.0994371482176361	1	0.0259295499021527	28	73
TJP1	13	49	2	6	1617.99	3235.98	15	1	1	-0.256410256410256	1	-0.0403225806451613	8	62
TJP2	9	27	2	2	685.41	1370.82	15	1	0.300306379253748	-2	1	-0.25	4	36
TJP3	17	38	8	18	923.67	1847.34	15	1	1	0.00653594771241828	1	0.00139860139860137	26	55
TK2	3	6	0	0	224.4	448.8	15	1	1	NA	1	NA	0	9
TKFC	11	17	4	6	330.99	661.98	15	1	1	-0.0303030303030303	1	-0.00714285714285717	10	28
TKT	11	25	1	1	597.3	1194.6	15	1	0.537695590327169	-1.27272727272727	1	-0.194444444444444	2	36
TLCD1	1	4	1	2	142.56	285.12	15	1	1	-1	1	-0.133333333333333	3	5
TLCD2	2	1	1	3	187.11	374.22	15	1	0.485714285714286	0.833333333333333	1	0.416666666666667	4	3
TLDC1	10	17	2	3	464.31	928.62	15	1	1	-0.133333333333333	1	-0.0296296296296297	5	27
TLDC2	2	7	0	2	129.69	259.38	15	1	1	1	1	0.222222222222222	2	9
TLE1	2	21	1	0	724.68	1449.36	15	1	0.125	-Inf	1	-0.91304347826087	1	23
TLE3	1	12	3	22	386.76	773.52	15	1	1	-0.636363636363636	1	-0.0430769230769231	25	13
TLE4Z1	8	33	4	1	807.51	1615.02	15	1	0.0128556983966489	-15.5	0.61231737012987	-0.604878048780488	5	41
TLK1	1	4	2	0	576.18	1152.36	15	1	0.142857142857143	-Inf	1	-0.8	2	5
TLK2	0	10	0	3	743.49	1486.98	15	1	1	NA	1	0	3	10
TLL1	8	28	3	2	968.55	1937.1	15	1	0.109603975457634	-4.25	0.98538656216834	-0.377777777777778	5	36
TLL2	9	17	1	3	981.09	1962.18	15	1	1	0.37037037037037	1	0.0961538461538461	4	26
TLN1	1	109	9	29	2322.54	4645.08	15	1	1.80728590199291e-05	-32.8275862068966	0.0311627726243635	-0.227751196172249	38	110
TLN2	11	71	1	4	2537.37	5074.74	15	1	0.53289697440507	-0.613636363636364	1	-0.0658536585365854	5	82
TLR21	13	6	4	6	536.25	1072.5	15	1	0.235867780395517	0.692307692307692	1	0.284210526315789	10	19
TLR2B	17	6	1	1	414.48	828.96	15	1	0.49	0.647058823529412	1	0.239130434782609	2	23
TLR3	14	31	1	2	907.5	1815	15	1	1	-0.107142857142857	1	-0.0222222222222222	3	45
TLR4	31	27	4	6	835.56	1671.12	15	1	0.506567872374294	0.419354838709677	1	0.13448275862069	10	58
TLR7	25	60	5	6	1346.4	2692.8	15	1	0.310989940772176	-1	1	-0.160427807486631	11	85
TLX1	1	2	0	3	158.4	316.8	15	1	1	1	1	0.333333333333333	3	3
TLX3	0	2	1	9	100.65	201.3	15	1	1	-Inf	1	-0.1	10	2
TM2D1	0	8	1	2	136.62	273.24	15	1	0.272727272727273	-Inf	1	-0.333333333333333	3	8
TM2D2	0	3	0	0	66	132	15	1	1	NA	1	NA	0	3
TM2D3	2	8	1	5	214.5	429	15	1	1	0.2	1	0.0333333333333334	6	10
TM4SF1	7	5	0	0	338.58	677.16	15	1	1	NA	1	NA	0	12
TM4SF19	6	5	0	0	216.81	433.62	15	1	1	NA	1	NA	0	11
TM4SF1a	8	10	4	2	187.11	374.22	15	1	0.64040536122916	-1.5	1	-0.222222222222222	6	18
TM4SF4	6	6	0	0	199.98	399.96	15	1	1	NA	1	NA	0	12
TM6SF1	0	7	0	0	336.93	673.86	15	1	1	NA	1	NA	0	7
TM7SF3	17	23	1	1	558.36	1116.72	15	1	1	-0.352941176470588	1	-0.075	2	40
TM9SF2	1	20	1	4	600.93	1201.86	15	1	0.353846153846154	-4	1	-0.152380952380952	5	21
TM9SF2L	3	20	0	3	640.53	1281.06	15	1	1	1	1	0.130434782608696	3	23
TM9SF3	0	16	0	4	550.44	1100.88	15	1	1	NA	1	0	4	16
TM9SF4	2	25	1	5	631.62	1263.24	15	1	0.463892961876833	-1.5	1	-0.0925925925925926	6	27
TMA16	12	6	0	0	191.73	383.46	15	1	1	NA	1	NA	0	18
TMBIM4	3	5	0	0	207.24	414.48	15	1	1	NA	1	NA	0	8
TMC1	12	19	1	0	415.8	831.6	15	1	0.40625	-Inf	1	-0.612903225806452	1	31
TMC2	30	30	5	2	1000.89	2001.78	15	1	0.430730960581707	-1.5	1	-0.214285714285714	7	60
TMC3	16	47	6	2	1081.08	2162.16	15	1	0.00906289833043083	-7.8125	0.560970168452821	-0.496031746031746	8	63
TMC5	36	28	1	2	820.71	1641.42	15	1	0.582924538148419	0.611111111111111	1	0.229166666666667	3	64
TMC6	37	40	7	12	924.66	1849.32	15	1	0.447038130491768	0.369369369369369	1	0.112098427887902	19	77
TMC7	16	28	0	1	682.77	1365.54	15	1	1	1	1	0.363636363636364	1	44
TMCC1	0	16	0	2	457.38	914.76	15	1	1	NA	1	0	2	16
TMCC2	2	15	2	15	545.16	1090.32	15	1	1	0	1	0	17	17
TMCC3	8	26	0	1	469.59	939.18	15	1	1	1	1	0.235294117647059	1	34
TMCO1	1	3	0	2	164.01	328.02	15	1	1	1	1	0.25	2	4
TMCO3	3	30	2	1	670.89	1341.78	15	1	0.0448179271708683	-19	0.822543273817637	-0.575757575757576	3	33
TMCO4	19	36	4	4	596.97	1193.94	15	1	0.448360341515374	-0.894736842105263	1	-0.154545454545455	8	55
TMCO6	17	13	5	6	397.32	794.64	15	1	0.72539629443642	0.362745098039216	1	0.112121212121212	11	30
TMCO7	46	40	20	24	875.82	1751.64	15	1	0.4593908152945	0.27536231884058	1	0.080338266384778	44	86
TMED10	0	4	0	2	146.52	293.04	15	1	1	NA	1	0	2	4
TMED11	4	6	0	2	215.82	431.64	15	1	0.515151515151515	1	1	0.4	2	10
TMED2	0	2	1	0	147.51	295.02	15	1	0.333333333333333	-Inf	1	-1	1	2
TMED3	3	5	1	1	160.38	320.76	15	1	1	-0.666666666666667	1	-0.125	2	8
TMED5	1	6	0	1	192.39	384.78	15	1	1	1	1	0.142857142857143	1	7
TMED6	12	7	3	4	231	462	15	1	0.406521739130435	0.5625	1	0.203007518796992	7	19
TMED7	0	7	0	0	179.52	359.04	15	1	1	NA	1	NA	0	7
TMED8	5	6	0	1	286.77	573.54	15	1	1	1	1	0.454545454545455	1	11
TMEFF1	17	8	4	4	380.49	760.98	15	1	0.419611534183281	0.529411764705882	1	0.18	8	25
TMEFF2	8	9	2	1	280.17	560.34	15	1	1	-1.25	1	-0.196078431372549	3	17
TMEM100	0	4	0	1	133.65	267.3	15	1	1	NA	1	0	1	4
TMEM104	2	17	3	9	487.74	975.48	15	1	0.349859632395784	-1.83333333333333	1	-0.144736842105263	12	19
TMEM106B	0	12	0	0	273.24	546.48	15	1	1	NA	1	NA	0	12
TMEM106C	5	11	0	6	241.89	483.78	15	1	0.266347687400319	1	1	0.3125	6	16
TMEM108	11	15	10	11	463.32	926.64	15	1	0.773841448983406	-0.239669421487603	1	-0.0531135531135531	21	26
TMEM11	0	9	1	2	170.61	341.22	15	1	0.25	-Inf	1	-0.333333333333333	3	9
TMEM114	4	6	3	0	160.05	320.1	15	1	0.192307692307693	-Inf	1	-0.6	3	10
TMEM115	4	6	0	2	233.31	466.62	15	1	0.515151515151515	1	1	0.4	2	10
TMEM116	6	9	4	2	350.79	701.58	15	1	0.361455108359133	-2	1	-0.266666666666667	6	15
TMEM117	7	3	2	2	130.35	260.7	15	1	0.58041958041958	0.571428571428571	1	0.2	4	10
TMEM120A	2	7	1	5	313.83	627.66	15	1	1	0.3	1	0.0555555555555556	6	9
TMEM120B	0	9	1	1	313.83	627.66	15	1	0.181818181818182	-Inf	1	-0.5	2	9
TMEM121	1	8	0	9	309.87	619.74	15	1	1	1	1	0.111111111111111	9	9
TMEM121L	8	16	5	8	331.65	663.3	15	1	1	-0.25	1	-0.0512820512820513	13	24
TMEM123	15	8	5	1	165.66	331.32	15	1	0.632815460401667	-1.66666666666667	1	-0.181159420289855	6	23
TMEM125	0	7	1	4	188.43	376.86	15	1	0.416666666666667	-Inf	1	-0.2	5	7
TMEM126A	14	10	1	0	286.44	572.88	15	1	1	-Inf	1	-0.416666666666667	1	24
TMEM128	5	9	0	2	166.32	332.64	15	1	1	1	1	0.357142857142857	2	14
TMEM129	5	9	2	0	356.07	712.14	15	1	0.175	-Inf	1	-0.642857142857143	2	14
TMEM130	8	15	3	0	422.73	845.46	15	1	0.0634615384615385	-Inf	0.879809916506555	-0.652173913043478	3	23
TMEM131	20	58	5	10	1840.08	3680.16	15	1	0.537328666941953	-0.45	1	-0.0769230769230769	15	78
TMEM132A	7	19	11	15	475.2	950.4	15	1	0.382273896675812	-0.990476190476191	1	-0.153846153846154	26	26
TMEM132C	17	24	3	3	621.72	1243.44	15	1	1	-0.411764705882353	1	-0.0853658536585366	6	41
TMEM132D	8	20	2	2	724.35	1448.7	15	1	0.57174638487208	-1.5	1	-0.214285714285714	4	28
TMEM132E	9	39	6	16	882.42	1764.84	15	1	0.532174448153382	-0.625	1	-0.0852272727272727	22	48
TMEM135	2	10	0	3	305.91	611.82	15	1	1	1	1	0.166666666666667	3	12
TMEM136-1	7	9	9	7	239.91	479.82	15	1	0.724434696663453	-0.653061224489796	1	-0.125	16	16
TMEM136-2	4	9	4	3	243.54	487.08	15	1	0.356346749226006	-2	1	-0.263736263736264	7	13
TMEM138	0	6	0	2	161.37	322.74	15	1	1	NA	1	0	2	6
TMEM139	4	7	0	2	213.51	427.02	15	1	1	1	1	0.363636363636364	2	11
TMEM141	5	4	0	0	103.95	207.9	15	1	1	NA	1	NA	0	9
TMEM144	13	13	1	2	373.56	747.12	15	1	1	0.5	1	0.166666666666667	3	26
TMEM14A	3	4	0	1	108.9	217.8	15	1	1	1	1	0.428571428571429	1	7
TMEM14C	1	2	0	2	101.31	202.62	15	1	1	1	1	0.333333333333333	2	3
TMEM14CL	0	2	1	0	63.03	126.06	15	1	0.333333333333333	-Inf	1	-1	1	2
TMEM150A	1	2	1	2	238.59	477.18	15	1	1	0	1	0	3	3
TMEM150C	1	20	0	4	247.5	495	15	1	1	1	1	0.0476190476190476	4	21
TMEM151B	0	16	0	11	459.36	918.72	15	1	1	NA	1	0	11	16
TMEM154	9	12	0	1	191.07	382.14	15	1	1	1	1	0.428571428571429	1	21
TMEM156	18	11	2	2	287.1	574.2	15	1	1	0.388888888888889	1	0.120689655172414	4	29
TMEM158	0	2	0	0	121.44	242.88	15	1	1	NA	1	NA	0	2
TMEM159	2	2	0	0	156.42	312.84	15	1	1	NA	1	NA	0	4
TMEM161A	9	20	9	13	371.58	743.16	15	1	0.558962152693824	-0.538461538461539	1	-0.0987460815047022	22	29
TMEM161B	2	16	0	0	471.57	943.14	15	1	1	NA	1	NA	0	18
TMEM163	10	16	1	1	309.21	618.42	15	1	1	-0.6	1	-0.115384615384615	2	26
TMEM164	6	8	5	0	341.55	683.1	15	1	0.044547643618851	-Inf	0.822543273817637	-0.571428571428571	5	14
TMEM165	1	10	0	3	253.44	506.88	15	1	1	1	1	0.0909090909090909	3	11
TMEM168	1	27	1	4	693.99	1387.98	15	1	0.284090909090909	-5.75	1	-0.164285714285714	5	28
TMEM169	1	11	1	2	305.91	611.82	15	1	0.371428571428571	-4.5	1	-0.25	3	12
TMEM17	10	4	2	2	193.05	386.1	15	1	0.568627450980392	0.6	1	0.214285714285714	4	14
TMEM170A	2	1	1	1	93.06	186.12	15	1	1	0.5	1	0.166666666666667	2	3
TMEM173	24	15	7	3	359.7	719.4	15	1	0.725837367486321	-0.458333333333333	1	-0.0846153846153845	10	39
TMEM174	36	23	5	2	546.15	1092.3	15	1	0.700919159869451	-0.597222222222222	1	-0.104116222760291	7	59
TMEM175	1	20	1	2	430.98	861.96	15	1	0.239130434782608	-9	1	-0.285714285714286	3	21
TMEM177	9	5	3	0	308.88	617.76	15	1	0.514705882352941	-Inf	1	-0.357142857142857	3	14
TMEM178B	2	5	1	3	143.55	287.1	15	1	1	0.166666666666667	1	0.0357142857142857	4	7
TMEM179	0	3	0	1	189.75	379.5	15	1	1	NA	1	0	1	3
TMEM18	0	4	1	0	93.06	186.12	15	1	0.2	-Inf	1	-1	1	4
TMEM181	5	18	1	2	470.25	940.5	15	1	1	-0.8	1	-0.115942028985507	3	23
TMEM182L	1	14	6	4	243.54	487.08	15	1	0.00680257957145827	-20	0.482983149573537	-0.533333333333333	10	15
TMEM183A	5	12	0	6	320.43	640.86	15	1	0.272489524205771	1	1	0.294117647058824	6	17
TMEM184A	8	19	3	4	404.91	809.82	15	1	0.655980092259373	-0.78125	1	-0.132275132275132	7	27
TMEM184B	4	18	1	4	406.89	813.78	15	1	1	-0.125	1	-0.0181818181818182	5	22
TMEM184C	2	19	3	2	432.63	865.26	15	1	0.0335360291882031	-13.25	0.784747167725891	-0.504761904761905	5	21
TMEM186	21	16	5	2	243.54	487.08	15	1	0.681653988009781	-0.904761904761905	1	-0.146718146718147	7	37
TMEM189	3	10	3	1	228.36	456.72	15	1	0.0987394957983193	-9	0.971353639774823	-0.519230769230769	4	13
TMEM19	5	11	0	0	339.57	679.14	15	1	1	NA	1	NA	0	16
TMEM192	3	7	2	1	255.42	510.84	15	1	0.510489510489511	-3.66666666666667	1	-0.366666666666667	3	10
TMEM198	0	1	1	4	246.18	492.36	15	1	1	-Inf	1	-0.2	5	1
TMEM199	3	14	0	1	161.37	322.74	15	1	1	1	1	0.176470588235294	1	17
TMEM2	21	55	2	0	1320.33	2640.66	15	1	0.0842490842490843	-Inf	0.949431371776132	-0.723684210526316	2	76
TMEM200A	7	22	1	1	487.08	974.16	15	1	0.455913978494623	-2.14285714285714	1	-0.258620689655172	2	29
TMEM200B	2	10	4	5	221.43	442.86	15	1	0.331048208757187	-3	1	-0.277777777777778	9	12
TMEM200C	15	30	5	1	540.54	1081.08	15	1	0.0288395099020182	-9	0.763361588853858	-0.5	6	45
TMEM201	6	25	2	4	625.35	1250.7	15	1	0.591342679577974	-1.08333333333333	1	-0.139784946236559	6	31
TMEM204	1	5	0	3	222.75	445.5	15	1	1	1	1	0.166666666666667	3	6
TMEM206	4	11	2	1	347.16	694.32	15	1	0.245098039215686	-4.5	1	-0.4	3	15
TMEM207	8	9	0	2	148.5	297	15	1	0.485380116959064	1	1	0.470588235294118	2	17
TMEM208	1	2	0	1	159.72	319.44	15	1	1	1	1	0.333333333333333	1	3
TMEM213	7	4	2	2	105.93	211.86	15	1	1	0.428571428571429	1	0.136363636363636	4	11
TMEM215	5	12	0	2	236.61	473.22	15	1	1	1	1	0.294117647058824	2	17
TMEM216	2	4	1	6	71.94	143.88	15	1	0.559440559440559	0.666666666666667	1	0.19047619047619	7	6
TMEM218	5	4	0	0	82.17	164.34	15	1	1	NA	1	NA	0	9
TMEM220	11	9	0	0	134.31	268.62	15	1	1	NA	1	NA	0	20
TMEM221	1	2	0	5	191.07	382.14	15	1	0.375	1	1	0.333333333333333	5	3
TMEM222	1	11	0	3	142.89	285.78	15	1	1	1	1	0.0833333333333333	3	12
TMEM229B	0	4	0	1	166.32	332.64	15	1	1	NA	1	0	1	4
TMEM230	0	4	0	1	118.8	237.6	15	1	1	NA	1	0	1	4
TMEM234	3	2	0	0	74.58	149.16	15	1	1	NA	1	NA	0	5
TMEM237	5	14	3	0	389.73	779.46	15	1	0.0363636363636363	-Inf	0.788199921465956	-0.736842105263158	3	19
TMEM238	1	4	1	0	101.31	202.62	15	1	0.333333333333333	-Inf	1	-0.8	1	5
TMEM240	0	1	0	1	151.8	303.6	15	1	1	NA	1	0	1	1
TMEM243	0	2	0	2	68.31	136.62	15	1	1	NA	1	0	2	2
TMEM246	9	25	1	2	392.04	784.08	15	1	1	-0.388888888888889	1	-0.0686274509803921	3	34
TMEM248	0	8	0	4	311.85	623.7	15	1	1	NA	1	0	4	8
TMEM252	6	5	3	1	110.88	221.76	15	1	0.604395604395604	-1.5	1	-0.204545454545455	4	11
TMEM254	2	5	0	2	98.67	197.34	15	1	1	1	1	0.285714285714286	2	7
TMEM255A	2	10	0	2	462	924	15	1	1	1	1	0.166666666666667	2	12
TMEM255B	2	19	2	2	308.55	617.1	15	1	0.106324110671937	-8.5	0.983875031494079	-0.404761904761905	4	21
TMEM259	10	28	6	21	674.19	1348.38	15	1	0.776621967028722	0.2	1	0.0409356725146199	27	38
TMEM26	5	11	2	1	362.34	724.68	15	1	0.523219814241486	-3.4	1	-0.354166666666667	3	16
TMEM260	20	29	9	13	667.92	1335.84	15	1	1	-0.00384615384615383	1	-0.000927643784786658	22	49
TMEM263	0	5	0	0	115.83	231.66	15	1	1	NA	1	NA	0	5
TMEM266	5	12	0	0	293.37	586.74	15	1	1	NA	1	NA	0	17
TMEM267	1	7	1	1	213.84	427.68	15	1	0.377777777777778	-6	1	-0.375	2	8
TMEM268	8	14	8	8	324.06	648.12	15	1	0.511293234521943	-0.75	1	-0.136363636363636	16	22
TMEM269	6	6	0	6	165.99	331.98	15	1	0.0537060978237449	1	0.846060006968071	0.5	6	12
TMEM27	9	10	0	1	290.73	581.46	15	1	1	1	1	0.473684210526316	1	19
TMEM272	1	8	1	2	186.12	372.24	15	1	0.454545454545454	-3	1	-0.222222222222222	3	9
TMEM30A	1	12	1	6	317.46	634.92	15	1	1	-1	1	-0.0659340659340659	7	13
TMEM30CP	15	16	2	1	537.57	1075.14	15	1	1	-1.13333333333333	1	-0.182795698924731	3	31
TMEM33	0	4	0	4	227.37	454.74	15	1	1	NA	1	0	4	4
TMEM35A	2	13	1	3	165.99	331.98	15	1	0.530443756449949	-1.16666666666667	1	-0.116666666666667	4	15
TMEM35B	1	4	1	3	82.83	165.66	15	1	1	-0.333333333333333	1	-0.05	4	5
TMEM37	2	6	2	1	195.69	391.38	15	1	0.490909090909091	-5	1	-0.416666666666667	3	8
TMEM38A	1	8	0	0	272.25	544.5	15	1	1	NA	1	NA	0	9
TMEM39A	0	14	1	1	480.15	960.3	15	1	0.125	-Inf	1	-0.5	2	14
TMEM39B	0	17	1	5	484.44	968.88	15	1	0.260869565217391	-Inf	1	-0.166666666666667	6	17
TMEM40L	13	6	1	1	286.11	572.22	15	1	1	0.538461538461538	1	0.184210526315789	2	19
TMEM41A	0	11	0	2	195.36	390.72	15	1	1	NA	1	0	2	11
TMEM41B	0	12	0	4	249.15	498.3	15	1	1	NA	1	0	4	12
TMEM42	2	9	3	4	96.03	192.06	15	1	0.325980392156863	-2.375	1	-0.246753246753247	7	11
TMEM43	5	12	3	2	396.99	793.98	15	1	0.308878256246677	-2.6	1	-0.305882352941176	5	17
TMEM45A	2	8	0	3	273.24	546.48	15	1	1	1	1	0.2	3	10
TMEM45B	4	10	1	4	279.18	558.36	15	1	1	0.375	1	0.0857142857142857	5	14
TMEM45BL	3	11	9	3	280.5	561	15	1	0.0162336788262216	-10	0.666464297389437	-0.535714285714286	12	14
TMEM47	0	3	0	0	137.28	274.56	15	1	1	NA	1	NA	0	3
TMEM5	9	13	3	3	406.89	813.78	15	1	1	-0.444444444444444	1	-0.0909090909090909	6	22
TMEM50B	1	7	0	1	157.41	314.82	15	1	1	1	1	0.125	1	8
TMEM51	4	13	2	4	247.83	495.66	15	1	0.632203037237362	-0.625	1	-0.0980392156862745	6	17
TMEM52	8	9	0	1	172.26	344.52	15	1	1	1	1	0.470588235294118	1	17
TMEM52B	7	8	2	3	181.17	362.34	15	1	1	0.238095238095238	1	0.0666666666666667	5	15
TMEM53	8	16	4	4	251.46	502.92	15	1	0.432509055645874	-1	1	-0.166666666666667	8	24
TMEM56	10	11	0	0	281.82	563.64	15	1	1	NA	1	NA	0	21
TMEM59L	3	7	1	4	197.34	394.68	15	1	1	0.416666666666667	1	0.1	5	10
TMEM60	0	2	1	0	133.65	267.3	15	1	0.333333333333333	-Inf	1	-1	1	2
TMEM61	2	2	5	6	208.89	417.78	15	1	1	0.166666666666667	1	0.0454545454545455	11	4
TMEM62	14	24	4	6	610.83	1221.66	15	1	1	-0.142857142857143	1	-0.0315789473684211	10	38
TMEM63C	6	38	4	6	770.88	1541.76	15	1	0.0746411076139274	-3.22222222222222	0.914637734923963	-0.263636363636364	10	44
TMEM65	0	5	0	0	157.08	314.16	15	1	1	NA	1	NA	0	5
TMEM68	10	12	0	1	328.68	657.36	15	1	1	1	1	0.454545454545455	1	22
TMEM68L	10	12	0	1	331.65	663.3	15	1	1	1	1	0.454545454545455	1	22
TMEM70	5	11	0	4	185.13	370.26	15	1	0.530443756449948	1	1	0.3125	4	16
TMEM72	6	20	3	2	242.55	485.1	15	1	0.131256952169077	-4	1	-0.369230769230769	5	26
TMEM74	11	18	0	1	312.84	625.68	15	1	1	1	1	0.379310344827586	1	29
TMEM74B	0	1	0	2	60.06	120.12	15	1	1	NA	1	0	2	1
TMEM80	5	4	3	1	141.57	283.14	15	1	1	-1.4	1	-0.194444444444444	4	9
TMEM82	4	7	5	7	297.99	595.98	15	1	1	-0.25	1	-0.053030303030303	12	11
TMEM86A	0	9	1	1	235.62	471.24	15	1	0.181818181818182	-Inf	1	-0.5	2	9
TMEM88B	4	6	1	0	178.2	356.4	15	1	0.454545454545455	-Inf	1	-0.6	1	10
TMEM8B	5	16	1	4	488.07	976.14	15	1	1	0.2	1	0.0380952380952381	5	21
TMEM8C	0	11	2	6	209.88	419.76	15	1	0.16374269005848	-Inf	1	-0.25	8	11
TMEM9	2	10	0	4	190.08	380.16	15	1	1	1	1	0.166666666666667	4	12
TMEM94	6	46	3	8	1322.64	2645.28	15	1	0.183902357983476	-1.875	1	-0.157342657342657	11	52
TMEM97	6	7	2	4	130.68	261.36	15	1	1	0.416666666666667	1	0.128205128205128	6	13
TMEM98	0	13	1	2	205.92	411.84	15	1	0.1875	-Inf	1	-0.333333333333333	3	13
TMEM9B	0	14	0	1	162.36	324.72	15	1	1	NA	1	0	1	14
TMF1	17	49	7	5	1092.96	2185.92	15	1	0.0392699776859332	-3.03529411764706	0.794052121283243	-0.325757575757576	12	66
TMIE	3	12	2	3	263.34	526.68	15	1	0.559791021671827	-1.66666666666667	1	-0.2	5	15
TMIGD1	9	10	4	5	255.42	510.84	15	1	1	0.111111111111111	1	0.0292397660818713	9	19
TMLHE	2	22	2	10	417.78	835.56	15	1	0.587675070028011	-1.2	1	-0.0833333333333333	12	24
TMOD1	1	19	2	3	356.4	712.8	15	1	0.0913043478260869	-11.6666666666667	0.953786405978059	-0.35	5	20
TMOD2	2	12	1	1	348.48	696.96	15	1	0.35	-5	1	-0.357142857142857	2	14
TMOD3	1	12	0	2	348.48	696.96	15	1	1	1	1	0.0769230769230769	2	13
TMOD4	3	19	2	1	245.85	491.7	15	1	0.091304347826087	-11.6666666666667	0.953786405978059	-0.53030303030303	3	22
TMPO	11	6	1	1	393.03	786.06	15	1	1	0.454545454545455	1	0.147058823529412	2	17
TMPRSS11D	5	12	0	2	474.21	948.42	15	1	1	1	1	0.294117647058824	2	17
TMPRSS11F	10	18	1	0	447.48	894.96	15	1	0.379310344827586	-Inf	1	-0.642857142857143	1	28
TMPRSS12	28	13	2	3	312.84	625.68	15	1	0.324692833287373	0.69047619047619	1	0.282926829268293	5	41
TMPRSS13	3	23	2	14	415.14	830.28	15	1	1	-0.0952380952380953	1	-0.00961538461538461	16	26
TMPRSS15	37	38	2	3	945.45	1890.9	15	1	1	0.315315315315315	1	0.0933333333333333	5	75
TMPRSS2	19	20	2	6	501.6	1003.2	15	1	0.268993254557345	0.649122807017544	1	0.237179487179487	8	39
TMPRSS3	3	26	2	7	472.23	944.46	15	1	0.574136055560204	-1.47619047619048	1	-0.118773946360153	9	29
TMPRSS4	15	15	11	15	431.64	863.28	15	1	0.601287377692812	0.266666666666667	1	0.0769230769230769	26	30
TMPRSS5	17	28	18	24	357.06	714.12	15	1	0.666666884350914	-0.235294117647059	1	-0.0507936507936508	42	45
TMPRSS6	8	27	4	11	713.13	1426.26	15	1	1	-0.227272727272727	1	-0.0380952380952381	15	35
TMPRSS7	20	43	3	3	784.08	1568.16	15	1	0.392603582764908	-1.15	1	-0.182539682539683	6	63
TMPRSS9	21	40	8	8	1104.84	2209.68	15	1	0.263934375193643	-0.904761904761905	1	-0.155737704918033	16	61
TMTC1	11	3	6	2	300.96	601.92	15	1	1	0.181818181818182	1	0.0357142857142857	8	14
TMTC2	11	8	0	0	471.57	943.14	15	1	1	NA	1	NA	0	19
TMTC4	2	18	1	1	733.59	1467.18	15	1	0.25974025974026	-8	1	-0.4	2	20
TMX1	3	29	1	3	178.86	357.72	15	1	0.389525507172566	-2.22222222222222	1	-0.15625	4	32
TMX2	1	2	0	1	124.41	248.82	15	1	1	1	1	0.333333333333333	1	3
TMX3	3	11	0	0	420.75	841.5	15	1	1	NA	1	NA	0	14
TMX4	9	22	1	4	284.79	569.58	15	1	1	0.388888888888889	1	0.0903225806451613	5	31
TNC	30	82	11	10	2177.01	4354.02	15	1	0.0367019645905978	-2.00666666666667	0.788199921465956	-0.255952380952381	21	112
TNFAIP1	1	13	1	5	311.85	623.7	15	1	0.521052631578947	-1.6	1	-0.0952380952380952	6	14
TNFAIP2	19	33	3	9	685.08	1370.16	15	1	0.520787087591282	0.421052631578947	1	0.115384615384615	12	52
TNFAIP3	17	43	5	5	852.39	1704.78	15	1	0.268164386711346	-1.52941176470588	1	-0.216666666666667	10	60
TNFAIP6	3	8	1	4	273.24	546.48	15	1	1	0.333333333333333	1	0.0727272727272727	5	11
TNFAIP8	0	6	0	0	190.41	380.82	15	1	1	NA	1	NA	0	6
TNFAIP8L1	0	5	0	0	185.13	370.26	15	1	1	NA	1	NA	0	5
TNFAIP8L3	0	7	1	0	189.09	378.18	15	1	0.125	-Inf	1	-1	1	7
TNFRSF11A	19	33	3	7	629.64	1259.28	15	1	1	0.255639097744361	1	0.0653846153846154	10	52
TNFRSF11B	13	10	4	4	398.97	797.94	15	1	1	0.230769230769231	1	0.0652173913043478	8	23
TNFRSF13B	4	20	2	5	252.45	504.9	15	1	0.595904281110065	-1	1	-0.119047619047619	7	24
TNFRSF13C	10	8	5	2	145.2	290.4	15	1	0.659246931558145	-1	1	-0.158730158730159	7	18
TNFRSF18	8	7	1	1	256.41	512.82	15	1	1	0.125	1	0.0333333333333333	2	15
TNFRSF19	1	15	3	2	404.91	809.82	15	1	0.0275689223057644	-21.5	0.761210061313465	-0.5375	5	16
TNFRSF1A	22	16	4	4	391.05	782.1	15	1	0.712611079599168	0.272727272727273	1	0.0789473684210527	8	38
TNFRSF1B	8	19	1	2	464.31	928.62	15	1	1	-0.1875	1	-0.037037037037037	3	27
TNFRSF21	7	31	6	7	635.58	1271.16	15	1	0.0682607645154921	-2.79591836734694	0.888803134120932	-0.277327935222672	13	38
TNFRSF25	24	30	2	1	416.46	832.92	15	1	0.586807928913192	-1.5	1	-0.222222222222222	3	54
TNFRSF4	23	12	5	2	328.68	657.36	15	1	1	-0.304347826086957	1	-0.0571428571428572	7	35
TNFRSF8	41	28	5	4	864.27	1728.54	15	1	1	0.146341463414634	1	0.038647342995169	9	69
TNFRSF9	7	4	0	0	215.82	431.64	15	1	1	NA	1	NA	0	11
TNFSF10	12	18	3	2	278.19	556.38	15	1	0.631274797308953	-1.25	1	-0.2	5	30
TNFSF13B	17	15	0	0	365.31	730.62	15	1	1	NA	1	NA	0	32
TNFSF15	9	11	0	0	239.58	479.16	15	1	1	NA	1	NA	0	20
TNFSF4	22	13	0	0	203.94	407.88	15	1	1	NA	1	NA	0	35
TNFSF8	4	5	0	1	215.82	431.64	15	1	1	1	1	0.444444444444444	1	9
TNIK	9	21	2	10	1400.52	2801.04	15	1	0.463770216479195	0.533333333333333	1	0.133333333333333	12	30
TNIP1	5	24	6	14	612.48	1224.96	15	1	0.319749058158537	-1.05714285714286	1	-0.127586206896552	20	29
TNIP2	7	20	1	1	463.32	926.64	15	1	0.482758620689655	-1.85714285714286	1	-0.240740740740741	2	27
TNIP3	16	16	5	1	416.46	832.92	15	1	0.196517091253933	-4	1	-0.333333333333333	6	32
TNK2	1	15	4	11	626.01	1252.02	15	1	0.171919416635768	-4.45454545454545	1	-0.204166666666667	15	16
TNKS2	1	43	1	1	1106.49	2212.98	15	1	0.0859903381642512	-42	0.951277979139867	-0.477272727272727	2	44
TNMD	20	18	2	4	398.97	797.94	15	1	0.664034207426153	0.55	1	0.192982456140351	6	38
TNN	40	54	14	10	1112.76	2225.52	15	1	0.177677794262222	-0.89	1	-0.157801418439716	24	94
TNNC1	0	9	0	2	160.38	320.76	15	1	1	NA	1	0	2	9
TNNC2	9	8	3	8	238.26	476.52	15	1	0.253002070393375	0.666666666666667	1	0.25668449197861	11	17
TNNI1	1	11	2	6	193.05	386.1	15	1	0.536842105263158	-2.66666666666667	1	-0.166666666666667	8	12
TNNI2	3	8	0	1	183.15	366.3	15	1	1	1	1	0.272727272727273	1	11
TNNI3K	7	27	3	4	827.64	1655.28	15	1	0.332406144665451	-1.89285714285714	1	-0.222689075630252	7	34
TNNT2	1	7	0	5	276.21	552.42	15	1	1	1	1	0.125	5	8
TNNT3	0	10	1	2	250.47	500.94	15	1	0.230769230769231	-Inf	1	-0.333333333333333	3	10
TNPO2	0	24	0	3	829.95	1659.9	15	1	1	NA	1	0	3	24
TNR	13	52	13	15	1322.31	2644.62	15	1	0.0125319526752003	-2.46666666666667	0.61231737012987	-0.264285714285714	28	65
TNRC18	20	113	17	45	2705.34	5410.68	15	1	0.0500221781075258	-1.13444444444444	0.838566235774774	-0.123817608537473	62	133
TNRC6A	11	24	4	7	1877.37	3754.74	15	1	1	-0.246753246753247	1	-0.0493506493506494	11	35
TNRC6B	10	18	7	7	1717.65	3435.3	15	1	0.507616558743828	-0.8	1	-0.142857142857143	14	28
TNRC6C	2	19	8	7	1811.37	3622.74	15	1	0.00712929861330046	-9.85714285714286	0.495282212683078	-0.438095238095238	15	21
TNS1	30	61	18	24	1473.12	2946.24	15	1	0.332060667272138	-0.525	1	-0.0989010989010989	42	91
TNS3	38	50	12	3	1556.94	3113.88	15	1	0.0111247266634782	-4.26315789473684	0.586355680472409	-0.368181818181818	15	88
TNS4	18	19	7	11	611.82	1223.64	15	1	0.57159069790863	0.328282828282828	1	0.0975975975975976	18	37
TNX	48	81	42	42	1111.11	2222.22	15	1	0.067385070570023	-0.6875	0.88598889082808	-0.127906976744186	84	129
TNXB	4	13	0	0	270.93	541.86	15	1	1	NA	1	NA	0	17
TOB2	3	12	3	7	336.6	673.2	15	1	0.653162055335968	-0.714285714285714	1	-0.1	10	15
TOE1	15	27	4	6	443.85	887.7	15	1	1	-0.2	1	-0.0428571428571429	10	42
TOLLIP	0	12	1	2	298.98	597.96	15	1	0.2	-Inf	1	-0.333333333333333	3	12
TOM1	8	32	3	11	537.24	1074.48	15	1	1	-0.0909090909090908	1	-0.0142857142857143	14	40
TOM1L1	5	15	2	2	321.75	643.5	15	1	0.552042160737813	-2	1	-0.25	4	20
TOM1L2	1	17	1	2	490.71	981.42	15	1	0.271428571428571	-7.5	1	-0.277777777777778	3	18
TOMM20	1	1	0	0	104.61	209.22	15	1	1	NA	1	NA	0	2
TOMM34	4	3	0	1	225.39	450.78	15	1	1	1	1	0.571428571428571	1	7
TOMM70	11	17	1	2	607.2	1214.4	15	1	1	0.227272727272727	1	0.0595238095238095	3	28
TOP1	2	9	0	4	740.19	1480.38	15	1	1	1	1	0.181818181818182	4	11
TOP1MT	21	42	11	17	792	1584	15	1	0.63800855048065	-0.294117647058824	1	-0.0595238095238095	28	63
TOP2A	27	61	0	15	1479.06	2958.12	15	1	0.00989309793420592	1	0.5818356433428	0.306818181818182	15	88
TOP3A	20	69	10	18	1009.47	2018.94	15	1	0.214149775482288	-0.916666666666667	1	-0.132423756019262	28	89
TOP3B	1	36	1	5	854.37	1708.74	15	1	0.262458471760798	-6.2	1	-0.13963963963964	6	37
TOPAZ1	142	100	30	20	1943.04	3886.08	15	1	1	-0.056338028169014	1	-0.0132231404958677	50	242
TOPBP1	33	75	20	14	1513.71	3027.42	15	1	0.00424591889896704	-2.24675324675325	0.454065685553736	-0.282679738562091	34	108
TOR1A	4	14	0	5	270.93	541.86	15	1	0.539243365330322	1	1	0.222222222222222	5	18
TOR1AIP1	21	13	4	4	342.21	684.42	15	1	0.693905419194251	0.380952380952381	1	0.117647058823529	8	34
TOR1AIP2	42	37	7	3	502.92	1005.84	15	1	0.501923932493338	-1.05555555555556	1	-0.168354430379747	10	79
TOR1BL	9	13	5	2	331.65	663.3	15	1	0.214759287023155	-2.61111111111111	1	-0.305194805194805	7	22
TOR3A	10	16	2	5	401.61	803.22	15	1	1	0.36	1	0.0989010989010989	7	26
TOR4A	10	17	1	5	506.88	1013.76	15	1	0.636749165739711	0.66	1	0.203703703703704	6	27
TOX	4	12	1	6	450.45	900.9	15	1	1	0.5	1	0.107142857142857	7	16
TOX2	7	9	6	7	380.16	760.32	15	1	1	-0.102040816326531	1	-0.0240384615384616	13	16
TOX3	0	15	0	2	533.61	1067.22	15	1	1	NA	1	0	2	15
TP53BP1	94	59	15	6	1879.68	3759.36	15	1	0.473851019946357	-0.569148936170213	1	-0.099906629318394	21	153
TP53BP2	11	38	6	10	1119.69	2239.38	15	1	0.325940652458412	-1.07272727272727	1	-0.150510204081633	16	49
TP53I11	6	13	2	6	188.1	376.2	15	1	1	0.277777777777778	1	0.0657894736842105	8	19
TP53I3	12	21	2	6	441.54	883.08	15	1	0.692451494007033	0.416666666666667	1	0.113636363636364	8	33
TP53INP1	2	14	3	10	211.2	422.4	15	1	0.632183908045977	-1.1	1	-0.105769230769231	13	16
TP53INP2	5	12	1	2	167.31	334.62	15	1	1	-0.2	1	-0.0392156862745098	3	17
TP53RK	2	15	0	0	197.67	395.34	15	1	1	NA	1	NA	0	17
TP53TG5	19	10	6	1	280.5	561	15	1	0.399905123339658	-2.15789473684211	1	-0.201970443349754	7	29
TP63	3	23	0	5	758.34	1516.68	15	1	1	1	1	0.115384615384615	5	26
TP73	5	24	1	8	655.71	1311.42	15	1	1	0.4	1	0.0613026819923372	9	29
TPBG	2	11	0	4	282.81	565.62	15	1	1	1	1	0.153846153846154	4	13
TPBGL	3	2	2	3	171.6	343.2	15	1	1	0.555555555555556	1	0.2	5	5
TPCN1	4	30	5	13	809.82	1619.64	15	1	0.246553557450875	-1.88461538461538	1	-0.160130718954248	18	34
TPCN2	13	21	2	1	730.62	1461.24	15	1	0.554054054054054	-2.23076923076923	1	-0.284313725490196	3	34
TPCN3	10	25	4	5	693	1386	15	1	0.433806423238313	-1	1	-0.158730158730159	9	35
TPD52	2	7	1	4	239.58	479.16	15	1	1	0.125	1	0.0222222222222222	5	9
TPD52L1	0	6	3	2	203.94	407.88	15	1	0.0606060606060606	-Inf	0.870851370851371	-0.6	5	6
TPD52L2	1	9	0	0	198.66	397.32	15	1	1	NA	1	NA	0	10
TPGS1	1	15	0	1	155.43	310.86	15	1	1	1	1	0.0625	1	16
TPGS2	6	10	2	2	329.34	658.68	15	1	1	-0.666666666666667	1	-0.125	4	16
TPH1	3	7	0	2	302.94	605.88	15	1	1	1	1	0.3	2	10
TPH2	3	14	3	2	333.63	667.26	15	1	0.100478468899522	-6	0.974116561941546	-0.423529411764706	5	17
TPI1	0	15	1	6	228.03	456.06	15	1	0.318181818181818	-Inf	1	-0.142857142857143	7	15
TPK1	29	10	4	1	305.25	610.5	15	1	1	-0.379310344827586	1	-0.0564102564102564	5	39
TPM1	0	2	0	1	202.95	405.9	15	1	1	NA	1	0	1	2
TPM2-TPM3	0	1	0	1	106.59	213.18	15	1	1	NA	1	0	1	1
TPM2-TPM4	0	1	3	2	82.17	164.34	15	1	1	-Inf	1	-0.6	5	1
TPM4	0	9	2	1	202.95	405.9	15	1	0.0454545454545455	-Inf	0.822543273817637	-0.666666666666667	3	9
TPMT	6	6	0	2	242.55	485.1	15	1	0.472527472527472	1	1	0.5	2	12
TPO	33	32	0	4	826.32	1652.64	15	1	0.115471237164561	1	1	0.507692307692308	4	65
TPP1	12	31	0	5	408.21	816.42	15	1	0.311979648473636	1	1	0.27906976744186	5	43
TPP2	3	41	0	2	1242.78	2485.56	15	1	1	1	1	0.0681818181818182	2	44
TPPP2	0	10	2	0	167.31	334.62	15	1	0.0151515151515152	-Inf	0.642329698273754	-1	2	10
TPPP3	0	8	0	3	166.98	333.96	15	1	1	NA	1	0	3	8
TPR	9	82	2	15	2318.58	4637.16	15	1	0.68329860952349	-0.214814814814815	1	-0.0187459599224305	17	91
TPRA1	2	14	0	1	381.15	762.3	15	1	1	1	1	0.125	1	16
TPRG1L	2	10	0	1	173.58	347.16	15	1	1	1	1	0.166666666666667	1	12
TPRKB	4	8	0	7	177.54	355.08	15	1	0.245098039215686	1	1	0.333333333333333	7	12
TPST1	2	17	0	1	376.2	752.4	15	1	1	1	1	0.105263157894737	1	19
TPST2	4	23	1	12	368.28	736.56	15	1	1	0.520833333333333	1	0.0712250712250712	13	27
TPTE2	11	19	2	11	506.88	1013.76	15	1	0.279456751058792	0.68595041322314	1	0.212820512820513	13	30
TPX2	41	60	14	22	1317.36	2634.72	15	1	1	0.0687361419068736	1	0.0170517051705171	36	101
TRA2A	0	5	1	2	263.34	526.68	15	1	0.375	-Inf	1	-0.333333333333333	3	5
TRA2B	0	10	0	2	274.23	548.46	15	1	1	NA	1	0	2	10
TRABD	2	9	1	2	371.25	742.5	15	1	1	-1.25	1	-0.151515151515151	3	11
TRABD2A-TRABD2B	6	10	6	3	416.79	833.58	15	1	0.226194642616772	-2.33333333333333	1	-0.291666666666667	9	16
TRADD	12	14	1	2	388.08	776.16	15	1	1	0.416666666666667	1	0.128205128205128	3	26
TRAF1	13	14	2	3	465.96	931.92	15	1	1	0.282051282051282	1	0.0814814814814814	5	27
TRAF2	1	15	1	2	472.23	944.46	15	1	0.298245614035088	-6.5	1	-0.270833333333333	3	16
TRAF3	0	13	0	2	562.32	1124.64	15	1	1	NA	1	0	2	13
TRAF3IP1	12	19	3	1	624.03	1248.06	15	1	0.292398777692895	-3.75	1	-0.362903225806452	4	31
TRAF3IP2	9	18	6	8	534.27	1068.54	15	1	0.733740550883742	-0.5	1	-0.0952380952380952	14	27
TRAF3IP3	19	37	5	4	507.87	1015.74	15	1	0.272093409954131	-1.43421052631579	1	-0.216269841269841	9	56
TRAF4	2	5	0	5	302.61	605.22	15	1	0.46969696969697	1	1	0.285714285714286	5	7
TRAF5	4	21	0	7	552.42	1104.84	15	1	0.552280311457175	1	1	0.16	7	25
TRAF6	5	12	2	8	540.54	1081.08	15	1	0.678389243606635	0.4	1	0.0941176470588235	10	17
TRAF7	2	29	0	8	664.29	1328.58	15	1	1	1	1	0.0645161290322581	8	31
TRAFD1	18	30	5	12	582.12	1164.24	15	1	0.768665079910957	0.305555555555556	1	0.0808823529411765	17	48
TRAK2	41	20	3	3	859.32	1718.64	15	1	0.405553652333864	0.51219512195122	1	0.172131147540984	6	61
TRAM1	0	6	0	2	330.66	661.32	15	1	1	NA	1	0	2	6
TRAM2	1	16	2	3	326.7	653.4	15	1	0.116883116883117	-9.66666666666667	1	-0.341176470588235	5	17
TRANK1	161	123	6	4	2933.7	5867.4	15	1	1	-0.145962732919255	1	-0.0330985915492957	10	284
TRAPPC10	10	39	1	13	1225.29	2450.58	15	1	0.429819691319147	0.7	1	0.13265306122449	14	49
TRAPPC12	24	30	1	1	868.23	1736.46	15	1	1	-0.25	1	-0.0555555555555556	2	54
TRAPPC13	0	3	0	0	378.18	756.36	15	1	1	NA	1	NA	0	3
TRAPPC2	0	3	0	0	114.51	229.02	15	1	1	NA	1	NA	0	3
TRAPPC2L	0	11	1	2	127.71	255.42	15	1	0.214285714285714	-Inf	1	-0.333333333333333	3	11
TRAPPC4	0	5	0	0	103.62	207.24	15	1	1	NA	1	NA	0	5
TRAPPC6B	0	2	0	0	147.18	294.36	15	1	1	NA	1	NA	0	2
TRAPPC8	12	41	5	10	1389.63	2779.26	15	1	0.501170936057423	-0.708333333333333	1	-0.106918238993711	15	53
TRAPPC9	4	53	4	15	861.63	1723.26	15	1	0.10169475232348	-2.53333333333333	0.976611477696721	-0.140350877192982	19	57
TRAT1	2	6	2	1	173.25	346.5	15	1	0.490909090909091	-5	1	-0.416666666666667	3	8
TRDMT1	12	7	1	3	379.83	759.66	15	1	0.280632411067194	0.805555555555556	1	0.381578947368421	4	19
TRDNL	18	4	4	0	282.15	564.3	15	1	1	-Inf	1	-0.181818181818182	4	22
TREM-B1	43	22	8	7	538.56	1077.12	15	1	0.383088874898377	0.415282392026578	1	0.128205128205128	15	65
TREM-B2	7	3	1	2	139.92	279.84	15	1	0.510489510489511	0.785714285714286	1	0.366666666666667	3	10
TRERF1	14	43	5	8	1154.34	2308.68	15	1	0.319138610921808	-0.919642857142857	1	-0.139001349527665	13	57
TRH	3	4	0	0	253.44	506.88	15	1	1	NA	1	NA	0	7
TRHDE	5	7	2	0	622.71	1245.42	15	1	0.461538461538462	-Inf	1	-0.583333333333333	2	12
TRHR	7	10	2	0	398.97	797.94	15	1	0.210526315789474	-Inf	1	-0.588235294117647	2	17
TRIB1	0	7	0	3	251.46	502.92	15	1	1	NA	1	0	3	7
TRIL	12	78	2	6	722.04	1444.08	15	1	0.320018550794832	-1.16666666666667	1	-0.116666666666667	8	90
TRIM10	24	25	12	13	447.81	895.62	15	1	1	0.0384615384615384	1	0.00979591836734695	25	49
TRIM13	7	21	4	6	412.83	825.66	15	1	0.431753980775598	-1	1	-0.15	10	28
TRIM14	4	9	1	0	265.98	531.96	15	1	0.357142857142857	-Inf	1	-0.692307692307692	1	13
TRIM23	4	16	0	3	573.21	1146.42	15	1	1	1	1	0.2	3	20
TRIM24	11	29	2	2	1007.82	2015.64	15	1	0.569542765799147	-1.63636363636364	1	-0.225	4	40
TRIM25	29	14	2	7	612.15	1224.3	15	1	0.0219708449030427	0.862068965517241	0.721018759249189	0.452196382428941	9	43
TRIM27.1	15	20	9	9	465.96	931.92	15	1	0.772020327278246	-0.333333333333333	1	-0.0714285714285715	18	35
TRIM27.2	10	21	3	8	461.01	922.02	15	1	1	0.2125	1	0.0498533724340176	11	31
TRIM29	0	18	1	9	585.09	1170.18	15	1	0.357142857142857	-Inf	1	-0.1	10	18
TRIM3	3	43	2	13	662.31	1324.62	15	1	0.588550257709215	-1.20512820512821	1	-0.0681159420289855	15	46
TRIM32	5	39	1	4	608.85	1217.7	15	1	0.495198449407515	-0.95	1	-0.0863636363636364	5	44
TRIM35	7	8	5	11	448.47	896.94	15	1	0.472547597169157	0.480519480519481	1	0.154166666666667	16	15
TRIM36	8	32	1	1	726.33	1452.66	15	1	0.386759581881533	-3	1	-0.3	2	40
TRIM37	7	34	4	8	969.21	1938.42	15	1	0.244376198051248	-1.42857142857143	1	-0.16260162601626	12	41
TRIM39.1	5	9	3	2	216.48	432.96	15	1	0.602683178534572	-1.7	1	-0.242857142857143	5	14
TRIM39.2	7	15	6	9	383.79	767.58	15	1	0.730448245798635	-0.428571428571429	1	-0.0818181818181818	15	22
TRIM41	1	18	3	7	466.29	932.58	15	1	0.104837691044588	-6.71428571428571	0.983379501385042	-0.247368421052632	10	19
TRIM42	36	39	7	3	723.69	1447.38	15	1	0.313359487273311	-1.52777777777778	1	-0.22	10	75
TRIM45	8	16	6	5	451.44	902.88	15	1	0.283114571746385	-1.4	1	-0.212121212121212	11	24
TRIM47	17	22	2	9	386.76	773.52	15	1	0.16988475742621	0.712418300653595	1	0.254079254079254	11	39
TRIM50	4	30	1	2	439.56	879.12	15	1	0.361647361647362	-2.75	1	-0.215686274509804	3	34
TRIM58	11	35	0	3	482.13	964.26	15	1	1	1	1	0.239130434782609	3	46
TRIM59	19	29	3	5	407.88	815.76	15	1	1	0.0842105263157895	1	0.0208333333333333	8	48
TRIM62	0	9	0	8	295.35	590.7	15	1	1	NA	1	0	8	9
TRIM63	2	4	2	5	264.33	528.66	15	1	1	0.2	1	0.0476190476190476	7	6
TRIM65	41	16	8	9	455.07	910.14	15	1	0.0801143760687883	0.653116531165312	0.9369966270836	0.248710010319917	17	57
TRIM66	33	40	11	10	1219.68	2439.36	15	1	0.62457053263915	-0.333333333333333	1	-0.0717547292889759	21	73
TRIM67	0	15	0	4	477.51	955.02	15	1	1	NA	1	0	4	15
TRIM7.2	0	19	0	8	346.17	692.34	15	1	1	NA	1	0	8	19
TRIM71	1	21	0	7	618.42	1236.84	15	1	1	1	1	0.0454545454545455	7	22
TRIM9	0	8	0	8	436.92	873.84	15	1	1	NA	1	0	8	8
TRIO	2	39	1	13	1705.11	3410.22	15	1	1	-0.5	1	-0.0226480836236934	14	41
TRIP11	44	50	8	8	1932.81	3865.62	15	1	1	-0.136363636363636	1	-0.0319148936170213	16	94
TRIP12	6	39	1	9	2057.22	4114.44	15	1	1	0.277777777777778	1	0.0333333333333333	10	45
TRIP4	9	17	3	9	554.07	1108.14	15	1	0.714373694040644	0.37037037037037	1	0.0961538461538461	12	26
TRIT1	22	22	1	2	400.95	801.9	15	1	1	0.5	1	0.166666666666667	3	44
TRMT	17	20	6	5	475.2	950.4	15	1	0.736260895989236	-0.411764705882353	1	-0.0859950859950859	11	37
TRMT10A	9	11	0	2	314.82	629.64	15	1	0.493506493506494	1	1	0.45	2	20
TRMT10B	2	10	0	0	210.21	420.42	15	1	1	NA	1	NA	0	12
TRMT10C	20	13	3	3	410.85	821.7	15	1	0.674311129419489	0.35	1	0.106060606060606	6	33
TRMT11	7	17	1	1	439.56	879.12	15	1	0.529230769230769	-1.42857142857143	1	-0.208333333333333	2	24
TRMT12	20	32	8	4	419.43	838.86	15	1	0.108283450465369	-2.2	0.985224113668503	-0.282051282051282	12	52
TRMT13	12	11	4	1	395.01	790.02	15	1	0.355311355311355	-2.66666666666667	1	-0.278260869565217	5	23
TRMT1L	15	26	1	5	718.41	1436.82	15	1	0.648356290569573	0.653333333333333	1	0.199186991869919	6	41
TRMT2A	11	27	3	4	590.37	1180.74	15	1	0.659276543082556	-0.840909090909091	1	-0.139097744360902	7	38
TRMT44	21	22	4	2	624.03	1248.06	15	1	0.667100882906354	-1.0952380952381	1	-0.178294573643411	6	43
TRMT5	20	33	3	4	493.35	986.7	15	1	1	-0.2375	1	-0.0512129380053908	7	53
TRMT6	4	19	1	5	459.69	919.38	15	1	1	0.05	1	0.00724637681159421	6	23
TRMT61A	3	12	0	2	323.73	647.46	15	1	1	1	1	0.2	2	15
TRMT61B	7	9	1	1	229.35	458.7	15	1	1	-0.285714285714286	1	-0.0625	2	16
TRMU	4	13	1	1	392.7	785.4	15	1	0.467836257309941	-2.25	1	-0.264705882352941	2	17
TRNAU1AP	1	13	0	5	276.21	552.42	15	1	1	1	1	0.0714285714285714	5	14
TRNT1	5	13	4	9	380.82	761.64	15	1	1	-0.155555555555555	1	-0.0299145299145299	13	18
TROVE2	8	14	6	7	495.99	991.98	15	1	0.724055714078445	-0.5	1	-0.0979020979020979	13	22
TRPA1	5	32	1	5	1056	2112	15	1	1	-0.28	1	-0.0315315315315315	6	37
TRPC1	0	19	0	4	771.54	1543.08	15	1	1	NA	1	0	4	19
TRPC3	5	33	0	5	891.99	1783.98	15	1	1	1	1	0.131578947368421	5	38
TRPC4AP	0	17	0	4	725.67	1451.34	15	1	1	NA	1	0	4	17
TRPC5	4	19	0	0	653.4	1306.8	15	1	1	NA	1	NA	0	23
TRPC6	2	36	1	3	810.81	1621.62	15	1	0.265156794425087	-5	1	-0.197368421052632	4	38
TRPC7	3	33	1	8	839.52	1679.04	15	1	1	-0.375	1	-0.0277777777777778	9	36
TRPM1	10	63	4	8	1605.45	3210.9	15	1	0.104813552657531	-2.15	0.983379501385042	-0.19634703196347	12	73
TRPM2	24	61	10	9	1493.91	2987.82	15	1	0.0575568121340475	-1.82407407407407	0.853452975992572	-0.243962848297214	19	85
TRPM3	24	50	4	1	1333.86	2667.72	15	1	0.0506934770758888	-7.33333333333333	0.840481137782937	-0.475675675675676	5	74
TRPM5	20	42	2	6	1155	2310	15	1	1	0.3	1	0.0725806451612903	8	62
TRPM6	38	77	1	2	2054.25	4108.5	15	1	1	-0.013157894736842	1	-0.00289855072463768	3	115
TRPM7	10	70	1	5	2437.38	4874.76	15	1	0.571716738049816	-0.4	1	-0.0416666666666667	6	80
TRPM8	7	32	1	13	1085.04	2170.08	15	1	0.665021904944758	0.648351648351648	1	0.108058608058608	14	39
TRPS1	8	23	3	1	918.72	1837.44	15	1	0.0819327731092437	-7.625	0.947249589490969	-0.491935483870968	4	31
TRPV1	5	25	2	1	835.56	1671.12	15	1	0.106488269794721	-9	0.983875031494079	-0.5	3	30
TRPV2	85	89	4	15	2103.75	4207.5	15	1	0.0278380086517256	0.72078431372549	0.761210061313465	0.277979431336963	19	174
TRPV4	6	35	3	21	795.63	1591.26	15	1	1	0.166666666666667	1	0.0213414634146341	24	41
TRPV6	5	21	1	3	717.75	1435.5	15	1	1	-0.4	1	-0.0576923076923077	4	26
TRRAP	5	156	1	11	3808.53	7617.06	15	1	0.35463003090106	-1.83636363636364	1	-0.0522774327122153	12	161
TRUB1	2	13	1	4	285.12	570.24	15	1	1	-0.625	1	-0.0666666666666667	5	15
TSC1	2	25	3	6	1147.41	2294.82	15	1	0.0875668449197861	-5.25	0.951277979139867	-0.259259259259259	9	27
TSC2	9	79	3	20	1792.89	3585.78	15	1	0.710432302295171	-0.316666666666667	1	-0.0281620553359684	23	88
TSC22D1	14	32	11	12	1030.26	2060.52	15	1	0.189412262871266	-1.0952380952381	1	-0.173913043478261	23	46
TSEN15	5	5	3	4	139.59	279.18	15	1	1	0.25	1	0.0714285714285715	7	10
TSEN54	14	17	3	9	493.35	986.7	15	1	0.306458666326714	0.595238095238095	1	0.201612903225806	12	31
TSG101	1	13	2	4	375.21	750.42	15	1	0.201754385964912	-5.5	1	-0.261904761904762	6	14
TSGA10	16	19	4	4	646.14	1292.28	15	1	1	-0.1875	1	-0.0428571428571429	8	35
TSHB	1	1	0	0	133.65	267.3	15	1	1	NA	1	NA	0	2
TSHR	4	23	0	2	756.36	1512.72	15	1	1	1	1	0.148148148148148	2	27
TSHZ1	7	31	2	1	1056.33	2112.66	15	1	0.115947467166979	-7.85714285714286	1	-0.482456140350877	3	38
TSHZ2	10	25	1	2	1054.35	2108.7	15	1	1	-0.25	1	-0.0476190476190476	3	35
TSHZ3	8	32	1	2	1067.22	2134.44	15	1	0.515112227534235	-1	1	-0.133333333333333	3	40
TSKU	4	20	1	8	340.23	680.46	15	1	1	0.375	1	0.0555555555555556	9	24
TSN	1	16	0	3	182.49	364.98	15	1	1	1	1	0.0588235294117647	3	17
TSNARE1	27	12	9	1	484.77	969.54	15	1	0.252793029649819	-3	1	-0.207692307692308	10	39
TSNAX	3	7	2	4	284.13	568.26	15	1	1	-0.166666666666667	1	-0.0333333333333333	6	10
TSNAXIP1	36	28	3	3	669.24	1338.48	15	1	1	0.222222222222222	1	0.0625	6	64
TSPAN1	15	11	1	2	205.26	410.52	15	1	0.573070607553366	0.633333333333333	1	0.243589743589744	3	26
TSPAN10	3	6	2	2	78.54	157.08	15	1	1	-1	1	-0.166666666666667	4	9
TSPAN12	2	7	0	1	302.94	605.88	15	1	1	1	1	0.222222222222222	1	9
TSPAN13	3	9	0	0	181.17	362.34	15	1	1	NA	1	NA	0	12
TSPAN14	0	9	2	1	295.02	590.04	15	1	0.0454545454545455	-Inf	0.822543273817637	-0.666666666666667	3	9
TSPAN18	0	4	1	0	240.9	481.8	15	1	0.2	-Inf	1	-1	1	4
TSPAN19	13	4	0	0	201.96	403.92	15	1	1	NA	1	NA	0	17
TSPAN2	1	4	1	1	173.25	346.5	15	1	1	-3	1	-0.3	2	5
TSPAN3	1	5	0	0	230.67	461.34	15	1	1	NA	1	NA	0	6
TSPAN32	7	17	2	4	240.57	481.14	15	1	1	-0.214285714285714	1	-0.0416666666666666	6	24
TSPAN33	0	5	0	0	105.93	211.86	15	1	1	NA	1	NA	0	5
TSPAN4	11	14	2	3	311.85	623.7	15	1	1	0.151515151515151	1	0.04	5	25
TSPAN6	2	7	1	0	221.76	443.52	15	1	0.3	-Inf	1	-0.777777777777778	1	9
TSPAN7	6	12	1	2	264.33	528.66	15	1	1	0	1	0	3	18
TSPAN8	25	9	1	1	231.33	462.66	15	1	0.484126984126984	0.64	1	0.235294117647059	2	34
TSPEAR	8	23	6	6	635.91	1271.82	15	1	0.159685651321645	-1.875	1	-0.241935483870968	12	31
TSPO2	1	4	1	2	163.35	326.7	15	1	1	-1	1	-0.133333333333333	3	5
TSPOAP1	95	88	17	11	2765.73	5531.46	15	1	0.421986036687013	-0.431578947368421	1	-0.0880171740827478	28	183
TSR1	33	70	10	17	746.13	1492.26	15	1	0.6501652048889	-0.24777183600713	1	-0.0499820208558072	27	103
TSR3	5	13	0	0	257.07	514.14	15	1	1	NA	1	NA	0	18
TSSC1	3	10	0	0	322.74	645.48	15	1	1	NA	1	NA	0	13
TSSC4	12	20	3	4	339.57	679.14	15	1	1	-0.25	1	-0.0535714285714285	7	32
TSSK3	7	10	0	3	259.38	518.76	15	1	0.521052631578947	1	1	0.411764705882353	3	17
TSSK6L2	14	13	0	3	275.22	550.44	15	1	0.227586206896552	1	1	0.518518518518518	3	27
TST	2	15	4	6	249.15	498.3	15	1	0.153474544778893	-4	1	-0.282352941176471	10	17
TSTA3	1	9	6	6	246.18	492.36	15	1	0.0743034055727553	-8	0.913861472365723	-0.4	12	10
TSTD2	11	12	1	1	361.68	723.36	15	1	1	-0.0909090909090908	1	-0.0217391304347826	2	23
TSTD3	3	8	2	0	108.24	216.48	15	1	0.128205128205128	-Inf	1	-0.727272727272727	2	11
TTBK1	10	42	5	9	1312.74	2625.48	15	1	0.279448351459706	-1.33333333333333	1	-0.164835164835165	14	52
TTBK2	14	22	3	2	1112.1	2224.2	15	1	0.632686503033101	-1.35714285714286	1	-0.211111111111111	5	36
TTC1	11	10	0	1	294.03	588.06	15	1	1	1	1	0.523809523809524	1	21
TTC12	21	34	11	5	689.04	1378.08	15	1	0.0452954070629252	-2.56190476190476	0.822543273817637	-0.305681818181818	16	55
TTC13	3	30	0	5	788.04	1576.08	15	1	1	1	1	0.0909090909090909	5	33
TTC14	13	33	0	4	744.15	1488.3	15	1	0.561398176291793	1	1	0.282608695652174	4	46
TTC17	13	44	6	8	1162.59	2325.18	15	1	0.177795239456829	-1.53846153846154	1	-0.200501253132832	14	57
TTC19	7	11	2	1	266.31	532.62	15	1	0.553383458646617	-2.14285714285714	1	-0.277777777777778	3	18
TTC21B	13	51	4	7	1296.24	2592.48	15	1	0.257135582679795	-1.24175824175824	1	-0.160511363636364	11	64
TTC25	23	20	3	3	551.43	1102.86	15	1	1	0.130434782608696	1	0.0348837209302325	6	43
TTC26	6	11	2	3	548.46	1096.92	15	1	1	-0.222222222222222	1	-0.0470588235294118	5	17
TTC27	3	4	1	0	130.68	261.36	15	1	1	-Inf	1	-0.571428571428571	1	7
TTC28	9	72	0	9	2325.51	4651.02	15	1	0.590120714312295	1	1	0.111111111111111	9	81
TTC29	13	16	4	1	493.02	986.04	15	1	0.335288367546432	-3.92307692307692	1	-0.351724137931035	5	29
TTC3	59	62	8	7	1976.7	3953.4	15	1	0.789652805661869	-0.200968523002421	1	-0.0457300275482094	15	121
TTC30B	5	26	2	6	625.68	1251.36	15	1	0.617042316732719	-0.733333333333333	1	-0.0887096774193548	8	31
TTC31	33	17	9	2	493.35	986.7	15	1	0.476339845720898	-1.31818181818182	1	-0.158181818181818	11	50
TTC32	2	2	1	0	85.8	171.6	15	1	1	-Inf	1	-0.5	1	4
TTC33	14	10	0	0	326.7	653.4	15	1	1	NA	1	NA	0	24
TTC34	11	38	10	4	1031.58	2063.16	15	1	0.00117126560222162	-7.63636363636364	0.254094564439392	-0.489795918367347	14	49
TTC36	6	12	0	2	186.12	372.24	15	1	1	1	1	0.333333333333333	2	18
TTC38-TTC38L	6	9	0	0	344.52	689.04	15	1	1	NA	1	NA	0	15
TTC39A	4	23	0	0	568.26	1136.52	15	1	1	NA	1	NA	0	27
TTC39B	10	16	0	2	529.98	1059.96	15	1	0.523809523809524	1	1	0.384615384615385	2	26
TTC39C	2	14	1	0	549.78	1099.56	15	1	0.176470588235294	-Inf	1	-0.875	1	16
TTC4	12	13	6	6	307.56	615.12	15	1	1	-0.0833333333333333	1	-0.02	12	25
TTC6	73	56	5	9	1791.9	3583.8	15	1	0.163954510520656	0.573820395738204	1	0.20874861572536	14	129
TTC7A	22	38	8	12	949.41	1898.82	15	1	0.795654754849213	-0.151515151515152	1	-0.0333333333333334	20	60
TTC7B	1	33	1	4	795.63	1591.26	15	1	0.242914979757085	-7.25	1	-0.170588235294118	5	34
TTC8	4	15	3	0	510.51	1021.02	15	1	0.0227272727272727	-Inf	0.731515151515151	-0.789473684210526	3	19
TTC9	0	3	1	0	102.96	205.92	15	1	0.25	-Inf	1	-1	1	3
TTF1	47	35	2	6	715.11	1430.22	15	1	0.13491256214756	0.75177304964539	1	0.323170731707317	8	82
TTF2	59	46	11	4	1158.96	2317.92	15	1	0.268476192548438	-1.14406779661017	1	-0.171428571428571	15	105
TTI1	42	66	12	11	1040.82	2081.64	15	1	0.25323810619664	-0.714285714285714	1	-0.132850241545894	23	108
TTI2	9	30	7	7	358.38	716.76	15	1	0.0899996939832989	-2.33333333333333	0.953786405978059	-0.269230769230769	14	39
TTK	27	30	8	9	935.22	1870.44	15	1	1	0.0123456790123457	1	0.00309597523219812	17	57
TTL	0	9	1	2	366.96	733.92	15	1	0.25	-Inf	1	-0.333333333333333	3	9
TTLL10	28	20	3	5	583.77	1167.54	15	1	0.44468085866532	0.571428571428571	1	0.208333333333333	8	48
TTLL11	11	13	3	5	541.53	1083.06	15	1	1	0.290909090909091	1	0.0833333333333333	8	24
TTLL2	13	22	4	3	546.48	1092.96	15	1	0.413318720122314	-1.25641025641026	1	-0.2	7	35
TTLL4	52	25	15	12	1073.16	2146.32	15	1	0.350296245745412	0.399038461538462	1	0.11976911976912	27	77
TTLL5	48	39	10	6	1304.16	2608.32	15	1	0.784799977793373	-0.354166666666667	1	-0.0732758620689655	16	87
TTLL7	13	19	3	6	928.62	1857.24	15	1	1	0.269230769230769	1	0.0729166666666667	9	32
TTLL9	4	19	1	6	379.5	759	15	1	1	0.208333333333333	1	0.031055900621118	7	23
TTPA	3	11	0	4	255.09	510.18	15	1	1	1	1	0.214285714285714	4	14
TTPAL	1	16	3	2	336.6	673.2	15	1	0.0239234449760766	-23	0.748072489277835	-0.541176470588235	5	17
TTR	1	4	0	3	149.49	298.98	15	1	1	1	1	0.2	3	5
TTYH2	3	2	1	5	155.76	311.52	15	1	0.242424242424242	0.866666666666667	1	0.433333333333333	6	5
TTYH3	7	15	2	4	522.72	1045.44	15	1	1	-0.0714285714285714	1	-0.0151515151515151	6	22
TUB	1	26	1	3	462.66	925.32	15	1	0.24516129032258	-7.66666666666667	1	-0.212962962962963	4	27
TUBA3E	0	19	0	7	444.51	889.02	15	1	1	NA	1	0	7	19
TUBA8A	2	16	1	2	443.52	887.04	15	1	0.386466165413534	-3	1	-0.222222222222222	3	18
TUBA8B	2	13	0	5	501.93	1003.86	15	1	1	1	1	0.133333333333333	5	15
TUBB	0	8	1	7	127.71	255.42	15	1	1	-Inf	1	-0.125	8	8
TUBB1	0	21	1	3	444.51	889.02	15	1	0.16	-Inf	1	-0.25	4	21
TUBB3	5	22	5	26	280.5	561	15	1	1	0.153846153846154	1	0.02389486260454	31	27
TUBB4B	0	14	0	2	366.63	733.26	15	1	1	NA	1	0	2	14
TUBB6	0	23	0	7	423.72	847.44	15	1	1	NA	1	0	7	23
TUBD1	13	15	8	4	449.46	898.92	15	1	0.310928751974358	-1.30769230769231	1	-0.202380952380952	12	28
TUBE1	4	22	5	4	471.24	942.48	15	1	0.0299406748238784	-5.875	0.771992783106328	-0.401709401709402	9	26
TUBG1	0	18	0	11	409.2	818.4	15	1	1	NA	1	0	11	18
TUBGCP2	11	33	0	1	919.05	1838.1	15	1	1	1	1	0.25	1	44
TUBGCP3	2	18	0	3	920.7	1841.4	15	1	1	1	1	0.1	3	20
TUBGCP4	6	34	5	3	804.54	1609.08	15	1	0.0103612493001638	-8.44444444444444	0.585928868752023	-0.475	8	40
TUBGCP5	2	30	4	7	967.56	1935.12	15	1	0.0293491921697433	-7.57142857142857	0.768994411487961	-0.301136363636364	11	32
TUBGCP6	62	102	17	11	2425.5	4851	15	1	0.0362540059403544	-1.5425219941349	0.788199921465956	-0.229094076655052	28	164
TUFT1	7	12	0	0	360.69	721.38	15	1	1	NA	1	NA	0	19
TULP1	1	8	8	5	291.39	582.78	15	1	0.0306059265811588	-11.8	0.773114333163925	-0.504273504273504	13	9
TULP3	1	16	2	8	447.81	895.62	15	1	0.535042735042735	-3	1	-0.141176470588235	10	17
TULP4	8	66	0	14	1312.74	2625.48	15	1	0.345769346938626	1	1	0.108108108108108	14	74
TUSC5	0	2	0	1	65.34	130.68	15	1	1	NA	1	0	1	2
TUT1	44	47	7	12	631.62	1263.24	15	1	0.45126684513169	0.376893939393939	1	0.115095430884905	19	91
TVP23A	5	8	0	0	222.75	445.5	15	1	1	NA	1	NA	0	13
TWF1	2	15	2	1	339.24	678.48	15	1	0.087719298245614	-14	0.951277979139867	-0.549019607843137	3	17
TWF2	0	12	1	4	343.2	686.4	15	1	0.294117647058824	-Inf	1	-0.2	5	12
TWIST3	0	2	0	2	160.38	320.76	15	1	1	NA	1	0	2	2
TWISTNB	7	5	0	0	253.77	507.54	15	1	1	NA	1	NA	0	12
TWNK	3	17	2	16	461.01	922.02	15	1	1	0.291666666666667	1	0.0388888888888889	18	20
TWSG1	0	16	1	5	223.74	447.48	15	1	0.272727272727273	-Inf	1	-0.166666666666667	6	16
TXK	6	22	3	6	522.72	1045.44	15	1	0.657361739151964	-0.833333333333333	1	-0.119047619047619	9	28
TXLNA	10	21	3	4	530.31	1060.62	15	1	0.671627897247092	-0.575	1	-0.105990783410138	7	31
TXLNB	15	26	3	4	675.84	1351.68	15	1	1	-0.3	1	-0.0627177700348432	7	41
TXLNG	7	24	1	2	505.89	1011.78	15	1	1	-0.714285714285714	1	-0.10752688172043	3	31
TXN	0	2	0	0	97.02	194.04	15	1	1	NA	1	NA	0	2
TXN2	1	5	0	3	132.66	265.32	15	1	1	1	1	0.166666666666667	3	6
TXNDC11	43	26	2	0	857.67	1715.34	15	1	0.529175050301811	-Inf	1	-0.376811594202899	2	69
TXNDC12	0	3	0	0	114.84	229.68	15	1	1	NA	1	NA	0	3
TXNDC15	12	30	1	5	312.51	625.02	15	1	1	0.5	1	0.119047619047619	6	42
TXNDC16	34	30	10	8	850.41	1700.82	15	1	1	-0.102941176470588	1	-0.0243055555555556	18	64
TXNDC17	2	4	2	0	121.77	243.54	15	1	0.428571428571429	-Inf	1	-0.666666666666667	2	6
TXNDC5	3	13	3	3	340.89	681.78	15	1	0.282859555305376	-3.33333333333333	1	-0.3125	6	16
TXNDC9	0	14	3	1	224.73	449.46	15	1	0.00490196078431373	-Inf	0.460299276725364	-0.75	4	14
TXNIP	1	25	0	10	318.78	637.56	15	1	1	1	1	0.0384615384615385	10	26
TXNL1	0	5	0	0	254.76	509.52	15	1	1	NA	1	NA	0	5
TXNL4A	0	8	0	1	141.57	283.14	15	1	1	NA	1	0	1	8
TXNL4B	1	2	4	1	148.5	297	15	1	0.464285714285714	-7	1	-0.466666666666667	5	3
TXNRD1	2	19	2	6	554.4	1108.8	15	1	0.300029472443266	-2.16666666666667	1	-0.154761904761905	8	21
TXNRD2	7	18	5	2	497.97	995.94	15	1	0.0734648184592567	-5.42857142857143	0.913861472365723	-0.434285714285714	7	25
TXNRD3	5	20	2	4	599.94	1199.88	15	1	0.595904281110065	-1	1	-0.133333333333333	6	25
TYMS	4	10	0	2	281.16	562.32	15	1	1	1	1	0.285714285714286	2	14
TYR	8	25	1	0	524.7	1049.4	15	1	0.264705882352941	-Inf	1	-0.757575757575758	1	33
TYRO3	4	22	3	3	879.12	1758.24	15	1	0.101007292052898	-4.5	0.975691437149951	-0.346153846153846	6	26
TYRP1	2	15	0	2	528	1056	15	1	1	1	1	0.117647058823529	2	17
TYW1	3	27	2	5	444.51	889.02	15	1	0.232981644746351	-2.6	1	-0.185714285714286	7	30
TYW3	5	3	0	0	174.24	348.48	15	1	1	NA	1	NA	0	8
TYW5	2	16	2	3	287.1	574.2	15	1	0.193675889328063	-4.33333333333333	1	-0.288888888888889	5	18
U2AF1	0	8	0	2	221.1	442.2	15	1	1	NA	1	0	2	8
U2SURP	0	31	0	8	948.42	1896.84	15	1	1	NA	1	0	8	31
UACA	19	42	8	7	1359.93	2719.86	15	1	0.136382719987152	-1.52631578947368	1	-0.221857923497268	15	61
UAP1L1	15	8	3	0	955.35	1910.7	15	1	0.529230769230769	-Inf	1	-0.347826086956522	3	23
UBA2	1	11	1	0	586.08	1172.16	15	1	0.153846153846154	-Inf	1	-0.916666666666667	1	12
UBA3	2	19	1	4	438.57	877.14	15	1	0.488461538461538	-1.375	1	-0.104761904761905	5	21
UBA5	2	9	3	2	509.52	1019.04	15	1	0.244505494505494	-5.75	1	-0.418181818181818	5	11
UBA6	6	39	3	4	1011.78	2023.56	15	1	0.0899867069862173	-3.875	0.953786405978059	-0.295238095238095	7	45
UBAC1	3	12	0	2	359.37	718.74	15	1	1	1	1	0.2	2	15
UBAC2	10	11	7	1	345.84	691.68	15	1	0.0925665372441984	-6.7	0.957393405773329	-0.398809523809524	8	21
UBAP1	6	22	3	2	516.12	1032.24	15	1	0.110956618464961	-4.5	0.98538656216834	-0.385714285714286	5	28
UBAP1L	10	28	7	9	425.7	851.4	15	1	0.220996825608116	-1.17777777777778	1	-0.174342105263158	16	38
UBAP2L	1	30	2	22	1032.57	2065.14	15	1	0.574614065180103	-1.72727272727273	1	-0.0510752688172043	24	31
UBASH3A	10	24	4	5	616.44	1232.88	15	1	0.44152158846012	-0.92	1	-0.150326797385621	9	34
UBASH3B	5	35	1	8	592.02	1184.04	15	1	1	0.125	1	0.0138888888888889	9	40
UBB-UBC	1	12	1	20	188.1	376.2	15	1	1	0.4	1	0.0293040293040293	21	13
UBE2A	0	2	0	0	104.28	208.56	15	1	1	NA	1	NA	0	2
UBE2B	0	8	0	2	136.95	273.9	15	1	1	NA	1	0	2	8
UBE2D1	1	4	1	1	158.4	316.8	15	1	1	-3	1	-0.3	2	5
UBE2E2	6	4	1	2	414.15	828.3	15	1	0.559440559440559	0.666666666666667	1	0.266666666666667	3	10
UBE2F	6	3	0	1	218.79	437.58	15	1	0.4	1	1	0.666666666666667	1	9
UBE2G1	3	2	1	1	207.24	414.48	15	1	1	0.333333333333333	1	0.1	2	5
UBE2G2	0	3	1	1	164.34	328.68	15	1	0.4	-Inf	1	-0.5	2	3
UBE2H	12	11	8	3	272.58	545.16	15	1	0.294809047089359	-1.44444444444444	1	-0.205533596837945	11	23
UBE2J1	5	14	1	5	316.8	633.6	15	1	1	0.44	1	0.0964912280701754	6	19
UBE2J2	1	6	1	0	292.05	584.1	15	1	0.25	-Inf	1	-0.857142857142857	1	7
UBE2K	2	0	2	0	207.57	415.14	15	1	1	NA	1	0	2	2
UBE2O	5	45	4	17	1169.19	2338.38	15	1	0.434562086814495	-1.11764705882353	1	-0.0904761904761905	21	50
UBE2Q2	0	6	0	1	344.19	688.38	15	1	1	NA	1	0	1	6
UBE2T	2	14	3	2	196.02	392.04	15	1	0.0629514963880289	-9.5	0.878646123461792	-0.475	5	16
UBE2V1	8	3	0	0	179.19	358.38	15	1	1	NA	1	NA	0	11
UBE2Z	1	8	1	0	251.13	502.26	15	1	0.2	-Inf	1	-0.888888888888889	1	9
UBE3A	1	19	0	6	857.34	1714.68	15	1	1	1	1	0.05	6	20
UBE3B	4	33	5	10	1034.55	2069.1	15	1	0.0995234876132194	-3.125	0.971353639774823	-0.225225225225225	15	37
UBE3C	4	43	1	3	1073.16	2146.32	15	1	0.346998799519808	-2.58333333333333	1	-0.164893617021277	4	47
UBE3D	18	15	3	2	359.7	719.4	15	1	1	-0.25	1	-0.0545454545454546	5	33
UBE4A	7	41	1	6	1045.11	2090.22	15	1	1	0.0238095238095238	1	0.00297619047619049	7	48
UBE4B	2	25	4	7	1249.38	2498.76	15	1	0.0466428392124987	-6.14285714285714	0.828231827900648	-0.28956228956229	11	27
UBFD1	0	5	0	2	195.36	390.72	15	1	1	NA	1	0	2	5
UBIAD1	2	18	0	5	331.32	662.64	15	1	1	1	1	0.1	5	20
UBL3	1	4	0	0	112.53	225.06	15	1	1	NA	1	NA	0	5
UBL7	2	17	1	5	344.85	689.7	15	1	1	-0.7	1	-0.0614035087719298	6	19
UBLCP1	1	9	0	1	315.81	631.62	15	1	1	1	1	0.1	1	10
UBN1	13	44	6	8	1107.81	2215.62	15	1	0.177795239456829	-1.53846153846154	1	-0.200501253132832	14	57
UBN2	7	29	1	3	1151.37	2302.74	15	1	1	-0.380952380952381	1	-0.0555555555555556	4	36
UBP1	5	19	0	0	505.23	1010.46	15	1	1	NA	1	NA	0	24
UBQLN4	2	12	1	4	553.41	1106.82	15	1	1	-0.5	1	-0.0571428571428572	5	14
UBR1	24	66	4	5	1705.77	3411.54	15	1	0.266460459110048	-1.2	1	-0.177777777777778	9	90
UBR2	13	53	3	7	1757.58	3515.16	15	1	0.430540007195916	-0.747252747252747	1	-0.103030303030303	10	66
UBR3	7	38	1	0	1322.64	2645.28	15	1	0.173913043478261	-Inf	1	-0.844444444444444	1	45
UBR5	0	86	1	20	2749.56	5499.12	15	1	0.196261682242991	-Inf	1	-0.0476190476190476	21	86
UBR7	4	16	0	2	318.78	637.56	15	1	1	1	1	0.2	2	20
UBTD1	2	1	2	3	160.38	320.76	15	1	1	0.666666666666667	1	0.266666666666667	5	3
UBTD2	0	6	2	3	209.55	419.1	15	1	0.181818181818182	-Inf	1	-0.4	5	6
UBTF	0	4	2	2	183.81	367.62	15	1	0.428571428571429	-Inf	1	-0.5	4	4
UBXN10	26	15	9	8	282.15	564.3	15	1	0.558977190532651	0.350961538461538	1	0.104734576757532	17	41
UBXN11	21	15	6	5	406.23	812.46	15	1	1	0.142857142857143	1	0.037878787878788	11	36
UBXN2A	11	11	0	1	287.1	574.2	15	1	1	1	1	0.5	1	22
UBXN2B	1	12	0	2	346.83	693.66	15	1	1	1	1	0.0769230769230769	2	13
UBXN4	5	21	0	3	494.67	989.34	15	1	1	1	1	0.192307692307692	3	26
UBXN6	13	21	4	5	356.07	712.14	15	1	1	-0.292307692307692	1	-0.0620915032679739	9	34
UBXN7	0	9	0	3	461.01	922.02	15	1	1	NA	1	0	3	9
UCHL1	1	8	0	1	191.4	382.8	15	1	1	1	1	0.111111111111111	1	9
UCHL5	0	4	0	3	328.02	656.04	15	1	1	NA	1	0	3	4
UCK1	0	11	0	2	217.14	434.28	15	1	1	NA	1	0	2	11
UCK2	0	6	0	3	231	462	15	1	1	NA	1	0	3	6
UCKL1	1	12	0	10	494.34	988.68	15	1	1	1	1	0.0769230769230769	10	13
UCP3	1	8	4	7	248.82	497.64	15	1	0.318885448916409	-3.57142857142857	1	-0.252525252525253	11	9
UEVLD	11	20	4	4	473.88	947.76	15	1	0.685660893091234	-0.818181818181818	1	-0.145161290322581	8	31
UFD1L	0	8	0	6	303.93	607.86	15	1	1	NA	1	0	6	8
UFL1	24	25	6	3	759.33	1518.66	15	1	0.473073512152898	-1.08333333333333	1	-0.17687074829932	9	49
UFM1	4	2	0	0	134.64	269.28	15	1	1	NA	1	NA	0	6
UGCG	1	19	1	2	360.69	721.38	15	1	0.24901185770751	-8.5	1	-0.283333333333333	3	20
UGDH	0	16	1	5	490.05	980.1	15	1	0.272727272727273	-Inf	1	-0.166666666666667	6	16
UGGT1	11	49	5	1	1516.68	3033.36	15	1	0.00249186737817092	-21.2727272727273	0.349730689006081	-0.65	6	60
UGGT2	26	51	10	5	1486.32	2972.64	15	1	0.0222130019384189	-2.92307692307692	0.721018759249189	-0.329004329004329	15	77
UGP2	0	19	0	4	502.92	1005.84	15	1	1	NA	1	0	4	19
UGT1A1	41	48	6	8	999.9	1999.8	15	1	1	0.121951219512195	1	0.0321027287319423	14	89
UGT2A1	20	36	1	7	783.09	1566.18	15	1	0.254632564374626	0.742857142857143	1	0.232142857142857	8	56
UGT8	3	20	0	6	536.58	1073.16	15	1	1	1	1	0.130434782608696	6	23
UGT8L	9	30	7	6	524.7	1049.4	15	1	0.0790630810964498	-2.88888888888889	0.93374891275357	-0.307692307692308	13	39
UHRF1	0	36	1	5	693.99	1387.98	15	1	0.142857142857143	-Inf	1	-0.166666666666667	6	36
UHRF1BP1	24	59	16	18	1442.76	2885.52	15	1	0.0852815212853462	-1.18518518518519	0.950356516076024	-0.181431608788094	34	83
UHRF1BP1L	12	34	3	4	1436.82	2873.64	15	1	0.389436587098169	-1.125	1	-0.167701863354037	7	46
UHRF2	2	13	1	3	773.19	1546.38	15	1	0.530443756449949	-1.16666666666667	1	-0.116666666666667	4	15
UIMC1	35	41	9	13	799.92	1599.84	15	1	0.808663422466444	0.189010989010989	1	0.0514354066985646	22	76
ULK1	3	21	4	5	962.28	1924.56	15	1	0.0683166481275491	-4.6	0.888803134120932	-0.319444444444444	9	24
ULK2	3	29	3	7	1036.53	2073.06	15	1	0.134895704857194	-3.14285714285714	1	-0.20625	10	32
ULK3	1	3	3	0	86.46	172.92	15	1	0.142857142857143	-Inf	1	-0.75	3	4
ULK4	5	6	2	1	185.79	371.58	15	1	1	-1.4	1	-0.212121212121212	3	11
UMAD1	9	7	0	0	143.55	287.1	15	1	1	NA	1	NA	0	16
UMOD	9	21	2	1	414.81	829.62	15	1	0.252016129032258	-3.66666666666667	1	-0.366666666666667	3	30
UMODL1	61	54	21	8	1306.8	2613.6	15	1	0.0920597483814779	-1.32377049180328	0.953786405978059	-0.193703148425787	29	115
UMPS	9	26	4	4	428.01	856.02	15	1	0.217035168135267	-1.88888888888889	1	-0.242857142857143	8	35
UNC119	0	7	0	1	177.87	355.74	15	1	1	NA	1	0	1	7
UNC13B	35	84	9	6	1993.86	3987.72	15	1	0.0371713580437045	-2.6	0.788503148659952	-0.305882352941176	15	119
UNC13C	20	39	6	7	1235.85	2471.7	15	1	0.525651929219804	-0.671428571428571	1	-0.122555410691004	13	59
UNC13D	11	46	6	12	954.36	1908.72	15	1	0.331709831618385	-1.09090909090909	1	-0.140350877192982	18	57
UNC45A	3	47	3	12	871.53	1743.06	15	1	0.130089899524061	-2.91666666666667	1	-0.14	15	50
UNC45B	8	32	2	16	920.7	1841.4	15	1	0.708445843588515	0.5	1	0.0888888888888889	18	40
UNC50	6	13	15	7	358.05	716.1	15	1	0.0293662585883116	-3.64285714285714	0.768994411487961	-0.366028708133971	22	19
UNC5A	2	13	4	16	488.07	976.14	15	1	0.680438157667759	-0.625	1	-0.0666666666666667	20	15
UNC5B	2	33	6	14	827.97	1655.94	15	1	0.0212730665560854	-6.07142857142857	0.721018759249189	-0.242857142857143	20	35
UNC5C	12	33	2	9	957.33	1914.66	15	1	0.711468447536451	0.388888888888889	1	0.0848484848484848	11	45
UNC5D	2	44	1	7	911.13	1822.26	15	1	0.388001935171747	-2.14285714285714	1	-0.0815217391304348	8	46
UNC79	14	83	7	8	2618.22	5236.44	15	1	0.00748081027421222	-4.1875	0.513030568237167	-0.32233676975945	15	97
UNC80	13	111	4	19	3474.57	6949.14	15	1	0.308240977002308	-0.797570850202429	1	-0.0690743338008415	23	124
UNC93A	4	8	0	1	454.41	908.82	15	1	1	1	1	0.333333333333333	1	12
UNCX	3	3	0	1	101.64	203.28	15	1	1	1	1	0.5	1	6
UNG	7	15	1	3	228.36	456.72	15	1	1	0.285714285714286	1	0.0681818181818182	4	22
UNK	4	12	2	7	795.96	1591.92	15	1	1	0.142857142857143	1	0.0277777777777778	9	16
UNKL	22	22	3	1	804.54	1609.08	15	1	0.609929078014184	-2	1	-0.25	4	44
UPF1	0	30	0	7	1032.57	2065.14	15	1	1	NA	1	0	7	30
UPF2	1	45	2	6	1280.07	2560.14	15	1	0.05418480890179	-14	0.846060006968071	-0.228260869565217	8	46
UPF3B	0	6	0	0	409.2	818.4	15	1	1	NA	1	NA	0	6
UPK1B	7	7	0	2	256.08	512.16	15	1	0.475	1	1	0.5	2	14
UPK3A	13	16	1	1	195.03	390.06	15	1	1	-0.230769230769231	1	-0.0517241379310345	2	29
UPK3B	6	9	7	5	136.29	272.58	15	1	0.449481760667654	-1.1	1	-0.183333333333333	12	15
UPK3BL	14	6	4	5	177.54	355.08	15	1	0.237062787287675	0.657142857142857	1	0.255555555555556	9	20
UPP1	3	12	2	3	310.86	621.72	15	1	0.559791021671827	-1.66666666666667	1	-0.2	5	15
UPP2	2	14	3	4	312.51	625.02	15	1	0.142084460162263	-4.25	1	-0.303571428571429	7	16
UQCC1	8	14	4	0	286.77	573.54	15	1	0.0331103678929766	-Inf	0.784275503573749	-0.636363636363636	4	22
UQCRB	0	7	0	1	110.88	221.76	15	1	1	NA	1	0	1	7
UQCRC2	3	15	3	0	441.54	883.08	15	1	0.0150375939849624	-Inf	0.642329698273754	-0.833333333333333	3	18
UQCRFS1	0	9	2	1	201.63	403.26	15	1	0.0454545454545455	-Inf	0.822543273817637	-0.666666666666667	3	9
UQCRH	0	2	0	1	62.04	124.08	15	1	1	NA	1	0	1	2
UQCRQ	2	3	0	2	89.76	179.52	15	1	1	1	1	0.4	2	5
URB1	63	103	23	16	2245.98	4491.96	15	1	0.0195376117890701	-1.35019841269841	0.691551244264153	-0.210225517454433	39	166
URB2	52	43	26	25	1503.48	3006.96	15	1	0.728965627872024	0.14	1	0.0375644994840042	51	95
URI1	9	10	1	1	476.19	952.38	15	1	1	-0.111111111111111	1	-0.0263157894736842	2	19
UROC1	6	19	6	2	659.01	1318.02	15	1	0.0152092068109866	-8.5	0.642329698273754	-0.51	8	25
UROD	1	23	3	5	365.64	731.28	15	1	0.039321468298109	-12.8	0.794052121283243	-0.333333333333333	8	24
UROS	4	17	3	2	274.23	548.46	15	1	0.101413803587717	-5.375	0.975691437149951	-0.40952380952381	5	21
USE1	0	8	0	1	252.12	504.24	15	1	1	NA	1	0	1	8
USF3	34	75	15	29	2220.57	4441.14	15	1	0.848375973170935	-0.140973630831643	1	-0.0289824854045037	44	109
USH1C	15	31	2	7	805.86	1611.72	15	1	0.704758669672359	0.40952380952381	1	0.103864734299517	9	46
USH1G	3	12	1	6	499.62	999.24	15	1	1	0.333333333333333	1	0.0571428571428572	7	15
USH2A	105	146	13	11	4289.01	8578.02	15	1	0.283260341053972	-0.643290043290043	1	-0.123339973439575	24	251
USHBP1	4	5	4	8	215.16	430.32	15	1	0.673065015479876	0.375	1	0.111111111111111	12	9
USO1	9	44	2	6	902.55	1805.1	15	1	0.626895530849493	-0.62962962962963	1	-0.080188679245283	8	53
USP1	9	45	5	10	764.61	1529.22	15	1	0.166525347547511	-1.5	1	-0.166666666666667	15	54
USP10	17	23	0	7	944.46	1888.92	15	1	0.0385827661700352	1	0.789311843512415	0.425	7	40
USP12-USP12-like	1	6	0	1	247.5	495	15	1	1	1	1	0.142857142857143	1	7
USP13	5	30	0	1	800.91	1601.82	15	1	1	1	1	0.142857142857143	1	35
USP14	1	16	2	5	477.18	954.36	15	1	0.193675889328063	-5.4	1	-0.226890756302521	7	17
USP15	3	18	0	3	942.81	1885.62	15	1	1	1	1	0.142857142857143	3	21
USP16	16	29	6	4	816.75	1633.5	15	1	0.174729070558661	-1.71875	1	-0.244444444444444	10	45
USP18	29	13	1	0	434.61	869.22	15	1	1	-Inf	1	-0.30952380952381	1	42
USP19	11	54	8	15	1386.66	2773.32	15	1	0.0848975049170233	-1.61818181818182	0.950356516076024	-0.178595317725752	23	65
USP2	7	5	2	4	141.9	283.8	15	1	0.619909502262444	0.642857142857143	1	0.25	6	12
USP20	4	47	2	10	895.62	1791.24	15	1	0.320070266294669	-1.35	1	-0.0882352941176471	12	51
USP24	3	87	2	10	2423.52	4847.04	15	1	0.104213566614765	-4.8	0.983379501385042	-0.133333333333333	12	90
USP25	1	28	1	0	1091.97	2183.94	15	1	0.0666666666666667	-Inf	0.884435842948953	-0.96551724137931	1	29
USP28	26	38	3	6	1182.06	2364.12	15	1	1	0.269230769230769	1	0.0729166666666667	9	64
USP3	0	11	0	1	485.76	971.52	15	1	1	NA	1	0	1	11
USP30	7	20	2	3	441.54	883.08	15	1	0.604247775305895	-0.904761904761905	1	-0.140740740740741	5	27
USP31	9	39	3	6	1146.09	2292.18	15	1	0.379567994029787	-1.16666666666667	1	-0.145833333333333	9	48
USP32	8	43	3	14	1581.36	3162.72	15	1	1	-0.151785714285714	1	-0.0196078431372549	17	51
USP33	6	34	2	2	885.06	1770.12	15	1	0.145310163461043	-4.66666666666667	1	-0.35	4	40
USP34	9	77	4	10	3523.08	7046.16	15	1	0.0821880144201912	-2.42222222222222	0.949291228757616	-0.181063122923588	14	86
USP35	20	59	6	10	1024.65	2049.3	15	1	0.361727575562478	-0.77	1	-0.121835443037975	16	79
USP36	29	39	11	12	728.31	1456.62	15	1	0.80855617015426	-0.232758620689655	1	-0.0517902813299233	23	68
USP37	3	46	2	9	910.14	1820.28	15	1	0.224112297107468	-2.40740740740741	1	-0.120593692022263	11	49
USP38	15	28	1	7	940.17	1880.34	15	1	0.408613423784562	0.733333333333333	1	0.223837209302326	8	43
USP4	16	41	7	13	828.96	1657.92	15	1	0.579741409742691	-0.379807692307692	1	-0.0692982456140351	20	57
USP40	24	38	9	10	1232.55	2465.1	15	1	0.596296122672196	-0.425	1	-0.0865874363327674	19	62
USP42	45	40	22	9	822.69	1645.38	15	1	0.0931556090902312	-1.17283950617284	0.958791526417971	-0.180265654648956	31	85
USP43	4	1	3	5	279.84	559.68	15	1	0.265734265734266	0.85	1	0.425	8	5
USP44	4	11	1	3	707.85	1415.7	15	1	1	0.0833333333333334	1	0.0166666666666667	4	15
USP45	6	36	2	2	803.55	1607.1	15	1	0.134093207096241	-5	1	-0.357142857142857	4	42
USP46	4	11	1	2	412.83	825.66	15	1	1	-0.375	1	-0.0666666666666667	3	15
USP47	4	55	2	14	1329.57	2659.14	15	1	0.602193310424065	-0.964285714285714	1	-0.0572033898305085	16	59
USP49	3	21	2	3	691.02	1382.04	15	1	0.194694960212202	-3.66666666666667	1	-0.275	5	24
USP5	1	54	1	10	821.04	1642.08	15	1	0.307692307692308	-4.4	1	-0.0727272727272727	11	55
USP51	0	5	1	1	501.93	1003.86	15	1	0.285714285714286	-Inf	1	-0.5	2	5
USP54	32	46	9	9	1687.29	3374.58	15	1	0.59900957393939	-0.4375	1	-0.0897435897435898	18	78
USP6NL	21	25	3	2	846.12	1692.24	15	1	0.656330617353324	-0.785714285714286	1	-0.143478260869565	5	46
USP7	3	33	0	6	1093.95	2187.9	15	1	1	1	1	0.0833333333333333	6	36
USP8	14	39	1	5	1060.95	2121.9	15	1	1	0.442857142857143	1	0.0974842767295598	6	53
USP9X	20	69	3	23	2660.13	5320.26	15	1	0.275117652402308	0.55	1	0.10933448573898	26	89
USPL1	63	52	14	14	1076.13	2152.26	15	1	0.677359028198089	0.174603174603175	1	0.0478260869565217	28	115
UST	0	3	1	1	324.72	649.44	15	1	0.4	-Inf	1	-0.5	2	3
UT2LZ	11	15	5	3	421.74	843.48	15	1	0.42899517982944	-1.27272727272727	1	-0.201923076923077	8	26
UTP11	4	10	0	2	231.66	463.32	15	1	1	1	1	0.285714285714286	2	14
UTP14A	42	34	8	18	661.98	1323.96	15	1	0.0409924641706064	0.64021164021164	0.798931947804628	0.244939271255061	26	76
UTP15	7	25	1	4	499.62	999.24	15	1	1	0.107142857142857	1	0.01875	5	32
UTP18	9	13	2	1	449.79	899.58	15	1	0.564782608695652	-1.88888888888889	1	-0.257575757575758	3	22
UTP20	77	75	17	11	2749.89	5499.78	15	1	0.411356084980138	-0.505312868949233	1	-0.100563909774436	28	152
UTP23	10	6	3	0	245.52	491.04	15	1	0.51702786377709	-Inf	1	-0.375	3	16
UTP3	12	25	4	4	405.24	810.48	15	1	0.427031457362532	-1.08333333333333	1	-0.175675675675676	8	37
UTP6	5	23	1	1	592.02	1184.04	15	1	0.36551724137931	-3.6	1	-0.321428571428571	2	28
UTRN	61	147	20	17	3445.86	6891.72	15	1	0.00441859122705025	-1.8351012536162	0.458402469160589	-0.24727130977131	37	208
UTS2	6	5	0	0	120.78	241.56	15	1	1	NA	1	NA	0	11
UTS2B	0	2	1	0	126.72	253.44	15	1	0.333333333333333	-Inf	1	-1	1	2
UTS2R	5	18	2	5	379.17	758.34	15	1	1	-0.44	1	-0.0683229813664596	7	23
UTS2RL	11	17	6	9	365.31	730.62	15	1	1	-0.0303030303030303	1	-0.00714285714285717	15	28
UVRAG	22	42	6	14	805.86	1611.72	15	1	0.791567389837091	0.181818181818182	1	0.04375	20	64
UVS.2L	22	9	7	3	336.6	673.2	15	1	1	0.0454545454545454	1	0.00967741935483879	10	31
UVSSA	20	23	6	7	656.7	1313.4	15	1	1	0.0142857142857142	1	0.00357781753130587	13	43
UXS1	0	15	0	3	414.48	828.96	15	1	1	NA	1	0	3	15
VAC14	0	3	0	1	180.18	360.36	15	1	1	NA	1	0	1	3
VAMP1	9	10	2	1	135.63	271.26	15	1	1	-1.22222222222222	1	-0.192982456140351	3	19
VAMP2	1	6	0	1	137.61	275.22	15	1	1	1	1	0.142857142857143	1	7
VAMP4	0	2	0	0	118.8	237.6	15	1	1	NA	1	NA	0	2
VAMP7	0	8	0	4	211.86	423.72	15	1	1	NA	1	0	4	8
VANGL2	0	3	1	2	201.3	402.6	15	1	1	-Inf	1	-0.333333333333333	3	3
VAPA	0	5	0	0	222.42	444.84	15	1	1	NA	1	NA	0	5
VAPB	1	4	0	1	222.42	444.84	15	1	1	1	1	0.2	1	5
VASH1	0	4	1	2	270.93	541.86	15	1	0.428571428571428	-Inf	1	-0.333333333333333	3	4
VAT1	1	13	3	3	268.29	536.58	15	1	0.0608875128998968	-12	0.871782064889388	-0.428571428571429	6	14
VAT1L	0	5	0	0	414.81	829.62	15	1	1	NA	1	NA	0	5
VAV3	3	32	1	6	781.11	1562.22	15	1	0.532207629768605	-0.777777777777778	1	-0.0571428571428571	7	35
VCAM1	18	18	5	1	537.57	1075.14	15	1	0.197273392395344	-4	1	-0.333333333333333	6	36
VCAN	161	135	12	3	3478.53	6957.06	15	1	0.0631677324645661	-2.35403726708075	0.878646123461792	-0.256081081081081	15	296
VCL	13	36	0	3	1105.17	2210.34	15	1	0.564117647058824	1	1	0.26530612244898	3	49
VCPIP1	8	55	3	19	1171.5	2343	15	1	1	-0.0855263157894737	1	-0.00937950937950938	22	63
VCPKMT	3	13	0	1	163.68	327.36	15	1	1	1	1	0.1875	1	16
VDAC1	1	7	1	0	281.16	562.32	15	1	0.222222222222222	-Inf	1	-0.875	1	8
VDAC2	1	8	2	2	294.03	588.06	15	1	0.202797202797203	-7	1	-0.388888888888889	4	9
VDAC3	4	10	0	1	294.03	588.06	15	1	1	1	1	0.285714285714286	1	14
VDHAP	9	20	4	3	555.39	1110.78	15	1	0.224998682268606	-1.96296296296296	1	-0.261083743842364	7	29
VDR	2	11	1	4	405.57	811.14	15	1	1	-0.375	1	-0.0461538461538462	5	13
VEGFC	2	10	1	1	392.04	784.08	15	1	0.395604395604396	-4	1	-0.333333333333333	2	12
VEGFD	2	9	3	0	350.46	700.92	15	1	0.0274725274725275	-Inf	0.761210061313465	-0.818181818181818	3	11
VEGFRKDRL	13	57	4	10	1297.89	2595.78	15	1	0.467683898202747	-0.753846153846154	1	-0.1	14	70
VEPH1	2	7	1	3	204.93	409.86	15	1	1	-0.166666666666667	1	-0.0277777777777778	4	9
VEZT	21	22	6	4	825.66	1651.32	15	1	0.727658225072446	-0.571428571428571	1	-0.111627906976744	10	43
VGLL1	2	4	0	2	241.56	483.12	15	1	1	1	1	0.333333333333333	2	6
VGLL2	0	4	0	1	136.62	273.24	15	1	1	NA	1	0	1	4
VGLL3	1	3	0	0	264.33	528.66	15	1	1	NA	1	NA	0	4
VGLL4	10	11	0	1	330.66	661.32	15	1	1	1	1	0.476190476190476	1	21
VHL	0	5	1	0	104.94	209.88	15	1	0.166666666666667	-Inf	1	-1	1	5
VIL1	21	19	5	9	670.56	1341.12	15	1	0.358159418760419	0.497354497354497	1	0.167857142857143	14	40
VILL	16	40	8	13	953.37	1906.74	15	1	0.423463619557568	-0.538461538461539	1	-0.0952380952380952	21	56
VIM	2	11	0	11	386.76	773.52	15	1	0.481884057971014	1	1	0.153846153846154	11	13
VIP	1	4	0	0	164.34	328.68	15	1	1	NA	1	NA	0	5
VIPR1	5	19	3	2	384.12	768.24	15	1	0.111877394636015	-4.7	0.989285811139328	-0.391666666666667	5	24
VIPR2	4	16	0	1	421.74	843.48	15	1	1	1	1	0.2	1	20
VIT	14	38	6	8	782.43	1564.86	15	1	0.327774461983215	-1.03571428571429	1	-0.159340659340659	14	52
VKORC1L1	0	2	1	1	111.21	222.42	15	1	1	-Inf	1	-0.5	2	2
VLDLR	3	34	13	10	771.87	1543.74	15	1	6.31784689928781e-05	-13.7333333333333	0.0456978181178775	-0.484136310223267	23	37
VMA21	0	3	0	0	83.49	166.98	15	1	1	NA	1	NA	0	3
VMO1	4	6	1	1	182.16	364.32	15	1	1	-0.5	1	-0.1	2	10
VMP1	2	5	0	3	402.93	805.86	15	1	1	1	1	0.285714285714286	3	7
VNN1	17	18	9	0	493.02	986.04	15	1	0.00608081885509715	-Inf	0.467685236262114	-0.514285714285714	9	35
VPREB3	1	2	1	2	102.63	205.26	15	1	1	0	1	0	3	3
VPS11	8	50	3	0	823.02	1646.04	15	1	0.00458460683523201	-Inf	0.458402469160589	-0.862068965517241	3	58
VPS13A	35	71	5	0	2165.46	4330.92	15	1	0.00513408110081351	-Inf	0.463165107753452	-0.669811320754717	5	106
VPS13B	42	97	13	17	2879.25	5758.5	15	1	0.198192611813338	-0.766106442577031	1	-0.131175059952038	30	139
VPS13C	82	146	9	11	3613.5	7227	15	1	0.471425323786825	-0.456762749445676	1	-0.0903508771929825	20	228
VPS13D	41	173	16	28	4330.92	8661.84	15	1	0.0166213980496493	-1.41114982578397	0.673222397514319	-0.172047578589635	44	214
VPS18	0	34	0	4	968.88	1937.76	15	1	1	NA	1	0	4	34
VPS26A	0	17	0	1	323.73	647.46	15	1	1	NA	1	0	1	17
VPS26B	0	13	1	3	307.56	615.12	15	1	0.235294117647059	-Inf	1	-0.25	4	13
VPS29	0	5	0	0	180.18	360.36	15	1	1	NA	1	NA	0	5
VPS29L	3	13	0	5	179.19	358.38	15	1	0.548872180451128	1	1	0.1875	5	16
VPS33A	1	21	1	8	530.64	1061.28	15	1	0.503225806451613	-1.625	1	-0.0656565656565656	9	22
VPS33B	2	25	2	3	463.65	927.3	15	1	0.105255839822024	-7.33333333333333	0.983379501385042	-0.325925925925926	5	27
VPS35	1	20	1	6	788.04	1576.08	15	1	0.444444444444444	-2.33333333333333	1	-0.0952380952380952	7	21
VPS36	5	19	1	6	377.52	755.04	15	1	1	0.366666666666667	1	0.0654761904761905	7	24
VPS37A	3	15	3	3	350.79	701.58	15	1	0.139112603643496	-4	1	-0.333333333333333	6	18
VPS37B	5	6	2	2	248.49	496.98	15	1	1	-0.2	1	-0.0454545454545455	4	11
VPS37D	7	11	1	0	241.23	482.46	15	1	0.421052631578948	-Inf	1	-0.611111111111111	1	18
VPS41	2	26	0	4	841.83	1683.66	15	1	1	1	1	0.0714285714285714	4	28
VPS45	3	18	3	9	516.45	1032.9	15	1	0.643353726362625	-1	1	-0.107142857142857	12	21
VPS50	5	27	0	6	947.43	1894.86	15	1	0.570149539189787	1	1	0.15625	6	32
VPS53	1	28	4	12	795.96	1591.92	15	1	0.0467751823395613	-8.33333333333333	0.828231827900648	-0.21551724137931	16	29
VPS54	2	16	2	5	967.23	1934.46	15	1	0.548458498023715	-2.2	1	-0.174603174603175	7	18
VPS72	2	22	6	2	273.24	546.48	15	1	0.000753068461633532	-32	0.233065034151711	-0.666666666666667	8	24
VPS8	8	60	5	9	1360.92	2721.84	15	1	0.0406150595320847	-3.16666666666667	0.798931947804628	-0.239495798319328	14	68
VRK1	8	13	1	4	409.86	819.72	15	1	0.627850410459106	0.59375	1	0.180952380952381	5	21
VRK2	20	14	0	0	528.33	1056.66	15	1	1	NA	1	NA	0	34
VRK3	5	7	2	2	298.65	597.3	15	1	1	-0.4	1	-0.0833333333333333	4	12
VRTN	13	24	6	8	668.25	1336.5	15	1	0.747698701582183	-0.384615384615385	1	-0.0772200772200772	14	37
VSIG1	2	9	2	3	301.62	603.24	15	1	0.546703296703297	-2	1	-0.218181818181818	5	11
VSIG10	10	24	6	4	395.01	790.02	15	1	0.133105102594908	-2.6	1	-0.305882352941176	10	34
VSIG10L	38	14	4	10	394.68	789.36	15	1	0.00392016773967636	0.852631578947368	0.446381364319751	0.445054945054945	14	52
VSIG4	22	16	4	5	667.59	1335.18	15	1	0.486368738007024	0.418181818181818	1	0.134502923976608	9	38
VSNL1	1	4	3	0	158.4	316.8	15	1	0.142857142857143	-Inf	1	-0.8	3	5
VSTM2A	6	4	0	0	239.58	479.16	15	1	1	NA	1	NA	0	10
VSTM2B	7	2	0	1	112.53	225.06	15	1	0.3	1	1	0.777777777777778	1	9
VSTM2L	3	6	2	1	118.14	236.28	15	1	0.522727272727273	-3	1	-0.333333333333333	3	9
VSTM4	4	12	2	3	298.65	597.3	15	1	0.597523219814241	-1	1	-0.15	5	16
VSTM5	2	11	0	0	168.96	337.92	15	1	1	NA	1	NA	0	13
VSX1	4	12	0	3	226.38	452.76	15	1	1	1	1	0.25	3	16
VSX2	3	8	0	1	265.98	531.96	15	1	1	1	1	0.272727272727273	1	11
VTA1	5	10	0	2	297.99	595.98	15	1	1	1	1	0.333333333333333	2	15
VTCN1	8	12	6	5	303.27	606.54	15	1	0.477465568291123	-0.8	1	-0.145454545454545	11	20
VTCN1L	9	9	1	1	156.42	312.84	15	1	1	0	1	0	2	18
VTG1	45	61	4	4	1831.83	3663.66	15	1	0.723479333886826	-0.355555555555556	1	-0.0754716981132075	8	106
VTG2	43	65	10	10	1806.75	3613.5	15	1	0.461995607463307	-0.511627906976744	1	-0.101851851851852	20	108
VTG3	67	88	10	9	2064.81	4129.62	15	1	0.470849942459743	-0.459369817578773	1	-0.0940577249575552	19	155
VTI1A	5	2	2	0	208.23	416.46	15	1	1	-Inf	1	-0.285714285714286	2	7
VTI1B	2	8	1	0	192.72	385.44	15	1	0.272727272727273	-Inf	1	-0.8	1	10
VTN	26	16	9	7	407.88	815.76	15	1	0.768237282122618	0.208791208791209	1	0.0565476190476191	16	42
VWA1	14	22	0	8	494.67	989.34	15	1	0.0409924127570484	1	0.798931947804628	0.388888888888889	8	36
VWA2	25	38	15	11	747.78	1495.56	15	1	0.160556679805786	-1.07272727272727	1	-0.18009768009768	26	63
VWA3A	46	26	3	1	1114.41	2228.82	15	1	1	-0.695652173913043	1	-0.111111111111111	4	72
VWA3B	68	44	15	6	1429.23	2858.46	15	1	0.463604321051776	-0.617647058823529	1	-0.107142857142857	21	112
VWA5A	22	16	5	2	540.21	1080.42	15	1	0.684422214201	-0.818181818181818	1	-0.135338345864662	7	38
VWA5B1	41	33	30	32	1178.43	2356.86	15	1	0.491200366474585	0.245426829268293	1	0.0701830863121186	62	74
VWA5B2	28	33	18	19	847.77	1695.54	15	1	0.836624291808529	-0.116541353383459	1	-0.0274700930438636	37	61
VWA9	0	22	0	5	513.81	1027.62	15	1	1	NA	1	0	5	22
VWC2L	1	2	0	0	227.7	455.4	15	1	1	NA	1	NA	0	3
VWCE	4	12	4	9	444.18	888.36	15	1	1	-0.333333333333333	1	-0.0576923076923077	13	16
VWDE	63	52	15	12	1809.39	3618.78	15	1	1	-0.0317460317460319	1	-0.0077294685990339	27	115
VWF	18	32	0	2	889.02	1778.04	15	1	0.538461538461539	1	1	0.36	2	50
WAC	1	6	1	1	575.19	1150.38	15	1	0.416666666666667	-5	1	-0.357142857142857	2	7
WAPL	11	33	4	1	1185.03	2370.06	15	1	0.0259129553764152	-11	0.761210061313465	-0.55	5	44
WARS	2	23	2	1	469.26	938.52	15	1	0.0451770451770452	-22	0.822543273817637	-0.586666666666667	3	25
WASF1	0	11	1	1	389.73	779.46	15	1	0.153846153846154	-Inf	1	-0.5	2	11
WASF2	1	9	0	1	346.83	693.66	15	1	1	1	1	0.1	1	10
WASF3	3	15	2	8	465.3	930.6	15	1	1	-0.25	1	-0.0333333333333334	10	18
WASHC1	2	20	1	4	433.95	867.9	15	1	0.473504273504273	-1.5	1	-0.109090909090909	5	22
WASHC2C	30	52	11	10	1219.02	2438.04	15	1	0.217013258666999	-0.906666666666667	1	-0.157955865272938	21	82
WASHC3	6	3	0	0	271.26	542.52	15	1	1	NA	1	NA	0	9
WASHC4	1	43	1	7	1162.26	2324.52	15	1	0.28657616892911	-5.14285714285714	1	-0.102272727272727	8	44
WASHC5	1	39	0	6	1148.4	2296.8	15	1	1	1	1	0.025	6	40
WASL	0	8	0	1	357.72	715.44	15	1	1	NA	1	0	1	8
WBP11	0	22	2	5	618.42	1236.84	15	1	0.0517241379310345	-Inf	0.843251957917679	-0.285714285714286	7	22
WBP2	2	7	1	1	233.97	467.94	15	1	0.490909090909091	-2.5	1	-0.277777777777778	2	9
WBP2NL	7	12	1	7	247.5	495	15	1	0.364497145366711	0.755102040816326	1	0.243421052631579	8	19
WBP4	11	15	4	0	405.57	811.14	15	1	0.0996168582375479	-Inf	0.971353639774823	-0.576923076923077	4	26
WBSCR17	2	18	1	5	263.34	526.68	15	1	1	-0.8	1	-0.0666666666666667	6	20
WBSCR22	3	11	0	0	231	462	15	1	1	NA	1	NA	0	14
WBSCR27	5	7	0	0	89.76	179.52	15	1	1	NA	1	NA	0	12
WDCP	15	48	8	8	742.5	1485	15	1	0.0623336162968797	-2.2	0.878102185642472	-0.261904761904762	16	63
WDCPL	26	33	6	0	726.66	1453.32	15	1	0.0109709962168979	-Inf	0.585928868752023	-0.559322033898305	6	59
WDFY1	2	16	1	5	405.9	811.8	15	1	1	-0.6	1	-0.0555555555555556	6	18
WDFY2	1	11	3	5	396.99	793.98	15	1	0.25531475748194	-5.6	1	-0.291666666666667	8	12
WDFY4	52	94	9	9	2548.26	5096.52	15	1	0.301840898755496	-0.807692307692308	1	-0.143835616438356	18	146
WDHD1	20	55	10	6	1119.69	2239.38	15	1	0.00862223289731843	-3.58333333333333	0.544626840515064	-0.358333333333333	16	75
WDPCP	17	21	6	3	745.47	1490.94	15	1	0.28646584223997	-1.47058823529412	1	-0.219298245614035	9	38
WDR1	6	16	3	0	547.8	1095.6	15	1	0.0365217391304348	-Inf	0.788199921465956	-0.727272727272727	3	22
WDR11	9	33	3	7	1185.69	2371.38	15	1	0.679159201059681	-0.571428571428571	1	-0.0857142857142857	10	42
WDR12	0	26	4	2	412.83	825.66	15	1	0.000417130144605117	-Inf	0.164755839006111	-0.666666666666667	6	26
WDR17	13	31	5	3	1219.68	2439.36	15	1	0.107592278212075	-2.97435897435897	0.983875031494079	-0.329545454545455	8	44
WDR18	3	13	0	3	335.61	671.22	15	1	1	1	1	0.1875	3	16
WDR19	10	45	10	10	1330.56	2661.12	15	1	0.00889869246936846	-3.5	0.556514083447032	-0.318181818181818	20	55
WDR25	21	10	0	2	347.49	694.98	15	1	0.125	1	1	0.67741935483871	2	31
WDR26	0	16	0	2	500.28	1000.56	15	1	1	NA	1	0	2	16
WDR27	53	50	6	7	999.24	1998.48	15	1	0.775013898834595	0.191374663072776	1	0.0530246452576549	13	103
WDR3	13	38	7	5	927.96	1855.92	15	1	0.0403804613445636	-3.09230769230769	0.798931947804628	-0.32843137254902	12	51
WDR31	8	15	6	4	337.92	675.84	15	1	0.256926888461928	-1.8125	1	-0.252173913043478	10	23
WDR33	0	25	2	2	1310.76	2621.52	15	1	0.0147783251231527	-Inf	0.641111817849989	-0.5	4	25
WDR34	19	32	5	5	484.44	968.88	15	1	0.494980935885816	-0.684210526315789	1	-0.127450980392157	10	51
WDR35	8	45	3	1	1158.3	2316.6	15	1	0.0200501253132832	-15.875	0.695416702676231	-0.599056603773585	4	53
WDR37	0	13	0	0	491.04	982.08	15	1	1	NA	1	NA	0	13
WDR4	12	15	5	5	375.54	751.08	15	1	1	-0.25	1	-0.0555555555555556	10	27
WDR41	2	18	3	3	377.52	755.04	15	1	0.062420188507145	-8	0.878102185642472	-0.4	6	20
WDR43	9	15	0	2	622.71	1245.42	15	1	0.529230769230769	1	1	0.375	2	24
WDR44	10	28	1	3	875.49	1750.98	15	1	1	0.0666666666666667	1	0.0131578947368421	4	38
WDR45B	0	10	0	1	319.44	638.88	15	1	1	NA	1	0	1	10
WDR47	8	40	2	6	950.4	1900.8	15	1	0.623196738782596	-0.666666666666667	1	-0.0833333333333333	8	48
WDR48	3	24	2	1	726	1452	15	1	0.0640394088669951	-15	0.884435842948953	-0.555555555555556	3	27
WDR5	0	19	0	2	331.65	663.3	15	1	1	NA	1	0	2	19
WDR53	14	17	2	4	279.51	559.02	15	1	0.679626150214385	0.392857142857143	1	0.118279569892473	6	31
WDR54	7	11	7	6	218.79	437.58	15	1	0.480875793003328	-0.833333333333333	1	-0.14957264957265	13	18
WDR55	7	11	1	3	276.54	553.08	15	1	1	0.476190476190476	1	0.138888888888889	4	18
WDR6	15	14	16	10	239.25	478.5	15	1	0.587910011462936	-0.493333333333333	1	-0.0981432360742706	26	29
WDR60	41	33	8	7	1095.27	2190.54	15	1	1	0.0801393728222997	1	0.0207207207207207	15	74
WDR61	1	7	0	0	302.94	605.88	15	1	1	NA	1	NA	0	8
WDR63	49	35	7	5	891	1782	15	1	1	0	1	0	12	84
WDR64	55	34	2	1	1029.93	2059.86	15	1	1	-0.236363636363636	1	-0.048689138576779	3	89
WDR66	46	61	13	24	909.15	1818.3	15	1	0.443033394311191	0.281702898550725	1	0.0785551907047234	37	107
WDR7	11	58	7	18	1423.95	2847.9	15	1	0.236843734948056	-1.05050505050505	1	-0.120579710144928	25	69
WDR70	9	13	0	2	451.44	902.88	15	1	0.510869565217391	1	1	0.409090909090909	2	22
WDR72	20	32	10	5	978.12	1956.24	15	1	0.0772890343416346	-2.2	0.92272862957817	-0.282051282051282	15	52
WDR73	16	14	3	6	155.1	310.2	15	1	0.450576450576451	0.5625	1	0.2	9	30
WDR74	7	7	1	0	128.37	256.74	15	1	1	-Inf	1	-0.5	1	14
WDR75	23	36	7	8	751.41	1502.82	15	1	0.769219917700332	-0.369565217391304	1	-0.0768361581920904	15	59
WDR76	11	35	2	11	477.18	954.36	15	1	0.711952603582475	0.421487603305785	1	0.0852842809364548	13	46
WDR77	3	3	0	2	219.12	438.24	15	1	0.464285714285714	1	1	0.5	2	6
WDR78	37	32	11	15	664.62	1329.24	15	1	0.364085810843746	0.365765765765766	1	0.113154960981048	26	69
WDR81	24	78	18	42	1822.26	3644.52	15	1	0.457974101858373	-0.392857142857143	1	-0.0647058823529412	60	102
WDR82	0	10	1	1	302.61	605.22	15	1	0.166666666666667	-Inf	1	-0.5	2	10
WDR86	1	18	1	7	395.01	790.02	15	1	0.512820512820513	-1.57142857142857	1	-0.0723684210526316	8	19
WDR88	14	8	3	2	364.32	728.64	15	1	1	0.142857142857143	1	0.0363636363636364	5	22
WDR89	20	17	1	0	386.1	772.2	15	1	1	-Inf	1	-0.459459459459459	1	37
WDR91	6	23	3	4	652.74	1305.48	15	1	0.332704416077281	-1.875	1	-0.221674876847291	7	29
WDR92	1	10	2	0	293.04	586.08	15	1	0.0384615384615385	-Inf	0.789311843512415	-0.909090909090909	2	11
WDSUB1	17	18	1	2	477.18	954.36	15	1	1	0.470588235294118	1	0.152380952380952	3	35
WDTC1	1	20	1	3	680.13	1360.26	15	1	0.3	-5.66666666666667	1	-0.202380952380952	4	21
WDYHV1	11	13	2	4	181.5	363	15	1	0.672468527640941	0.409090909090909	1	0.125	6	24
WEE1	4	25	1	3	525.69	1051.38	15	1	0.499633431085044	-1.08333333333333	1	-0.112068965517241	4	29
WEE2	19	30	3	2	555.39	1110.78	15	1	0.387549762688497	-1.36842105263158	1	-0.212244897959184	5	49
WFDC2-WFDC8	19	14	8	10	405.9	811.8	15	1	0.396250729720723	0.410526315789474	1	0.131313131313131	18	33
WFIKKN1	0	11	1	12	522.06	1044.12	15	1	1	-Inf	1	-0.0769230769230769	13	11
WFIKKN2	3	31	0	8	565.29	1130.58	15	1	1	1	1	0.0882352941176471	8	34
WFS1	6	29	3	1	866.25	1732.5	15	1	0.0321698216435058	-13.5	0.784275503573749	-0.578571428571429	4	35
WHAMM	18	9	5	4	559.68	1119.36	15	1	0.693330825099784	0.375	1	0.111111111111111	9	27
WHRN	9	17	5	15	492.36	984.72	15	1	0.534985921826534	0.37037037037037	1	0.0961538461538461	20	26
WHSC1	5	33	4	3	1295.91	2591.82	15	1	0.0216414328722894	-7.8	0.721018759249189	-0.43984962406015	7	38
WHSC1L1	4	30	2	3	1188	2376	15	1	0.161354529775583	-4	1	-0.282352941176471	5	34
WIF1	5	21	0	1	392.7	785.4	15	1	1	1	1	0.192307692307692	1	26
WIPF1	2	14	1	2	231.33	462.66	15	1	0.422084623323013	-2.5	1	-0.208333333333333	3	16
WIPF3	9	9	1	2	218.46	436.92	15	1	1	0.5	1	0.166666666666667	3	18
WIPI1	2	15	2	5	408.21	816.42	15	1	0.552042160737813	-2	1	-0.168067226890756	7	17
WIPI2	0	13	0	4	397.32	794.64	15	1	1	NA	1	0	4	13
WISP1	7	19	0	1	403.92	807.84	15	1	1	1	1	0.269230769230769	1	26
WISP2	26	20	6	12	544.83	1089.66	15	1	0.163612076299838	0.615384615384615	1	0.231884057971014	18	46
WISP3	7	16	3	2	350.46	700.92	15	1	0.315018315018315	-2.42857142857143	1	-0.295652173913043	5	23
WLS	0	15	0	7	455.07	910.14	15	1	1	NA	1	0	7	15
WNK1	28	64	5	13	2678.28	5356.56	15	1	1	0.120879120879121	1	0.0265700483091788	18	92
WNK2	27	65	10	27	2085.93	4171.86	15	1	0.833280652953937	0.108367626886145	1	0.023207990599295	37	92
WNT10A	0	4	0	5	274.89	549.78	15	1	1	NA	1	0	5	4
WNT11	1	8	3	2	323.73	647.46	15	1	0.0949050949050949	-11	0.960983694935281	-0.488888888888889	5	9
WNT11B	6	7	3	6	322.41	644.82	15	1	0.673993808049536	0.416666666666667	1	0.128205128205128	9	13
WNT16	3	16	1	2	248.16	496.32	15	1	0.47012987012987	-1.66666666666667	1	-0.175438596491228	3	19
WNT2	2	6	0	0	267.3	534.6	15	1	1	NA	1	NA	0	8
WNT2B	0	18	0	6	322.74	645.48	15	1	1	NA	1	0	6	18
WNT3	5	21	1	4	405.57	811.14	15	1	1	-0.05	1	-0.00769230769230769	5	26
WNT3A	0	7	0	5	355.41	710.82	15	1	1	NA	1	0	5	7
WNT4	0	21	0	3	329.01	658.02	15	1	1	NA	1	0	3	21
WNT5A	1	27	0	0	375.54	751.08	15	1	1	NA	1	NA	0	28
WNT5B	0	5	0	7	330	660	15	1	1	NA	1	0	7	5
WNT7A	0	9	0	5	346.5	693	15	1	1	NA	1	0	5	9
WNT8A	3	31	4	6	354.42	708.84	15	1	0.0366714814874352	-5.88888888888889	0.788199921465956	-0.311764705882353	10	34
WNT8B	0	15	0	5	348.81	697.62	15	1	1	NA	1	0	5	15
WNT9A	0	12	1	3	329.01	658.02	15	1	0.25	-Inf	1	-0.25	4	12
WNT9B	1	15	1	0	338.58	677.16	15	1	0.117647058823529	-Inf	1	-0.9375	1	16
WRAP73	7	15	2	2	430.65	861.3	15	1	0.590635451505017	-1.14285714285714	1	-0.181818181818182	4	22
WRB	1	8	0	0	139.59	279.18	15	1	1	NA	1	NA	0	9
WRN	46	60	15	7	1465.2	2930.4	15	1	0.038041908505571	-1.79503105590062	0.789311843512415	-0.247855917667238	22	106
WSB1	0	15	1	2	404.58	809.16	15	1	0.166666666666667	-Inf	1	-0.333333333333333	3	15
WSB2	1	12	2	6	367.62	735.24	15	1	0.530827067669173	-3	1	-0.173076923076923	8	13
WSCD1	5	15	0	1	570.24	1140.48	15	1	1	1	1	0.25	1	20
WSCD2	3	11	4	16	442.86	885.72	15	1	1	0.0833333333333334	1	0.0142857142857143	20	14
WT1	0	10	0	1	372.9	745.8	15	1	1	NA	1	0	1	10
WTAP	1	7	2	2	393.03	786.06	15	1	0.236363636363636	-6	1	-0.375	4	8
WWC1	9	39	2	3	1085.37	2170.74	15	1	0.274520374187411	-1.88888888888889	1	-0.2125	5	48
WWC3	3	24	3	1	1121.67	2243.34	15	1	0.016367392340696	-23	0.669143255825333	-0.638888888888889	4	27
WWOX	2	4	1	0	194.04	388.08	15	1	0.428571428571428	-Inf	1	-0.666666666666667	1	6
WWP1	5	23	0	3	903.87	1807.74	15	1	1	1	1	0.178571428571429	3	28
WWTR1	8	7	0	0	235.62	471.24	15	1	1	NA	1	NA	0	15
XAF1	22	8	1	2	335.61	671.22	15	1	0.211693548387097	0.818181818181818	1	0.4	3	30
XBP1	9	13	2	0	336.93	673.86	15	1	0.199275362318841	-Inf	1	-0.590909090909091	2	22
xcc-b100_1894L	16	15	5	4	512.49	1024.98	15	1	1	-0.171875	1	-0.0394265232974911	9	31
XCL1	0	4	0	0	97.02	194.04	15	1	1	NA	1	NA	0	4
XCR1	6	12	0	0	335.61	671.22	15	1	1	NA	1	NA	0	18
XDH	21	53	7	4	1346.4	2692.8	15	1	0.0353853238718089	-3.41666666666667	0.788199921465956	-0.352579852579853	11	74
XG	0	8	1	2	163.35	326.7	15	1	0.272727272727273	-Inf	1	-0.333333333333333	3	8
XIAP	18	24	8	8	488.07	976.14	15	1	0.76925389620683	-0.333333333333333	1	-0.0714285714285715	16	42
XIRP1	64	88	29	21	2825.46	5650.92	15	1	0.0713946327113912	-0.898809523809524	0.908058284769907	-0.158947368421053	50	152
XIRP2	53	34	2	1	890.01	1780.02	15	1	1	-0.283018867924528	1	-0.057471264367816	3	87
XK	5	11	0	10	360.69	721.38	15	1	0.121313469139556	1	1	0.3125	10	16
XKR4	4	10	2	2	360.36	720.72	15	1	0.568627450980392	-1.5	1	-0.214285714285714	4	14
XKR5	42	30	19	15	642.18	1284.36	15	1	0.835864531484056	0.0952380952380952	1	0.0245098039215687	34	72
XKR6	5	7	1	1	419.1	838.2	15	1	1	-0.4	1	-0.0833333333333333	2	12
XKR7	2	1	2	7	287.76	575.52	15	1	0.236363636363636	0.857142857142857	1	0.444444444444444	9	3
XKR8	11	18	1	1	309.21	618.42	15	1	1	-0.636363636363636	1	-0.120689655172414	2	29
XKR9	8	14	2	0	375.21	750.42	15	1	0.16304347826087	-Inf	1	-0.636363636363636	2	22
XKRX	7	22	1	2	338.58	677.16	15	1	1	-0.571428571428571	1	-0.0919540229885057	3	29
XPA	0	10	0	0	177.87	355.74	15	1	1	NA	1	NA	0	10
XPC	28	33	8	6	953.37	1906.74	15	1	0.557251970482545	-0.571428571428571	1	-0.112412177985948	14	61
XPNPEP1	7	28	3	3	616.11	1232.22	15	1	0.143464487495296	-3	1	-0.3	6	35
XPNPEP2	7	11	4	9	381.15	762.3	15	1	0.717831406877207	0.301587301587302	1	0.0811965811965812	13	18
XPNPEP3	4	22	11	2	482.79	965.58	15	1	4.77400503917755e-05	-29.25	0.04042271543353	-0.692307692307692	13	26
XPO1	0	18	3	1	995.94	1991.88	15	1	0.0025974025974026	-Inf	0.352254487085948	-0.75	4	18
XPO4	2	21	2	2	1037.85	2075.7	15	1	0.0917948717948718	-9.5	0.953786405978059	-0.41304347826087	4	23
XPO5	2	42	2	3	1140.15	2280.3	15	1	0.0467490418924276	-13	0.828231827900648	-0.354545454545455	5	44
XPO7	8	38	2	8	1061.94	2123.88	15	1	1	-0.1875	1	-0.0260869565217391	10	46
XPOT	6	28	1	2	947.43	1894.86	15	1	0.477477477477477	-1.33333333333333	1	-0.156862745098039	3	34
XPR1	7	20	3	6	715.77	1431.54	15	1	0.685575008646395	-0.428571428571429	1	-0.0740740740740741	9	27
XRCC2	3	6	2	1	266.31	532.62	15	1	0.522727272727273	-3	1	-0.333333333333333	3	9
XRCC3	8	14	0	1	344.52	689.04	15	1	1	1	1	0.363636363636364	1	22
XRCC4	3	5	2	2	179.19	358.38	15	1	1	-0.666666666666667	1	-0.125	4	8
XRCC5	18	19	2	2	721.05	1442.1	15	1	1	-0.0555555555555556	1	-0.0135135135135135	4	37
XRCC6	10	22	8	9	610.17	1220.34	15	1	0.354936699662848	-0.955555555555555	1	-0.158088235294118	17	32
XRN1	19	54	3	9	1713.69	3427.38	15	1	1	0.0526315789473685	1	0.0102739726027397	12	73
XRN2	2	30	0	6	939.51	1879.02	15	1	1	1	1	0.0625	6	32
XRRA1	50	34	26	12	754.38	1508.76	15	1	0.421633398162292	-0.473333333333333	1	-0.0889724310776943	38	84
XXYLT1	2	14	3	4	346.5	693	15	1	0.142084460162263	-4.25	1	-0.303571428571429	7	16
XYLB	17	15	7	3	485.76	971.52	15	1	0.472600674141111	-1.05882352941176	1	-0.16875	10	32
XYLT1	14	35	4	5	931.92	1863.84	15	1	0.438007925711244	-1	1	-0.158730158730159	9	49
XYLT2	10	30	7	8	772.86	1545.72	15	1	0.189248614791715	-1.625	1	-0.216666666666667	15	40
YAE1D1	11	10	2	0	220.77	441.54	15	1	0.486166007905138	-Inf	1	-0.476190476190476	2	21
YARS	5	37	1	4	456.39	912.78	15	1	0.511455149129137	-0.85	1	-0.080952380952381	5	42
YARS2	0	8	2	1	258.39	516.78	15	1	0.0545454545454546	-Inf	0.846060006968071	-0.666666666666667	3	8
YBEY	1	2	1	3	51.48	102.96	15	1	1	0.333333333333333	1	0.0833333333333333	4	3
YBX1	0	3	0	1	257.73	515.46	15	1	1	NA	1	0	1	3
YBX3	5	10	4	2	261.36	522.72	15	1	0.331048208757187	-3	1	-0.333333333333333	6	15
YDJC	3	13	3	6	305.91	611.82	15	1	0.6300395256917	-1.16666666666667	1	-0.145833333333333	9	16
YEATS2	6	39	1	7	1348.05	2696.1	15	1	1	0.0714285714285714	1	0.00833333333333333	8	45
YEATS4	9	19	7	6	293.7	587.4	15	1	0.302387830287473	-1.46296296296296	1	-0.217032967032967	13	28
YES1	0	17	0	8	536.58	1073.16	15	1	1	NA	1	0	8	17
YIPF1	1	11	1	5	270.6	541.2	15	1	1	-1.2	1	-0.0833333333333333	6	12
YIPF3	2	16	1	8	251.13	502.26	15	1	1	0	1	0	9	18
YIPF4	0	10	0	3	234.3	468.6	15	1	1	NA	1	0	3	10
YIPF5	1	12	0	4	236.94	473.88	15	1	1	1	1	0.0769230769230769	4	13
YIPF6	1	9	1	1	159.39	318.78	15	1	0.318181818181818	-8	1	-0.4	2	10
YIPF7	6	9	0	2	254.43	508.86	15	1	0.514705882352941	1	1	0.4	2	15
YLPM1	25	59	7	22	1668.15	3336.3	15	1	0.638688933894629	0.249090909090909	1	0.05623973727422	29	84
YME1L1	5	30	4	5	704.88	1409.76	15	1	0.0678099016159142	-3.8	0.887960242513107	-0.301587301587302	9	35
YOD1	1	13	0	5	223.41	446.82	15	1	1	1	1	0.0714285714285714	5	14
YPEL1	0	2	0	0	118.8	237.6	15	1	1	NA	1	NA	0	2
YPEL2	0	4	0	2	118.8	237.6	15	1	1	NA	1	0	2	4
YPEL5	0	2	0	1	120.78	241.56	15	1	1	NA	1	0	1	2
YRDC	2	14	4	1	151.14	302.28	15	1	0.0113519091847265	-27	0.593149540517961	-0.675	5	16
YTHDC1	5	20	1	0	668.91	1337.82	15	1	0.230769230769231	-Inf	1	-0.8	1	25
YTHDC2	24	46	7	3	1112.1	2224.2	15	1	0.0406770541834657	-3.47222222222222	0.798931947804628	-0.357142857142857	10	70
YTHDF1	0	22	0	4	548.13	1096.26	15	1	1	NA	1	0	4	22
YTHDF3	0	8	0	2	570.24	1140.48	15	1	1	NA	1	0	2	8
YWHAB	0	5	0	3	242.55	485.1	15	1	1	NA	1	0	3	5
YWHAE	0	3	1	1	232.32	464.64	15	1	0.4	-Inf	1	-0.5	2	3
YWHAG	0	5	0	2	216.81	433.62	15	1	1	NA	1	0	2	5
YWHAQ	0	3	0	0	196.02	392.04	15	1	1	NA	1	NA	0	3
YWHAZ	0	4	0	0	243.54	487.08	15	1	1	NA	1	NA	0	4
YY2	0	8	0	1	253.11	506.22	15	1	1	NA	1	0	1	8
ZAR1	0	3	0	1	98.34	196.68	15	1	1	NA	1	0	1	3
ZAR1L	15	13	5	3	300.96	601.92	15	1	0.708598779788991	-0.444444444444444	1	-0.0892857142857143	8	28
ZBBX	31	23	4	5	628.65	1257.3	15	1	0.494487529052484	0.406451612903226	1	0.12962962962963	9	54
ZBED1	4	33	1	6	689.04	1378.08	15	1	1	-0.375	1	-0.0347490347490347	7	37
ZBED4	4	32	2	3	1161.27	2322.54	15	1	0.147593134756164	-4.33333333333333	1	-0.288888888888889	5	36
ZBTB1	2	23	1	3	703.89	1407.78	15	1	0.370552818828681	-2.83333333333333	1	-0.17	4	25
ZBTB10	0	10	0	2	587.73	1175.46	15	1	1	NA	1	0	2	10
ZBTB14	1	11	0	2	444.51	889.02	15	1	1	1	1	0.0833333333333333	2	12
ZBTB17	3	24	8	15	667.26	1334.52	15	1	0.0842240502843586	-3.26666666666667	0.949431371776132	-0.236714975845411	23	27
ZBTB18-ZBTB42	0	2	1	2	516.78	1033.56	15	1	1	-Inf	1	-0.333333333333333	3	2
ZBTB2	1	11	1	1	508.86	1017.72	15	1	0.274725274725275	-10	1	-0.416666666666667	2	12
ZBTB20	1	9	1	3	658.35	1316.7	15	1	0.505494505494505	-2	1	-0.15	4	10
ZBTB21	5	45	2	14	1047.42	2094.84	15	1	1	-0.285714285714286	1	-0.025	16	50
ZBTB25	9	20	3	2	432.63	865.26	15	1	0.319259962049336	-2.33333333333333	1	-0.289655172413793	5	29
ZBTB26	1	17	1	5	434.61	869.22	15	1	0.445652173913043	-2.4	1	-0.111111111111111	6	18
ZBTB32	5	27	3	9	645.15	1290.3	15	1	0.662541412310048	-0.8	1	-0.09375	12	32
ZBTB33	27	55	0	3	673.2	1346.4	15	1	0.548132023893895	1	1	0.329268292682927	3	82
ZBTB34	2	17	1	1	515.79	1031.58	15	1	0.271428571428572	-7.5	1	-0.394736842105263	2	19
ZBTB37	1	17	0	3	498.96	997.92	15	1	1	1	1	0.0555555555555556	3	18
ZBTB38	29	56	10	13	1181.07	2362.14	15	1	0.466337507823156	-0.485411140583554	1	-0.0936061381074169	23	85
ZBTB39	7	35	1	5	686.73	1373.46	15	1	1	0	1	0	6	42
ZBTB40	31	10	4	2	295.02	590.04	15	1	0.637200697029021	0.354838709677419	1	0.0894308943089431	6	41
ZBTB41	9	37	2	6	896.94	1793.88	15	1	0.659320606783237	-0.37037037037037	1	-0.0543478260869565	8	46
ZBTB43	2	13	0	2	460.35	920.7	15	1	1	1	1	0.133333333333333	2	15
ZBTB44	5	17	1	6	647.46	1294.92	15	1	1	0.433333333333333	1	0.0844155844155844	7	22
ZBTB45	0	13	1	2	208.23	416.46	15	1	0.1875	-Inf	1	-0.333333333333333	3	13
ZBTB46	4	17	3	10	684.42	1368.84	15	1	1	-0.275	1	-0.0402930402930403	13	21
ZBTB47	5	16	1	9	540.87	1081.74	15	1	0.634208950115513	0.644444444444444	1	0.138095238095238	10	21
ZBTB49	21	24	6	8	756.69	1513.38	15	1	1	0.142857142857143	1	0.0380952380952381	14	45
ZBTB6	10	18	0	4	391.05	782.1	15	1	0.282675194660734	1	1	0.357142857142857	4	28
ZBTB7C	6	22	5	8	617.1	1234.2	15	1	0.28017971001574	-1.29166666666667	1	-0.17032967032967	13	28
ZBTB8AL	6	19	2	2	482.13	964.26	15	1	0.300029472443266	-2.16666666666667	1	-0.26	4	25
ZBTB8B	4	18	4	3	466.29	932.58	15	1	0.0675662168915542	-5	0.887403958521284	-0.38961038961039	7	22
ZBTB8OS	2	3	0	2	163.35	326.7	15	1	1	1	1	0.4	2	5
ZC2HC1A	5	9	3	1	320.43	640.86	15	1	0.274509803921569	-4.4	1	-0.392857142857143	4	14
ZC2HC1C	47	28	4	6	452.43	904.86	15	1	0.188642684520053	0.602836879432624	1	0.226666666666667	10	75
ZC3H10	1	10	1	3	231.33	462.66	15	1	0.476190476190476	-2.33333333333333	1	-0.159090909090909	4	11
ZC3H11A	11	15	3	6	185.46	370.92	15	1	0.711512791991101	0.318181818181818	1	0.0897435897435898	9	26
ZC3H12A	13	29	5	5	646.8	1293.6	15	1	0.286785408726764	-1.23076923076923	1	-0.19047619047619	10	42
ZC3H12B	5	22	2	1	829.62	1659.24	15	1	0.127586206896552	-7.8	1	-0.481481481481481	3	27
ZC3H12C	5	24	6	8	882.09	1764.18	15	1	0.132991431783773	-2.6	1	-0.25615763546798	14	29
ZC3H12D	22	26	10	9	586.08	1172.16	15	1	0.786797329851508	-0.313131313131313	1	-0.0679824561403509	19	48
ZC3H13	6	62	5	13	1527.24	3054.48	15	1	0.0473968402556391	-2.97435897435897	0.828231827900648	-0.189542483660131	18	68
ZC3H14	10	33	5	2	714.12	1428.24	15	1	0.0197067309810141	-7.25	0.69334271185944	-0.481727574750831	7	43
ZC3H15	9	18	0	0	408.87	817.74	15	1	1	NA	1	NA	0	27
ZC3H18	3	51	7	17	954.03	1908.06	15	1	0.00771649519478961	-6	0.525963507605449	-0.236111111111111	24	54
ZC3H3	19	19	9	11	398.64	797.28	15	1	0.786556618005193	0.181818181818182	1	0.05	20	38
ZC3H4	17	51	2	5	609.51	1219.02	15	1	1	-0.2	1	-0.0357142857142857	7	68
ZC3H6	3	25	3	2	1115.07	2230.14	15	1	0.0313100414602083	-11.5	0.777597120215462	-0.492857142857143	5	28
ZC3H7A	11	29	0	1	961.95	1923.9	15	1	1	1	1	0.275	1	40
ZC3H7B	4	29	1	10	979.77	1959.54	15	1	1	0.275	1	0.0303030303030303	11	33
ZC3HAV1	29	16	3	0	673.86	1347.72	15	1	0.541165587419056	-Inf	1	-0.355555555555556	3	45
ZC3HC1	17	15	7	9	346.17	692.34	15	1	0.760109163604173	0.313725490196078	1	0.09375	16	32
ZC4H2	0	5	0	0	222.75	445.5	15	1	1	NA	1	NA	0	5
ZCCHC10	0	15	0	4	165.33	330.66	15	1	1	NA	1	0	4	15
ZCCHC11	8	35	11	7	1578.72	3157.44	15	1	0.00204345392585119	-5.875	0.327855520331649	-0.425064599483204	18	43
ZCCHC14	5	25	2	8	1033.23	2066.46	15	1	1	-0.25	1	-0.0333333333333334	10	30
ZCCHC17	5	10	3	3	229.02	458.04	15	1	0.631062951496388	-1	1	-0.166666666666667	6	15
ZCCHC2	4	33	2	8	967.89	1935.78	15	1	0.594045134780457	-1.0625	1	-0.0918918918918919	10	37
ZCCHC24	4	4	2	1	109.89	219.78	15	1	1	-1	1	-0.166666666666667	3	8
ZCCHC4	16	14	3	3	485.76	971.52	15	1	1	0.125	1	0.0333333333333333	6	30
ZCCHC6	27	51	5	3	1482.36	2964.72	15	1	0.141808905099205	-2.14814814814815	1	-0.278846153846154	8	78
ZCCHC7	7	14	2	2	280.17	560.34	15	1	0.601581027667984	-1	1	-0.166666666666667	4	21
ZCCHC8	11	15	0	4	674.19	1348.38	15	1	0.267870826491516	1	1	0.423076923076923	4	26
ZCCHC9	5	2	0	0	123.75	247.5	15	1	1	NA	1	NA	0	7
ZDBF2	41	33	5	2	1093.95	2187.9	15	1	0.692844608817294	-1.01219512195122	1	-0.16023166023166	7	74
ZDHHC1	21	20	9	2	535.59	1071.18	15	1	0.0919697856189503	-3.28571428571429	0.953786405978059	-0.305986696230599	11	41
ZDHHC12	5	13	4	3	245.52	491.04	15	1	0.204909506969003	-2.46666666666667	1	-0.293650793650794	7	18
ZDHHC14	0	7	0	3	331.32	662.64	15	1	1	NA	1	0	3	7
ZDHHC16	7	9	3	6	366.63	733.26	15	1	0.691317808587966	0.357142857142857	1	0.104166666666667	9	16
ZDHHC17	2	20	3	6	580.8	1161.6	15	1	0.131256952169077	-4	1	-0.242424242424242	9	22
ZDHHC18	0	7	1	2	189.42	378.84	15	1	0.3	-Inf	1	-0.333333333333333	3	7
ZDHHC2	2	12	2	0	298.65	597.3	15	1	0.05	-Inf	0.838566235774774	-0.857142857142857	2	14
ZDHHC20	0	8	0	3	320.43	640.86	15	1	1	NA	1	0	3	8
ZDHHC22	2	4	1	2	273.24	546.48	15	1	1	0	1	0	3	6
ZDHHC23	8	17	2	7	331.65	663.3	15	1	0.692066096567831	0.392857142857143	1	0.0977777777777778	9	25
ZDHHC3	5	10	1	3	324.72	649.44	15	1	1	0.333333333333333	1	0.0833333333333333	4	15
ZDHHC4	11	14	3	2	299.97	599.94	15	1	0.642401021711367	-0.909090909090909	1	-0.16	5	25
ZDHHC5	6	18	4	10	530.31	1060.62	15	1	1	-0.2	1	-0.0357142857142857	14	24
ZDHHC6	1	3	0	1	237.6	475.2	15	1	1	1	1	0.25	1	4
ZDHHC7	1	1	0	1	302.94	605.88	15	1	1	1	1	0.5	1	2
ZDHHC8	13	31	5	10	815.43	1630.86	15	1	0.757668473601684	-0.192307692307692	1	-0.0378787878787878	15	44
ZDHHC9	3	8	5	3	337.26	674.52	15	1	0.180916091132809	-3.44444444444444	1	-0.352272727272727	8	11
ZEB1	10	11	3	4	945.45	1890.9	15	1	1	0.175	1	0.0476190476190476	7	21
ZER1	0	21	2	5	757.68	1515.36	15	1	0.0555555555555555	-Inf	0.846060006968071	-0.285714285714286	7	21
ZFAND2A	5	7	1	1	176.22	352.44	15	1	1	-0.4	1	-0.0833333333333333	2	12
ZFAND2B	0	3	1	8	135.63	271.26	15	1	1	-Inf	1	-0.111111111111111	9	3
ZFAND3	1	5	0	2	213.51	427.02	15	1	1	1	1	0.166666666666667	2	6
ZFAND4	18	20	1	5	660.33	1320.66	15	1	0.213116718788868	0.777777777777778	1	0.307017543859649	6	38
ZFAND5	0	4	0	0	113.85	227.7	15	1	1	NA	1	NA	0	4
ZFAND6	0	5	0	0	206.91	413.82	15	1	1	NA	1	NA	0	5
ZFAT	15	53	5	9	1227.27	2454.54	15	1	0.312863394500344	-0.962962962962963	1	-0.13655462184874	14	68
ZFC3H1	15	54	8	5	1761.87	3523.74	15	1	0.00642494001682557	-4.76	0.467685236262114	-0.397993311036789	13	69
ZFHX3	8	62	2	11	2076.36	4152.72	15	1	0.652417615388329	-0.409090909090909	1	-0.0395604395604396	13	70
ZFHX4	25	52	5	3	2420.22	4840.44	15	1	0.123757912349687	-2.46666666666667	1	-0.300324675324675	8	77
ZFP2	8	22	4	5	467.28	934.56	15	1	0.416123903789938	-1.2	1	-0.177777777777778	9	30
ZFP36L1	0	1	0	2	281.82	563.64	15	1	1	NA	1	0	2	1
ZFP64	3	34	2	1	671.88	1343.76	15	1	0.0364372469635628	-21.6666666666667	0.788199921465956	-0.585585585585586	3	37
ZFP91	3	25	0	5	452.1	904.2	15	1	1	1	1	0.107142857142857	5	28
ZFP92	14	14	7	3	323.73	647.46	15	1	0.460440620618596	-1.33333333333333	1	-0.2	10	28
ZFPM1	9	17	6	10	384.78	769.56	15	1	1	-0.133333333333333	1	-0.0288461538461539	16	26
ZFPM2	15	24	3	1	1016.73	2033.46	15	1	0.292601896118629	-3.8	1	-0.365384615384615	4	39
ZFX	0	14	2	3	787.05	1574.1	15	1	0.0584795321637427	-Inf	0.861744483565755	-0.4	5	14
ZFYVE1	0	20	0	1	775.17	1550.34	15	1	1	NA	1	0	1	20
ZFYVE16	102	61	9	4	1613.04	3226.08	15	1	0.769991298708508	-0.345588235294118	1	-0.0665408211420481	13	163
ZFYVE19	14	23	5	2	415.8	831.6	15	1	0.210401056685799	-3.10714285714286	1	-0.335907335907336	7	37
ZFYVE21	1	4	1	0	233.64	467.28	15	1	0.333333333333333	-Inf	1	-0.8	1	5
ZFYVE26	62	96	17	11	2527.14	5054.28	15	1	0.0394980714818345	-1.39296187683284	0.794548741720226	-0.214737793851718	28	158
ZFYVE27	0	14	3	5	260.04	520.08	15	1	0.0363636363636363	-Inf	0.788199921465956	-0.375	8	14
ZFYVE28	14	34	3	1	963.27	1926.54	15	1	0.0967032967032967	-6.28571428571429	0.971055566729444	-0.458333333333333	4	48
ZFYVE9	22	34	3	5	1399.86	2799.72	15	1	1	0.0727272727272728	1	0.0178571428571428	8	56
ZGPAT	10	53	1	13	515.79	1031.58	15	1	0.67766228184219	0.592307692307692	1	0.0873015873015873	14	63
ZGRF1	131	124	25	16	2070.09	4140.18	15	1	0.312403340604545	-0.479007633587786	1	-0.0960306073648972	41	255
ZHX1	11	47	9	1	859.98	1719.96	15	1	2.83637777295073e-05	-37.4545454545455	0.0380389774661281	-0.710344827586207	10	58
ZHX2	7	27	3	8	824.67	1649.34	15	1	0.686980377489975	-0.446428571428571	1	-0.0668449197860962	11	34
ZHX3	15	43	3	10	919.71	1839.42	15	1	1	0.14	1	0.0278514588859416	13	58
ZIC1	1	5	0	0	402.6	805.2	15	1	1	NA	1	NA	0	6
ZIC3	0	8	0	2	334.95	669.9	15	1	1	NA	1	0	2	8
ZMAT2	0	11	1	3	192.06	384.12	15	1	0.266666666666667	-Inf	1	-0.25	4	11
ZMAT3	2	5	1	4	287.1	574.2	15	1	1	0.375	1	0.0857142857142857	5	7
ZMAT4	2	15	1	0	249.48	498.96	15	1	0.166666666666667	-Inf	1	-0.882352941176471	1	17
ZMAT5	6	13	4	3	178.2	356.4	15	1	0.369169960474308	-1.88888888888889	1	-0.255639097744361	7	19
ZMIZ1	2	20	1	5	838.53	1677.06	15	1	0.52991452991453	-1	1	-0.0757575757575757	6	22
ZMPSTE24	2	17	0	1	460.35	920.7	15	1	1	1	1	0.105263157894737	1	19
ZMYM2	3	20	2	6	580.14	1160.28	15	1	0.58307584558975	-1.22222222222222	1	-0.119565217391304	8	23
ZMYM3	4	35	3	11	1420.65	2841.3	15	1	0.363768980093041	-1.38636363636364	1	-0.111721611721612	14	39
ZMYM4	13	40	1	10	1522.62	3045.24	15	1	0.430580019884758	0.692307692307692	1	0.154373927958834	11	53
ZMYND10	9	20	7	6	407.22	814.44	15	1	0.186756897422057	-1.59259259259259	1	-0.228116710875332	13	29
ZMYND12	3	12	1	0	228.69	457.38	15	1	0.25	-Inf	1	-0.8	1	15
ZMYND19	0	8	0	0	189.09	378.18	15	1	1	NA	1	NA	0	8
ZNF106	48	62	5	7	1789.92	3579.84	15	1	1	0.0773809523809523	1	0.0196969696969697	12	110
ZNF142	62	64	34	34	1851.63	3703.26	15	1	1	-0.032258064516129	1	-0.00793650793650796	68	126
ZNF143	0	29	0	5	631.62	1263.24	15	1	1	NA	1	0	5	29
ZNF148	1	15	1	1	785.07	1570.14	15	1	0.215686274509804	-14	1	-0.4375	2	16
ZNF185L	38	41	16	5	797.94	1595.88	15	1	0.0270683533920425	-2.45263157894737	0.761210061313465	-0.280892103676914	21	79
ZNF207	0	5	0	3	436.26	872.52	15	1	1	NA	1	0	3	5
ZNF217L	27	30	3	0	1068.21	2136.42	15	1	0.23728813559322	-Inf	1	-0.526315789473684	3	57
ZNF236	8	53	3	4	1864.83	3729.66	15	1	0.0779792061078348	-3.96875	0.927455919491027	-0.297423887587822	7	61
ZNF276	3	20	2	10	521.4	1042.8	15	1	1	-0.333333333333333	1	-0.036231884057971	12	23
ZNF277	18	13	3	0	458.04	916.08	15	1	0.270053475935829	-Inf	1	-0.419354838709677	3	31
ZNF280D	20	20	3	4	683.1	1366.2	15	1	1	0.25	1	0.0714285714285715	7	40
ZNF292	66	139	13	21	2652.21	5304.42	15	1	0.555628291086716	-0.303751803751804	1	-0.0604017216642754	34	205
ZNF318	69	72	19	20	2115.96	4231.92	15	1	1	0.00869565217391299	1	0.00218221494817239	39	141
ZNF319	1	20	0	3	550.44	1100.88	15	1	1	1	1	0.0476190476190476	3	21
ZNF326	0	9	0	1	556.05	1112.1	15	1	1	NA	1	0	1	9
ZNF330	2	11	1	3	318.78	637.56	15	1	1	-0.833333333333333	1	-0.0961538461538461	4	13
ZNF335	10	54	6	13	1321.65	2643.3	15	1	0.182115029535294	-1.49230769230769	1	-0.159539473684211	19	64
ZNF341	3	31	5	9	802.56	1605.12	15	1	0.0365294255958716	-4.74074074074074	0.788199921465956	-0.26890756302521	14	34
ZNF346	9	13	2	1	243.21	486.42	15	1	0.564782608695652	-1.88888888888889	1	-0.257575757575758	3	22
ZNF362	0	7	0	3	267.96	535.92	15	1	1	NA	1	0	3	7
ZNF365	16	9	5	4	343.86	687.72	15	1	0.704115684093437	0.296875	1	0.0844444444444444	9	25
ZNF366	9	17	6	1	725.67	1451.34	15	1	0.0300439040010786	-10.3333333333333	0.771992783106328	-0.510989010989011	7	26
ZNF367	1	7	0	1	164.01	328.02	15	1	1	1	1	0.125	1	8
ZNF384	1	16	0	1	500.28	1000.56	15	1	1	1	1	0.0588235294117647	1	17
ZNF385B	2	13	2	1	323.73	647.46	15	1	0.107843137254902	-12	0.983875031494079	-0.533333333333333	3	15
ZNF385C	8	11	9	10	398.64	797.28	15	1	1	-0.2375	1	-0.0526315789473684	19	19
ZNF385D	1	8	0	0	255.42	510.84	15	1	1	NA	1	NA	0	9
ZNF395	4	7	1	5	247.17	494.34	15	1	0.600032320620556	0.65	1	0.196969696969697	6	11
ZNF398L	11	19	18	13	612.81	1225.62	15	1	0.126076896502138	-1.39160839160839	1	-0.213978494623656	31	30
ZNF407	60	57	9	7	1698.84	3397.68	15	1	0.793308495790598	-0.221428571428572	1	-0.0496794871794872	16	117
ZNF408	43	21	13	6	621.39	1242.78	15	1	1	-0.058139534883721	1	-0.0123355263157895	19	64
ZNF410	0	11	0	0	440.55	881.1	15	1	1	NA	1	NA	0	11
ZNF423	9	57	3	17	1207.47	2414.94	15	1	1	-0.117647058823529	1	-0.0136363636363636	20	66
ZNF438	51	38	5	6	835.56	1671.12	15	1	0.528743258674656	0.379084967320261	1	0.118488253319714	11	89
ZNF451	21	33	4	5	1059.3	2118.6	15	1	1	-0.257142857142857	1	-0.0555555555555555	9	54
ZNF488	18	25	4	5	529.65	1059.3	15	1	1	-0.111111111111111	1	-0.0258397932816537	9	43
ZNF503	2	21	0	7	480.15	960.3	15	1	1	1	1	0.0869565217391304	7	23
ZNF507	25	22	1	0	971.19	1942.38	15	1	1	-Inf	1	-0.468085106382979	1	47
ZNF511	6	6	1	0	216.81	433.62	15	1	1	-Inf	1	-0.5	1	12
ZNF512	5	16	1	2	557.7	1115.4	15	1	1	-0.6	1	-0.0952380952380952	3	21
ZNF512B	4	18	3	12	756.03	1512.06	15	1	1	-0.125	1	-0.0181818181818182	15	22
ZNF516	20	60	11	9	1196.91	2393.82	15	1	0.0145265002140991	-2.66666666666667	0.635271223131072	-0.3	20	80
ZNF518A	46	53	6	3	1531.53	3063.06	15	1	0.308112954476647	-1.30434782608696	1	-0.202020202020202	9	99
ZNF518B	40	44	6	0	1072.17	2144.34	15	1	0.0263820832478671	-Inf	0.761210061313465	-0.523809523809524	6	84
ZNF521	3	41	1	3	1251.36	2502.72	15	1	0.302338369822181	-3.55555555555556	1	-0.181818181818182	4	44
ZNF532	14	26	1	1	813.78	1627.56	15	1	1	-0.857142857142857	1	-0.15	2	40
ZNF536	9	16	1	4	599.94	1199.88	15	1	0.640015157256537	0.555555555555556	1	0.16	5	25
ZNF541	1	2	0	1	38.61	77.22	15	1	1	1	1	0.333333333333333	1	3
ZNF592	22	65	5	12	1380.39	2760.78	15	1	0.765258810323319	-0.231060606060606	1	-0.0412440838404327	17	87
ZNF593	0	2	0	1	46.86	93.72	15	1	1	NA	1	0	1	2
ZNF598	8	35	3	12	804.87	1609.74	15	1	1	-0.09375	1	-0.013953488372093	15	43
ZNF608	19	26	2	1	1481.04	2962.08	15	1	0.573832099907493	-1.73684210526316	1	-0.244444444444444	3	45
ZNF609	16	57	7	22	1442.43	2884.86	15	1	0.798023730423959	-0.133522727272727	1	-0.0222012281530468	29	73
ZNF622	12	24	0	6	465.3	930.6	15	1	0.158943578712513	1	1	0.333333333333333	6	36
ZNF628	8	31	8	2	702.24	1404.48	15	1	0.000873818821049313	-14.5	0.24410961674588	-0.594871794871795	10	39
ZNF638	106	136	19	26	2045.67	4091.34	15	1	0.871472074376558	0.0624092888243831	1	0.0157943067033976	45	242
ZNF639	2	20	0	2	484.11	968.22	15	1	1	1	1	0.0909090909090909	2	22
ZNF644	17	28	0	1	1144.44	2288.88	15	1	1	1	1	0.377777777777778	1	45
ZNF648	8	23	2	2	384.12	768.24	15	1	0.560733384262796	-1.875	1	-0.241935483870968	4	31
ZNF652	1	17	1	0	600.93	1201.86	15	1	0.105263157894737	-Inf	0.983379501385042	-0.944444444444444	1	18
ZNF654	12	27	1	7	1042.47	2084.94	15	1	0.413326980805466	0.678571428571429	1	0.182692307692308	8	39
ZNF687	7	62	6	1	1247.73	2495.46	15	1	5.02353547226968e-05	-52.1428571428571	0.04042271543353	-0.755693581780538	7	69
ZNF706	0	2	0	0	76.23	152.46	15	1	1	NA	1	NA	0	2
ZNF710	9	16	4	20	631.29	1262.58	15	1	0.196326205504226	0.644444444444444	1	0.193333333333333	24	25
ZNF746	36	20	8	14	458.7	917.4	15	1	0.041245709259248	0.682539682539683	0.798931947804628	0.279220779220779	22	56
ZNF750	7	38	4	13	705.87	1411.74	15	1	0.474504370352497	-0.67032967032967	1	-0.0797385620915033	17	45
ZNF76	15	22	8	8	572.88	1145.76	15	1	0.559404583728217	-0.466666666666667	1	-0.0945945945945946	16	37
ZNF767	52	53	11	16	791.67	1583.34	15	1	0.518128330967966	0.299278846153846	1	0.0878306878306879	27	105
ZNF800	2	15	2	1	674.19	1348.38	15	1	0.087719298245614	-14	0.951277979139867	-0.549019607843137	3	17
ZNF804A	46	54	7	4	1162.59	2325.18	15	1	0.34622941270685	-1.05434782608696	1	-0.176363636363636	11	100
ZNF821	5	15	1	3	394.68	789.36	15	1	1	0	1	0	4	20
ZNF827	18	49	6	9	1403.82	2807.64	15	1	0.353658384894489	-0.814814814814815	1	-0.13134328358209	15	67
ZNF830	6	10	6	2	311.85	623.7	15	1	0.193027325346615	-4	1	-0.375	8	16
ZNF831	64	53	6	4	1832.49	3664.98	15	1	1	-0.2421875	1	-0.0529914529914529	10	117
ZNF839	44	34	2	5	895.62	1791.24	15	1	0.239108026339842	0.690909090909091	1	0.278388278388278	7	78
ZNF853	3	10	1	1	198	396	15	1	0.476190476190476	-2.33333333333333	1	-0.269230769230769	2	13
ZNF862L	3	29	7	14	671.55	1343.1	15	1	0.0385633475726609	-3.83333333333333	0.789311843512415	-0.239583333333333	21	32
ZNF91L	20	36	4	2	619.74	1239.48	15	1	0.194885737942903	-2.6	1	-0.309523809523809	6	56
ZNHIT3	2	3	1	1	74.25	148.5	15	1	1	-0.5	1	-0.1	2	5
ZNHIT6	8	13	1	0	287.1	574.2	15	1	0.409090909090909	-Inf	1	-0.619047619047619	1	21
ZNRF3	10	14	5	3	812.13	1624.26	15	1	0.423458163391422	-1.33333333333333	1	-0.208333333333333	8	24
ZNRF4	12	15	2	4	335.61	671.22	15	1	1	0.375	1	0.111111111111111	6	27
ZONADHL	115	124	35	33	3208.26	6416.52	15	1	0.680764779180855	-0.14361001317523	1	-0.0335343342357863	68	239
ZP1	6	4	3	1	213.51	427.02	15	1	1	-1	1	-0.15	4	10
ZP2	25	37	3	1	703.89	1407.78	15	1	0.303554778554778	-3.44	1	-0.346774193548387	4	62
ZP3	5	9	1	9	331.32	662.64	15	1	0.340805075930934	0.8	1	0.257142857142857	10	14
ZP3L1	13	26	15	14	406.23	812.46	15	1	0.143618756935665	-1.14285714285714	1	-0.183908045977012	29	39
ZP3L2	14	34	12	9	408.87	817.74	15	1	0.0340468834971476	-2.23809523809524	0.787252650978106	-0.279761904761905	21	48
ZP4	19	27	7	1	565.95	1131.9	15	1	0.0221908112903933	-8.94736842105263	0.721018759249189	-0.46195652173913	8	46
ZPAX	43	41	2	1	829.29	1658.58	15	1	1	-0.906976744186047	1	-0.154761904761905	3	84
ZPBP2	20	19	5	2	377.19	754.38	15	1	0.428487942384709	-1.375	1	-0.201465201465202	7	39
ZPLD1	3	16	1	4	411.84	823.68	15	1	1	-0.333333333333333	1	-0.0421052631578948	5	19
ZPR1	8	19	5	8	330.99	661.98	15	1	0.721514351689628	-0.484375	1	-0.0883190883190884	13	27
ZRANB1	0	34	0	10	703.56	1407.12	15	1	1	NA	1	0	10	34
ZRANB2	1	6	0	1	304.26	608.52	15	1	1	1	1	0.142857142857143	1	7
ZRANB3	27	38	2	3	1118.7	2237.4	15	1	1	0.0617283950617284	1	0.0153846153846154	5	65
ZRSR2	0	14	1	4	458.7	917.4	15	1	0.263157894736842	-Inf	1	-0.2	5	14
ZSWIM5	1	54	2	10	978.78	1957.56	15	1	0.0803673938002296	-9.8	0.937475435512484	-0.148484848484848	12	55
ZSWIM7	2	5	2	4	179.85	359.7	15	1	1	-0.25	1	-0.0476190476190476	6	7
ZSWIM8	6	73	4	14	1794.87	3589.74	15	1	0.0854146680021042	-2.47619047619048	0.950356516076024	-0.146272855133615	18	79
ZUFSP	12	18	2	2	387.75	775.5	15	1	1	-0.5	1	-0.1	4	30
ZW10	8	34	0	9	722.37	1444.74	15	1	0.322113228774817	1	1	0.19047619047619	9	42
ZWILCH	11	13	2	3	572.22	1144.44	15	1	1	0.212121212121212	1	0.0583333333333333	5	24
ZXDC	5	14	0	3	567.27	1134.54	15	1	1	1	1	0.263157894736842	3	19
ZYG11B	1	24	1	6	673.2	1346.4	15	1	0.39516129032258	-3	1	-0.102857142857143	7	25
ZYX	12	24	5	3	546.15	1092.3	15	1	0.227440441877556	-2.33333333333333	1	-0.291666666666667	8	36
ZZZ3	7	20	2	1	896.94	1793.88	15	1	0.206896551724138	-4.71428571428571	1	-0.407407407407407	3	27
AK1	0	0	1	4	96.69	193.38	15	1	1	NA	1	NA	5	0
DBNDD1	0	0	2	0	60.39	120.78	15	1	1	NA	1	NA	2	0
EDQM1	0	0	2	1	129.69	259.38	15	1	1	NA	1	NA	3	0
F13B	0	0	4	0	51.48	102.96	15	1	1	NA	1	NA	4	0
GADD45B	0	0	0	2	51.81	103.62	15	1	1	NA	1	NA	2	0
HIST2H4B	0	0	0	4	47.85	95.7	15	1	1	NA	1	NA	4	0
MIDN	0	0	1	1	85.8	171.6	15	1	1	NA	1	NA	2	0
RPP40	0	0	3	0	1060.29	2120.58	15	1	1	NA	1	NA	3	0
TCEA3	0	0	0	2	22.77	45.54	15	1	1	NA	1	NA	2	0
TGFA	0	0	1	1	56.76	113.52	15	1	1	NA	1	NA	2	0
TMEM119	0	0	1	1	30.03	60.06	15	1	1	NA	1	NA	2	0
TWIST2	0	0	0	2	159.39	318.78	15	1	1	NA	1	NA	2	0
UBA52	0	0	0	4	13.53	27.06	15	1	1	NA	1	NA	4	0
UBE2D2	0	0	0	2	138.6	277.2	15	1	1	NA	1	NA	2	0
