gene	FR	FS	PR	PS	Tsil	Trepl	npop	nout	mk_pval	alpha	mk_pval_fdr	dos	total_poly	total_div
2KTGRL-LOC420808	5	3	1	1	92.73	185.46	15	1	1	0.4	1	0.125	2	8
44G24.1	1	2	0	0	11.22	22.44	15	1	1	NA	1	NA	0	3
A1CF	1	14	0	0	175.23	350.46	15	1	1	NA	1	NA	0	15
A2M	26	21	3	3	386.43	772.86	15	1	1	0.192307692307692	1	0.0531914893617021	6	47
A2ML1	22	15	3	6	418.44	836.88	15	1	0.263929490815481	0.659090909090909	1	0.261261261261261	9	37
A2ML2	12	11	2	0	443.52	887.04	15	1	0.486666666666667	-Inf	1	-0.478260869565217	2	23
A2ML4	13	37	0	1	269.28	538.56	15	1	1	1	1	0.26	1	50
A4GALT	2	8	0	0	101.97	203.94	15	1	1	NA	1	NA	0	10
A4GNT	5	7	0	3	99.33	198.66	15	1	0.505494505494505	1	1	0.416666666666667	3	12
AACS	0	11	0	2	176.55	353.1	15	1	1	NA	1	0	2	11
AADAC	13	18	4	6	118.8	237.6	15	1	1	0.0769230769230769	1	0.0193548387096774	10	31
AADACL4L1	6	2	3	0	82.17	164.34	15	1	1	-Inf	1	-0.25	3	8
AADACL4L2	5	6	3	1	117.15	234.3	15	1	0.569230769230769	-2.6	1	-0.295454545454545	4	11
AADACL4L3	6	3	3	0	119.13	238.26	15	1	0.509090909090909	-Inf	1	-0.333333333333333	3	9
AADACL4L5	4	7	1	2	125.73	251.46	15	1	1	0.125	1	0.0303030303030303	3	11
AADAT	1	5	0	0	131.67	263.34	15	1	1	NA	1	NA	0	6
AAED1	0	2	0	0	48.84	97.68	15	1	1	NA	1	NA	0	2
AAGAB	2	7	1	2	85.8	171.6	15	1	1	-0.75	1	-0.111111111111111	3	9
AAK1	8	12	2	0	448.14	896.28	15	1	0.194805194805195	-Inf	1	-0.6	2	20
AAMDC	1	1	0	1	45.87	91.74	15	1	1	1	1	0.5	1	2
AAMP	2	3	2	1	53.13	106.26	15	1	1	-2	1	-0.266666666666667	3	5
AANAT	1	1	1	1	26.4	52.8	15	1	1	0	1	0	2	2
AAR2	4	8	0	0	102.96	205.92	15	1	1	NA	1	NA	0	12
AAREL	5	5	1	0	24.75	49.5	15	1	1	-Inf	1	-0.5	1	10
AARS	5	18	4	6	331.65	663.3	15	1	0.399858817489518	-1.4	1	-0.182608695652174	10	23
AARS2	4	15	1	3	216.15	432.3	15	1	1	-0.25	1	-0.0394736842105263	4	19
AARSD1	8	5	4	2	132	264	15	1	1	-0.25	1	-0.0512820512820512	6	13
AASDHPPT	1	7	0	0	78.54	157.08	15	1	1	NA	1	NA	0	8
AASS	2	10	1	1	297.99	595.98	15	1	0.395604395604396	-4	1	-0.333333333333333	2	12
AATF	5	8	2	1	155.1	310.2	15	1	0.55	-2.2	1	-0.282051282051282	3	13
AATK	5	7	2	4	132.99	265.98	15	1	1	0.3	1	0.0833333333333334	6	12
ABAT	0	6	0	1	180.18	360.36	15	1	1	NA	1	0	1	6
ABCA1	2	13	1	1	572.55	1145.1	15	1	0.330882352941177	-5.5	1	-0.366666666666667	2	15
ABCA12	38	51	12	4	1285.02	2570.04	15	1	0.0276711377815047	-3.02631578947368	1	-0.323033707865169	16	89
ABCA13	74	34	11	3	1038.51	2077.02	15	1	0.54844505438672	-0.684684684684685	1	-0.1005291005291	14	108
ABCA2	10	30	1	0	682.77	1365.54	15	1	0.268292682926829	-Inf	1	-0.75	1	40
ABCA3	5	20	1	11	391.38	782.76	15	1	0.640869861458097	0.636363636363636	1	0.116666666666667	12	25
ABCA4	19	43	10	12	831.93	1663.86	15	1	0.296405619035837	-0.885964912280702	1	-0.148093841642229	22	62
ABCA5	5	42	3	13	584.43	1168.86	15	1	0.407478662981061	-0.938461538461538	1	-0.0811170212765957	16	47
ABCA7	5	11	4	6	101.97	203.94	15	1	0.692448512585812	-0.466666666666667	1	-0.0875	10	16
ABCA8	11	31	7	5	478.17	956.34	15	1	0.0787652110745682	-2.94545454545455	1	-0.321428571428571	12	42
ABCA9	19	21	4	4	423.39	846.78	15	1	1	-0.105263157894737	1	-0.025	8	40
ABCB1	16	17	1	4	401.28	802.56	15	1	0.355144618302513	0.734375	1	0.284848484848485	5	33
ABCB10	2	8	0	1	123.42	246.84	15	1	1	1	1	0.2	1	10
ABCB11	6	20	2	2	427.68	855.36	15	1	0.283524904214559	-2.33333333333333	1	-0.269230769230769	4	26
ABCB1LA	12	21	2	2	477.84	955.68	15	1	0.62458929517753	-0.75	1	-0.136363636363636	4	33
ABCB5	10	15	2	0	441.54	883.08	15	1	0.188034188034188	-Inf	1	-0.6	2	25
ABCB6	1	3	0	2	67.32	134.64	15	1	1	1	1	0.25	2	4
ABCB9	1	17	0	4	199.32	398.64	15	1	1	1	1	0.0555555555555556	4	18
ABCC1	6	19	3	0	512.16	1024.32	15	1	0.0256410256410257	-Inf	1	-0.76	3	25
ABCC10	27	23	6	4	465.3	930.6	15	1	1	-0.277777777777778	1	-0.0599999999999999	10	50
ABCC13	10	16	0	1	366.3	732.6	15	1	1	1	1	0.384615384615385	1	26
ABCC2	3	15	1	2	180.84	361.68	15	1	0.488721804511278	-1.5	1	-0.166666666666667	3	18
ABCC3	2	22	1	2	450.12	900.24	15	1	0.308034188034188	-4.5	1	-0.25	3	24
ABCC5	1	10	1	0	482.79	965.58	15	1	0.166666666666667	-Inf	1	-0.909090909090909	1	11
ABCC6	18	31	4	1	436.59	873.18	15	1	0.146020091636074	-5.88888888888889	1	-0.43265306122449	5	49
ABCC8	4	25	2	1	528.99	1057.98	15	1	0.0826612903225806	-11.5	1	-0.528735632183908	3	29
ABCC9	3	17	0	1	482.46	964.92	15	1	1	1	1	0.15	1	20
ABCD2	1	9	0	4	190.74	381.48	15	1	1	1	1	0.1	4	10
ABCD3	0	7	0	1	194.04	388.08	15	1	1	NA	1	0	1	7
ABCD4	1	8	0	0	156.42	312.84	15	1	1	NA	1	NA	0	9
ABCE1	0	5	0	1	182.16	364.32	15	1	1	NA	1	0	1	5
ABCF2	0	7	0	3	181.17	362.34	15	1	1	NA	1	0	3	7
ABCF3	2	14	1	3	132	264	15	1	0.508771929824561	-1.33333333333333	1	-0.125	4	16
ABCG1	0	10	0	0	263.01	526.02	15	1	1	NA	1	NA	0	10
ABCG2	2	4	1	1	207.57	415.14	15	1	1	-1	1	-0.166666666666667	2	6
ABCG4	1	1	1	0	48.84	97.68	15	1	1	-Inf	1	-0.5	1	2
ABHD10	3	5	1	0	105.27	210.54	15	1	0.444444444444444	-Inf	1	-0.625	1	8
ABHD11	1	3	0	0	39.93	79.86	15	1	1	NA	1	NA	0	4
ABHD12	0	8	0	2	112.53	225.06	15	1	1	NA	1	0	2	8
ABHD13	0	2	0	0	124.41	248.82	15	1	1	NA	1	NA	0	2
ABHD14A	2	3	0	1	20.13	40.26	15	1	1	1	1	0.4	1	5
ABHD17A	0	4	0	0	45.54	91.08	15	1	1	NA	1	NA	0	4
ABHD17B	0	3	0	0	84.81	169.62	15	1	1	NA	1	NA	0	3
ABHD17C	0	3	0	1	54.12	108.24	15	1	1	NA	1	0	1	3
ABHD18	1	0	1	0	104.28	208.56	15	1	1	NA	1	0	1	1
ABHD2	0	7	0	1	153.45	306.9	15	1	1	NA	1	0	1	7
ABHD5	0	11	0	0	114.51	229.02	15	1	1	NA	1	NA	0	11
ABHD6	0	5	0	3	95.04	190.08	15	1	1	NA	1	0	3	5
ABHD8	0	3	0	2	78.21	156.42	15	1	1	NA	1	0	2	3
ABI2	1	6	1	0	169.62	339.24	15	1	0.25	-Inf	1	-0.857142857142857	1	7
ABI3	2	0	0	0	62.7	125.4	15	1	1	NA	1	NA	0	2
ABI3BP	11	15	1	1	370.26	740.52	15	1	1	-0.363636363636364	1	-0.0769230769230769	2	26
ABL2	1	9	1	2	326.7	653.4	15	1	0.423076923076923	-3.5	1	-0.233333333333333	3	10
ABLIM1	1	9	0	1	227.04	454.08	15	1	1	1	1	0.1	1	10
ABLIM2	0	5	0	0	60.39	120.78	15	1	1	NA	1	NA	0	5
ABLIM3	1	11	0	0	99.66	199.32	15	1	1	NA	1	NA	0	12
ABR	0	10	0	6	122.43	244.86	15	1	1	NA	1	0	6	10
ABRA	7	11	1	2	137.61	275.22	15	1	1	0.214285714285714	1	0.0555555555555556	3	18
ABRACL	0	1	0	1	29.04	58.08	15	1	1	NA	1	0	1	1
ABTB1	0	7	0	3	140.25	280.5	15	1	1	NA	1	0	3	7
ACAA1	2	7	0	1	107.25	214.5	15	1	1	1	1	0.222222222222222	1	9
ACAA2	1	18	0	4	99	198	15	1	1	1	1	0.0526315789473684	4	19
ACACA	0	36	0	7	746.79	1493.58	15	1	1	NA	1	0	7	36
ACACB	6	34	1	8	533.94	1067.88	15	1	1	0.291666666666667	1	0.0388888888888889	9	40
ACAD11	4	7	1	1	126.06	252.12	15	1	1	-0.75	1	-0.136363636363636	2	11
ACAD6L	3	7	1	1	126.39	252.78	15	1	1	-1.33333333333333	1	-0.2	2	10
ACAD8	1	8	0	1	108.57	217.14	15	1	1	1	1	0.111111111111111	1	9
ACAD9	0	7	0	1	173.91	347.82	15	1	1	NA	1	0	1	7
ACADSB	0	3	0	0	94.05	188.1	15	1	1	NA	1	NA	0	3
ACAN	15	30	5	9	563.31	1126.62	15	1	1	-0.111111111111111	1	-0.0238095238095238	14	45
ACAP2	2	16	1	1	248.16	496.32	15	1	0.284210526315789	-7	1	-0.388888888888889	2	18
ACAP3	0	10	0	3	177.54	355.08	15	1	1	NA	1	0	3	10
ACAT1	4	11	1	1	125.73	251.46	15	1	0.514705882352941	-1.75	1	-0.233333333333333	2	15
ACAT2	0	2	0	0	92.73	185.46	15	1	1	NA	1	NA	0	2
ACBD4	3	0	1	0	25.74	51.48	15	1	1	NA	1	0	1	3
ACBD5	7	5	3	2	139.92	279.84	15	1	1	-0.0714285714285714	1	-0.0166666666666666	5	12
ACCS	2	10	0	1	192.06	384.12	15	1	1	1	1	0.166666666666667	1	12
ACCSL	27	6	3	2	170.61	341.22	15	1	0.279307170948038	0.666666666666667	1	0.218181818181818	5	33
ACD	17	5	2	1	160.71	321.42	15	1	1	0.411764705882353	1	0.106060606060606	3	22
ACE	10	21	4	4	347.49	694.98	15	1	0.423711637333928	-1.1	1	-0.17741935483871	8	31
ACE2	14	8	1	1	269.28	538.56	15	1	1	0.428571428571429	1	0.136363636363636	2	22
ACER3	1	3	0	0	81.18	162.36	15	1	1	NA	1	NA	0	4
ACKR1	0	2	0	0	16.83	33.66	15	1	1	NA	1	NA	0	2
ACKR3	1	10	0	1	122.76	245.52	15	1	1	1	1	0.0909090909090909	1	11
ACKR4	1	8	1	1	106.92	213.84	15	1	0.345454545454545	-7	1	-0.388888888888889	2	9
ACLY	0	14	0	5	292.05	584.1	15	1	1	NA	1	0	5	14
ACMSD	0	2	0	1	89.43	178.86	15	1	1	NA	1	0	1	2
ACO1	1	10	0	3	244.86	489.72	15	1	1	1	1	0.0909090909090909	3	11
ACO2	0	19	0	5	258.72	517.44	15	1	1	NA	1	0	5	19
ACOD1	2	5	1	1	157.74	315.48	15	1	1	-1.5	1	-0.214285714285714	2	7
ACOT11	0	3	0	2	44.55	89.1	15	1	1	NA	1	0	2	3
ACOT12	3	6	1	0	116.49	232.98	15	1	0.4	-Inf	1	-0.666666666666667	1	9
ACOT13	1	1	0	1	33.33	66.66	15	1	1	1	1	0.5	1	2
ACOT2L	0	5	0	1	85.8	171.6	15	1	1	NA	1	0	1	5
ACOT4	7	10	3	3	211.53	423.06	15	1	1	-0.428571428571429	1	-0.0882352941176471	6	17
ACOT7	0	4	0	0	47.52	95.04	15	1	1	NA	1	NA	0	4
ACOT8	1	0	2	0	30.36	60.72	15	1	1	NA	1	0	2	1
ACOT9	2	9	0	0	147.51	295.02	15	1	1	NA	1	NA	0	11
ACOX1	12	19	4	4	420.42	840.84	15	1	0.693720870191458	-0.583333333333333	1	-0.112903225806452	8	31
ACOX2	9	4	0	0	246.51	493.02	15	1	1	NA	1	NA	0	13
ACOX3	6	9	0	3	213.84	427.68	15	1	0.514705882352941	1	1	0.4	3	15
ACP6	1	3	0	1	105.27	210.54	15	1	1	1	1	0.25	1	4
ACPP	6	2	0	0	115.5	231	15	1	1	NA	1	NA	0	8
ACR-ACRL	12	8	1	2	194.7	389.4	15	1	0.55957086391869	0.666666666666667	1	0.266666666666667	3	20
ACRBP	5	7	0	1	90.09	180.18	15	1	1	1	1	0.416666666666667	1	12
ACSBG1	3	10	1	0	223.08	446.16	15	1	0.285714285714286	-Inf	1	-0.769230769230769	1	13
ACSF2	7	9	2	3	110.88	221.76	15	1	1	0.142857142857143	1	0.0375	5	16
ACSF3	10	13	4	4	149.82	299.64	15	1	1	-0.3	1	-0.0652173913043478	8	23
ACSL3	5	10	1	2	202.95	405.9	15	1	1	0	1	0	3	15
ACSL4	1	7	0	0	180.18	360.36	15	1	1	NA	1	NA	0	8
ACSL5	5	7	0	2	225.39	450.78	15	1	0.505494505494505	1	1	0.416666666666667	2	12
ACSL6	0	10	0	1	163.35	326.7	15	1	1	NA	1	0	1	10
ACSM3	6	11	0	1	189.42	378.84	15	1	1	1	1	0.352941176470588	1	17
ACSS1	1	9	0	3	200.97	401.94	15	1	1	1	1	0.1	3	10
ACSS3	20	4	0	1	155.76	311.52	15	1	0.2	1	1	0.833333333333333	1	24
ACT85CL	3	5	0	0	90.75	181.5	15	1	1	NA	1	NA	0	8
ACTA2	0	2	0	0	93.72	187.44	15	1	1	NA	1	NA	0	2
ACTB	0	2	0	0	87.12	174.24	15	1	1	NA	1	NA	0	2
ACTBL2L	0	3	0	1	134.97	269.94	15	1	1	NA	1	0	1	3
ACTC1	0	4	0	0	118.8	237.6	15	1	1	NA	1	NA	0	4
ACTC2L	0	11	0	4	83.82	167.64	15	1	1	NA	1	0	4	11
ACTG1	0	2	0	1	56.1	112.2	15	1	1	NA	1	0	1	2
ACTG2	0	3	0	0	56.1	112.2	15	1	1	NA	1	NA	0	3
ACTL6A	1	6	0	0	114.84	229.68	15	1	1	NA	1	NA	0	7
ACTN1	0	7	0	1	263.67	527.34	15	1	1	NA	1	0	1	7
ACTN2	1	5	1	0	288.09	576.18	15	1	0.285714285714286	-Inf	1	-0.833333333333333	1	6
ACTR10-ACTR10L	1	7	0	3	126.72	253.44	15	1	1	1	1	0.125	3	8
ACTR1A	1	8	1	3	125.4	250.8	15	1	1	-1.66666666666667	1	-0.138888888888889	4	9
ACTR2	0	2	0	1	116.82	233.64	15	1	1	NA	1	0	1	2
ACTR3	0	2	0	0	120.45	240.9	15	1	1	NA	1	NA	0	2
ACTR3B	0	2	0	0	72.27	144.54	15	1	1	NA	1	NA	0	2
ACTR5	0	10	0	3	128.7	257.4	15	1	1	NA	1	0	3	10
ACTR8	0	4	0	0	141.9	283.8	15	1	1	NA	1	NA	0	4
ACTRT2	10	8	1	1	126.72	253.44	15	1	1	0.2	1	0.0555555555555556	2	18
ACVR1	0	3	0	0	161.04	322.08	15	1	1	NA	1	NA	0	3
ACVR1B	0	11	0	2	141.24	282.48	15	1	1	NA	1	0	2	11
ACVR1C	2	10	1	4	131.01	262.02	15	1	1	-0.25	1	-0.0333333333333334	5	12
ACVR2A	1	12	1	2	175.23	350.46	15	1	0.35	-5	1	-0.256410256410256	3	13
ACVRL1	0	3	0	1	43.23	86.46	15	1	1	NA	1	0	1	3
ACY1	0	2	0	1	45.21	90.42	15	1	1	NA	1	0	1	2
ADA	3	4	1	2	84.15	168.3	15	1	1	0.333333333333333	1	0.0952380952380952	3	7
ADAD1	7	13	2	1	212.85	425.7	15	1	0.537549407114625	-2.71428571428571	1	-0.316666666666667	3	20
ADAL	2	3	0	1	91.41	182.82	15	1	1	1	1	0.4	1	5
ADAM10	0	6	0	1	218.13	436.26	15	1	1	NA	1	0	1	6
ADAM12	3	10	1	4	258.06	516.12	15	1	1	0.166666666666667	1	0.0307692307692308	5	13
ADAM15	9	13	7	5	196.02	392.04	15	1	0.475397784978478	-1.02222222222222	1	-0.174242424242424	12	22
ADAM17	3	14	0	4	262.02	524.04	15	1	1	1	1	0.176470588235294	4	17
ADAM19	7	9	3	0	198.66	397.32	15	1	0.210526315789474	-Inf	1	-0.5625	3	16
ADAM20	25	23	3	9	290.73	581.46	15	1	0.115479211394049	0.693333333333333	1	0.270833333333333	12	48
ADAM22	1	10	0	2	287.76	575.52	15	1	1	1	1	0.0909090909090909	2	11
ADAM23	3	6	0	0	272.58	545.16	15	1	1	NA	1	NA	0	9
ADAM28	10	13	1	0	225.39	450.78	15	1	0.458333333333333	-Inf	1	-0.565217391304348	1	23
ADAM33	4	17	1	8	170.94	341.88	15	1	1	0.46875	1	0.0793650793650794	9	21
ADAM5P	5	12	1	3	197.01	394.02	15	1	1	0.2	1	0.0441176470588235	4	17
ADAM8	25	10	0	0	184.14	368.28	15	1	1	NA	1	NA	0	35
ADAM9	10	12	4	0	287.1	574.2	15	1	0.100066889632107	-Inf	1	-0.545454545454545	4	22
ADAM9L-LOC100857794	6	3	0	0	84.15	168.3	15	1	1	NA	1	NA	0	9
ADAMTS1	1	27	0	2	203.94	407.88	15	1	1	1	1	0.0357142857142857	2	28
ADAMTS12	9	17	0	0	394.02	788.04	15	1	1	NA	1	NA	0	26
ADAMTS13	23	18	7	0	472.23	944.46	15	1	0.0356454852507173	-Inf	1	-0.439024390243902	7	41
ADAMTS15	0	14	0	6	119.46	238.92	15	1	1	NA	1	0	6	14
ADAMTS17	1	8	1	0	355.41	710.82	15	1	0.2	-Inf	1	-0.888888888888889	1	9
ADAMTS18	3	11	0	0	380.16	760.32	15	1	1	NA	1	NA	0	14
ADAMTS19	5	5	1	0	194.7	389.4	15	1	1	-Inf	1	-0.5	1	10
ADAMTS20	17	22	2	1	503.58	1007.16	15	1	0.581271777003484	-1.58823529411765	1	-0.230769230769231	3	39
ADAMTS5	1	9	0	0	224.73	449.46	15	1	1	NA	1	NA	0	10
ADAMTS6	5	8	1	0	355.74	711.48	15	1	0.428571428571428	-Inf	1	-0.615384615384615	1	13
ADAMTS7	11	30	2	7	416.13	832.26	15	1	1	0.220779220779221	1	0.0460704607046071	9	41
ADAMTS8	1	12	1	6	133.32	266.64	15	1	1	-1	1	-0.0659340659340659	7	13
ADAMTS9	4	21	1	8	516.78	1033.56	15	1	1	0.34375	1	0.0488888888888889	9	25
ADAMTSL2	4	13	1	6	162.36	324.72	15	1	1	0.458333333333333	1	0.092436974789916	7	17
ADAMTSL2L	9	8	2	1	305.25	610.5	15	1	1	-0.777777777777778	1	-0.137254901960784	3	17
ADAMTSL3	8	14	2	1	584.43	1168.86	15	1	0.543478260869565	-2.5	1	-0.303030303030303	3	22
ADAMTSL5	1	5	1	2	36.63	73.26	15	1	1	-1.5	1	-0.166666666666667	3	6
ADAP1	0	2	0	0	96.03	192.06	15	1	1	NA	1	NA	0	2
ADAP2	3	2	1	0	100.65	201.3	15	1	1	-Inf	1	-0.4	1	5
ADAR	16	27	4	4	361.68	723.36	15	1	0.695807506418596	-0.6875	1	-0.127906976744186	8	43
ADARB1	2	5	2	0	193.05	386.1	15	1	0.166666666666667	-Inf	1	-0.714285714285714	2	7
ADARB2	3	4	1	2	185.79	371.58	15	1	1	0.333333333333333	1	0.0952380952380952	3	7
ADAT1	11	14	5	1	178.2	356.4	15	1	0.171919416635768	-5.36363636363636	1	-0.393333333333333	6	25
ADAT2	0	2	0	0	11.55	23.1	15	1	1	NA	1	NA	0	2
ADCK2	3	10	1	5	99.33	198.66	15	1	1	0.333333333333333	1	0.0641025641025641	6	13
ADCY1	2	12	0	1	208.56	417.12	15	1	1	1	1	0.142857142857143	1	14
ADCY2	5	7	1	1	341.55	683.1	15	1	1	-0.4	1	-0.0833333333333333	2	12
ADCY3	1	4	1	2	88.11	176.22	15	1	1	-1	1	-0.133333333333333	3	5
ADCY7	7	23	3	2	313.5	627	15	1	0.127843219399197	-3.92857142857143	1	-0.366666666666667	5	30
ADCY8	4	3	2	0	269.28	538.56	15	1	0.5	-Inf	1	-0.428571428571429	2	7
ADCYAP1R1	1	5	1	1	109.23	218.46	15	1	0.464285714285714	-4	1	-0.333333333333333	2	6
ADD1	0	2	0	0	182.49	364.98	15	1	1	NA	1	NA	0	2
ADD3	2	5	2	0	190.41	380.82	15	1	0.166666666666667	-Inf	1	-0.714285714285714	2	7
ADGB	22	19	5	1	485.76	971.52	15	1	0.220531958199493	-3.31818181818182	1	-0.296747967479675	6	41
ADGRA1L	0	6	0	2	276.54	553.08	15	1	1	NA	1	0	2	6
ADGRA2	1	8	0	4	77.88	155.76	15	1	1	1	1	0.111111111111111	4	9
ADGRA3L	7	17	2	2	363.99	727.98	15	1	0.574065934065934	-1.42857142857143	1	-0.208333333333333	4	24
ADGRB1	1	16	0	5	403.92	807.84	15	1	1	1	1	0.0588235294117647	5	17
ADGRB2	2	3	1	2	76.56	153.12	15	1	1	0.25	1	0.0666666666666667	3	5
ADGRB3	1	8	0	1	184.8	369.6	15	1	1	1	1	0.111111111111111	1	9
ADGRD1	3	8	1	1	279.84	559.68	15	1	1	-1.66666666666667	1	-0.227272727272727	2	11
ADGRD2	10	12	4	3	265.98	531.96	15	1	0.681659170414793	-0.6	1	-0.116883116883117	7	22
ADGRF4	9	13	2	0	225.72	451.44	15	1	0.199275362318841	-Inf	1	-0.590909090909091	2	22
ADGRF5	33	26	4	5	425.37	850.74	15	1	0.721682609964051	0.36969696969697	1	0.114877589453861	9	59
ADGRG1	6	8	0	1	178.53	357.06	15	1	1	1	1	0.428571428571429	1	14
ADGRG2	10	13	1	2	361.02	722.04	15	1	1	0.35	1	0.101449275362319	3	23
ADGRG3	5	7	0	0	133.65	267.3	15	1	1	NA	1	NA	0	12
ADGRG4	17	15	4	2	342.54	685.08	15	1	0.672399672399672	-0.764705882352941	1	-0.135416666666667	6	32
ADGRG5	12	2	0	0	113.85	227.7	15	1	1	NA	1	NA	0	14
ADGRG6	38	28	2	1	814.77	1629.54	15	1	1	-0.473684210526316	1	-0.0909090909090908	3	66
ADGRG7	12	7	1	1	231.33	462.66	15	1	1	0.416666666666667	1	0.131578947368421	2	19
ADGRL2	3	10	2	2	502.26	1004.52	15	1	0.53781512605042	-2.33333333333333	1	-0.269230769230769	4	13
ADGRL3	5	13	2	2	306.9	613.8	15	1	0.564593301435407	-1.6	1	-0.222222222222222	4	18
ADGRV1	39	57	5	9	1521.96	3043.92	15	1	0.779306360284847	0.188034188034188	1	0.0491071428571428	14	96
ADH1C	2	6	1	3	103.62	207.24	15	1	1	0	1	0	4	8
ADH5	0	5	0	2	82.83	165.66	15	1	1	NA	1	0	2	5
ADHFE1	4	3	2	1	113.52	227.04	15	1	1	-0.5	1	-0.0952380952380952	3	7
ADI1	0	3	0	1	58.08	116.16	15	1	1	NA	1	0	1	3
ADIPOQ	1	9	0	3	66	132	15	1	1	1	1	0.1	3	10
ADIPOR1	0	6	0	0	50.16	100.32	15	1	1	NA	1	NA	0	6
ADIPOR2	0	4	0	1	154.11	308.22	15	1	1	NA	1	0	1	4
ADK	2	5	0	0	113.85	227.7	15	1	1	NA	1	NA	0	7
ADM	0	1	0	1	23.1	46.2	15	1	1	NA	1	0	1	1
ADMP	4	8	1	3	156.75	313.5	15	1	1	0.333333333333333	1	0.0833333333333333	4	12
ADNP	7	16	4	3	513.81	1027.62	15	1	0.371706454465075	-2.04761904761905	1	-0.267080745341615	7	23
ADNP2	3	22	1	4	314.49	628.98	15	1	0.538405400474366	-0.833333333333333	1	-0.08	5	25
ADORA1	2	3	0	1	54.12	108.24	15	1	1	1	1	0.4	1	5
ADORA2B	3	8	1	5	117.48	234.96	15	1	1	0.466666666666667	1	0.106060606060606	6	11
ADPGK	0	10	0	1	163.35	326.7	15	1	1	NA	1	0	1	10
ADPRH	1	2	0	1	97.68	195.36	15	1	1	1	1	0.333333333333333	1	3
ADPRHL1	44	34	8	8	627.33	1254.66	15	1	0.783724091448024	0.227272727272727	1	0.0641025641025641	16	78
ADPRHL2	1	4	0	0	104.61	209.22	15	1	1	NA	1	NA	0	5
ADPRM	1	2	0	0	40.59	81.18	15	1	1	NA	1	NA	0	3
ADRA1A	1	6	0	1	168.3	336.6	15	1	1	1	1	0.142857142857143	1	7
ADRA1D	2	6	1	1	65.67	131.34	15	1	1	-2	1	-0.25	2	8
ADRA2A	1	8	0	3	102.3	204.6	15	1	1	1	1	0.111111111111111	3	9
ADRA2BL2	6	2	5	1	46.53	93.06	15	1	1	-0.666666666666667	1	-0.0833333333333334	6	8
ADRB2	0	7	0	2	82.83	165.66	15	1	1	NA	1	0	2	7
ADRB3	3	3	2	3	59.07	118.14	15	1	1	0.333333333333333	1	0.1	5	6
ADRM1	0	4	0	1	92.4	184.8	15	1	1	NA	1	0	1	4
ADSL	1	8	0	3	133.32	266.64	15	1	1	1	1	0.111111111111111	3	9
ADSS	1	1	1	0	128.04	256.08	15	1	1	-Inf	1	-0.5	1	2
ADSSL1	0	5	0	0	133.32	266.64	15	1	1	NA	1	NA	0	5
ADTRP	1	2	0	0	62.37	124.74	15	1	1	NA	1	NA	0	3
AEN	0	1	0	1	30.69	61.38	15	1	1	NA	1	0	1	1
AFAP1	2	9	1	0	218.46	436.92	15	1	0.25	-Inf	1	-0.818181818181818	1	11
AFAP1L1	4	7	0	0	109.89	219.78	15	1	1	NA	1	NA	0	11
AFAP1L2	8	19	2	7	247.83	495.66	15	1	1	0.321428571428571	1	0.0740740740740741	9	27
AFDN	3	15	0	1	558.36	1116.72	15	1	1	1	1	0.166666666666667	1	18
AFF1	13	10	5	2	289.08	578.16	15	1	0.669319186560566	-0.923076923076923	1	-0.149068322981367	7	23
AFF3	4	5	1	0	112.2	224.4	15	1	1	-Inf	1	-0.555555555555556	1	9
AFF4	1	9	0	4	336.27	672.54	15	1	1	1	1	0.1	4	10
AFG1L	0	4	0	0	129.03	258.06	15	1	1	NA	1	NA	0	4
AFG3L2	0	12	0	3	216.48	432.96	15	1	1	NA	1	0	3	12
AFMID	0	5	0	0	45.87	91.74	15	1	1	NA	1	NA	0	5
AFP	4	9	1	1	193.71	387.42	15	1	1	-1.25	1	-0.192307692307692	2	13
AFTPH	6	6	4	0	292.71	585.42	15	1	0.233516483516484	-Inf	1	-0.5	4	12
AGA	2	3	1	0	90.42	180.84	15	1	1	-Inf	1	-0.6	1	5
AGAP3	2	14	1	5	189.42	378.84	15	1	1	-0.4	1	-0.0416666666666667	6	16
AGBL1	15	14	2	0	272.58	545.16	15	1	0.488172043010753	-Inf	1	-0.482758620689655	2	29
AGBL2	4	3	3	1	42.57	85.14	15	1	1	-1.25	1	-0.178571428571429	4	7
AGBL3	11	10	0	1	221.43	442.86	15	1	1	1	1	0.523809523809524	1	21
AGBL4	2	2	0	0	147.84	295.68	15	1	1	NA	1	NA	0	4
AGFG1	1	3	1	1	143.88	287.76	15	1	1	-2	1	-0.25	2	4
AGGF1	5	9	2	1	199.65	399.3	15	1	0.536764705882353	-2.6	1	-0.309523809523809	3	14
AGK	4	5	4	0	118.14	236.28	15	1	0.104895104895105	-Inf	1	-0.555555555555556	4	9
AGL	5	14	2	6	424.05	848.1	15	1	1	0.0666666666666667	1	0.0131578947368421	8	19
AGMAT	3	4	1	0	42.24	84.48	15	1	1	-Inf	1	-0.571428571428571	1	7
AGO1	0	14	0	3	245.85	491.7	15	1	1	NA	1	0	3	14
AGO3	0	8	0	1	245.19	490.38	15	1	1	NA	1	0	1	8
AGPAT1	4	3	0	0	72.93	145.86	15	1	1	NA	1	NA	0	7
AGPAT2	2	3	1	2	62.37	124.74	15	1	1	0.25	1	0.0666666666666667	3	5
AGPAT3	2	4	1	0	94.05	188.1	15	1	0.428571428571428	-Inf	1	-0.666666666666667	1	6
AGPAT4	2	5	1	1	115.5	231	15	1	1	-1.5	1	-0.214285714285714	2	7
AGPAT5	0	2	0	0	108.57	217.14	15	1	1	NA	1	NA	0	2
AGPAT9L	5	6	1	1	138.27	276.54	15	1	1	-0.2	1	-0.0454545454545455	2	11
AGPS	7	13	2	0	219.78	439.56	15	1	0.155844155844156	-Inf	1	-0.65	2	20
AGR2	0	1	0	1	45.54	91.08	15	1	1	NA	1	0	1	1
AGRN	3	13	1	9	203.61	407.22	15	1	1	0.518518518518519	1	0.0875	10	16
AGT	7	4	1	0	171.27	342.54	15	1	1	-Inf	1	-0.363636363636364	1	11
AGTR1	0	5	0	0	97.68	195.36	15	1	1	NA	1	NA	0	5
AGTR2	4	10	0	3	187.44	374.88	15	1	0.541176470588235	1	1	0.285714285714286	3	14
AGTRAP	2	4	0	0	53.13	106.26	15	1	1	NA	1	NA	0	6
AGXT	4	1	2	1	27.06	54.12	15	1	1	0.5	1	0.133333333333333	3	5
AGXT2	2	7	0	1	128.7	257.4	15	1	1	1	1	0.222222222222222	1	9
AHCYL1	0	10	0	1	141.9	283.8	15	1	1	NA	1	0	1	10
AHDC1-LOC107055013-LOC112530227	0	3	0	1	96.36	192.72	15	1	1	NA	1	0	1	3
AHI1	10	15	1	0	279.18	558.36	15	1	0.423076923076923	-Inf	1	-0.6	1	25
AHNAK2	40	31	6	1	673.86	1347.72	15	1	0.229659430380411	-3.65	1	-0.293762575452716	7	71
AHR	3	10	0	1	268.62	537.24	15	1	1	1	1	0.230769230769231	1	13
AHR1B	24	21	4	4	236.28	472.56	15	1	1	0.125	1	0.0333333333333333	8	45
AHR2	12	11	3	5	160.38	320.76	15	1	0.685082190087752	0.45	1	0.146739130434783	8	23
AHRR	4	3	1	0	186.12	372.24	15	1	1	-Inf	1	-0.428571428571429	1	7
AHSA1	0	4	0	1	91.74	183.48	15	1	1	NA	1	0	1	4
AHSA2	1	6	0	0	84.48	168.96	15	1	1	NA	1	NA	0	7
AHSG	6	4	2	0	106.92	213.84	15	1	0.515151515151515	-Inf	1	-0.4	2	10
AIFM1	3	7	3	0	170.94	341.88	15	1	0.06993006993007	-Inf	1	-0.7	3	10
AIFM2	2	6	0	3	106.26	212.52	15	1	1	1	1	0.25	3	8
AIFM3	0	3	0	1	166.65	333.3	15	1	1	NA	1	0	1	3
AIG1	3	2	0	0	63.03	126.06	15	1	1	NA	1	NA	0	5
AIM1	14	31	4	3	569.58	1139.16	15	1	0.217964644051601	-1.95238095238095	1	-0.26031746031746	7	45
AIM1L	4	6	1	4	95.7	191.4	15	1	0.6003996003996	0.625	1	0.2	5	10
AIMP1	1	8	0	1	93.39	186.78	15	1	1	1	1	0.111111111111111	1	9
AIMP2	0	5	0	0	73.26	146.52	15	1	1	NA	1	NA	0	5
AIPL1	1	3	0	1	56.76	113.52	15	1	1	1	1	0.25	1	4
AJAP1	0	3	0	1	38.28	76.56	15	1	1	NA	1	0	1	3
AK1	1	0	1	0	11.55	23.1	15	1	1	NA	1	0	1	1
AK2	0	4	0	0	39.93	79.86	15	1	1	NA	1	NA	0	4
AK3	3	4	0	2	84.15	168.3	15	1	0.5	1	1	0.428571428571429	2	7
AK4	0	2	0	1	36.3	72.6	15	1	1	NA	1	0	1	2
AK5	5	8	1	0	194.7	389.4	15	1	0.428571428571428	-Inf	1	-0.615384615384615	1	13
AK6	0	3	0	0	38.28	76.56	15	1	1	NA	1	NA	0	3
AK7	6	13	1	0	220.44	440.88	15	1	0.35	-Inf	1	-0.684210526315789	1	19
AK8	3	8	0	1	143.55	287.1	15	1	1	1	1	0.272727272727273	1	11
AK9	23	30	2	6	772.53	1545.06	15	1	0.452521512747962	0.565217391304348	1	0.183962264150943	8	53
AKAP1	12	12	3	2	333.96	667.92	15	1	1	-0.5	1	-0.1	5	24
AKAP10	4	20	3	6	323.73	647.46	15	1	0.35826844642195	-1.5	1	-0.166666666666667	9	24
AKAP12	32	18	12	3	590.7	1181.4	15	1	0.349672384901755	-1.25	1	-0.16	15	50
AKAP13	7	15	3	3	487.41	974.82	15	1	0.634495938843765	-1.14285714285714	1	-0.181818181818182	6	22
AKAP14	4	2	1	0	62.37	124.74	15	1	1	-Inf	1	-0.333333333333333	1	6
AKAP17A	8	13	1	2	203.28	406.56	15	1	1	0.1875	1	0.0476190476190476	3	21
AKAP2	9	15	0	0	212.52	425.04	15	1	1	NA	1	NA	0	24
AKAP5	10	9	0	1	172.26	344.52	15	1	1	1	1	0.526315789473684	1	19
AKAP6	20	28	1	2	832.92	1665.84	15	1	1	0.3	1	0.0833333333333334	3	48
AKAP7	3	3	0	0	70.62	141.24	15	1	1	NA	1	NA	0	6
AKAP7L	7	7	5	0	113.52	227.04	15	1	0.106037151702786	-Inf	1	-0.5	5	14
AKAP9	37	44	7	8	1053.69	2107.38	15	1	1	-0.0405405405405406	1	-0.00987654320987658	15	81
AKNA	6	1	3	0	25.41	50.82	15	1	1	-Inf	1	-0.142857142857143	3	7
AKNAD1	32	4	11	1	196.35	392.7	15	1	1	-0.375	1	-0.0277777777777778	12	36
AKR1A1	1	0	1	0	96.69	193.38	15	1	1	NA	1	0	1	1
AKR1B10L2	2	4	0	1	85.14	170.28	15	1	1	1	1	0.333333333333333	1	6
AKR1B10L3	1	2	0	0	94.38	188.76	15	1	1	NA	1	NA	0	3
AKR1D1	0	4	0	1	103.29	206.58	15	1	1	NA	1	0	1	4
AKR7A2	1	7	0	4	74.91	149.82	15	1	1	1	1	0.125	4	8
AKT1	0	3	0	0	168.3	336.6	15	1	1	NA	1	NA	0	3
AKT3	0	7	0	1	143.55	287.1	15	1	1	NA	1	0	1	7
AKTIP	2	6	1	0	109.89	219.78	15	1	0.333333333333333	-Inf	1	-0.75	1	8
ALAD	1	6	1	1	53.13	106.26	15	1	0.416666666666667	-5	1	-0.357142857142857	2	7
ALAS1	2	6	1	1	177.54	355.08	15	1	1	-2	1	-0.25	2	8
ALB	8	9	1	2	213.18	426.36	15	1	1	0.4375	1	0.137254901960784	3	17
ALDH18A1	15	24	0	1	409.86	819.72	15	1	1	1	1	0.384615384615385	1	39
ALDH1A1	1	6	0	0	106.92	213.84	15	1	1	NA	1	NA	0	7
ALDH1A2	0	3	0	0	153.78	307.56	15	1	1	NA	1	NA	0	3
ALDH1A3	0	8	0	0	156.09	312.18	15	1	1	NA	1	NA	0	8
ALDH1L2	4	12	0	1	283.14	566.28	15	1	1	1	1	0.25	1	16
ALDH3A2	5	19	0	9	329.34	658.68	15	1	0.290044493882091	1	1	0.208333333333333	9	24
ALDH4A1	3	12	2	4	106.59	213.18	15	1	0.597523219814242	-1	1	-0.133333333333333	6	15
ALDH5A1	1	4	0	0	111.54	223.08	15	1	1	NA	1	NA	0	5
ALDH6A1	1	4	1	0	180.84	361.68	15	1	0.333333333333333	-Inf	1	-0.8	1	5
ALDH7A1	3	2	2	1	110.55	221.1	15	1	1	-0.333333333333333	1	-0.0666666666666667	3	5
ALDH8A1	6	9	0	1	267.63	535.26	15	1	1	1	1	0.4	1	15
ALDH9A1	2	6	0	2	113.19	226.38	15	1	1	1	1	0.25	2	8
ALDOB	1	3	0	1	74.91	149.82	15	1	1	1	1	0.25	1	4
ALDOC	0	2	0	1	32.67	65.34	15	1	1	NA	1	0	1	2
ALG1	5	8	1	2	129.36	258.72	15	1	1	0.2	1	0.0512820512820513	3	13
ALG10	6	9	2	4	115.83	231.66	15	1	1	0.25	1	0.0666666666666667	6	15
ALG11	4	7	0	2	113.85	227.7	15	1	1	1	1	0.363636363636364	2	11
ALG12	0	4	0	0	74.91	149.82	15	1	1	NA	1	NA	0	4
ALG13	2	12	1	0	255.75	511.5	15	1	0.2	-Inf	1	-0.857142857142857	1	14
ALG14	1	3	1	0	54.12	108.24	15	1	0.4	-Inf	1	-0.75	1	4
ALG2	0	3	0	0	61.38	122.76	15	1	1	NA	1	NA	0	3
ALG3	2	2	1	1	54.12	108.24	15	1	1	0	1	0	2	4
ALG5	2	4	1	0	121.77	243.54	15	1	0.428571428571428	-Inf	1	-0.666666666666667	1	6
ALG6	5	2	1	0	111.87	223.74	15	1	1	-Inf	1	-0.285714285714286	1	7
ALG8	9	8	3	0	118.47	236.94	15	1	0.242105263157895	-Inf	1	-0.470588235294118	3	17
ALG9	8	10	4	6	203.61	407.22	15	1	1	0.166666666666667	1	0.0444444444444444	10	18
ALK	16	14	4	3	431.97	863.94	15	1	1	-0.166666666666667	1	-0.0380952380952381	7	30
ALKBH1	2	7	1	2	121.44	242.88	15	1	1	-0.75	1	-0.111111111111111	3	9
ALKBH2	2	4	0	0	47.19	94.38	15	1	1	NA	1	NA	0	6
ALKBH3-HSD17B12	3	3	0	0	120.78	241.56	15	1	1	NA	1	NA	0	6
ALKBH4	5	4	0	0	54.45	108.9	15	1	1	NA	1	NA	0	9
ALKBH5	0	3	0	2	63.69	127.38	15	1	1	NA	1	0	2	3
ALKBH8	13	13	1	4	190.08	380.16	15	1	0.344456803856137	0.75	1	0.3	5	26
ALMS1	89	52	22	12	1041.81	2083.62	15	1	1	-0.0711610486891385	1	-0.0158531497705465	34	141
ALOX5	1	6	0	0	254.43	508.86	15	1	1	NA	1	NA	0	7
ALOX5AP	0	5	0	2	65.34	130.68	15	1	1	NA	1	0	2	5
ALPI	4	7	2	2	59.73	119.46	15	1	1	-0.75	1	-0.136363636363636	4	11
ALPK1	23	26	7	3	376.2	752.4	15	1	0.298979382156861	-1.63768115942029	1	-0.230612244897959	10	49
ALPK2	49	19	3	2	705.54	1411.08	15	1	0.621498097179464	0.418367346938776	1	0.120588235294118	5	68
ALPK3	11	19	2	4	459.69	919.38	15	1	1	0.136363636363636	1	0.0333333333333333	6	30
ALPL	0	2	0	1	25.41	50.82	15	1	1	NA	1	0	1	2
ALPP	3	1	0	0	47.19	94.38	15	1	1	NA	1	NA	0	4
ALS2	6	23	2	1	475.53	951.06	15	1	0.146774193548387	-6.66666666666667	1	-0.459770114942529	3	29
ALS2CL	1	11	0	1	286.77	573.54	15	1	1	1	1	0.0833333333333333	1	12
ALX1	1	0	1	0	80.85	161.7	15	1	1	NA	1	0	1	1
ALX3	0	3	0	1	29.7	59.4	15	1	1	NA	1	0	1	3
ALX4	1	4	0	1	53.79	107.58	15	1	1	1	1	0.2	1	5
ALYREF	0	2	0	0	25.74	51.48	15	1	1	NA	1	NA	0	2
AMACR	1	1	0	0	67.32	134.64	15	1	1	NA	1	NA	0	2
AMBP	2	7	0	0	75.57	151.14	15	1	1	NA	1	NA	0	9
AMBRA1	0	17	0	3	400.29	800.58	15	1	1	NA	1	0	3	17
AMD1	0	3	0	2	109.89	219.78	15	1	1	NA	1	0	2	3
AMDHD1	2	7	1	1	158.73	317.46	15	1	0.490909090909091	-2.5	1	-0.277777777777778	2	9
AMDHD2	0	4	0	0	100.98	201.96	15	1	1	NA	1	NA	0	4
AMER1	8	13	3	2	222.75	445.5	15	1	0.619565217391304	-1.4375	1	-0.219047619047619	5	21
AMER2	5	5	1	0	149.82	299.64	15	1	1	-Inf	1	-0.5	1	10
AMER3	13	18	1	5	344.19	688.38	15	1	0.376093004769475	0.723076923076923	1	0.252688172043011	6	31
AMFR	1	5	0	0	153.45	306.9	15	1	1	NA	1	NA	0	6
AMH	5	7	2	0	69.96	139.92	15	1	0.461538461538462	-Inf	1	-0.583333333333333	2	12
AMHR2	5	12	0	4	189.75	379.5	15	1	0.532163742690059	1	1	0.294117647058824	4	17
AMIGO2	4	8	2	2	194.04	388.08	15	1	0.604395604395604	-1	1	-0.166666666666667	4	12
AMMECR1	0	2	0	1	47.52	95.04	15	1	1	NA	1	0	1	2
AMN	9	5	2	1	93.06	186.12	15	1	1	-0.111111111111111	1	-0.0238095238095237	3	14
AMN1	1	4	1	0	66.66	133.32	15	1	0.333333333333333	-Inf	1	-0.8	1	5
AMOTL2	1	5	0	1	84.48	168.96	15	1	1	1	1	0.166666666666667	1	6
AMPD1	5	13	2	1	202.95	405.9	15	1	0.247368421052632	-4.2	1	-0.388888888888889	3	18
AMPD2	0	2	0	0	82.83	165.66	15	1	1	NA	1	NA	0	2
AMPD3	0	10	0	2	250.14	500.28	15	1	1	NA	1	0	2	10
AMPH	17	16	2	2	445.17	890.34	15	1	1	0.0588235294117647	1	0.0151515151515151	4	33
AMZ1	1	7	0	1	133.98	267.96	15	1	1	1	1	0.125	1	8
AN1ZNF5L	1	2	1	1	52.8	105.6	15	1	1	-1	1	-0.166666666666667	2	3
ANAPC1	2	20	1	5	610.5	1221	15	1	0.52991452991453	-1	1	-0.0757575757575757	6	22
ANAPC11	0	2	0	1	6.6	13.2	15	1	1	NA	1	0	1	2
ANAPC2	1	9	1	2	228.03	456.06	15	1	0.423076923076923	-3.5	1	-0.233333333333333	3	10
ANAPC4	8	11	2	2	226.71	453.42	15	1	1	-0.375	1	-0.0789473684210527	4	19
ANAPC5	2	7	0	2	189.09	378.18	15	1	1	1	1	0.222222222222222	2	9
ANAPC7	0	8	0	0	186.78	373.56	15	1	1	NA	1	NA	0	8
ANGEL1	5	12	1	4	233.64	467.28	15	1	1	0.4	1	0.0941176470588235	5	17
ANGEL2	6	10	3	1	151.47	302.94	15	1	0.284829721362229	-4	1	-0.375	4	16
ANGPT2	3	2	1	0	261.69	523.38	15	1	1	-Inf	1	-0.4	1	5
ANGPTL1	1	4	0	0	130.68	261.36	15	1	1	NA	1	NA	0	5
ANGPTL2	11	11	1	0	238.59	477.18	15	1	1	-Inf	1	-0.5	1	22
ANGPTL3	3	5	1	0	137.28	274.56	15	1	0.444444444444444	-Inf	1	-0.625	1	8
ANGPTL4	2	4	1	2	89.1	178.2	15	1	1	0	1	0	3	6
ANGPTL5	3	4	0	1	123.75	247.5	15	1	1	1	1	0.428571428571429	1	7
ANGPTL7	0	5	0	1	99	198	15	1	1	NA	1	0	1	5
ANK1	5	27	0	3	630.3	1260.6	15	1	1	1	1	0.15625	3	32
ANK2	40	76	7	15	1202.19	2404.38	15	1	1	0.113333333333333	1	0.0266457680250784	22	116
ANK3	9	40	4	6	1602.48	3204.96	15	1	0.204449498927569	-1.96296296296296	1	-0.216326530612245	10	49
ANKDD1A	3	6	1	2	156.75	313.5	15	1	1	0	1	0	3	9
ANKDD1B	6	9	0	1	152.13	304.26	15	1	1	1	1	0.4	1	15
ANKEF1	15	23	3	2	308.55	617.1	15	1	0.634426832384858	-1.3	1	-0.205263157894737	5	38
ANKFN1	4	4	0	0	321.42	642.84	15	1	1	NA	1	NA	0	8
ANKFN1L	2	9	1	3	179.85	359.7	15	1	1	-0.5	1	-0.0681818181818182	4	11
ANKFY1	3	12	0	3	370.26	740.52	15	1	1	1	1	0.2	3	15
ANKH	1	10	0	1	136.95	273.9	15	1	1	1	1	0.0909090909090909	1	11
ANKHD1	0	11	0	2	482.13	964.26	15	1	1	NA	1	0	2	11
ANKIB1	1	14	1	2	392.37	784.74	15	1	0.313725490196079	-6	1	-0.266666666666667	3	15
ANKK1	4	10	1	2	140.91	281.82	15	1	1	-0.25	1	-0.0476190476190476	3	14
ANKLE1	4	3	2	3	28.71	57.42	15	1	1	0.5	1	0.171428571428571	5	7
ANKLE2	4	13	1	3	257.07	514.14	15	1	1	-0.0833333333333333	1	-0.0147058823529412	4	17
ANKMY2	3	6	1	0	137.61	275.22	15	1	0.4	-Inf	1	-0.666666666666667	1	9
ANKRA2	0	4	0	0	58.41	116.82	15	1	1	NA	1	NA	0	4
ANKRD1	1	2	0	0	84.15	168.3	15	1	1	NA	1	NA	0	3
ANKRD10	2	4	0	1	91.74	183.48	15	1	1	1	1	0.333333333333333	1	6
ANKRD11	4	25	1	4	613.14	1226.28	15	1	1	-0.5625	1	-0.0620689655172414	5	29
ANKRD12	9	21	2	4	460.02	920.04	15	1	1	-0.166666666666667	1	-0.0333333333333333	6	30
ANKRD13A	2	7	1	2	189.42	378.84	15	1	1	-0.75	1	-0.111111111111111	3	9
ANKRD13C	0	3	0	1	130.35	260.7	15	1	1	NA	1	0	1	3
ANKRD17	7	39	2	5	784.74	1569.48	15	1	0.587840933242024	-1.22857142857143	1	-0.133540372670807	7	46
ANKRD2	2	1	2	0	26.4	52.8	15	1	1	-Inf	1	-0.333333333333333	2	3
ANKRD22	5	3	2	1	86.79	173.58	15	1	1	-0.2	1	-0.0416666666666666	3	8
ANKRD24	1	2	1	1	27.72	55.44	15	1	1	-1	1	-0.166666666666667	2	3
ANKRD26	30	39	8	3	806.19	1612.38	15	1	0.104649206143746	-2.46666666666667	1	-0.292490118577075	11	69
ANKRD27	14	8	1	0	355.41	710.82	15	1	1	-Inf	1	-0.363636363636364	1	22
ANKRD28	8	9	1	3	321.09	642.18	15	1	0.603007518796992	0.625	1	0.220588235294118	4	17
ANKRD29	0	3	0	0	80.85	161.7	15	1	1	NA	1	NA	0	3
ANKRD31	34	12	3	1	368.94	737.88	15	1	1	-0.0588235294117647	1	-0.0108695652173914	4	46
ANKRD33	2	5	1	2	46.2	92.4	15	1	1	-0.25	1	-0.0476190476190476	3	7
ANKRD33B	4	9	1	3	148.17	296.34	15	1	1	0.25	1	0.0576923076923077	4	13
ANKRD34C	1	1	0	0	48.84	97.68	15	1	1	NA	1	NA	0	2
ANKRD40	2	5	2	1	101.64	203.28	15	1	0.5	-4	1	-0.380952380952381	3	7
ANKRD40L	7	5	2	2	61.38	122.76	15	1	1	0.285714285714286	1	0.0833333333333334	4	12
ANKRD46	0	6	0	1	65.67	131.34	15	1	1	NA	1	0	1	6
ANKRD49	1	5	0	0	48.51	97.02	15	1	1	NA	1	NA	0	6
ANKRD50	2	16	1	3	450.78	901.56	15	1	0.47012987012987	-1.66666666666667	1	-0.138888888888889	4	18
ANKRD52	0	3	0	1	149.82	299.64	15	1	1	NA	1	0	1	3
ANKRD55	2	9	0	1	165.99	331.98	15	1	1	1	1	0.181818181818182	1	11
ANKRD6	4	15	1	4	227.37	454.74	15	1	1	0.0625	1	0.0105263157894737	5	19
ANKRD60	5	1	0	0	86.46	172.92	15	1	1	NA	1	NA	0	6
ANKRD66	2	5	0	1	53.46	106.92	15	1	1	1	1	0.285714285714286	1	7
ANKRD9	3	2	1	2	39.6	79.2	15	1	1	0.666666666666667	1	0.266666666666667	3	5
ANKRD9L	0	5	0	0	119.13	238.26	15	1	1	NA	1	NA	0	5
ANKS1A	3	13	2	6	237.6	475.2	15	1	1	-0.444444444444444	1	-0.0625	8	16
ANKS1B	2	11	1	0	222.75	445.5	15	1	0.214285714285714	-Inf	1	-0.846153846153846	1	13
ANKS4B	8	3	1	0	126.72	253.44	15	1	1	-Inf	1	-0.272727272727273	1	11
ANKS6	7	12	1	0	361.35	722.7	15	1	0.4	-Inf	1	-0.631578947368421	1	19
ANKZF1	8	8	1	3	148.5	297	15	1	0.591331269349845	0.666666666666667	1	0.25	4	16
ANLN	18	9	0	1	343.86	687.72	15	1	0.357142857142857	1	1	0.666666666666667	1	27
ANO1	2	12	0	2	302.94	605.88	15	1	1	1	1	0.142857142857143	2	14
ANO10	1	6	0	0	169.29	338.58	15	1	1	NA	1	NA	0	7
ANO4	2	5	0	0	283.14	566.28	15	1	1	NA	1	NA	0	7
ANO5	1	11	0	1	285.45	570.9	15	1	1	1	1	0.0833333333333333	1	12
ANO6	6	9	3	1	264	528	15	1	0.303405572755418	-3.5	1	-0.35	4	15
ANO8	1	5	0	3	65.34	130.68	15	1	1	1	1	0.166666666666667	3	6
ANO9	4	11	2	2	191.07	382.14	15	1	0.557275541795666	-1.75	1	-0.233333333333333	4	15
ANOS1	7	12	0	1	238.26	476.52	15	1	1	1	1	0.368421052631579	1	19
ANP32A	0	5	0	2	62.04	124.08	15	1	1	NA	1	0	2	5
ANP32E	0	3	0	1	49.17	98.34	15	1	1	NA	1	0	1	3
ANPEP	7	7	1	1	144.54	289.08	15	1	1	0	1	0	2	14
ANTXR2	1	4	0	0	127.05	254.1	15	1	1	NA	1	NA	0	5
ANTXRL	0	4	0	0	148.83	297.66	15	1	1	NA	1	NA	0	4
ANXA1	0	3	0	0	83.49	166.98	15	1	1	NA	1	NA	0	3
ANXA10	0	6	0	1	75.57	151.14	15	1	1	NA	1	0	1	6
ANXA11	5	7	4	0	160.71	321.42	15	1	0.0884615384615385	-Inf	1	-0.583333333333333	4	12
ANXA13	8	4	1	0	128.04	256.08	15	1	1	-Inf	1	-0.333333333333333	1	12
ANXA2	0	2	0	0	90.09	180.18	15	1	1	NA	1	NA	0	2
ANXA5	0	6	0	0	104.61	209.22	15	1	1	NA	1	NA	0	6
ANXA6	0	8	0	3	73.26	146.52	15	1	1	NA	1	0	3	8
ANXA7	0	4	0	1	115.17	230.34	15	1	1	NA	1	0	1	4
ANXA8	2	5	0	2	118.47	236.94	15	1	1	1	1	0.285714285714286	2	7
AOAH	4	3	0	0	152.13	304.26	15	1	1	NA	1	NA	0	7
AOC1	0	8	0	3	71.28	142.56	15	1	1	NA	1	0	3	8
AOC3	14	20	7	11	246.51	493.02	15	1	1	0.0909090909090909	1	0.022875816993464	18	34
AOX2	19	19	7	4	383.79	767.58	15	1	0.506200429750109	-0.75	1	-0.136363636363636	11	38
AP1AR	1	4	0	1	65.34	130.68	15	1	1	1	1	0.2	1	5
AP1B1	0	5	0	5	83.82	167.64	15	1	1	NA	1	0	5	5
AP1M1	0	5	0	1	111.87	223.74	15	1	1	NA	1	0	1	5
AP1S2	0	3	0	0	52.14	104.28	15	1	1	NA	1	NA	0	3
AP1S3	1	1	0	0	43.23	86.46	15	1	1	NA	1	NA	0	2
AP2A2	0	5	0	0	269.28	538.56	15	1	1	NA	1	NA	0	5
AP2B1	0	11	0	5	308.88	617.76	15	1	1	NA	1	0	5	11
AP2M1	0	9	0	2	118.8	237.6	15	1	1	NA	1	0	2	9
AP3B2	1	3	0	0	268.29	536.58	15	1	1	NA	1	NA	0	4
AP3D1	1	14	0	1	334.29	668.58	15	1	1	1	1	0.0666666666666667	1	15
AP3M1	0	6	0	1	128.37	256.74	15	1	1	NA	1	0	1	6
AP3M2	1	2	0	0	132.66	265.32	15	1	1	NA	1	NA	0	3
AP3S2	0	1	0	1	20.13	40.26	15	1	1	NA	1	0	1	1
AP4B1	2	11	0	0	206.25	412.5	15	1	1	NA	1	NA	0	13
AP4E1	12	23	4	5	333.63	667.26	15	1	0.702404681955089	-0.533333333333333	1	-0.101587301587302	9	35
AP4S1	0	2	0	0	42.24	84.48	15	1	1	NA	1	NA	0	2
AP5M1	1	5	0	2	154.44	308.88	15	1	1	1	1	0.166666666666667	2	6
AP5Z1	6	14	2	3	250.14	500.28	15	1	1	-0.555555555555556	1	-0.1	5	20
APAF1	7	17	1	2	422.07	844.14	15	1	1	-0.214285714285714	1	-0.0416666666666666	3	24
APBA1	5	8	1	0	212.19	424.38	15	1	0.428571428571428	-Inf	1	-0.615384615384615	1	13
APBA2	1	6	0	2	217.47	434.94	15	1	1	1	1	0.142857142857143	2	7
APBA3	0	9	0	2	105.27	210.54	15	1	1	NA	1	0	2	9
APBB1	2	1	0	0	48.18	96.36	15	1	1	NA	1	NA	0	3
APBB1IP	11	12	1	1	242.22	484.44	15	1	1	-0.0909090909090908	1	-0.0217391304347826	2	23
APBB2	2	9	1	0	260.04	520.08	15	1	0.25	-Inf	1	-0.818181818181818	1	11
APBB3	0	3	0	0	78.87	157.74	15	1	1	NA	1	NA	0	3
APC	5	33	2	1	769.56	1539.12	15	1	0.0702626641651032	-12.2	1	-0.535087719298246	3	38
APC2	7	12	4	6	266.31	532.62	15	1	1	-0.142857142857143	1	-0.0315789473684211	10	19
APCDD1	1	12	0	3	178.53	357.06	15	1	1	1	1	0.0769230769230769	3	13
APCDD1L	1	3	1	2	43.89	87.78	15	1	1	-0.5	1	-0.0833333333333333	3	4
APEH	0	1	0	1	4.95	9.9	15	1	1	NA	1	0	1	1
APH1AL	0	2	0	0	12.87	25.74	15	1	1	NA	1	NA	0	2
API5	0	9	0	2	190.08	380.16	15	1	1	NA	1	0	2	9
APLF	9	6	1	0	126.72	253.44	15	1	1	-Inf	1	-0.4	1	15
APMAP	4	5	2	0	130.02	260.04	15	1	0.454545454545455	-Inf	1	-0.555555555555556	2	9
APOA1	0	2	0	1	12.54	25.08	15	1	1	NA	1	0	1	2
APOA1BP	2	3	1	2	54.78	109.56	15	1	1	0.25	1	0.0666666666666667	3	5
APOB	38	54	5	5	1638.78	3277.56	15	1	0.738952201283619	-0.421052631578947	1	-0.0869565217391304	10	92
APOBEC2	5	2	4	0	98.01	196.02	15	1	0.490909090909091	-Inf	1	-0.285714285714286	4	7
APOD	0	7	0	2	69.63	139.26	15	1	1	NA	1	0	2	7
APOH	1	7	0	2	101.64	203.28	15	1	1	1	1	0.125	2	8
APOLD1	1	2	0	1	62.7	125.4	15	1	1	1	1	0.333333333333333	1	3
APOO	5	2	3	0	74.91	149.82	15	1	1	-Inf	1	-0.285714285714286	3	7
APOOL	8	9	1	0	88.77	177.54	15	1	1	-Inf	1	-0.529411764705882	1	17
APOV1	0	2	0	1	39.6	79.2	15	1	1	NA	1	0	1	2
APP	1	12	1	3	262.35	524.7	15	1	0.426470588235294	-3	1	-0.173076923076923	4	13
APPBP2	0	6	0	1	149.16	298.32	15	1	1	NA	1	0	1	6
APPL2	2	14	1	2	252.12	504.24	15	1	0.422084623323013	-2.5	1	-0.208333333333333	3	16
APTX	7	2	0	0	72.93	145.86	15	1	1	NA	1	NA	0	9
AQP1	1	4	0	0	81.51	163.02	15	1	1	NA	1	NA	0	5
AQP10	2	4	2	2	46.86	93.72	15	1	1	-1	1	-0.166666666666667	4	6
AQP11	4	8	2	3	65.67	131.34	15	1	1	-0.333333333333333	1	-0.0666666666666667	5	12
AQP12A	2	3	2	1	54.45	108.9	15	1	1	-2	1	-0.266666666666667	3	5
AQP2	0	5	0	0	63.36	126.72	15	1	1	NA	1	NA	0	5
AQP4	1	4	1	0	92.4	184.8	15	1	0.333333333333333	-Inf	1	-0.8	1	5
AQP5	0	6	0	1	67.32	134.64	15	1	1	NA	1	0	1	6
AQP7	3	5	1	0	83.16	166.32	15	1	0.444444444444444	-Inf	1	-0.625	1	8
AQP8	3	11	1	5	81.84	163.68	15	1	1	0.266666666666667	1	0.0476190476190476	6	14
AQP9	1	6	0	1	100.98	201.96	15	1	1	1	1	0.142857142857143	1	7
AQR	25	33	3	0	729.3	1458.6	15	1	0.0910252848013337	-Inf	1	-0.568965517241379	3	58
AR	0	9	0	1	126.39	252.78	15	1	1	NA	1	0	1	9
ARAP2	22	19	1	2	531.3	1062.6	15	1	0.598837209302326	0.568181818181818	1	0.203252032520325	3	41
ARC	0	4	0	0	115.83	231.66	15	1	1	NA	1	NA	0	4
AREG	0	2	0	0	50.16	100.32	15	1	1	NA	1	NA	0	2
AREL1	1	5	1	0	203.94	407.88	15	1	0.285714285714286	-Inf	1	-0.833333333333333	1	6
ARF1	0	2	0	1	42.9	85.8	15	1	1	NA	1	0	1	2
ARF6	2	3	2	2	29.7	59.4	15	1	1	-0.5	1	-0.1	4	5
ARFGAP1	1	4	1	1	176.22	352.44	15	1	1	-3	1	-0.3	2	5
ARFGAP2	2	3	0	1	139.59	279.18	15	1	1	1	1	0.4	1	5
ARFGAP3	7	8	1	0	138.93	277.86	15	1	1	-Inf	1	-0.533333333333333	1	15
ARFGEF1	5	19	1	2	534.93	1069.86	15	1	0.545299145299145	-0.9	1	-0.125	3	24
ARFGEF2	1	32	0	3	605.88	1211.76	15	1	1	1	1	0.0303030303030303	3	33
ARFGEF3	5	29	1	5	686.73	1373.46	15	1	1	-0.16	1	-0.0196078431372549	6	34
ARFIP1	1	3	0	0	113.19	226.38	15	1	1	NA	1	NA	0	4
ARFRP1	1	3	1	1	70.29	140.58	15	1	1	-2	1	-0.25	2	4
ARG2	0	8	0	0	97.02	194.04	15	1	1	NA	1	NA	0	8
ARHGAP1	1	5	1	1	131.34	262.68	15	1	0.464285714285714	-4	1	-0.333333333333333	2	6
ARHGAP10	4	8	2	0	230.67	461.34	15	1	0.164835164835165	-Inf	1	-0.666666666666667	2	12
ARHGAP11A	17	12	0	1	316.8	633.6	15	1	0.433333333333333	1	1	0.586206896551724	1	29
ARHGAP12	4	6	1	0	280.5	561	15	1	0.454545454545455	-Inf	1	-0.6	1	10
ARHGAP15	1	0	1	0	59.4	118.8	15	1	1	NA	1	0	1	1
ARHGAP17	3	7	1	2	201.3	402.6	15	1	1	-0.166666666666667	1	-0.0333333333333333	3	10
ARHGAP18	9	9	1	1	244.86	489.72	15	1	1	0	1	0	2	18
ARHGAP19	2	7	1	1	134.64	269.28	15	1	0.490909090909091	-2.5	1	-0.277777777777778	2	9
ARHGAP20	4	19	3	6	276.87	553.74	15	1	0.370178938136391	-1.375	1	-0.159420289855072	9	23
ARHGAP21	9	27	5	3	654.39	1308.78	15	1	0.0868537202238728	-4	1	-0.375	8	36
ARHGAP22	2	6	2	1	148.5	297	15	1	0.490909090909091	-5	1	-0.416666666666667	3	8
ARHGAP23	1	3	1	1	91.74	183.48	15	1	1	-2	1	-0.25	2	4
ARHGAP24	0	9	0	0	230.34	460.68	15	1	1	NA	1	NA	0	9
ARHGAP25	1	15	0	1	283.47	566.94	15	1	1	1	1	0.0625	1	16
ARHGAP26	0	5	0	3	165	330	15	1	1	NA	1	0	3	5
ARHGAP27	2	11	0	0	79.86	159.72	15	1	1	NA	1	NA	0	13
ARHGAP28	1	11	1	1	226.38	452.76	15	1	0.274725274725275	-10	1	-0.416666666666667	2	12
ARHGAP29	11	14	1	1	414.15	828.3	15	1	1	-0.272727272727273	1	-0.06	2	25
ARHGAP32	14	34	2	4	453.42	906.84	15	1	1	-0.214285714285714	1	-0.0416666666666666	6	48
ARHGAP36	3	11	0	2	156.75	313.5	15	1	1	1	1	0.214285714285714	2	14
ARHGAP39	7	15	2	3	267.63	535.26	15	1	1	-0.428571428571429	1	-0.0818181818181818	5	22
ARHGAP39L	3	3	1	2	178.86	357.72	15	1	1	0.5	1	0.166666666666667	3	6
ARHGAP40	2	10	1	4	221.43	442.86	15	1	1	-0.25	1	-0.0333333333333334	5	12
ARHGAP42	1	4	1	1	224.73	449.46	15	1	1	-3	1	-0.3	2	5
ARHGAP44	0	4	0	0	62.7	125.4	15	1	1	NA	1	NA	0	4
ARHGAP45	55	39	3	5	477.18	954.36	15	1	0.286029043171145	0.574545454545454	1	0.210106382978723	8	94
ARHGAP5	4	28	0	4	572.22	1144.44	15	1	1	1	1	0.125	4	32
ARHGAP8	6	1	0	0	59.07	118.14	15	1	1	NA	1	NA	0	7
ARHGDIA	0	3	0	1	39.27	78.54	15	1	1	NA	1	0	1	3
ARHGDIB	0	2	0	0	59.73	119.46	15	1	1	NA	1	NA	0	2
ARHGEF1	15	21	3	6	391.71	783.42	15	1	0.721232140851808	0.3	1	0.0833333333333334	9	36
ARHGEF10	7	22	0	2	421.74	843.48	15	1	1	1	1	0.241379310344828	2	29
ARHGEF10L	0	6	0	2	125.73	251.46	15	1	1	NA	1	0	2	6
ARHGEF11	2	5	2	3	63.03	126.06	15	1	1	-0.666666666666667	1	-0.114285714285714	5	7
ARHGEF12	7	19	3	3	423.06	846.12	15	1	0.346148498331479	-1.71428571428571	1	-0.230769230769231	6	26
ARHGEF16	3	7	0	2	128.7	257.4	15	1	1	1	1	0.3	2	10
ARHGEF17	1	5	1	5	93.39	186.78	15	1	1	0	1	0	6	6
ARHGEF18	9	21	3	9	508.86	1017.72	15	1	1	0.222222222222222	1	0.05	12	30
ARHGEF26	19	19	3	4	240.57	481.14	15	1	1	0.25	1	0.0714285714285715	7	38
ARHGEF28	18	25	3	2	403.26	806.52	15	1	0.641272811369944	-1.08333333333333	1	-0.181395348837209	5	43
ARHGEF3	7	4	3	1	141.9	283.8	15	1	1	-0.714285714285714	1	-0.113636363636364	4	11
ARHGEF33	19	15	18	5	312.51	625.02	15	1	0.0980382723437755	-1.84210526315789	1	-0.223785166240409	23	34
ARHGEF37	6	20	1	0	115.83	231.66	15	1	0.259259259259259	-Inf	1	-0.769230769230769	1	26
ARHGEF38	5	6	0	2	254.1	508.2	15	1	0.487179487179487	1	1	0.454545454545455	2	11
ARHGEF39	2	5	0	0	65.34	130.68	15	1	1	NA	1	NA	0	7
ARHGEF4	24	21	3	4	545.16	1090.32	15	1	0.698283568746647	0.34375	1	0.104761904761905	7	45
ARHGEF5	31	12	1	1	551.1	1102.2	15	1	0.498989898989899	0.612903225806452	1	0.220930232558139	2	43
ARHGEF6	2	9	0	0	227.04	454.08	15	1	1	NA	1	NA	0	11
ARHGEF7	4	10	3	3	232.32	464.64	15	1	0.612616099071208	-1.5	1	-0.214285714285714	6	14
ARHGEF9	1	1	0	1	132.99	265.98	15	1	1	1	1	0.5	1	2
ARID1A	6	10	2	1	536.25	1072.5	15	1	0.545923632610939	-2.33333333333333	1	-0.291666666666667	3	16
ARID1B	1	5	0	3	337.26	674.52	15	1	1	1	1	0.166666666666667	3	6
ARID2	1	11	0	1	632.61	1265.22	15	1	1	1	1	0.0833333333333333	1	12
ARID3B	1	11	0	6	103.95	207.9	15	1	1	1	1	0.0833333333333333	6	12
ARID4A	2	7	0	2	386.76	773.52	15	1	1	1	1	0.222222222222222	2	9
ARID4B	6	6	0	1	311.19	622.38	15	1	1	1	1	0.5	1	12
ARID5A	0	4	0	1	33.99	67.98	15	1	1	NA	1	0	1	4
ARID5B	19	21	3	3	440.88	881.76	15	1	1	-0.105263157894737	1	-0.025	6	40
ARIH1	0	1	0	1	136.62	273.24	15	1	1	NA	1	0	1	1
ARIH2	0	2	0	0	138.93	277.86	15	1	1	NA	1	NA	0	2
ARL10	0	2	0	1	21.45	42.9	15	1	1	NA	1	0	1	2
ARL11	2	2	0	1	20.13	40.26	15	1	1	1	1	0.5	1	4
ARL13A	1	2	1	0	45.54	91.08	15	1	1	-Inf	1	-0.666666666666667	1	3
ARL13B	2	0	0	0	46.2	92.4	15	1	1	NA	1	NA	0	2
ARL14	2	7	0	1	77.55	155.1	15	1	1	1	1	0.222222222222222	1	9
ARL14EP	1	5	0	2	103.29	206.58	15	1	1	1	1	0.166666666666667	2	6
ARL14EPL	1	2	0	0	54.45	108.9	15	1	1	NA	1	NA	0	3
ARL15	3	5	1	0	59.73	119.46	15	1	0.444444444444444	-Inf	1	-0.625	1	8
ARL16	2	0	1	0	11.22	22.44	15	1	1	NA	1	0	1	2
ARL2	0	7	0	1	40.26	80.52	15	1	1	NA	1	0	1	7
ARL5A	0	2	0	1	55.44	110.88	15	1	1	NA	1	0	1	2
ARL5B	0	3	0	0	62.37	124.74	15	1	1	NA	1	NA	0	3
ARL6	1	2	0	1	53.79	107.58	15	1	1	1	1	0.333333333333333	1	3
ARL6IP4	1	5	0	1	47.85	95.7	15	1	1	1	1	0.166666666666667	1	6
ARMC1	0	3	0	0	80.52	161.04	15	1	1	NA	1	NA	0	3
ARMC10	2	5	0	1	68.97	137.94	15	1	1	1	1	0.285714285714286	1	7
ARMC2	6	12	2	3	207.57	415.14	15	1	1	-0.333333333333333	1	-0.0666666666666667	5	18
ARMC3	11	9	3	0	278.85	557.7	15	1	0.25296442687747	-Inf	1	-0.45	3	20
ARMC4	8	18	0	4	335.94	671.88	15	1	0.550446998722861	1	1	0.307692307692308	4	26
ARMC6	0	12	0	2	128.37	256.74	15	1	1	NA	1	0	2	12
ARMC8	0	6	0	1	195.69	391.38	15	1	1	NA	1	0	1	6
ARMC9	8	12	4	5	264.66	529.32	15	1	1	-0.2	1	-0.0444444444444444	9	20
ARMT1	5	6	0	0	129.03	258.06	15	1	1	NA	1	NA	0	11
ARNT	3	9	1	0	214.5	429	15	1	0.307692307692308	-Inf	1	-0.75	1	12
ARNT2	1	8	0	0	265.98	531.96	15	1	1	NA	1	NA	0	9
ARNTL	2	8	1	3	181.5	363	15	1	1	-0.333333333333333	1	-0.05	4	10
ARNTL2	1	2	0	1	120.12	240.24	15	1	1	1	1	0.333333333333333	1	3
ARPC1B	0	1	0	1	16.17	32.34	15	1	1	NA	1	0	1	1
ARPC5	1	1	1	1	22.44	44.88	15	1	1	0	1	0	2	2
ARPC5L	1	4	0	0	23.1	46.2	15	1	1	NA	1	NA	0	5
ARPP21	3	7	0	0	190.74	381.48	15	1	1	NA	1	NA	0	10
ARR3	0	8	0	2	85.47	170.94	15	1	1	NA	1	0	2	8
ARRDC1	0	8	0	0	131.01	262.02	15	1	1	NA	1	NA	0	8
ARRDC2	1	4	1	1	114.18	228.36	15	1	1	-3	1	-0.3	2	5
ARRDC4	0	3	0	0	106.92	213.84	15	1	1	NA	1	NA	0	3
ARSA	1	8	0	1	144.21	288.42	15	1	1	1	1	0.111111111111111	1	9
ARSB	4	5	1	0	127.05	254.1	15	1	1	-Inf	1	-0.555555555555556	1	9
ARSE	11	9	1	3	272.58	545.16	15	1	0.590062111801242	0.727272727272727	1	0.3	4	20
ARSG	9	5	1	2	108.9	217.8	15	1	0.536764705882353	0.722222222222222	1	0.30952380952381	3	14
ARSH	14	8	1	0	211.86	423.72	15	1	1	-Inf	1	-0.363636363636364	1	22
ARSI	2	9	2	5	85.8	171.6	15	1	1	-0.8	1	-0.103896103896104	7	11
ARSJ	2	15	1	0	183.81	367.62	15	1	0.166666666666667	-Inf	1	-0.882352941176471	1	17
ART4	3	2	2	1	84.48	168.96	15	1	1	-0.333333333333333	1	-0.0666666666666667	3	5
ARTN	1	1	0	1	16.17	32.34	15	1	1	1	1	0.5	1	2
ARV1	2	2	1	0	64.68	129.36	15	1	1	-Inf	1	-0.5	1	4
ARVCF	4	20	2	5	360.36	720.72	15	1	0.595904281110065	-1	1	-0.119047619047619	7	24
AS3MT	4	9	2	1	85.47	170.94	15	1	0.517857142857143	-3.5	1	-0.358974358974359	3	13
ASAH1	3	7	0	2	152.46	304.92	15	1	1	1	1	0.3	2	10
ASAH2	7	9	1	0	198.66	397.32	15	1	0.470588235294118	-Inf	1	-0.5625	1	16
ASAP1	2	15	1	2	325.38	650.76	15	1	0.403508771929824	-2.75	1	-0.215686274509804	3	17
ASAP2	2	9	0	1	296.67	593.34	15	1	1	1	1	0.181818181818182	1	11
ASAP3	0	3	0	3	22.44	44.88	15	1	1	NA	1	0	3	3
ASB1	1	3	1	1	90.09	180.18	15	1	1	-2	1	-0.25	2	4
ASB10	5	7	2	2	99.99	199.98	15	1	1	-0.4	1	-0.0833333333333333	4	12
ASB11	4	5	0	0	104.28	208.56	15	1	1	NA	1	NA	0	9
ASB12	1	6	1	3	57.42	114.84	15	1	1	-1	1	-0.107142857142857	4	7
ASB14	15	22	0	4	251.46	502.92	15	1	0.277920410783055	1	1	0.405405405405405	4	37
ASB15	5	10	2	1	154.11	308.22	15	1	0.528186274509804	-3	1	-0.333333333333333	3	15
ASB2	1	6	0	0	210.87	421.74	15	1	1	NA	1	NA	0	7
ASB3	9	9	2	2	169.29	338.58	15	1	1	0	1	0	4	18
ASB4	4	6	1	3	164.01	328.02	15	1	1	0.5	1	0.15	4	10
ASB5	5	2	0	0	74.91	149.82	15	1	1	NA	1	NA	0	7
ASB6	1	6	1	0	77.88	155.76	15	1	0.25	-Inf	1	-0.857142857142857	1	7
ASB9	1	4	0	1	77.55	155.1	15	1	1	1	1	0.2	1	5
ASCC2	5	11	4	1	177.54	355.08	15	1	0.119416187527643	-7.8	1	-0.4875	5	16
ASCC3	4	15	0	1	479.49	958.98	15	1	1	1	1	0.210526315789474	1	19
ASCL4	1	4	1	1	46.2	92.4	15	1	1	-3	1	-0.3	2	5
ASF1A	0	1	0	1	54.45	108.9	15	1	1	NA	1	0	1	1
ASH1L	9	41	4	6	1013.1	2026.2	15	1	0.201142396109886	-2.03703703703704	1	-0.22	10	50
ASH2L	2	7	2	1	162.36	324.72	15	1	0.236363636363636	-6	1	-0.444444444444444	3	9
ASIC1	1	5	1	2	150.48	300.96	15	1	1	-1.5	1	-0.166666666666667	3	6
ASIC2	1	6	0	0	95.04	190.08	15	1	1	NA	1	NA	0	7
ASIC5	2	3	0	0	149.16	298.32	15	1	1	NA	1	NA	0	5
ASL2	5	2	2	0	259.71	519.42	15	1	1	-Inf	1	-0.285714285714286	2	7
ASMT	1	7	0	1	146.85	293.7	15	1	1	1	1	0.125	1	8
ASMTL	13	8	5	2	200.31	400.62	15	1	1	-0.538461538461539	1	-0.0952380952380952	7	21
ASNS	2	5	0	2	146.85	293.7	15	1	1	1	1	0.285714285714286	2	7
ASNSD1	15	11	4	0	229.35	458.7	15	1	0.267870826491516	-Inf	1	-0.423076923076923	4	26
ASPA	2	5	0	0	100.32	200.64	15	1	1	NA	1	NA	0	7
ASPG	10	8	1	1	204.93	409.86	15	1	1	0.2	1	0.0555555555555556	2	18
ASPHD2	0	2	0	1	58.74	117.48	15	1	1	NA	1	0	1	2
ASPM	36	33	6	8	985.38	1970.76	15	1	0.570007630734928	0.3125	1	0.093167701863354	14	69
ASPN	2	6	0	0	98.67	197.34	15	1	1	NA	1	NA	0	8
ASRGL1	2	8	0	2	119.13	238.26	15	1	1	1	1	0.2	2	10
ASS1	0	3	0	2	52.8	105.6	15	1	1	NA	1	0	2	3
ASTE1	7	9	1	2	160.71	321.42	15	1	1	0.357142857142857	1	0.104166666666667	3	16
ASTL	4	4	1	0	170.94	341.88	15	1	1	-Inf	1	-0.5	1	8
ASTN1	1	14	0	3	213.84	427.68	15	1	1	1	1	0.0666666666666667	3	15
ASTN2	4	4	0	1	100.65	201.3	15	1	1	1	1	0.5	1	8
ASXL1	24	39	2	8	663.96	1327.92	15	1	0.478461921843157	0.59375	1	0.180952380952381	10	63
ASXL2	15	24	3	6	382.47	764.94	15	1	1	0.2	1	0.0512820512820513	9	39
ASXL3	14	23	3	2	715.11	1430.22	15	1	0.379487649705878	-1.46428571428571	1	-0.221621621621622	5	37
ASZ1	6	4	1	1	145.2	290.4	15	1	1	0.333333333333333	1	0.1	2	10
ATAD1	0	12	0	0	104.28	208.56	15	1	1	NA	1	NA	0	12
ATAD2	44	36	11	12	448.14	896.28	15	1	0.637446147570579	0.25	1	0.0717391304347826	23	80
ATAD2B	4	15	2	0	370.59	741.18	15	1	0.0714285714285714	-Inf	1	-0.789473684210526	2	19
ATAD3A	0	11	0	3	128.37	256.74	15	1	1	NA	1	0	3	11
ATAD5	29	22	5	3	456.72	913.44	15	1	1	-0.264367816091954	1	-0.0563725490196079	8	51
ATE1	2	9	0	0	141.24	282.48	15	1	1	NA	1	NA	0	11
ATF4	3	4	2	1	102.63	205.26	15	1	1	-1.66666666666667	1	-0.238095238095238	3	7
ATF6	4	8	0	1	165	330	15	1	1	1	1	0.333333333333333	1	12
ATF7	0	6	0	1	65.34	130.68	15	1	1	NA	1	0	1	6
ATF7IP	13	21	0	0	494.34	988.68	15	1	1	NA	1	NA	0	34
ATG12	0	1	0	1	13.2	26.4	15	1	1	NA	1	0	1	1
ATG14	0	5	0	2	151.8	303.6	15	1	1	NA	1	0	2	5
ATG2B	6	37	0	4	613.47	1226.94	15	1	1	1	1	0.13953488372093	4	43
ATG4B	0	7	0	2	90.75	181.5	15	1	1	NA	1	0	2	7
ATG4C	0	7	0	1	152.46	304.92	15	1	1	NA	1	0	1	7
ATG7	5	11	3	2	186.45	372.9	15	1	0.325372254164824	-2.3	1	-0.2875	5	16
ATG9A	0	9	0	4	222.42	444.84	15	1	1	NA	1	0	4	9
ATG9B	0	1	0	1	25.08	50.16	15	1	1	NA	1	0	1	1
ATIC	1	17	0	0	190.41	380.82	15	1	1	NA	1	NA	0	18
ATL1	0	11	0	3	148.83	297.66	15	1	1	NA	1	0	3	11
ATL2	3	5	2	2	220.44	440.88	15	1	1	-0.666666666666667	1	-0.125	4	8
ATM	27	37	5	7	950.4	1900.8	15	1	1	0.0211640211640212	1	0.00520833333333331	12	64
ATMIN	4	7	0	0	237.27	474.54	15	1	1	NA	1	NA	0	11
ATN1	0	6	0	3	107.58	215.16	15	1	1	NA	1	0	3	6
ATOH7	1	3	1	1	79.53	159.06	15	1	1	-2	1	-0.25	2	4
ATOX1	0	3	0	0	32.34	64.68	15	1	1	NA	1	NA	0	3
ATP10A	8	20	1	3	492.03	984.06	15	1	1	0.166666666666667	1	0.0357142857142857	4	28
ATP10B	8	20	1	2	440.55	881.1	15	1	1	-0.25	1	-0.0476190476190476	3	28
ATP10D	19	17	1	1	547.47	1094.94	15	1	1	0.105263157894737	1	0.0277777777777778	2	36
ATP11A	7	16	2	3	420.75	841.5	15	1	1	-0.523809523809524	1	-0.0956521739130435	5	23
ATP11B	2	9	0	0	262.35	524.7	15	1	1	NA	1	NA	0	11
ATP11C	1	16	0	2	307.23	614.46	15	1	1	1	1	0.0588235294117647	2	17
ATP12A	4	23	2	4	321.09	642.18	15	1	0.295402178466695	-1.875	1	-0.185185185185185	6	27
ATP13A2	15	9	4	2	307.56	615.12	15	1	1	-0.2	1	-0.0416666666666666	6	24
ATP13A3	12	16	1	2	397.65	795.3	15	1	1	0.333333333333333	1	0.0952380952380952	3	28
ATP13A4	9	17	1	2	412.5	825	15	1	1	0.0555555555555556	1	0.0128205128205128	3	26
ATP13A5	15	17	3	3	339.57	679.14	15	1	1	-0.133333333333333	1	-0.03125	6	32
ATP1A1	0	14	0	3	298.32	596.64	15	1	1	NA	1	0	3	14
ATP1B1	1	2	0	0	71.61	143.22	15	1	1	NA	1	NA	0	3
ATP1B3	2	1	0	0	69.63	139.26	15	1	1	NA	1	NA	0	3
ATP1B4	1	2	0	0	71.28	142.56	15	1	1	NA	1	NA	0	3
ATP23	0	3	0	1	41.25	82.5	15	1	1	NA	1	0	1	3
ATP2A2	1	14	0	4	289.41	578.82	15	1	1	1	1	0.0666666666666667	4	15
ATP2A3	7	13	3	6	197.34	394.68	15	1	1	0.0714285714285714	1	0.0166666666666667	9	20
ATP2B4	0	14	0	6	222.75	445.5	15	1	1	NA	1	0	6	14
ATP2C1	3	12	0	1	288.42	576.84	15	1	1	1	1	0.2	1	15
ATP2C2	5	12	3	2	250.14	500.28	15	1	0.308878256246677	-2.6	1	-0.305882352941176	5	17
ATP4B	5	11	2	2	86.13	172.26	15	1	0.586790505675955	-1.2	1	-0.1875	4	16
ATP5A1Z	0	3	0	1	143.22	286.44	15	1	1	NA	1	0	1	3
ATP5C1	0	2	0	0	77.55	155.1	15	1	1	NA	1	NA	0	2
ATP5F1	2	0	0	0	41.25	82.5	15	1	1	NA	1	NA	0	2
ATP5F1B	0	10	0	1	71.28	142.56	15	1	1	NA	1	0	1	10
ATP5G1	0	1	0	1	18.81	37.62	15	1	1	NA	1	0	1	1
ATP5G3	1	0	1	0	51.15	102.3	15	1	1	NA	1	0	1	1
ATP5H	5	8	0	2	41.25	82.5	15	1	0.523809523809524	1	1	0.384615384615385	2	13
ATP5L	1	1	0	0	15.84	31.68	15	1	1	NA	1	NA	0	2
ATP5O	1	4	0	1	45.54	91.08	15	1	1	1	1	0.2	1	5
ATP5S	3	1	0	0	34.32	68.64	15	1	1	NA	1	NA	0	4
ATP6AP1	5	6	2	0	157.41	314.82	15	1	0.461538461538462	-Inf	1	-0.545454545454545	2	11
ATP6AP2	1	4	1	3	113.19	226.38	15	1	1	-0.333333333333333	1	-0.05	4	5
ATP6V0A1	1	11	1	4	209.22	418.44	15	1	0.514705882352941	-1.75	1	-0.116666666666667	5	12
ATP6V0A2	2	11	0	0	256.74	513.48	15	1	1	NA	1	NA	0	13
ATP6V0A4	3	15	1	3	287.76	575.52	15	1	1	-0.666666666666667	1	-0.0833333333333333	4	18
ATP6V0C	0	2	0	1	66.66	133.32	15	1	1	NA	1	0	1	2
ATP6V0D2	1	6	1	1	93.72	187.44	15	1	0.416666666666667	-5	1	-0.357142857142857	2	7
ATP6V1A-ATP6V1AL	0	8	0	2	207.57	415.14	15	1	1	NA	1	0	2	8
ATP6V1B2	1	1	1	1	186.12	372.24	15	1	1	0	1	0	2	2
ATP6V1G1	1	1	0	0	19.14	38.28	15	1	1	NA	1	NA	0	2
ATP6V1G3	1	1	1	0	29.37	58.74	15	1	1	-Inf	1	-0.5	1	2
ATP6V1H	1	6	1	0	140.91	281.82	15	1	0.25	-Inf	1	-0.857142857142857	1	7
ATP7B	14	31	3	3	478.83	957.66	15	1	0.387128320338311	-1.21428571428571	1	-0.188888888888889	6	45
ATP8A1	0	7	0	1	346.17	692.34	15	1	1	NA	1	0	1	7
ATP8A2	2	7	1	0	219.12	438.24	15	1	0.3	-Inf	1	-0.777777777777778	1	9
ATP8B1	0	20	0	2	387.09	774.18	15	1	1	NA	1	0	2	20
ATP8B3	9	24	3	1	263.34	526.68	15	1	0.0907714437126202	-7	1	-0.477272727272727	4	33
ATP8B4	3	26	0	1	326.37	652.74	15	1	1	1	1	0.103448275862069	1	29
ATP9A	1	9	0	0	339.9	679.8	15	1	1	NA	1	NA	0	10
ATP9B	1	8	0	1	320.1	640.2	15	1	1	1	1	0.111111111111111	1	9
ATPAF1	2	1	0	0	95.7	191.4	15	1	1	NA	1	NA	0	3
ATPAF2	1	1	0	1	64.35	128.7	15	1	1	1	1	0.5	1	2
ATR	20	47	5	10	873.18	1746.36	15	1	0.765830290020358	-0.175	1	-0.0348258706467662	15	67
ATRIP	10	5	4	2	250.14	500.28	15	1	1	0	1	0	6	15
ATRN	9	14	2	6	351.12	702.24	15	1	0.675719460369071	0.481481481481482	1	0.141304347826087	8	23
ATRNL1	2	14	2	4	312.51	625.02	15	1	0.291866028708134	-2.5	1	-0.208333333333333	6	16
ATXN1	2	3	2	2	110.88	221.76	15	1	1	-0.5	1	-0.1	4	5
ATXN10	5	3	0	1	91.08	182.16	15	1	0.444444444444444	1	1	0.625	1	8
ATXN1L	2	6	0	1	195.69	391.38	15	1	1	1	1	0.25	1	8
ATXN2	1	4	1	1	229.02	458.04	15	1	1	-3	1	-0.3	2	5
ATXN3	0	2	0	0	101.97	203.94	15	1	1	NA	1	NA	0	2
ATXN7	2	1	0	1	194.7	389.4	15	1	1	1	1	0.666666666666667	1	3
ATXN7L1	1	5	1	1	224.07	448.14	15	1	0.464285714285714	-4	1	-0.333333333333333	2	6
AUP1	4	8	1	0	152.46	304.92	15	1	0.384615384615385	-Inf	1	-0.666666666666667	1	12
AURKA	1	5	1	1	112.2	224.4	15	1	0.464285714285714	-4	1	-0.333333333333333	2	6
AURKAIP1	3	1	0	0	50.16	100.32	15	1	1	NA	1	NA	0	4
AUTS2	0	5	0	0	200.64	401.28	15	1	1	NA	1	NA	0	5
AvBD10-AvBD9	0	4	0	1	21.78	43.56	15	1	1	NA	1	0	1	4
AvBD12	1	3	0	0	22.11	44.22	15	1	1	NA	1	NA	0	4
AvBD4-AvBD6-AvBD7	2	0	0	0	12.54	25.08	15	1	1	NA	1	NA	0	2
AVD-AVR2-LOC427416-LOC769899	0	2	0	1	18.81	37.62	15	1	1	NA	1	0	1	2
AVL9	4	9	1	0	198.66	397.32	15	1	0.357142857142857	-Inf	1	-0.692307692307692	1	13
AVPR1A	0	4	0	1	45.54	91.08	15	1	1	NA	1	0	1	4
AVPR1B	2	11	1	5	78.87	157.74	15	1	1	-0.1	1	-0.0128205128205128	6	13
AVPR2	1	4	0	0	146.85	293.7	15	1	1	NA	1	NA	0	5
AWAT1	0	2	0	1	54.45	108.9	15	1	1	NA	1	0	1	2
AXDND1	14	17	4	3	377.52	755.04	15	1	0.686732186732187	-0.619047619047619	1	-0.119815668202765	7	31
AXIN2	0	2	0	1	152.46	304.92	15	1	1	NA	1	0	1	2
AZI2	6	2	2	0	104.61	209.22	15	1	1	-Inf	1	-0.25	2	8
AZIN1	0	2	0	1	121.77	243.54	15	1	1	NA	1	0	1	2
AZIN2	6	13	0	1	107.91	215.82	15	1	1	1	1	0.315789473684211	1	19
B3GALNT1	3	5	1	1	95.7	191.4	15	1	1	-0.666666666666667	1	-0.125	2	8
B3GALNT2	3	7	2	1	144.87	289.74	15	1	0.510489510489511	-3.66666666666667	1	-0.366666666666667	3	10
B3GALT1	0	11	0	0	116.16	232.32	15	1	1	NA	1	NA	0	11
B3GALT2	2	5	0	2	115.5	231	15	1	1	1	1	0.285714285714286	2	7
B3GALT5	4	4	0	1	125.4	250.8	15	1	1	1	1	0.5	1	8
B3GALT6	3	6	1	2	79.86	159.72	15	1	1	0	1	0	3	9
B3GAT1L	1	4	0	1	98.34	196.68	15	1	1	1	1	0.2	1	5
B3GAT2	0	2	0	0	36.3	72.6	15	1	1	NA	1	NA	0	2
B3GLCT	3	7	2	1	143.22	286.44	15	1	0.510489510489511	-3.66666666666667	1	-0.366666666666667	3	10
B3GNT2	1	8	0	1	132.66	265.32	15	1	1	1	1	0.111111111111111	1	9
B3GNT4	5	10	3	4	81.51	163.02	15	1	1	-0.5	1	-0.0952380952380952	7	15
B3GNT5	0	4	0	1	98.01	196.02	15	1	1	NA	1	0	1	4
B3GNT7	1	3	0	3	79.53	159.06	15	1	1	1	1	0.25	3	4
B3GNT9	2	4	0	1	107.58	215.16	15	1	1	1	1	0.333333333333333	1	6
B3GNTL	6	9	5	1	134.31	268.62	15	1	0.148606811145511	-6.5	1	-0.433333333333333	6	15
B3GNTL1	1	6	0	0	86.46	172.92	15	1	1	NA	1	NA	0	7
B4GALNT3	10	29	2	3	318.78	637.56	15	1	0.602654860737674	-0.933333333333333	1	-0.143589743589744	5	39
B4GALNT4	5	13	1	4	203.94	407.88	15	1	1	0.35	1	0.0777777777777778	5	18
B4GALT1	1	1	1	1	67.32	134.64	15	1	1	0	1	0	2	2
B4GALT2	1	2	1	1	45.54	91.08	15	1	1	-1	1	-0.166666666666667	2	3
B4GALT3	1	5	0	2	72.6	145.2	15	1	1	1	1	0.166666666666667	2	6
B4GALT4	5	14	1	3	125.07	250.14	15	1	1	0.0666666666666667	1	0.0131578947368421	4	19
B4GALT5	0	4	0	2	93.72	187.44	15	1	1	NA	1	0	2	4
B4GALT6	0	2	0	1	92.07	184.14	15	1	1	NA	1	0	1	2
B9D1	1	2	1	0	33.66	67.32	15	1	1	-Inf	1	-0.666666666666667	1	3
BAALC	2	0	1	0	45.54	91.08	15	1	1	NA	1	0	1	2
BAAT	1	2	1	0	39.27	78.54	15	1	1	-Inf	1	-0.666666666666667	1	3
BACE1	1	2	1	1	73.59	147.18	15	1	1	-1	1	-0.166666666666667	2	3
BACE2	2	6	1	1	115.5	231	15	1	1	-2	1	-0.25	2	8
BACH1	1	13	0	1	275.55	551.1	15	1	1	1	1	0.0714285714285714	1	14
BACH2	2	5	2	2	244.53	489.06	15	1	0.575757575757576	-1.5	1	-0.214285714285714	4	7
BAG1	0	1	0	1	51.48	102.96	15	1	1	NA	1	0	1	1
BAG2	0	3	0	3	38.94	77.88	15	1	1	NA	1	0	3	3
BAG3	5	7	2	2	172.59	345.18	15	1	1	-0.4	1	-0.0833333333333333	4	12
BAG4	1	1	1	1	30.03	60.06	15	1	1	0	1	0	2	2
BAG5	4	3	1	1	126.06	252.12	15	1	1	0.25	1	0.0714285714285714	2	7
BAHCC1	2	2	1	1	39.93	79.86	15	1	1	0	1	0	2	4
BAHD1	2	11	1	3	267.63	535.26	15	1	1	-0.833333333333333	1	-0.0961538461538461	4	13
BAIAP2	1	4	1	3	76.89	153.78	15	1	1	-0.333333333333333	1	-0.05	4	5
BAIAP2L1	2	6	0	0	159.39	318.78	15	1	1	NA	1	NA	0	8
BAIAP2L2	4	6	1	1	142.89	285.78	15	1	1	-0.5	1	-0.1	2	10
BAK1	5	2	1	1	40.26	80.52	15	1	1	0.6	1	0.214285714285714	2	7
BAMBI	0	3	0	0	104.28	208.56	15	1	1	NA	1	NA	0	3
BANK1	17	14	4	3	220.11	440.22	15	1	1	-0.0980392156862746	1	-0.0230414746543779	7	31
BANP	3	7	1	1	125.07	250.14	15	1	1	-1.33333333333333	1	-0.2	2	10
BAP1	1	10	0	1	146.52	293.04	15	1	1	1	1	0.0909090909090909	1	11
BARD1	11	14	0	0	239.25	478.5	15	1	1	NA	1	NA	0	25
BARL	2	8	0	0	122.76	245.52	15	1	1	NA	1	NA	0	10
BARX2	0	1	0	1	39.93	79.86	15	1	1	NA	1	0	1	1
BASP1	0	2	0	0	52.8	105.6	15	1	1	NA	1	NA	0	2
BATF3	1	3	0	2	30.03	60.06	15	1	1	1	1	0.25	2	4
BAZ1A	7	16	6	3	498.63	997.26	15	1	0.108965517241379	-3.57142857142857	1	-0.36231884057971	9	23
BAZ1B	3	24	1	0	390.06	780.12	15	1	0.142857142857143	-Inf	1	-0.888888888888889	1	27
BAZ2A	1	6	1	1	132	264	15	1	0.416666666666667	-5	1	-0.357142857142857	2	7
BAZ2B	19	22	1	2	805.53	1611.06	15	1	1	0.421052631578947	1	0.130081300813008	3	41
BBOF1	8	10	3	1	129.36	258.72	15	1	0.586466165413534	-2.75	1	-0.305555555555556	4	18
BBS10	12	11	0	3	177.21	354.42	15	1	0.224615384615385	1	1	0.521739130434783	3	23
BBS12	17	22	7	9	242.55	485.1	15	1	1	-0.00653594771241828	1	-0.0016025641025641	16	39
BBS2	2	7	0	0	205.26	410.52	15	1	1	NA	1	NA	0	9
BBS4	3	12	0	4	171.93	343.86	15	1	1	1	1	0.2	4	15
BBS5	0	2	0	0	99	198	15	1	1	NA	1	NA	0	2
BBS7	2	8	0	0	188.1	376.2	15	1	1	NA	1	NA	0	10
BBX	2	5	0	1	305.91	611.82	15	1	1	1	1	0.285714285714286	1	7
BCAN	1	3	0	2	36.96	73.92	15	1	1	1	1	0.25	2	4
BCAP29	1	1	0	0	70.29	140.58	15	1	1	NA	1	NA	0	2
BCAR3	6	9	2	1	263.34	526.68	15	1	0.558823529411765	-2	1	-0.266666666666667	3	15
BCAS1	4	3	2	0	130.35	260.7	15	1	0.5	-Inf	1	-0.428571428571429	2	7
BCAS2	0	2	0	0	36.3	72.6	15	1	1	NA	1	NA	0	2
BCAS3	9	17	6	4	282.15	564.3	15	1	0.26004904439276	-1.83333333333333	1	-0.253846153846154	10	26
BCAT1	7	8	1	0	138.27	276.54	15	1	1	-Inf	1	-0.533333333333333	1	15
BCCIP	4	7	1	0	99	198	15	1	0.416666666666667	-Inf	1	-0.636363636363636	1	11
BCDIN3D	2	2	0	1	48.18	96.36	15	1	1	1	1	0.5	1	4
BCHE	6	7	1	2	251.13	502.26	15	1	1	0.416666666666667	1	0.128205128205128	3	13
BCKDHB	8	6	0	1	152.79	305.58	15	1	0.466666666666667	1	1	0.571428571428571	1	14
BCL10	0	4	0	1	60.72	121.44	15	1	1	NA	1	0	1	4
BCL11A	0	3	0	0	93.39	186.78	15	1	1	NA	1	NA	0	3
BCL11B	0	3	0	0	148.83	297.66	15	1	1	NA	1	NA	0	3
BCL2A1	1	3	0	0	65.34	130.68	15	1	1	NA	1	NA	0	4
BCL2L1	0	2	0	1	36.63	73.26	15	1	1	NA	1	0	1	2
BCL2L13	3	8	1	0	125.07	250.14	15	1	0.333333333333333	-Inf	1	-0.727272727272727	1	11
BCL2L15	2	3	0	0	46.53	93.06	15	1	1	NA	1	NA	0	5
BCL6	0	8	0	2	155.76	311.52	15	1	1	NA	1	0	2	8
BCL7B	1	3	1	0	45.54	91.08	15	1	0.4	-Inf	1	-0.75	1	4
BCL9	3	7	2	1	290.73	581.46	15	1	0.510489510489511	-3.66666666666667	1	-0.366666666666667	3	10
BCL9L	5	19	1	1	414.15	828.3	15	1	0.415384615384615	-2.8	1	-0.291666666666667	2	24
BCO1	1	4	0	1	169.62	339.24	15	1	1	1	1	0.2	1	5
BCO2	4	7	1	2	187.44	374.88	15	1	1	0.125	1	0.0303030303030303	3	11
BCOR	4	12	2	4	332.31	664.62	15	1	1	-0.5	1	-0.0833333333333333	6	16
BCORL1	8	21	4	5	351.78	703.56	15	1	0.422952863979529	-1.1	1	-0.168582375478927	9	29
BCS1L	1	4	0	1	68.31	136.62	15	1	1	1	1	0.2	1	5
BDH1	1	3	1	0	68.64	137.28	15	1	0.4	-Inf	1	-0.75	1	4
BDH1A	0	7	0	2	97.35	194.7	15	1	1	NA	1	0	2	7
BDH1B	2	4	1	2	93.06	186.12	15	1	1	0	1	0	3	6
BDH2	3	2	3	1	70.62	141.24	15	1	1	-1	1	-0.15	4	5
BDKRB1	14	5	0	0	135.96	271.92	15	1	1	NA	1	NA	0	19
BDKRB2	6	11	2	0	154.77	309.54	15	1	0.16374269005848	-Inf	1	-0.647058823529412	2	17
BDP1L	39	28	1	1	565.95	1131.9	15	1	1	0.282051282051282	1	0.082089552238806	2	67
BEND2	5	12	1	1	208.89	417.78	15	1	1	-1.4	1	-0.205882352941176	2	17
BEND3	1	20	0	3	307.23	614.46	15	1	1	1	1	0.0476190476190476	3	21
BEND4	1	4	1	1	153.45	306.9	15	1	1	-3	1	-0.3	2	5
BEND6	2	2	0	0	133.98	267.96	15	1	1	NA	1	NA	0	4
BEND7	4	5	0	2	129.36	258.72	15	1	0.490909090909091	1	1	0.444444444444444	2	9
BEST1	7	10	1	0	137.94	275.88	15	1	0.444444444444444	-Inf	1	-0.588235294117647	1	17
BEST2-BEST4	2	4	2	3	56.76	113.52	15	1	1	-0.333333333333333	1	-0.0666666666666667	5	6
BEST3	3	9	1	0	212.85	425.7	15	1	0.307692307692308	-Inf	1	-0.75	1	12
BET1	0	3	0	1	41.58	83.16	15	1	1	NA	1	0	1	3
BET1L	1	3	0	0	25.41	50.82	15	1	1	NA	1	NA	0	4
BF1-BF2-HLA-F10AL1-HLA-F10AL3-HLA-F10AL4-LOC101751283-LOC107049114-LOC107049124-LOC107050538-LOC107050833-LOC107054704-LOC112529954-LOC417056-MHCIA2-MHCIA3-MHCIA6-MHCIA7-MHCIA9-MHCIY-MICA-MR1-YF5-YF6	1	2	1	2	32.01	64.02	15	1	1	0	1	0	3	3
BFAR	3	6	0	2	116.82	233.64	15	1	1	1	1	0.333333333333333	2	9
BFSP1	1	5	1	0	175.23	350.46	15	1	0.285714285714286	-Inf	1	-0.833333333333333	1	6
BFSP2	1	4	1	2	113.19	226.38	15	1	1	-1	1	-0.133333333333333	3	5
BHLHA9	3	3	1	2	34.98	69.96	15	1	1	0.5	1	0.166666666666667	3	6
BHLHE23	1	4	0	0	16.17	32.34	15	1	1	NA	1	NA	0	5
BHLHE40	0	1	0	1	45.21	90.42	15	1	1	NA	1	0	1	1
BHMT	0	2	0	0	91.08	182.16	15	1	1	NA	1	NA	0	2
BICC1	4	5	0	0	47.19	94.38	15	1	1	NA	1	NA	0	9
BICD1	4	14	1	1	293.7	587.4	15	1	0.447368421052632	-2.5	1	-0.277777777777778	2	18
BICD2	6	10	2	2	223.41	446.82	15	1	1	-0.666666666666667	1	-0.125	4	16
BID	3	7	0	1	96.69	193.38	15	1	1	1	1	0.3	1	10
BIN1	1	3	0	1	188.76	377.52	15	1	1	1	1	0.25	1	4
BIN2-CELA1	3	11	1	3	198	396	15	1	1	-0.222222222222222	1	-0.0357142857142857	4	14
BIN3	2	3	1	0	43.89	87.78	15	1	1	-Inf	1	-0.6	1	5
BIRC2	2	7	0	1	190.41	380.82	15	1	1	1	1	0.222222222222222	1	9
BIRC6	4	44	2	10	1457.28	2914.56	15	1	0.589571239612767	-1.2	1	-0.0833333333333333	12	48
BIRC7	7	9	2	2	120.45	240.9	15	1	1	-0.285714285714286	1	-0.0625	4	16
BIVM	3	14	1	1	167.97	335.94	15	1	0.385964912280702	-3.66666666666667	1	-0.323529411764706	2	17
BLEC1	2	1	0	1	41.58	83.16	15	1	1	1	1	0.666666666666667	1	3
BLEC3-LOC107054697	3	2	1	0	28.71	57.42	15	1	1	-Inf	1	-0.4	1	5
BLK	1	15	0	1	157.74	315.48	15	1	1	1	1	0.0625	1	16
BLM	25	20	7	3	397.65	795.3	15	1	0.4939789880069	-0.866666666666667	1	-0.144444444444444	10	45
BLMH	0	2	0	0	131.01	262.02	15	1	1	NA	1	NA	0	2
BLNK	0	8	0	0	154.44	308.88	15	1	1	NA	1	NA	0	8
BLOC1S2	0	2	0	0	24.75	49.5	15	1	1	NA	1	NA	0	2
BLOC1S4	0	2	0	0	40.59	81.18	15	1	1	NA	1	NA	0	2
BLOC1S5	2	1	0	0	47.52	95.04	15	1	1	NA	1	NA	0	3
BLOC1S6	2	3	0	0	55.11	110.22	15	1	1	NA	1	NA	0	5
BLZF1	3	4	0	0	141.24	282.48	15	1	1	NA	1	NA	0	7
BMI1	0	2	0	1	61.38	122.76	15	1	1	NA	1	0	1	2
BMP10	5	7	2	0	148.83	297.66	15	1	0.461538461538462	-Inf	1	-0.583333333333333	2	12
BMP2K	10	16	4	2	308.22	616.44	15	1	0.364942528735632	-2.2	1	-0.282051282051282	6	26
BMP3	3	4	0	0	131.34	262.68	15	1	1	NA	1	NA	0	7
BMP5	1	2	0	0	105.93	211.86	15	1	1	NA	1	NA	0	3
BMP6	0	5	0	1	112.86	225.72	15	1	1	NA	1	0	1	5
BMP7	0	3	0	0	79.86	159.72	15	1	1	NA	1	NA	0	3
BMPER	6	4	1	2	232.98	465.96	15	1	0.559440559440559	0.666666666666667	1	0.266666666666667	3	10
BMPR1A	0	5	0	0	165.66	331.32	15	1	1	NA	1	NA	0	5
BMPR1B	0	7	0	2	137.28	274.56	15	1	1	NA	1	0	2	7
BMPR2	4	13	0	0	303.6	607.2	15	1	1	NA	1	NA	0	17
BMS1	6	9	2	1	274.56	549.12	15	1	0.558823529411765	-2	1	-0.266666666666667	3	15
BMT2	3	3	0	0	80.85	161.7	15	1	1	NA	1	NA	0	6
BMX	4	6	1	0	194.7	389.4	15	1	0.454545454545455	-Inf	1	-0.6	1	10
BNC1	3	9	0	1	421.41	842.82	15	1	1	1	1	0.25	1	12
BNC2	0	9	0	1	237.93	475.86	15	1	1	NA	1	0	1	9
BNIP1	0	2	0	0	29.37	58.74	15	1	1	NA	1	NA	0	2
BNIP2	0	4	0	0	90.75	181.5	15	1	1	NA	1	NA	0	4
BNIP3	2	4	0	0	79.86	159.72	15	1	1	NA	1	NA	0	6
BNIP3L	2	1	1	0	45.21	90.42	15	1	1	-Inf	1	-0.333333333333333	1	3
BOC	7	13	0	3	331.32	662.64	15	1	0.525691699604743	1	1	0.35	3	20
BOD1L1	33	30	5	1	806.85	1613.7	15	1	0.212832165830124	-3.54545454545455	1	-0.30952380952381	6	63
BOK	1	3	1	1	76.23	152.46	15	1	1	-2	1	-0.25	2	4
BOLL	2	4	0	0	75.9	151.8	15	1	1	NA	1	NA	0	6
BORA	5	8	1	0	207.24	414.48	15	1	0.428571428571428	-Inf	1	-0.615384615384615	1	13
BORCS5	1	1	0	0	9.24	18.48	15	1	1	NA	1	NA	0	2
BORL1-BORL4	6	5	2	0	85.47	170.94	15	1	0.487179487179487	-Inf	1	-0.454545454545455	2	11
BPGM	1	4	0	0	68.97	137.94	15	1	1	NA	1	NA	0	5
BPHL	2	6	0	0	74.91	149.82	15	1	1	NA	1	NA	0	8
BPIFB2	5	1	2	0	106.92	213.84	15	1	1	-Inf	1	-0.166666666666667	2	6
BPIFB3	5	8	0	2	112.2	224.4	15	1	0.523809523809524	1	1	0.384615384615385	2	13
BPIFB4	2	4	1	1	69.96	139.92	15	1	1	-1	1	-0.166666666666667	2	6
BPIFB6	4	6	2	1	124.08	248.16	15	1	0.559440559440559	-2	1	-0.266666666666667	3	10
BPIFCB	6	8	0	0	140.58	281.16	15	1	1	NA	1	NA	0	14
BPIL3	13	9	4	4	133.98	267.96	15	1	0.697626742184463	0.307692307692308	1	0.0909090909090909	8	22
BPNT1	1	5	0	0	84.81	169.62	15	1	1	NA	1	NA	0	6
BPTF	14	20	1	2	942.81	1885.62	15	1	1	0.285714285714286	1	0.0784313725490196	3	34
BRAF	0	2	0	0	234.3	468.6	15	1	1	NA	1	NA	0	2
BRAP	0	5	0	0	147.84	295.68	15	1	1	NA	1	NA	0	5
BRAT1	8	19	2	4	282.81	565.62	15	1	1	-0.1875	1	-0.037037037037037	6	27
BRCA1	38	41	5	8	503.91	1007.82	15	1	0.563636927239616	0.325657894736842	1	0.0963972736124635	13	79
BRCA2	86	46	19	5	1099.89	2199.78	15	1	0.238465590030082	-1.03255813953488	1	-0.140151515151515	24	132
BRCC3	0	8	0	3	66.66	133.32	15	1	1	NA	1	0	3	8
BRD1	1	13	1	0	429.66	859.32	15	1	0.133333333333333	-Inf	1	-0.928571428571429	1	14
BRD3	2	10	2	4	193.38	386.76	15	1	0.568627450980392	-1.5	1	-0.166666666666667	6	12
BRD7	3	9	2	1	178.2	356.4	15	1	0.241758241758242	-5	1	-0.416666666666667	3	12
BRD8	6	12	0	2	323.4	646.8	15	1	1	1	1	0.333333333333333	2	18
BRDT	29	19	2	2	337.59	675.18	15	1	1	0.344827586206897	1	0.104166666666667	4	48
BRE	7	2	3	1	128.37	256.74	15	1	1	0.142857142857143	1	0.0277777777777778	4	9
BRF1	4	5	1	1	145.86	291.72	15	1	1	-0.25	1	-0.0555555555555556	2	9
BRF2	5	4	2	3	73.92	147.84	15	1	1	0.466666666666667	1	0.155555555555556	5	9
BRINP1	3	6	0	2	209.55	419.1	15	1	1	1	1	0.333333333333333	2	9
BRINP2	1	12	0	6	136.95	273.9	15	1	1	1	1	0.0769230769230769	6	13
BRINP3	8	6	1	0	131.67	263.34	15	1	1	-Inf	1	-0.428571428571429	1	14
BRIX1	1	1	0	0	86.46	172.92	15	1	1	NA	1	NA	0	2
BRMS1L	0	4	0	0	101.64	203.28	15	1	1	NA	1	NA	0	4
BRPF1	1	6	0	2	109.56	219.12	15	1	1	1	1	0.142857142857143	2	7
BRPF3	7	16	0	8	301.29	602.58	15	1	0.146011047412605	1	1	0.304347826086957	8	23
BRS3	3	2	1	1	114.51	229.02	15	1	1	0.333333333333333	1	0.1	2	5
BRSK2	0	9	0	5	216.15	432.3	15	1	1	NA	1	0	5	9
BRWD3	1	11	1	3	433.62	867.24	15	1	0.45	-2.66666666666667	1	-0.166666666666667	4	12
BSDC1	2	2	1	0	96.36	192.72	15	1	1	-Inf	1	-0.5	1	4
BSG	0	9	0	0	76.23	152.46	15	1	1	NA	1	NA	0	9
BSPRY	3	6	1	0	79.53	159.06	15	1	0.4	-Inf	1	-0.666666666666667	1	9
BST1	5	6	0	0	111.54	223.08	15	1	1	NA	1	NA	0	11
BTAF1	1	18	0	2	632.94	1265.88	15	1	1	1	1	0.0526315789473684	2	19
BTBD1	0	6	0	1	88.77	177.54	15	1	1	NA	1	0	1	6
BTBD10	1	8	0	2	172.59	345.18	15	1	1	1	1	0.111111111111111	2	9
BTBD11	3	6	1	2	252.45	504.9	15	1	1	0	1	0	3	9
BTBD18	1	0	1	0	4.62	9.24	15	1	1	NA	1	0	1	1
BTBD2	1	2	0	0	133.65	267.3	15	1	1	NA	1	NA	0	3
BTBD6	0	4	0	1	99.99	199.98	15	1	1	NA	1	0	1	4
BTBD7	3	14	2	0	398.97	797.94	15	1	0.0584795321637427	-Inf	1	-0.823529411764706	2	17
BTBD9	0	6	0	0	105.93	211.86	15	1	1	NA	1	NA	0	6
BTC	0	1	0	1	8.25	16.5	15	1	1	NA	1	0	1	1
BTD	6	6	5	1	144.87	289.74	15	1	0.315610859728507	-4	1	-0.333333333333333	6	12
BTG2	1	0	1	0	11.22	22.44	15	1	1	NA	1	0	1	1
BTG4	2	6	0	0	51.48	102.96	15	1	1	NA	1	NA	0	8
BTK	2	7	2	3	173.25	346.5	15	1	0.58041958041958	-1.33333333333333	1	-0.177777777777778	5	9
BTLA	5	5	0	1	100.65	201.3	15	1	1	1	1	0.5	1	10
BTN1	2	9	1	3	127.05	254.1	15	1	1	-0.5	1	-0.0681818181818182	4	11
BTN1A1	10	9	2	0	141.9	283.8	15	1	0.485714285714286	-Inf	1	-0.473684210526316	2	19
BTN3A2-BTN3A3-LOC107049000-LOC107055478-LOC426827	13	4	3	1	104.94	209.88	15	1	1	0.0769230769230769	1	0.0147058823529411	4	17
BUB1	14	12	2	5	333.3	666.6	15	1	0.39832136717565	0.657142857142857	1	0.252747252747253	7	26
BUB1B	13	8	3	1	322.08	644.16	15	1	1	-0.846153846153846	1	-0.130952380952381	4	21
BUB3	0	2	0	0	81.51	163.02	15	1	1	NA	1	NA	0	2
BUD13-LOC770165	7	17	4	7	150.48	300.96	15	1	0.709143859477564	-0.387755102040816	1	-0.071969696969697	11	24
BUD31	0	2	0	2	42.9	85.8	15	1	1	NA	1	0	2	2
BVES	1	2	1	1	118.47	236.94	15	1	1	-1	1	-0.166666666666667	2	3
BYSL	1	2	1	1	42.9	85.8	15	1	1	-1	1	-0.166666666666667	2	3
BZFP1-LOC112533547	1	3	1	3	44.55	89.1	15	1	1	0	1	0	4	4
BZW1	0	8	0	2	139.59	279.18	15	1	1	NA	1	0	2	8
BZW2	0	3	0	0	147.84	295.68	15	1	1	NA	1	NA	0	3
C10H15ORF58	4	3	0	0	234.3	468.6	15	1	1	NA	1	NA	0	7
C10orf10	5	6	2	0	103.95	207.9	15	1	0.461538461538462	-Inf	1	-0.545454545454545	2	11
C11H16orf70	0	5	0	1	125.73	251.46	15	1	1	NA	1	0	1	5
C11H16ORF87	0	2	0	0	34.32	68.64	15	1	1	NA	1	NA	0	2
C11H19orf12-LOC100858381-LOC415756	2	2	0	1	44.22	88.44	15	1	1	1	1	0.5	1	4
C11orf24	10	6	2	0	156.09	312.18	15	1	0.529411764705882	-Inf	1	-0.375	2	16
C11ORF52	3	1	1	1	38.28	76.56	15	1	1	0.666666666666667	1	0.25	2	4
C11orf63	18	10	6	2	270.27	540.54	15	1	0.690985626731227	-0.666666666666667	1	-0.107142857142857	8	28
C12H3orf14	1	1	0	0	38.61	77.22	15	1	1	NA	1	NA	0	2
C12H3orf18	2	0	1	0	45.21	90.42	15	1	1	NA	1	0	1	2
C12H3ORF67	9	8	2	0	203.28	406.56	15	1	0.485380116959064	-Inf	1	-0.470588235294118	2	17
C12orf74-PLEKHG7	13	6	2	1	200.64	401.28	15	1	1	0.0769230769230769	1	0.0175438596491229	3	19
C13H5orf15	4	5	2	0	113.19	226.38	15	1	0.454545454545455	-Inf	1	-0.555555555555556	2	9
C14H16ORF52	0	2	0	0	53.13	106.26	15	1	1	NA	1	NA	0	2
C14H16orf62	6	12	4	0	319.11	638.22	15	1	0.0287081339712919	-Inf	1	-0.666666666666667	4	18
C14H7orf50	2	2	0	0	42.9	85.8	15	1	1	NA	1	NA	0	4
C14ORF166B	5	3	0	0	76.56	153.12	15	1	1	NA	1	NA	0	8
C14orf180	3	3	2	0	53.13	106.26	15	1	0.464285714285714	-Inf	1	-0.5	2	6
C14ORF39	6	5	2	1	183.48	366.96	15	1	1	-0.666666666666667	1	-0.121212121212121	3	11
C15H12orf49	7	6	2	1	120.78	241.56	15	1	1	-0.714285714285714	1	-0.128205128205128	3	13
C15H12ORF65	1	2	1	0	52.14	104.28	15	1	1	-Inf	1	-0.666666666666667	1	3
C15orf39-MUC1	12	12	2	1	121.44	242.88	15	1	1	-1	1	-0.166666666666667	3	24
C16orf72	0	2	0	0	66.99	133.98	15	1	1	NA	1	NA	0	2
C17ORF80	1	3	0	0	12.54	25.08	15	1	1	NA	1	NA	0	4
C18H17orf58	2	6	0	0	110.22	220.44	15	1	1	NA	1	NA	0	8
C18H17orf62	1	6	0	0	64.02	128.04	15	1	1	NA	1	NA	0	7
C18H17orf75	0	7	0	1	137.28	274.56	15	1	1	NA	1	0	1	7
C18orf63	12	13	1	1	199.98	399.96	15	1	1	-0.0833333333333333	1	-0.02	2	25
C19H17ORF64	8	6	2	1	68.64	137.28	15	1	1	-0.5	1	-0.0952380952380952	3	14
C19H17orf78	9	3	2	1	64.35	128.7	15	1	1	0.333333333333333	1	0.0833333333333334	3	12
C19orf24	1	0	1	0	13.53	27.06	15	1	1	NA	1	0	1	1
C19orf35	4	4	0	0	75.9	151.8	15	1	1	NA	1	NA	0	8
C19orf45	7	6	1	0	104.94	209.88	15	1	1	-Inf	1	-0.461538461538462	1	13
C19orf70	3	0	2	0	27.72	55.44	15	1	1	NA	1	0	2	3
C1D	4	2	2	0	44.88	89.76	15	1	1	-Inf	1	-0.333333333333333	2	6
C1GALT1	2	7	0	2	122.76	245.52	15	1	1	1	1	0.222222222222222	2	9
C1GALT1C1	1	5	0	0	77.22	154.44	15	1	1	NA	1	NA	0	6
C1H11ORF54	2	12	0	4	127.05	254.1	15	1	1	1	1	0.142857142857143	4	14
C1H11ORF70	1	2	0	1	56.76	113.52	15	1	1	1	1	0.333333333333333	1	3
C1H11ORF87	2	2	1	0	36.63	73.26	15	1	1	-Inf	1	-0.5	1	4
C1H12ORF45	1	4	0	1	51.15	102.3	15	1	1	1	1	0.2	1	5
C1H12ORF66	0	3	0	1	149.49	298.98	15	1	1	NA	1	0	1	3
C1H12ORF73	1	1	0	1	4.62	9.24	15	1	1	1	1	0.5	1	2
C1H21ORF33	0	3	0	0	62.7	125.4	15	1	1	NA	1	NA	0	3
C1H21ORF59	1	5	0	1	76.89	153.78	15	1	1	1	1	0.166666666666667	1	6
C1H21ORF62	1	3	1	0	65.67	131.34	15	1	0.4	-Inf	1	-0.75	1	4
C1H22orf23	2	2	1	0	41.91	83.82	15	1	1	-Inf	1	-0.5	1	4
C1H2ORF40	0	2	0	0	31.02	62.04	15	1	1	NA	1	NA	0	2
C1H2ORF49	1	4	0	0	63.03	126.06	15	1	1	NA	1	NA	0	5
C1H3ORF30	2	1	0	0	44.22	88.44	15	1	1	NA	1	NA	0	3
C1H3ORF38	2	0	1	0	65.01	130.02	15	1	1	NA	1	0	1	2
C1HXORF36	0	2	0	0	81.84	163.68	15	1	1	NA	1	NA	0	2
C1HXORF59	39	25	4	2	710.82	1421.64	15	1	1	-0.282051282051282	1	-0.0572916666666666	6	64
C1orf158	10	7	3	1	83.16	166.32	15	1	1	-1.1	1	-0.161764705882353	4	17
C1orf167	31	31	3	2	467.61	935.22	15	1	1	-0.5	1	-0.1	5	62
C1orf186	1	3	0	0	27.72	55.44	15	1	1	NA	1	NA	0	4
C1orf210	3	3	1	2	88.11	176.22	15	1	1	0.5	1	0.166666666666667	3	6
C1orf228	8	6	3	0	86.13	172.26	15	1	0.514705882352941	-Inf	1	-0.428571428571429	3	14
C1QA	3	6	1	4	48.18	96.36	15	1	1	0.5	1	0.133333333333333	5	9
C1QBP	0	3	0	0	51.15	102.3	15	1	1	NA	1	NA	0	3
C1QC	3	2	1	1	40.92	81.84	15	1	1	0.333333333333333	1	0.1	2	5
C1QL4	0	2	0	0	18.81	37.62	15	1	1	NA	1	NA	0	2
C1QTNF2	1	4	1	1	84.48	168.96	15	1	1	-3	1	-0.3	2	5
C1QTNF3	0	5	0	0	83.16	166.32	15	1	1	NA	1	NA	0	5
C1QTNF4	4	6	1	2	149.82	299.64	15	1	1	0.25	1	0.0666666666666667	3	10
C1QTNF5	0	2	0	1	13.53	27.06	15	1	1	NA	1	0	1	2
C1QTNF6	0	2	0	0	73.92	147.84	15	1	1	NA	1	NA	0	2
C1QTNF7	0	5	0	0	129.03	258.06	15	1	1	NA	1	NA	0	5
C1QTNF8	1	2	1	0	54.12	108.24	15	1	1	-Inf	1	-0.666666666666667	1	3
C1QTNF9	1	1	0	0	62.7	125.4	15	1	1	NA	1	NA	0	2
C1R	7	8	1	1	220.77	441.54	15	1	1	-0.142857142857143	1	-0.0333333333333333	2	15
C1S	9	14	4	2	229.02	458.04	15	1	0.363984674329502	-2.11111111111111	1	-0.27536231884058	6	23
C20H20ORF112	1	9	1	5	99.33	198.66	15	1	1	-0.8	1	-0.0666666666666667	6	10
C20H20ORF195	11	9	3	0	151.14	302.28	15	1	0.25296442687747	-Inf	1	-0.45	3	20
C20H20ORF85	1	1	0	0	36.3	72.6	15	1	1	NA	1	NA	0	2
C20H20orf96	9	12	3	3	87.78	175.56	15	1	1	-0.333333333333333	1	-0.0714285714285715	6	21
C21H1orf159	0	2	0	2	68.97	137.94	15	1	1	NA	1	0	2	2
C21H1orf174	5	0	0	0	58.41	116.82	15	1	1	NA	1	NA	0	5
C21H1orf50	0	4	0	0	30.36	60.72	15	1	1	NA	1	NA	0	4
C21orf140	5	4	1	1	96.36	192.72	15	1	1	0.2	1	0.0555555555555556	2	9
C22H2ORF42	0	5	0	3	42.24	84.48	15	1	1	NA	1	0	3	5
C22H8ORF4	0	2	0	0	21.78	43.56	15	1	1	NA	1	NA	0	2
C23H1ORF109	3	2	1	0	12.54	25.08	15	1	1	-Inf	1	-0.4	1	5
C23H1ORF94	8	6	4	0	128.37	256.74	15	1	0.245098039215686	-Inf	1	-0.428571428571429	4	14
C24H11orf1	2	1	1	1	46.53	93.06	15	1	1	0.5	1	0.166666666666667	2	3
C24H11orf34	0	3	0	0	42.57	85.14	15	1	1	NA	1	NA	0	3
C24H11orf57	3	2	1	2	64.35	128.7	15	1	1	0.666666666666667	1	0.266666666666667	3	5
C26H1orf116	3	3	0	2	73.59	147.18	15	1	0.464285714285714	1	1	0.5	2	6
C26H1orf74	2	1	0	0	12.54	25.08	15	1	1	NA	1	NA	0	3
C26H6orf106	0	4	0	3	80.85	161.7	15	1	1	NA	1	0	3	4
C28H19ORF44	17	13	0	1	204.27	408.54	15	1	0.451612903225806	1	1	0.566666666666667	1	30
C2CD2	5	8	1	0	169.29	338.58	15	1	0.428571428571428	-Inf	1	-0.615384615384615	1	13
C2CD2L	8	5	0	1	177.21	354.42	15	1	0.428571428571428	1	1	0.615384615384615	1	13
C2CD3	55	55	20	10	633.93	1267.86	15	1	0.147771181006217	-1	1	-0.166666666666667	30	110
C2CD4A	0	7	0	0	132.33	264.66	15	1	1	NA	1	NA	0	7
C2CD4C	0	7	0	0	38.61	77.22	15	1	1	NA	1	NA	0	7
C2CD5	1	10	0	0	265.98	531.96	15	1	1	NA	1	NA	0	11
C2H18ORF21	5	3	1	1	81.18	162.36	15	1	1	0.4	1	0.125	2	8
C2H18ORF8	2	9	0	2	205.26	410.52	15	1	1	1	1	0.181818181818182	2	11
C2H7orf31	13	10	0	2	141.57	283.14	15	1	0.22	1	1	0.565217391304348	2	23
C2H7ORF57	4	1	0	0	43.56	87.12	15	1	1	NA	1	NA	0	5
C2H8ORF22	2	1	0	0	27.06	54.12	15	1	1	NA	1	NA	0	3
C2H8ORF34	6	3	0	0	132.33	264.66	15	1	1	NA	1	NA	0	9
C2H8ORF37	1	4	0	1	46.86	93.72	15	1	1	1	1	0.2	1	5
C2H8ORF46	4	4	0	1	55.44	110.88	15	1	1	1	1	0.5	1	8
C2H8ORF76	6	9	1	3	125.07	250.14	15	1	1	0.5	1	0.15	4	15
C2orf71	18	21	5	3	344.52	689.04	15	1	0.461396797045655	-0.944444444444444	1	-0.163461538461538	8	39
C3AR1	11	11	4	1	168.3	336.6	15	1	0.341880341880342	-3	1	-0.3	5	22
C3H1ORF131	1	1	0	0	46.86	93.72	15	1	1	NA	1	NA	0	2
C3H1ORF198	1	2	1	0	89.1	178.2	15	1	1	-Inf	1	-0.666666666666667	1	3
C3H2ORF3-GCFC2-LOC112530730	15	8	3	0	225.39	450.78	15	1	0.529230769230769	-Inf	1	-0.347826086956522	3	23
C3H2ORF70	2	1	0	0	21.45	42.9	15	1	1	NA	1	NA	0	3
C3H6orf120	1	4	1	2	50.49	100.98	15	1	1	-1	1	-0.133333333333333	3	5
C3H6ORF203	6	6	1	0	101.31	202.62	15	1	1	-Inf	1	-0.5	1	12
C3H8ORF80	11	14	3	5	167.31	334.62	15	1	1	0.236363636363636	1	0.065	8	25
C3orf33	4	7	2	1	90.42	180.84	15	1	0.538461538461539	-2.5	1	-0.303030303030303	3	11
C3orf70	0	2	0	1	41.25	82.5	15	1	1	NA	1	0	1	2
C4A	21	20	2	2	479.16	958.32	15	1	1	0.0476190476190477	1	0.0121951219512195	4	41
C4BPA	25	43	6	7	557.04	1114.08	15	1	0.546982438506146	-0.474285714285714	1	-0.0938914027149321	13	68
C4H20ORF194	8	16	4	3	342.54	685.08	15	1	0.383866974701235	-1.66666666666667	1	-0.238095238095238	7	24
C4H2orf81	5	0	2	0	17.16	34.32	15	1	1	NA	1	0	2	5
C4H4orf17	12	11	1	1	109.23	218.46	15	1	1	0.0833333333333334	1	0.0217391304347826	2	23
C4H4ORF32	0	2	0	0	31.02	62.04	15	1	1	NA	1	NA	0	2
C4H4orf33	0	2	0	0	23.1	46.2	15	1	1	NA	1	NA	0	2
C4H4ORF47	10	10	1	3	150.81	301.62	15	1	0.596273291925466	0.666666666666667	1	0.25	4	20
C4H4ORF50	39	13	3	1	556.38	1112.76	15	1	1	0	1	0	4	52
C4HCXorf57	9	4	1	0	228.36	456.72	15	1	1	-Inf	1	-0.307692307692308	1	13
C4HXorf56	0	2	0	0	34.98	69.96	15	1	1	NA	1	NA	0	2
C4ORF19	10	5	3	2	100.65	201.3	15	1	1	0.25	1	0.0666666666666667	5	15
C5	12	17	1	5	477.84	955.68	15	1	0.377134724857685	0.716666666666667	1	0.247126436781609	6	29
C5H11orf16	8	9	1	1	124.41	248.82	15	1	1	-0.125	1	-0.0294117647058824	2	17
C5H11orf74	8	2	1	0	83.82	167.64	15	1	1	-Inf	1	-0.2	1	10
C5H11ORF9	2	9	0	4	276.87	553.74	15	1	1	1	1	0.181818181818182	4	11
C5H14ORF105	8	4	2	2	76.23	152.46	15	1	0.604395604395604	0.5	1	0.166666666666667	4	12
C5H14orf159	7	10	1	0	250.8	501.6	15	1	0.444444444444444	-Inf	1	-0.588235294117647	1	17
C5H14orf166	0	10	0	1	54.12	108.24	15	1	1	NA	1	0	1	10
C5H14ORF169	2	5	0	2	95.37	190.74	15	1	1	1	1	0.285714285714286	2	7
C5H14orf37	9	22	0	2	246.51	493.02	15	1	1	1	1	0.290322580645161	2	31
C5H14orf4	0	2	0	0	48.51	97.02	15	1	1	NA	1	NA	0	2
C5H14orf79	13	2	2	1	102.3	204.6	15	1	0.442401960784314	0.692307692307692	1	0.2	3	15
C5H15orf41	0	2	0	1	36.96	73.92	15	1	1	NA	1	0	1	2
C5H15orf52	4	4	0	1	231.66	463.32	15	1	1	1	1	0.5	1	8
C5H15orf57	0	4	0	0	62.04	124.08	15	1	1	NA	1	NA	0	4
C5H15ORF62	2	6	0	3	74.91	149.82	15	1	1	1	1	0.25	3	8
C5NT1AL	2	4	0	2	78.87	157.74	15	1	1	1	1	0.333333333333333	2	6
C6	7	11	1	3	227.04	454.08	15	1	1	0.476190476190476	1	0.138888888888889	4	18
C6H10orf53	1	1	0	0	21.78	43.56	15	1	1	NA	1	NA	0	2
C6H10ORF71	29	14	5	1	457.71	915.42	15	1	0.651777454737677	-1.41379310344828	1	-0.158914728682171	6	43
C6H10ORF88	6	4	3	0	122.43	244.86	15	1	0.496503496503497	-Inf	1	-0.4	3	10
C6H10ORF90	15	9	1	0	202.62	405.24	15	1	1	-Inf	1	-0.375	1	24
C6orf132	8	12	1	0	133.65	267.3	15	1	0.428571428571429	-Inf	1	-0.6	1	20
C6orf58	7	10	1	1	110.88	221.76	15	1	1	-0.428571428571429	1	-0.0882352941176471	2	17
C7	13	9	1	0	261.36	522.72	15	1	1	-Inf	1	-0.409090909090909	1	22
C7H2ORF47	1	1	1	0	47.52	95.04	15	1	1	-Inf	1	-0.5	1	2
C7H2ORF69	5	3	0	1	138.6	277.2	15	1	0.444444444444444	1	1	0.625	1	8
C7H2ORF76	0	5	0	1	51.48	102.96	15	1	1	NA	1	0	1	5
C8A	4	8	0	1	168.3	336.6	15	1	1	1	1	0.333333333333333	1	12
C8B	5	18	1	6	345.84	691.68	15	1	1	0.4	1	0.0745341614906832	7	23
C8G	1	1	0	0	24.42	48.84	15	1	1	NA	1	NA	0	2
C8H14ORF80	3	3	0	1	113.52	227.04	15	1	1	1	1	0.5	1	6
C8H1ORF112	4	10	2	2	198.99	397.98	15	1	0.568627450980392	-1.5	1	-0.214285714285714	4	14
C8H1ORF146	1	1	0	0	39.27	78.54	15	1	1	NA	1	NA	0	2
C8H1orf168	13	5	3	0	136.29	272.58	15	1	0.548872180451128	-Inf	1	-0.277777777777778	3	18
C8H1orf27	3	6	1	1	109.56	219.12	15	1	1	-1	1	-0.166666666666667	2	9
C8H1orf52	1	0	1	0	17.82	35.64	15	1	1	NA	1	0	1	1
C8orf59	2	1	0	0	20.46	40.92	15	1	1	NA	1	NA	0	3
C9H21orf2	1	2	0	1	50.49	100.98	15	1	1	1	1	0.333333333333333	1	3
C9H2orf54	4	2	2	1	36.96	73.92	15	1	1	0	1	0	3	6
C9H2ORF82	0	2	0	0	21.45	42.9	15	1	1	NA	1	NA	0	2
C9H3orf58	1	1	0	0	76.23	152.46	15	1	1	NA	1	NA	0	2
C9orf116	1	0	1	0	4.95	9.9	15	1	1	NA	1	0	1	1
C9ORF58	0	2	0	1	25.74	51.48	15	1	1	NA	1	0	1	2
C9orf69	0	2	0	1	34.98	69.96	15	1	1	NA	1	0	1	2
C9orf84	35	15	5	4	355.74	711.48	15	1	0.450292878388552	0.464285714285714	1	0.144444444444444	9	50
C9orf85	2	0	1	0	24.42	48.84	15	1	1	NA	1	0	1	2
CA10	0	4	0	0	86.79	173.58	15	1	1	NA	1	NA	0	4
CA12	3	5	1	1	119.46	238.92	15	1	1	-0.666666666666667	1	-0.125	2	8
CA13	0	3	0	0	54.45	108.9	15	1	1	NA	1	NA	0	3
CA15L	5	3	2	0	25.74	51.48	15	1	1	-Inf	1	-0.375	2	8
CA2	3	5	1	0	89.1	178.2	15	1	0.444444444444444	-Inf	1	-0.625	1	8
CA3A	3	3	1	0	51.48	102.96	15	1	1	-Inf	1	-0.5	1	6
CA3B	2	4	1	0	101.31	202.62	15	1	0.428571428571428	-Inf	1	-0.666666666666667	1	6
CA4	4	5	0	2	95.37	190.74	15	1	0.490909090909091	1	1	0.444444444444444	2	9
CA5A	0	3	0	0	59.4	118.8	15	1	1	NA	1	NA	0	3
CA6	3	0	0	0	85.8	171.6	15	1	1	NA	1	NA	0	3
CA7	1	3	0	0	85.47	170.94	15	1	1	NA	1	NA	0	4
CA8	0	1	0	1	51.81	103.62	15	1	1	NA	1	0	1	1
CA9	2	4	0	3	42.24	84.48	15	1	0.5	1	1	0.333333333333333	3	6
CAAP1	1	2	0	0	52.14	104.28	15	1	1	NA	1	NA	0	3
CAB39	0	3	0	0	83.49	166.98	15	1	1	NA	1	NA	0	3
CAB39L	0	5	0	2	103.29	206.58	15	1	1	NA	1	0	2	5
CABIN1	4	34	0	7	637.23	1274.46	15	1	1	1	1	0.105263157894737	7	38
CABLES2	7	8	0	1	130.35	260.7	15	1	1	1	1	0.466666666666667	1	15
CABYR	25	8	1	0	149.16	298.32	15	1	1	-Inf	1	-0.242424242424242	1	33
CACFD1	0	3	0	2	35.64	71.28	15	1	1	NA	1	0	2	3
CACNA1B	1	22	0	7	517.44	1034.88	15	1	1	1	1	0.0434782608695652	7	23
CACNA1C	2	13	2	4	277.86	555.72	15	1	0.543859649122807	-2.25	1	-0.2	6	15
CACNA1D	5	24	4	5	628.65	1257.3	15	1	0.173561685533622	-2.84	1	-0.272030651340996	9	29
CACNA1E	7	33	6	18	381.15	762.3	15	1	0.530000408897237	-0.571428571428571	1	-0.075	24	40
CACNA1G	7	24	2	8	575.19	1150.38	15	1	1	0.142857142857143	1	0.0258064516129032	10	31
CACNA1H	8	32	3	9	641.19	1282.38	15	1	0.701227615801607	-0.333333333333333	1	-0.05	12	40
CACNA1I	12	26	2	6	577.83	1155.66	15	1	1	0.277777777777778	1	0.0657894736842105	8	38
CACNA1S	14	27	9	10	485.1	970.2	15	1	0.39701542592581	-0.735714285714286	1	-0.132220795892169	19	41
CACNA2D1	0	3	0	1	201.63	403.26	15	1	1	NA	1	0	1	3
CACNA2D2	2	5	0	3	127.71	255.42	15	1	1	1	1	0.285714285714286	3	7
CACNA2D4	3	17	1	3	244.53	489.06	15	1	0.544042913608131	-0.888888888888889	1	-0.1	4	20
CACNG1	0	2	0	0	44.55	89.1	15	1	1	NA	1	NA	0	2
CACNG3	2	2	1	2	55.44	110.88	15	1	1	0.5	1	0.166666666666667	3	4
CACNG4	1	2	0	0	121.77	243.54	15	1	1	NA	1	NA	0	3
CACNG5	0	7	0	2	66.99	133.98	15	1	1	NA	1	0	2	7
CACTIN	2	2	1	0	173.25	346.5	15	1	1	-Inf	1	-0.5	1	4
CACYBP	1	2	0	1	58.08	116.16	15	1	1	1	1	0.333333333333333	1	3
CADM1	1	2	0	1	140.91	281.82	15	1	1	1	1	0.333333333333333	1	3
CADM3	3	1	0	0	61.71	123.42	15	1	1	NA	1	NA	0	4
CADNL	20	10	3	0	326.7	653.4	15	1	0.536290322580645	-Inf	1	-0.333333333333333	3	30
CADPS	0	3	0	1	171.93	343.86	15	1	1	NA	1	0	1	3
CADPS2	6	15	0	0	333.96	667.92	15	1	1	NA	1	NA	0	21
CALCOCO2	7	7	1	1	161.04	322.08	15	1	1	0	1	0	2	14
CALCR	0	6	0	0	140.25	280.5	15	1	1	NA	1	NA	0	6
CALCRL	0	7	0	0	154.11	308.22	15	1	1	NA	1	NA	0	7
CALD1	3	3	0	0	126.72	253.44	15	1	1	NA	1	NA	0	6
CALHM1	0	3	0	0	36.63	73.26	15	1	1	NA	1	NA	0	3
CALHM2	0	6	0	1	104.28	208.56	15	1	1	NA	1	0	1	6
CALHM3	8	5	2	0	97.68	195.36	15	1	0.523809523809524	-Inf	1	-0.384615384615385	2	13
CALML3	0	3	0	2	52.47	104.94	15	1	1	NA	1	0	2	3
CALML4	0	4	0	0	38.61	77.22	15	1	1	NA	1	NA	0	4
CAMK1G	0	4	0	0	114.18	228.36	15	1	1	NA	1	NA	0	4
CAMK2A	3	2	3	1	81.51	163.02	15	1	1	-1	1	-0.15	4	5
CAMK2D	1	4	0	1	126.72	253.44	15	1	1	1	1	0.2	1	5
CAMK2G	0	6	0	3	173.58	347.16	15	1	1	NA	1	0	3	6
CAMK4L	0	5	0	1	49.17	98.34	15	1	1	NA	1	0	1	5
CAMKK1	7	10	2	2	151.8	303.6	15	1	1	-0.428571428571429	1	-0.0882352941176471	4	17
CAMKK2	1	6	0	4	114.84	229.68	15	1	1	1	1	0.142857142857143	4	7
CAMLG	1	3	1	0	50.16	100.32	15	1	0.4	-Inf	1	-0.75	1	4
CAMSAP1	6	27	4	6	543.84	1087.68	15	1	0.205614067243467	-2	1	-0.218181818181818	10	33
CAMSAP2	10	22	2	2	519.75	1039.5	15	1	0.587675070028011	-1.2	1	-0.1875	4	32
CAMTA1	4	19	0	0	464.64	929.28	15	1	1	NA	1	NA	0	23
CAND1	0	13	0	2	390.06	780.12	15	1	1	NA	1	0	2	13
CAND2	8	21	1	2	408.21	816.42	15	1	1	-0.3125	1	-0.0574712643678161	3	29
CANT1	1	2	1	0	70.95	141.9	15	1	1	-Inf	1	-0.666666666666667	1	3
CANX	2	4	0	1	189.09	378.18	15	1	1	1	1	0.333333333333333	1	6
CAP1	1	8	0	0	124.74	249.48	15	1	1	NA	1	NA	0	9
CAP2	2	10	1	2	151.47	302.94	15	1	0.516483516483516	-1.5	1	-0.166666666666667	3	12
CAPG	1	0	1	0	12.54	25.08	15	1	1	NA	1	0	1	1
CAPN10	5	10	2	2	224.73	449.46	15	1	0.602683178534572	-1	1	-0.166666666666667	4	15
CAPN11	0	6	0	3	144.21	288.42	15	1	1	NA	1	0	3	6
CAPN13	10	11	3	0	227.04	454.08	15	1	0.222826086956522	-Inf	1	-0.523809523809524	3	21
CAPN15	1	12	1	6	148.17	296.34	15	1	1	-1	1	-0.0659340659340659	7	13
CAPN2	4	12	1	1	187.44	374.88	15	1	0.490196078431373	-2	1	-0.25	2	16
CAPN3	3	14	1	2	248.82	497.64	15	1	0.508771929824561	-1.33333333333333	1	-0.156862745098039	3	17
CAPN5	4	13	2	3	280.83	561.66	15	1	0.585326953748006	-1.16666666666667	1	-0.164705882352941	5	17
CAPN6	2	10	0	1	208.89	417.78	15	1	1	1	1	0.166666666666667	1	12
CAPN7	0	10	0	2	202.62	405.24	15	1	1	NA	1	0	2	10
CAPN8	6	7	1	1	209.55	419.1	15	1	1	-0.166666666666667	1	-0.0384615384615384	2	13
CAPN9	4	6	3	1	187.77	375.54	15	1	0.559440559440559	-3.5	1	-0.35	4	10
CAPRIN2	7	12	2	2	345.51	691.02	15	1	1	-0.714285714285714	1	-0.131578947368421	4	19
CAPS2	8	7	1	2	151.8	303.6	15	1	1	0.5625	1	0.2	3	15
CAPSL	0	4	0	1	65.67	131.34	15	1	1	NA	1	0	1	4
CAPZA1	0	3	0	0	63.36	126.72	15	1	1	NA	1	NA	0	3
CAPZA3	7	1	0	0	100.32	200.64	15	1	1	NA	1	NA	0	8
CAPZB	0	4	0	0	98.34	196.68	15	1	1	NA	1	NA	0	4
CARD10	7	14	3	3	215.49	430.98	15	1	0.638187899057464	-1	1	-0.166666666666667	6	21
CARD11	0	6	0	2	353.76	707.52	15	1	1	NA	1	0	2	6
CARD9	5	7	2	0	190.08	380.16	15	1	0.461538461538462	-Inf	1	-0.583333333333333	2	12
CARF	8	8	0	0	199.65	399.3	15	1	1	NA	1	NA	0	16
CARHSP1	3	1	1	0	58.74	117.48	15	1	1	-Inf	1	-0.25	1	4
CARMIL1	9	19	3	2	564.63	1129.26	15	1	0.327535645666903	-2.16666666666667	1	-0.278571428571429	5	28
CARNMT1	4	2	1	0	78.54	157.08	15	1	1	-Inf	1	-0.333333333333333	1	6
CARS	5	17	4	2	386.76	773.52	15	1	0.0637681159420291	-5.8	1	-0.439393939393939	6	22
CARS2	5	11	0	2	158.4	316.8	15	1	1	1	1	0.3125	2	16
CARTPT	2	0	0	0	8.25	16.5	15	1	1	NA	1	NA	0	2
CASC1	9	8	1	0	227.04	454.08	15	1	1	-Inf	1	-0.470588235294118	1	17
CASC3	1	6	0	3	55.77	111.54	15	1	1	1	1	0.142857142857143	3	7
CASD1	1	11	0	2	252.78	505.56	15	1	1	1	1	0.0833333333333333	2	12
CASK	1	11	0	5	299.31	598.62	15	1	1	1	1	0.0833333333333333	5	12
CASKIN1	1	10	1	4	100.98	201.96	15	1	1	-1.5	1	-0.109090909090909	5	11
CASKIN2	7	11	4	4	184.8	369.6	15	1	0.682837528604119	-0.571428571428571	1	-0.111111111111111	8	18
CASP1	5	5	0	1	70.62	141.24	15	1	1	1	1	0.5	1	10
CASP10	4	5	0	2	146.19	292.38	15	1	0.490909090909091	1	1	0.444444444444444	2	9
CASP18	11	3	1	0	150.81	301.62	15	1	1	-Inf	1	-0.214285714285714	1	14
CASP2	3	9	1	2	98.34	196.68	15	1	1	-0.5	1	-0.0833333333333333	3	12
CASP6	4	3	1	0	88.11	176.22	15	1	1	-Inf	1	-0.428571428571429	1	7
CASP8	2	8	0	1	135.96	271.92	15	1	1	1	1	0.2	1	10
CASP8AP2	34	28	12	4	622.71	1245.42	15	1	0.166530489756359	-1.47058823529412	1	-0.201612903225806	16	62
CASP9	5	6	2	0	75.9	151.8	15	1	0.461538461538462	-Inf	1	-0.545454545454545	2	11
CASQ2	2	7	2	2	138.6	277.2	15	1	0.53006993006993	-2.5	1	-0.277777777777778	4	9
CASR	1	17	0	0	281.82	563.64	15	1	1	NA	1	NA	0	18
CAST	9	8	4	2	122.76	245.52	15	1	0.660019614253024	-0.777777777777778	1	-0.137254901960784	6	17
CASZ1	1	18	1	4	449.13	898.26	15	1	0.380434782608696	-3.5	1	-0.147368421052632	5	19
CAT	0	4	0	0	168.3	336.6	15	1	1	NA	1	NA	0	4
CATH3	0	3	0	1	10.89	21.78	15	1	1	NA	1	0	1	3
CAV1	0	4	0	3	47.52	95.04	15	1	1	NA	1	0	3	4
CAV2	1	3	1	1	27.72	55.44	15	1	1	-2	1	-0.25	2	4
CBARP	0	1	0	1	4.62	9.24	15	1	1	NA	1	0	1	1
CBFA2T2	0	8	0	3	115.17	230.34	15	1	1	NA	1	0	3	8
CBFA2T3	1	2	1	1	20.46	40.92	15	1	1	-1	1	-0.166666666666667	2	3
CBL	3	19	0	6	246.18	492.36	15	1	1	1	1	0.136363636363636	6	22
CBLL1	0	4	0	0	77.22	154.44	15	1	1	NA	1	NA	0	4
CBLN1	0	1	0	1	23.76	47.52	15	1	1	NA	1	0	1	1
CBLN4	0	3	0	0	35.64	71.28	15	1	1	NA	1	NA	0	3
CBR1	0	3	0	0	82.83	165.66	15	1	1	NA	1	NA	0	3
CBR4	1	2	1	0	77.88	155.76	15	1	1	-Inf	1	-0.666666666666667	1	3
CBS	1	7	0	0	188.43	376.86	15	1	1	NA	1	NA	0	8
CBWD1	1	7	1	0	103.62	207.24	15	1	0.222222222222222	-Inf	1	-0.875	1	8
CBX3	0	4	0	1	37.62	75.24	15	1	1	NA	1	0	1	4
CBX4	2	3	1	1	69.96	139.92	15	1	1	-0.5	1	-0.1	2	5
CBX6	0	2	0	2	28.05	56.1	15	1	1	NA	1	0	2	2
CBX7	0	1	0	1	46.86	93.72	15	1	1	NA	1	0	1	1
CBX8	1	3	1	2	35.64	71.28	15	1	1	-0.5	1	-0.0833333333333333	3	4
CC2D1B-LOC101748080	12	12	3	2	327.36	654.72	15	1	1	-0.5	1	-0.1	5	24
CC2D2A	9	18	3	1	509.52	1019.04	15	1	0.271762275544256	-5	1	-0.416666666666667	4	27
CCAH221-CCL26-CCLI7-CCLI8	2	1	0	0	30.36	60.72	15	1	1	NA	1	NA	0	3
CCBL1	5	15	3	7	214.5	429	15	1	1	-0.285714285714286	1	-0.05	10	20
CCDC102A	2	2	1	0	91.08	182.16	15	1	1	-Inf	1	-0.5	1	4
CCDC102B	4	1	0	0	33.66	67.32	15	1	1	NA	1	NA	0	5
CCDC107	4	3	2	1	90.75	181.5	15	1	1	-0.5	1	-0.0952380952380952	3	7
CCDC110	18	7	2	0	157.08	314.16	15	1	1	-Inf	1	-0.28	2	25
CCDC113	9	2	3	1	144.54	289.08	15	1	1	0.333333333333333	1	0.0681818181818182	4	11
CCDC117	2	2	0	0	113.52	227.04	15	1	1	NA	1	NA	0	4
CCDC122	6	2	1	0	59.4	118.8	15	1	1	-Inf	1	-0.25	1	8
CCDC124	0	1	0	1	17.49	34.98	15	1	1	NA	1	0	1	1
CCDC125	7	1	0	0	35.31	70.62	15	1	1	NA	1	NA	0	8
CCDC126	1	2	0	0	32.01	64.02	15	1	1	NA	1	NA	0	3
CCDC129	22	10	3	0	234.3	468.6	15	1	0.541634835752483	-Inf	1	-0.3125	3	32
CCDC13	6	11	1	2	253.44	506.88	15	1	1	0.0833333333333334	1	0.0196078431372549	3	17
CCDC137	4	0	2	0	14.19	28.38	15	1	1	NA	1	0	2	4
CCDC138	6	2	1	0	29.7	59.4	15	1	1	-Inf	1	-0.25	1	8
CCDC14	15	15	3	0	299.31	598.62	15	1	0.232954545454545	-Inf	1	-0.5	3	30
CCDC146	16	5	5	2	318.45	636.9	15	1	1	0.21875	1	0.0476190476190476	7	21
CCDC148	9	8	0	1	171.93	343.86	15	1	1	1	1	0.529411764705882	1	17
CCDC149	6	14	1	2	171.27	342.54	15	1	1	-0.166666666666667	1	-0.0333333333333333	3	20
CCDC15	4	6	0	1	87.45	174.9	15	1	1	1	1	0.4	1	10
CCDC152Z	0	2	0	1	64.68	129.36	15	1	1	NA	1	0	1	2
CCDC166	6	4	1	1	98.67	197.34	15	1	1	0.333333333333333	1	0.1	2	10
CCDC167	1	1	1	0	25.41	50.82	15	1	1	-Inf	1	-0.5	1	2
CCDC169	1	1	0	0	55.11	110.22	15	1	1	NA	1	NA	0	2
CCDC17	5	2	3	0	30.03	60.06	15	1	1	-Inf	1	-0.285714285714286	3	7
CCDC170	8	10	2	2	229.35	458.7	15	1	1	-0.25	1	-0.0555555555555556	4	18
CCDC171	4	2	0	0	313.17	626.34	15	1	1	NA	1	NA	0	6
CCDC173	3	2	2	0	80.52	161.04	15	1	1	-Inf	1	-0.4	2	5
CCDC173L	14	7	3	1	174.9	349.8	15	1	1	-0.5	1	-0.0833333333333334	4	21
CCDC174	8	9	4	2	192.39	384.78	15	1	0.64040536122916	-1.25	1	-0.196078431372549	6	17
CCDC175-LOC112532521	15	5	2	0	206.58	413.16	15	1	1	-Inf	1	-0.25	2	20
CCDC177	0	6	0	0	82.17	164.34	15	1	1	NA	1	NA	0	6
CCDC178	4	8	0	1	198.33	396.66	15	1	1	1	1	0.333333333333333	1	12
CCDC180-LOC112529956	28	19	5	1	399.3	798.6	15	1	0.390410445745787	-2.39285714285714	1	-0.23758865248227	6	47
CCDC181	6	4	0	0	127.05	254.1	15	1	1	NA	1	NA	0	10
CCDC183	13	17	1	3	157.08	314.16	15	1	0.627177850612386	0.564102564102564	1	0.183333333333333	4	30
CCDC186	11	16	0	1	305.91	611.82	15	1	1	1	1	0.407407407407407	1	27
CCDC191	18	8	2	0	289.74	579.48	15	1	1	-Inf	1	-0.307692307692308	2	26
CCDC27	6	1	0	0	94.71	189.42	15	1	1	NA	1	NA	0	7
CCDC28A	0	2	0	0	51.81	103.62	15	1	1	NA	1	NA	0	2
CCDC3	0	2	0	0	47.52	95.04	15	1	1	NA	1	NA	0	2
CCDC30	25	10	4	1	420.42	840.84	15	1	1	-0.6	1	-0.0857142857142857	5	35
CCDC33-LOC107052135	4	2	1	1	45.54	91.08	15	1	1	0.5	1	0.166666666666667	2	6
CCDC39	3	8	0	1	270.93	541.86	15	1	1	1	1	0.272727272727273	1	11
CCDC40	13	8	3	1	280.5	561	15	1	1	-0.846153846153846	1	-0.130952380952381	4	21
CCDC42	3	5	0	1	53.46	106.92	15	1	1	1	1	0.375	1	8
CCDC47	0	5	0	1	164.67	329.34	15	1	1	NA	1	0	1	5
CCDC50	8	4	1	0	174.24	348.48	15	1	1	-Inf	1	-0.333333333333333	1	12
CCDC51	5	6	1	1	137.61	275.22	15	1	1	-0.2	1	-0.0454545454545455	2	11
CCDC57	18	8	2	0	173.25	346.5	15	1	1	-Inf	1	-0.307692307692308	2	26
CCDC58	0	3	0	1	28.71	57.42	15	1	1	NA	1	0	1	3
CCDC6	0	4	0	0	100.65	201.3	15	1	1	NA	1	NA	0	4
CCDC60	4	2	1	0	42.9	85.8	15	1	1	-Inf	1	-0.333333333333333	1	6
CCDC63	8	6	3	0	147.18	294.36	15	1	0.514705882352941	-Inf	1	-0.428571428571429	3	14
CCDC65	1	1	0	1	27.72	55.44	15	1	1	1	1	0.5	1	2
CCDC66	23	7	2	0	277.53	555.06	15	1	1	-Inf	1	-0.233333333333333	2	30
CCDC69	2	3	0	2	29.7	59.4	15	1	1	1	1	0.4	2	5
CCDC71	2	12	0	3	59.07	118.14	15	1	1	1	1	0.142857142857143	3	14
CCDC73	14	13	2	2	328.68	657.36	15	1	1	0.0714285714285714	1	0.0185185185185185	4	27
CCDC77	4	9	1	1	151.14	302.28	15	1	1	-1.25	1	-0.192307692307692	2	13
CCDC80	5	12	2	2	265.98	531.96	15	1	0.574269005847953	-1.4	1	-0.205882352941176	4	17
CCDC82	8	8	1	0	135.63	271.26	15	1	1	-Inf	1	-0.5	1	16
CCDC83	9	5	0	1	201.63	403.26	15	1	0.4	1	1	0.642857142857143	1	14
CCDC84	3	5	0	1	50.49	100.98	15	1	1	1	1	0.375	1	8
CCDC85A	2	10	0	0	113.19	226.38	15	1	1	NA	1	NA	0	12
CCDC85C	1	6	1	1	99	198	15	1	0.416666666666667	-5	1	-0.357142857142857	2	7
CCDC88A	8	21	1	0	553.08	1106.16	15	1	0.3	-Inf	1	-0.724137931034483	1	29
CCDC88C	13	19	5	3	627.33	1254.66	15	1	0.429521829521829	-1.43589743589744	1	-0.21875	8	32
CCDC91	3	0	0	0	57.75	115.5	15	1	1	NA	1	NA	0	3
CCDC92	0	7	0	1	137.61	275.22	15	1	1	NA	1	0	1	7
CCDC93	3	7	0	3	148.17	296.34	15	1	0.527972027972028	1	1	0.3	3	10
CCDC96	5	1	0	0	60.72	121.44	15	1	1	NA	1	NA	0	6
CCKAR	3	5	0	0	155.1	310.2	15	1	1	NA	1	NA	0	8
CCKBR	2	5	1	3	60.72	121.44	15	1	1	0.166666666666667	1	0.0357142857142857	4	7
CCL17	3	2	0	0	31.02	62.04	15	1	1	NA	1	NA	0	5
CCL19	3	0	0	0	32.01	64.02	15	1	1	NA	1	NA	0	3
CCL20	1	1	0	0	26.4	52.8	15	1	1	NA	1	NA	0	2
CCL4	3	4	0	1	50.82	101.64	15	1	1	1	1	0.428571428571429	1	7
CCL5	2	0	0	0	29.37	58.74	15	1	1	NA	1	NA	0	2
CCLI5	1	0	1	0	9.9	19.8	15	1	1	NA	1	0	1	1
CCLL4	2	1	0	0	15.18	30.36	15	1	1	NA	1	NA	0	3
CCM2	1	1	1	0	30.36	60.72	15	1	1	-Inf	1	-0.5	1	2
CCM2L	0	1	0	1	25.74	51.48	15	1	1	NA	1	0	1	1
CCNA1	5	4	0	1	151.8	303.6	15	1	1	1	1	0.555555555555556	1	9
CCNB2	6	7	0	0	136.95	273.9	15	1	1	NA	1	NA	0	13
CCND1	0	1	0	1	25.08	50.16	15	1	1	NA	1	0	1	1
CCNE1	1	4	0	1	125.73	251.46	15	1	1	1	1	0.2	1	5
CCNE2	1	7	0	1	144.54	289.08	15	1	1	1	1	0.125	1	8
CCNF	2	6	2	2	202.95	405.9	15	1	0.547474747474747	-2	1	-0.25	4	8
CCNG1	1	3	0	0	65.01	130.02	15	1	1	NA	1	NA	0	4
CCNI	1	2	0	0	134.31	268.62	15	1	1	NA	1	NA	0	3
CCNI2	2	7	0	1	100.65	201.3	15	1	1	1	1	0.222222222222222	1	9
CCNJ	1	2	1	1	142.56	285.12	15	1	1	-1	1	-0.166666666666667	2	3
CCNJL	12	4	2	0	126.39	252.78	15	1	1	-Inf	1	-0.25	2	16
CCNK	1	4	0	0	131.01	262.02	15	1	1	NA	1	NA	0	5
CCNL1	0	13	0	1	132	264	15	1	1	NA	1	0	1	13
CCNL2	2	7	1	3	147.84	295.68	15	1	1	-0.166666666666667	1	-0.0277777777777778	4	9
CCNT2	1	2	1	1	211.2	422.4	15	1	1	-1	1	-0.166666666666667	2	3
CCNY	2	4	0	2	124.41	248.82	15	1	1	1	1	0.333333333333333	2	6
CCP110	9	13	0	0	391.71	783.42	15	1	1	NA	1	NA	0	22
CCPG1	7	6	1	1	203.28	406.56	15	1	1	0.142857142857143	1	0.0384615384615384	2	13
CCR4	1	8	0	0	135.63	271.26	15	1	1	NA	1	NA	0	9
CCR5	2	2	0	1	81.84	163.68	15	1	1	1	1	0.5	1	4
CCR6	2	5	0	3	103.95	207.9	15	1	1	1	1	0.285714285714286	3	7
CCR7	1	6	0	3	116.82	233.64	15	1	1	1	1	0.142857142857143	3	7
CCR8L	3	9	0	5	162.03	324.06	15	1	0.514705882352941	1	1	0.25	5	12
CCR9	8	10	0	1	125.07	250.14	15	1	1	1	1	0.444444444444444	1	18
CCSAP	1	3	1	2	50.82	101.64	15	1	1	-0.5	1	-0.0833333333333333	3	4
CCSER1	4	4	2	2	152.13	304.26	15	1	1	0	1	0	4	8
CCSER2	12	12	0	0	238.26	476.52	15	1	1	NA	1	NA	0	24
CCT2	2	3	1	3	134.64	269.28	15	1	1	0.5	1	0.15	4	5
CCT3-LOC101751456	3	9	0	0	132.99	265.98	15	1	1	NA	1	NA	0	12
CCT4-FAM161A	8	8	2	1	322.41	644.82	15	1	1	-1	1	-0.166666666666667	3	16
CCT5	1	9	1	1	137.28	274.56	15	1	0.318181818181818	-8	1	-0.4	2	10
CCT6A	1	10	1	2	167.31	334.62	15	1	0.395604395604396	-4	1	-0.242424242424242	3	11
CCT7	2	19	0	9	175.89	351.78	15	1	1	1	1	0.0952380952380952	9	21
CCT8	1	8	0	1	191.73	383.46	15	1	1	1	1	0.111111111111111	1	9
CCZ1	0	5	0	0	140.91	281.82	15	1	1	NA	1	NA	0	5
CD101	15	10	3	4	172.26	344.52	15	1	0.669076751946607	0.5	1	0.171428571428571	7	25
CD109	7	15	3	2	396.99	793.98	15	1	0.326148891366283	-2.21428571428571	1	-0.281818181818182	5	22
CD14	12	11	1	1	124.41	248.82	15	1	1	0.0833333333333334	1	0.0217391304347826	2	23
CD151	0	3	0	2	76.23	152.46	15	1	1	NA	1	0	2	3
CD163	9	14	0	4	343.53	687.06	15	1	0.267692307692308	1	1	0.391304347826087	4	23
CD180	11	14	2	1	161.37	322.74	15	1	0.583333333333333	-1.54545454545455	1	-0.226666666666667	3	25
CD1B	7	4	1	0	39.6	79.2	15	1	1	-Inf	1	-0.363636363636364	1	11
CD1C	1	5	0	2	28.05	56.1	15	1	1	1	1	0.166666666666667	2	6
CD2	4	2	0	0	84.15	168.3	15	1	1	NA	1	NA	0	6
CD200	12	18	1	2	218.79	437.58	15	1	1	0.25	1	0.0666666666666667	3	30
CD200R1-CD200R1L	10	5	1	0	179.52	359.04	15	1	1	-Inf	1	-0.333333333333333	1	15
CD244	2	4	0	1	35.31	70.62	15	1	1	1	1	0.333333333333333	1	6
CD247	1	6	0	2	58.08	116.16	15	1	1	1	1	0.142857142857143	2	7
CD274	9	5	0	0	102.96	205.92	15	1	1	NA	1	NA	0	14
CD276	1	9	1	2	73.59	147.18	15	1	0.423076923076923	-3.5	1	-0.233333333333333	3	10
CD28	0	2	0	0	89.43	178.86	15	1	1	NA	1	NA	0	2
CD2AP	5	3	0	0	177.21	354.42	15	1	1	NA	1	NA	0	8
CD300LF	0	2	0	0	15.18	30.36	15	1	1	NA	1	NA	0	2
CD300LG	6	2	3	1	30.69	61.38	15	1	1	0	1	0	4	8
CD320	0	2	0	0	27.39	54.78	15	1	1	NA	1	NA	0	2
CD34	7	7	1	1	84.81	169.62	15	1	1	0	1	0	2	14
CD36	1	10	0	0	151.14	302.28	15	1	1	NA	1	NA	0	11
CD38	3	2	1	0	78.87	157.74	15	1	1	-Inf	1	-0.4	1	5
CD3D	7	4	0	0	39.93	79.86	15	1	1	NA	1	NA	0	11
CD3E	2	3	2	0	42.24	84.48	15	1	0.428571428571428	-Inf	1	-0.6	2	5
CD4	15	3	2	1	127.38	254.76	15	1	0.488721804511278	0.6	1	0.166666666666667	3	18
CD40LG	3	7	0	1	102.96	205.92	15	1	1	1	1	0.3	1	10
CD44	8	8	0	1	168.96	337.92	15	1	1	1	1	0.5	1	16
CD47	3	0	0	0	73.26	146.52	15	1	1	NA	1	NA	0	3
CD5-CD6	1	2	0	0	37.95	75.9	15	1	1	NA	1	NA	0	3
CD7	20	4	2	1	166.32	332.64	15	1	0.473504273504274	0.6	1	0.166666666666667	3	24
CD72	2	1	1	0	17.49	34.98	15	1	1	-Inf	1	-0.333333333333333	1	3
CD74	1	1	0	0	19.14	38.28	15	1	1	NA	1	NA	0	2
CD79B	2	5	0	1	62.04	124.08	15	1	1	1	1	0.285714285714286	1	7
CD80	2	9	0	2	100.65	201.3	15	1	1	1	1	0.181818181818182	2	11
CD81	3	5	0	1	71.94	143.88	15	1	1	1	1	0.375	1	8
CD86	3	1	1	0	78.54	157.08	15	1	1	-Inf	1	-0.25	1	4
CD8A-LOC100857817-LOC100857839-LOC100858172-LOC101752184-LOC107049163-LOC107049196-LOC107049200-LOC107053306-LOC107053324-LOC107056303-LOC112529934-LOC422924-LOC771798-LOC771804-LOC771880-LOC777408-TCD8AL1-TCD8AL4	8	3	2	0	62.37	124.74	15	1	1	-Inf	1	-0.272727272727273	2	11
CD8B	4	1	1	0	35.97	71.94	15	1	1	-Inf	1	-0.2	1	5
CD9	0	2	0	1	63.03	126.06	15	1	1	NA	1	0	1	2
CD99	0	4	0	0	45.54	91.08	15	1	1	NA	1	NA	0	4
CD99L2	3	9	0	2	96.36	192.72	15	1	1	1	1	0.25	2	12
CDADC1	3	6	0	0	138.93	277.86	15	1	1	NA	1	NA	0	9
CDAN1	10	25	0	1	434.61	869.22	15	1	1	1	1	0.285714285714286	1	35
CDC123	2	2	2	0	92.4	184.8	15	1	0.466666666666667	-Inf	1	-0.5	2	4
CDC14A	4	6	3	2	160.71	321.42	15	1	0.608391608391608	-1.25	1	-0.2	5	10
CDC14B	5	7	3	0	94.71	189.42	15	1	0.2	-Inf	1	-0.583333333333333	3	12
CDC16	1	14	0	1	167.97	335.94	15	1	1	1	1	0.0666666666666667	1	15
CDC20	4	7	1	1	143.22	286.44	15	1	1	-0.75	1	-0.136363636363636	2	11
CDC20B	4	3	2	0	99.99	199.98	15	1	0.5	-Inf	1	-0.428571428571429	2	7
CDC23	1	8	1	1	169.62	339.24	15	1	0.345454545454545	-7	1	-0.388888888888889	2	9
CDC25A	5	16	1	2	167.31	334.62	15	1	1	-0.6	1	-0.0952380952380952	3	21
CDC27	0	9	0	3	233.97	467.94	15	1	1	NA	1	0	3	9
CDC34	0	2	0	0	19.47	38.94	15	1	1	NA	1	NA	0	2
CDC37L1	1	2	0	0	47.85	95.7	15	1	1	NA	1	NA	0	3
CDC40	0	4	0	0	151.8	303.6	15	1	1	NA	1	NA	0	4
CDC42BPA	4	12	2	1	365.97	731.94	15	1	0.2218782249742	-5	1	-0.416666666666667	3	16
CDC42BPB	0	20	0	5	534.93	1069.86	15	1	1	NA	1	0	5	20
CDC42EP1	0	4	0	1	74.58	149.16	15	1	1	NA	1	0	1	4
CDC42EP3	0	3	0	0	85.47	170.94	15	1	1	NA	1	NA	0	3
CDC42EP4	1	5	0	4	45.54	91.08	15	1	1	1	1	0.166666666666667	4	6
CDC42SE2	2	0	0	0	27.39	54.78	15	1	1	NA	1	NA	0	2
CDC45	0	3	0	1	149.49	298.98	15	1	1	NA	1	0	1	3
CDC5L	0	17	0	1	253.11	506.22	15	1	1	NA	1	0	1	17
CDC7	3	8	0	0	192.72	385.44	15	1	1	NA	1	NA	0	11
CDC73	0	4	0	0	81.51	163.02	15	1	1	NA	1	NA	0	4
CDCA2	44	13	5	2	328.35	656.7	15	1	0.662344216552552	0.261363636363636	1	0.0576441102756892	7	57
CDCA3	2	4	0	1	18.81	37.62	15	1	1	1	1	0.333333333333333	1	6
CDCA4	5	6	0	3	129.69	259.38	15	1	0.258241758241758	1	1	0.454545454545455	3	11
CDCA4L	0	1	0	1	77.22	154.44	15	1	1	NA	1	0	1	1
CDCA7	2	6	0	2	131.67	263.34	15	1	1	1	1	0.25	2	8
CDCA7L	3	8	0	1	130.02	260.04	15	1	1	1	1	0.272727272727273	1	11
CDCA9	5	1	0	0	69.96	139.92	15	1	1	NA	1	NA	0	6
CDCP1	10	13	4	2	289.41	578.82	15	1	0.389846743295019	-1.6	1	-0.231884057971014	6	23
CDCP2	4	11	1	0	121.77	243.54	15	1	0.3125	-Inf	1	-0.733333333333333	1	15
CDH11	1	16	0	0	278.19	556.38	15	1	1	NA	1	NA	0	17
CDH12	1	2	0	0	187.11	374.22	15	1	1	NA	1	NA	0	3
CDH13	4	3	0	0	128.37	256.74	15	1	1	NA	1	NA	0	7
CDH18	8	8	0	0	208.56	417.12	15	1	1	NA	1	NA	0	16
CDH19	5	2	1	0	157.08	314.16	15	1	1	-Inf	1	-0.285714285714286	1	7
CDH2	5	11	0	0	306.24	612.48	15	1	1	NA	1	NA	0	16
CDH20	3	10	0	3	207.57	415.14	15	1	1	1	1	0.230769230769231	3	13
CDH22	5	9	2	1	193.38	386.76	15	1	0.536764705882353	-2.6	1	-0.309523809523809	3	14
CDH23	12	42	4	15	676.5	1353	15	1	1	0.0666666666666667	1	0.0116959064327485	19	54
CDH4	1	4	0	1	202.95	405.9	15	1	1	1	1	0.2	1	5
CDH5	0	13	0	0	279.84	559.68	15	1	1	NA	1	NA	0	13
CDH6	1	9	0	1	266.97	533.94	15	1	1	1	1	0.1	1	10
CDH7	2	5	1	1	227.37	454.74	15	1	1	-1.5	1	-0.214285714285714	2	7
CDH8	2	9	1	0	238.59	477.18	15	1	0.25	-Inf	1	-0.818181818181818	1	11
CDHR1	8	15	3	1	284.13	568.26	15	1	0.272934472934473	-4.625	1	-0.402173913043478	4	23
CDHR2	16	8	2	3	182.49	364.98	15	1	0.338638373121132	0.666666666666667	1	0.266666666666667	5	24
CDHR3	18	13	2	2	292.71	585.42	15	1	1	0.277777777777778	1	0.0806451612903226	4	31
CDK1	0	10	0	1	108.9	217.8	15	1	1	NA	1	0	1	10
CDK11A	1	5	1	1	184.8	369.6	15	1	0.464285714285714	-4	1	-0.333333333333333	2	6
CDK12	4	4	2	1	255.75	511.5	15	1	1	-1	1	-0.166666666666667	3	8
CDK13	10	20	1	4	395.34	790.68	15	1	1	0.5	1	0.133333333333333	5	30
CDK15	6	4	2	0	88.77	177.54	15	1	0.515151515151515	-Inf	1	-0.4	2	10
CDK17	0	7	0	0	166.65	333.3	15	1	1	NA	1	NA	0	7
CDK18	3	10	2	2	139.92	279.84	15	1	0.53781512605042	-2.33333333333333	1	-0.269230769230769	4	13
CDK19	1	2	0	0	131.34	262.68	15	1	1	NA	1	NA	0	3
CDK2AP1	0	2	0	0	43.56	87.12	15	1	1	NA	1	NA	0	2
CDK3	4	5	3	2	92.73	185.46	15	1	1	-0.875	1	-0.155555555555556	5	9
CDK5RAP1	13	11	2	3	234.3	468.6	15	1	0.651340996168582	0.435897435897436	1	0.141666666666667	5	24
CDK5RAP2	18	23	2	3	529.98	1059.96	15	1	1	0.148148148148148	1	0.0390243902439024	5	41
CDK5RAP3	3	3	0	2	25.74	51.48	15	1	0.464285714285714	1	1	0.5	2	6
CDK6	3	0	0	0	49.5	99	15	1	1	NA	1	NA	0	3
CDK7	0	8	0	1	102.3	204.6	15	1	1	NA	1	0	1	8
CDK8	0	4	0	2	114.84	229.68	15	1	1	NA	1	0	2	4
CDKAL1	8	8	4	2	179.52	359.04	15	1	0.646174259177355	-1	1	-0.166666666666667	6	16
CDKL1	0	4	0	1	108.57	217.14	15	1	1	NA	1	0	1	4
CDKL2	5	7	1	3	141.9	283.8	15	1	1	0.533333333333333	1	0.166666666666667	4	12
CDKL5	4	16	1	3	325.38	650.76	15	1	1	-0.333333333333333	1	-0.05	4	20
CDKN2B	0	2	0	0	17.82	35.64	15	1	1	NA	1	NA	0	2
CDKN3	2	6	0	2	43.23	86.46	15	1	1	1	1	0.25	2	8
CDO1	0	2	0	0	52.8	105.6	15	1	1	NA	1	NA	0	2
CDON	15	23	3	0	419.43	838.86	15	1	0.076547842401501	-Inf	1	-0.605263157894737	3	38
CDR2	1	4	0	0	152.79	305.58	15	1	1	NA	1	NA	0	5
CDR2L	0	7	0	0	76.89	153.78	15	1	1	NA	1	NA	0	7
CDRT1	26	12	5	4	253.44	506.88	15	1	0.465844628699341	0.423076923076923	1	0.128654970760234	9	38
CDV3	1	2	0	0	36.63	73.26	15	1	1	NA	1	NA	0	3
CDYL	1	4	0	1	104.94	209.88	15	1	1	1	1	0.2	1	5
CDYL2	0	3	0	0	191.4	382.8	15	1	1	NA	1	NA	0	3
CECR2	9	9	0	0	351.78	703.56	15	1	1	NA	1	NA	0	18
CECR5L	6	7	3	0	149.16	298.32	15	1	0.2125	-Inf	1	-0.538461538461538	3	13
CEL	6	11	0	1	206.91	413.82	15	1	1	1	1	0.352941176470588	1	17
CELA3B	0	1	0	1	12.54	25.08	15	1	1	NA	1	0	1	1
CELF1	0	4	0	1	157.74	315.48	15	1	1	NA	1	0	1	4
CELF5	1	3	0	0	160.38	320.76	15	1	1	NA	1	NA	0	4
CELF6	0	4	0	3	56.1	112.2	15	1	1	NA	1	0	3	4
CELSR1	5	21	2	2	560.67	1121.34	15	1	0.224521072796935	-3.2	1	-0.307692307692308	4	26
CEMIP	4	21	1	3	418.11	836.22	15	1	0.552608311229001	-0.75	1	-0.09	4	25
CENPC	26	13	0	1	289.41	578.82	15	1	0.35	1	1	0.666666666666667	1	39
CENPE	27	35	3	5	654.72	1309.44	15	1	1	0.222222222222222	1	0.0604838709677419	8	62
CENPF	48	35	4	4	674.52	1349.04	15	1	0.720522853759476	0.270833333333333	1	0.0783132530120482	8	83
CENPI	15	8	1	1	207.57	415.14	15	1	1	0.466666666666667	1	0.152173913043478	2	23
CENPJ	10	23	0	4	379.83	759.66	15	1	0.55712014535544	1	1	0.303030303030303	4	33
CENPK	9	3	0	0	56.43	112.86	15	1	1	NA	1	NA	0	12
CENPL	2	7	0	1	79.86	159.72	15	1	1	1	1	0.222222222222222	1	9
CENPM	3	2	0	1	36.96	73.92	15	1	1	1	1	0.6	1	5
CENPN	3	1	0	0	79.53	159.06	15	1	1	NA	1	NA	0	4
CENPO	10	6	0	1	68.97	137.94	15	1	0.411764705882353	1	1	0.625	1	16
CENPP	4	3	0	0	46.86	93.72	15	1	1	NA	1	NA	0	7
CENPQ	5	6	1	0	78.87	157.74	15	1	1	-Inf	1	-0.545454545454545	1	11
CENPT	12	8	1	0	163.68	327.36	15	1	1	-Inf	1	-0.4	1	20
CENPV	0	3	0	1	52.47	104.94	15	1	1	NA	1	0	1	3
CEP104	6	19	3	2	276.54	553.08	15	1	0.143236074270557	-3.75	1	-0.36	5	25
CEP112	10	11	3	0	281.16	562.32	15	1	0.222826086956522	-Inf	1	-0.523809523809524	3	21
CEP120	2	9	0	2	223.74	447.48	15	1	1	1	1	0.181818181818182	2	11
CEP126	17	4	3	0	191.73	383.46	15	1	1	-Inf	1	-0.19047619047619	3	21
CEP128	14	7	3	0	333.63	667.26	15	1	0.529644268774704	-Inf	1	-0.333333333333333	3	21
CEP135	17	16	3	4	351.12	702.24	15	1	1	0.294117647058823	1	0.0865800865800866	7	33
CEP152	21	7	3	0	665.28	1330.56	15	1	1	-Inf	1	-0.25	3	28
CEP164	34	24	8	3	560.67	1121.34	15	1	0.508193420080181	-0.882352941176471	1	-0.141065830721003	11	58
CEP170	6	19	2	3	436.92	873.84	15	1	0.589350623833382	-1.11111111111111	1	-0.16	5	25
CEP170B	8	25	0	1	384.45	768.9	15	1	1	1	1	0.242424242424242	1	33
CEP19	2	3	1	0	50.49	100.98	15	1	1	-Inf	1	-0.6	1	5
CEP192	40	34	7	4	749.1	1498.2	15	1	0.747382782608812	-0.4875	1	-0.0958230958230958	11	74
CEP250	24	23	8	3	677.49	1354.98	15	1	0.313583891020824	-1.55555555555556	1	-0.216634429400387	11	47
CEP295	36	37	8	4	606.54	1213.08	15	1	0.354905734343964	-1.05555555555556	1	-0.17351598173516	12	73
CEP350	38	44	8	3	1017.39	2034.78	15	1	0.1196278358744	-2.08771929824561	1	-0.263858093126386	11	82
CEP350L	70	31	16	5	829.29	1658.58	15	1	0.608322466241963	-0.417142857142857	1	-0.0688354549740688	21	101
CEP41	5	4	1	1	107.91	215.82	15	1	1	0.2	1	0.0555555555555556	2	9
CEP44	4	6	0	1	121.77	243.54	15	1	1	1	1	0.4	1	10
CEP55	2	5	1	0	122.43	244.86	15	1	0.375	-Inf	1	-0.714285714285714	1	7
CEP57	3	3	1	1	155.43	310.86	15	1	1	0	1	0	2	6
CEP57L1	6	6	0	2	144.21	288.42	15	1	0.472527472527472	1	1	0.5	2	12
CEP63	7	6	0	1	218.79	437.58	15	1	1	1	1	0.538461538461538	1	13
CEP68	16	17	4	6	183.81	367.62	15	1	0.727906622971853	0.291666666666667	1	0.0848484848484848	10	33
CEP70	6	14	2	1	160.05	320.1	15	1	0.268774703557312	-3.66666666666667	1	-0.366666666666667	3	20
CEP76	4	11	2	1	184.47	368.94	15	1	0.245098039215686	-4.5	1	-0.4	3	15
CEP78	6	9	0	0	187.44	374.88	15	1	1	NA	1	NA	0	15
CEP83	7	13	2	2	246.18	492.36	15	1	0.614624505928854	-0.857142857142857	1	-0.15	4	20
CEP85	6	10	2	3	243.21	486.42	15	1	1	-0.111111111111111	1	-0.025	5	16
CEP85L	8	13	1	4	271.26	542.52	15	1	0.627850410459106	0.59375	1	0.180952380952381	5	21
CEP95	12	6	1	2	259.05	518.1	15	1	0.530827067669173	0.75	1	0.333333333333333	3	18
CEP97	10	5	0	0	298.98	597.96	15	1	1	NA	1	NA	0	15
CEPT1	2	12	0	2	130.68	261.36	15	1	1	1	1	0.142857142857143	2	14
CER1	2	5	0	0	66.33	132.66	15	1	1	NA	1	NA	0	7
CERK	3	5	2	2	152.46	304.92	15	1	1	-0.666666666666667	1	-0.125	4	8
CERKL	5	7	2	1	140.91	281.82	15	1	0.569230769230769	-1.8	1	-0.25	3	12
CERS1	0	3	0	1	47.85	95.7	15	1	1	NA	1	0	1	3
CERS2	1	4	0	1	108.24	216.48	15	1	1	1	1	0.2	1	5
CERS3	5	6	0	0	211.53	423.06	15	1	1	NA	1	NA	0	11
CERS4	14	13	1	2	197.01	394.02	15	1	1	0.535714285714286	1	0.185185185185185	3	27
CERS4L	5	5	2	0	112.53	225.06	15	1	0.46969696969697	-Inf	1	-0.5	2	10
CERS5	3	3	2	1	89.76	179.52	15	1	1	-1	1	-0.166666666666667	3	6
CERS6	7	4	0	0	146.19	292.38	15	1	1	NA	1	NA	0	11
CES1L1-CES1L2-LOC769704	5	3	0	0	134.31	268.62	15	1	1	NA	1	NA	0	8
CETN1	0	3	0	0	29.7	59.4	15	1	1	NA	1	NA	0	3
CETN3	2	1	0	0	38.61	77.22	15	1	1	NA	1	NA	0	3
CFAP100	22	6	1	0	210.21	420.42	15	1	1	-Inf	1	-0.214285714285714	1	28
CFAP161	1	4	0	0	49.83	99.66	15	1	1	NA	1	NA	0	5
CFAP20	0	1	0	1	48.84	97.68	15	1	1	NA	1	0	1	1
CFAP206	8	6	2	1	188.76	377.52	15	1	1	-0.5	1	-0.0952380952380952	3	14
CFAP221	21	14	3	1	317.46	634.92	15	1	1	-1	1	-0.15	4	35
CFAP36	2	4	0	0	102.96	205.92	15	1	1	NA	1	NA	0	6
CFAP43	33	18	2	2	574.53	1149.06	15	1	0.616190936945654	0.454545454545455	1	0.147058823529412	4	51
CFAP44	30	27	3	3	612.48	1224.96	15	1	1	0.1	1	0.0263157894736842	6	57
CFAP52	5	11	2	1	202.29	404.58	15	1	0.523219814241486	-3.4	1	-0.354166666666667	3	16
CFAP54	56	30	6	2	909.15	1818.3	15	1	0.711663733117028	-0.607142857142857	1	-0.0988372093023255	8	86
CFAP57	15	12	2	1	391.38	782.76	15	1	1	-0.6	1	-0.111111111111111	3	27
CFAP58	9	8	1	0	305.91	611.82	15	1	1	-Inf	1	-0.470588235294118	1	17
CFAP61	17	16	3	5	417.78	835.56	15	1	0.696516403833477	0.435294117647059	1	0.140151515151515	8	33
CFAP65	28	25	7	5	575.52	1151.04	15	1	0.760715695880435	-0.25	1	-0.0550314465408805	12	53
CFAP69	8	8	4	2	452.43	904.86	15	1	0.646174259177355	-1	1	-0.166666666666667	6	16
CFAP73	2	0	0	0	24.09	48.18	15	1	1	NA	1	NA	0	2
CFAP74	29	25	6	2	491.37	982.74	15	1	0.447378840003612	-1.58620689655172	1	-0.212962962962963	8	54
CFAP77	6	5	1	1	74.25	148.5	15	1	1	0.166666666666667	1	0.0454545454545454	2	11
CFAP99	5	7	2	0	172.26	344.52	15	1	0.461538461538462	-Inf	1	-0.583333333333333	2	12
CFC1	0	3	0	0	43.56	87.12	15	1	1	NA	1	NA	0	3
CFDP1	2	4	1	0	63.03	126.06	15	1	0.428571428571428	-Inf	1	-0.666666666666667	1	6
CFH	25	8	2	3	292.38	584.76	15	1	0.134053336839715	0.786666666666667	1	0.357575757575758	5	33
CFI	14	8	2	1	197.34	394.68	15	1	1	-0.142857142857143	1	-0.0303030303030303	3	22
CFLAR	6	2	0	0	167.64	335.28	15	1	1	NA	1	NA	0	8
CFTR	5	20	2	3	460.02	920.04	15	1	0.565035858139306	-1.66666666666667	1	-0.2	5	25
CG-16	2	5	1	2	55.44	110.88	15	1	1	-0.25	1	-0.0476190476190476	3	7
CGA	0	3	0	0	35.97	71.94	15	1	1	NA	1	NA	0	3
CGGBP1	0	4	0	1	60.72	121.44	15	1	1	NA	1	0	1	4
CGN	5	6	0	0	103.29	206.58	15	1	1	NA	1	NA	0	11
CGNL1	12	20	7	3	418.77	837.54	15	1	0.143458387360826	-2.88888888888889	1	-0.325	10	32
CGNRHRL	3	3	2	1	58.74	117.48	15	1	1	-1	1	-0.166666666666667	3	6
CGRRF1	2	5	1	0	89.1	178.2	15	1	0.375	-Inf	1	-0.714285714285714	1	7
CGTL	0	6	0	2	126.06	252.12	15	1	1	NA	1	0	2	6
CH25H	3	4	0	1	79.86	159.72	15	1	1	1	1	0.428571428571429	1	7
CHAD	1	2	1	0	67.32	134.64	15	1	1	-Inf	1	-0.666666666666667	1	3
CHADL	10	16	4	4	142.89	285.78	15	1	0.689172031774924	-0.6	1	-0.115384615384615	8	26
CHAF1A	6	29	1	6	219.12	438.24	15	1	1	0.194444444444444	1	0.0285714285714286	7	35
CHAF1B	5	6	2	1	172.92	345.84	15	1	1	-1.4	1	-0.212121212121212	3	11
CHAMP1	5	11	1	2	223.74	447.48	15	1	1	-0.1	1	-0.0208333333333333	3	16
CHAT	3	6	0	0	193.38	386.76	15	1	1	NA	1	NA	0	9
CHCHD1	3	1	2	0	30.36	60.72	15	1	1	-Inf	1	-0.25	2	4
CHCHD3	5	6	0	1	119.13	238.26	15	1	1	1	1	0.454545454545455	1	11
CHCHD6	3	4	0	1	83.49	166.98	15	1	1	1	1	0.428571428571429	1	7
CHD1L	7	19	3	7	397.32	794.64	15	1	1	-0.163265306122449	1	-0.0307692307692308	10	26
CHD1Z-CHDB1	8	14	5	4	412.83	825.66	15	1	0.432768776901872	-1.1875	1	-0.191919191919192	9	22
CHD2	4	20	1	1	613.14	1226.28	15	1	0.353846153846154	-4	1	-0.333333333333333	2	24
CHD4	0	15	0	4	573.21	1146.42	15	1	1	NA	1	0	4	15
CHD5	2	40	1	11	519.42	1038.84	15	1	0.537171423963877	-0.818181818181818	1	-0.0357142857142857	12	42
CHD7	3	22	1	4	1003.86	2007.72	15	1	0.538405400474366	-0.833333333333333	1	-0.08	5	25
CHD9	4	42	1	5	977.13	1954.26	15	1	0.472575953458306	-1.1	1	-0.0797101449275362	6	46
CHDH	3	9	1	1	185.79	371.58	15	1	0.505494505494505	-2	1	-0.25	2	12
CHEK2	2	5	0	0	158.4	316.8	15	1	1	NA	1	NA	0	7
CHERP	1	8	0	1	245.19	490.38	15	1	1	1	1	0.111111111111111	1	9
CHFR	2	2	0	0	185.13	370.26	15	1	1	NA	1	NA	0	4
CHGA	7	1	2	0	78.54	157.08	15	1	1	-Inf	1	-0.125	2	8
CHGB	9	11	4	3	136.95	273.9	15	1	0.677616747181965	-0.62962962962963	1	-0.121428571428571	7	20
CHIA-CHIA-M31-LOC768786	14	13	8	4	276.21	552.42	15	1	0.494032408381685	-0.857142857142857	1	-0.148148148148148	12	27
CHIC2	1	1	1	0	42.57	85.14	15	1	1	-Inf	1	-0.5	1	2
CHID1	2	7	0	0	119.79	239.58	15	1	1	NA	1	NA	0	9
CHKA	1	8	1	2	113.52	227.04	15	1	0.454545454545454	-3	1	-0.222222222222222	3	9
CHL1	5	19	1	4	380.82	761.64	15	1	1	0.05	1	0.00833333333333333	5	24
CHM	5	7	2	2	213.51	427.02	15	1	1	-0.4	1	-0.0833333333333333	4	12
CHMP1A	0	4	0	0	26.73	53.46	15	1	1	NA	1	NA	0	4
CHMP1B	0	3	0	0	41.58	83.16	15	1	1	NA	1	NA	0	3
CHMP2B	0	5	0	0	57.09	114.18	15	1	1	NA	1	NA	0	5
CHMP3	1	7	0	1	81.51	163.02	15	1	1	1	1	0.125	1	8
CHMP4B	0	3	0	0	58.74	117.48	15	1	1	NA	1	NA	0	3
CHMP5	0	4	0	0	37.29	74.58	15	1	1	NA	1	NA	0	4
CHMP6	2	1	0	0	40.59	81.18	15	1	1	NA	1	NA	0	3
CHMP7	2	5	2	2	104.61	209.22	15	1	0.575757575757576	-1.5	1	-0.214285714285714	4	7
CHN1	0	5	0	2	171.6	343.2	15	1	1	NA	1	0	2	5
CHP1	1	1	0	1	52.14	104.28	15	1	1	1	1	0.5	1	2
CHPF	2	3	0	1	97.68	195.36	15	1	1	1	1	0.4	1	5
CHPF2	2	21	1	3	246.18	492.36	15	1	0.394529914529915	-2.5	1	-0.16304347826087	4	23
CHRAC1	1	5	0	0	84.81	169.62	15	1	1	NA	1	NA	0	6
CHRD	0	1	0	1	24.75	49.5	15	1	1	NA	1	0	1	1
CHRDL1	1	4	0	0	120.78	241.56	15	1	1	NA	1	NA	0	5
CHRDL2	1	3	0	1	78.21	156.42	15	1	1	1	1	0.25	1	4
CHRM2	1	1	0	0	126.06	252.12	15	1	1	NA	1	NA	0	2
CHRM3	2	13	0	2	257.07	514.14	15	1	1	1	1	0.133333333333333	2	15
CHRM4	0	5	0	2	137.61	275.22	15	1	1	NA	1	0	2	5
CHRM5	0	8	0	0	231.66	463.32	15	1	1	NA	1	NA	0	8
CHRNA1	2	10	2	0	183.15	366.3	15	1	0.0659340659340659	-Inf	1	-0.833333333333333	2	12
CHRNA10	0	2	0	1	34.32	68.64	15	1	1	NA	1	0	1	2
CHRNA3	2	4	0	1	129.03	258.06	15	1	1	1	1	0.333333333333333	1	6
CHRNA4	1	10	1	2	187.11	374.22	15	1	0.395604395604396	-4	1	-0.242424242424242	3	11
CHRNA5	1	5	0	1	136.95	273.9	15	1	1	1	1	0.166666666666667	1	6
CHRNA6	1	7	0	1	113.19	226.38	15	1	1	1	1	0.125	1	8
CHRNA7	1	12	0	2	172.92	345.84	15	1	1	1	1	0.0769230769230769	2	13
CHRNA7L	3	8	1	1	150.15	300.3	15	1	1	-1.66666666666667	1	-0.227272727272727	2	11
CHRNA9	2	7	2	3	133.65	267.3	15	1	0.58041958041958	-1.33333333333333	1	-0.177777777777778	5	9
CHRNB2	0	2	0	2	53.13	106.26	15	1	1	NA	1	0	2	2
CHRNB3	2	9	0	2	121.77	243.54	15	1	1	1	1	0.181818181818182	2	11
CHRNB4	1	2	0	0	146.85	293.7	15	1	1	NA	1	NA	0	3
CHRND	4	2	1	1	64.02	128.04	15	1	1	0.5	1	0.166666666666667	2	6
CHRNG	2	6	1	3	66.33	132.66	15	1	1	0	1	0	4	8
CHST1	1	2	1	2	54.78	109.56	15	1	1	0	1	0	3	3
CHST10	4	1	3	0	102.96	205.92	15	1	1	-Inf	1	-0.2	3	5
CHST11	0	8	0	1	111.54	223.08	15	1	1	NA	1	0	1	8
CHST12	3	5	2	1	117.81	235.62	15	1	0.545454545454546	-2.33333333333333	1	-0.291666666666667	3	8
CHST13	2	9	1	2	65.34	130.68	15	1	1	-1.25	1	-0.151515151515151	3	11
CHST15	4	2	1	0	148.17	296.34	15	1	1	-Inf	1	-0.333333333333333	1	6
CHST2	1	2	0	1	64.35	128.7	15	1	1	1	1	0.333333333333333	1	3
CHST3	3	2	1	1	65.01	130.02	15	1	1	0.333333333333333	1	0.1	2	5
CHST6	1	7	0	0	127.38	254.76	15	1	1	NA	1	NA	0	8
CHST8	0	7	0	0	142.56	285.12	15	1	1	NA	1	NA	0	7
CHST9	3	11	0	0	124.41	248.82	15	1	1	NA	1	NA	0	14
CHSY1	1	13	0	1	180.84	361.68	15	1	1	1	1	0.0714285714285714	1	14
CHSY3	1	5	0	0	128.37	256.74	15	1	1	NA	1	NA	0	6
CHTF18	7	11	4	4	146.19	292.38	15	1	0.682837528604119	-0.571428571428571	1	-0.111111111111111	8	18
CHTOP	1	3	1	1	49.5	99	15	1	1	-2	1	-0.25	2	4
CHUK	2	11	0	0	227.04	454.08	15	1	1	NA	1	NA	0	13
CIAPIN1	4	8	1	0	106.59	213.18	15	1	0.384615384615385	-Inf	1	-0.666666666666667	1	12
CIB1	1	3	0	0	46.2	92.4	15	1	1	NA	1	NA	0	4
CIB2	1	5	0	1	65.01	130.02	15	1	1	1	1	0.166666666666667	1	6
CIB3	1	3	0	0	52.8	105.6	15	1	1	NA	1	NA	0	4
CIDEA	0	2	0	0	60.72	121.44	15	1	1	NA	1	NA	0	2
CIITA	19	8	3	0	398.97	797.94	15	1	0.544827586206897	-Inf	1	-0.296296296296296	3	27
CILP	9	23	5	6	332.97	665.94	15	1	0.456766481662478	-1.12962962962963	1	-0.173295454545455	11	32
CINP	2	2	1	0	67.65	135.3	15	1	1	-Inf	1	-0.5	1	4
CIPC	2	5	0	0	134.64	269.28	15	1	1	NA	1	NA	0	7
CIR1	2	6	0	2	154.11	308.22	15	1	1	1	1	0.25	2	8
CISD1	0	2	0	0	19.47	38.94	15	1	1	NA	1	NA	0	2
CISD2	0	3	0	2	28.38	56.76	15	1	1	NA	1	0	2	3
CISH	0	3	0	1	71.94	143.88	15	1	1	NA	1	0	1	3
CITED4	1	3	0	0	61.71	123.42	15	1	1	NA	1	NA	0	4
CIZ1	7	6	1	2	234.96	469.92	15	1	1	0.571428571428571	1	0.205128205128205	3	13
CKAP2	17	9	2	1	251.46	502.92	15	1	1	-0.0588235294117647	1	-0.0128205128205128	3	26
CKAP4	3	8	0	2	114.51	229.02	15	1	1	1	1	0.272727272727273	2	11
CKAP5	3	35	0	2	634.92	1269.84	15	1	1	1	1	0.0789473684210526	2	38
CKMT1A	2	8	2	1	106.92	213.84	15	1	0.202797202797203	-7	1	-0.466666666666667	3	10
CKMT2	1	5	0	0	97.35	194.7	15	1	1	NA	1	NA	0	6
CLASP1	1	14	1	1	422.73	845.46	15	1	0.227941176470588	-13	1	-0.433333333333333	2	15
CLASP2	9	13	0	2	366.63	733.26	15	1	0.510869565217391	1	1	0.409090909090909	2	22
CLCA1	28	22	3	1	457.38	914.76	15	1	0.628001176280866	-1.35714285714286	1	-0.19	4	50
CLCC1	8	13	1	1	182.82	365.64	15	1	1	-0.625	1	-0.119047619047619	2	21
CLCN1	8	10	5	0	293.37	586.74	15	1	0.0457368718238284	-Inf	1	-0.555555555555556	5	18
CLCN2	3	4	0	1	47.85	95.7	15	1	1	1	1	0.428571428571429	1	7
CLCN3	0	9	0	4	241.23	482.46	15	1	1	NA	1	0	4	9
CLCN4	5	9	3	1	290.4	580.8	15	1	0.274509803921569	-4.4	1	-0.392857142857143	4	14
CLCN5	1	9	1	1	253.11	506.22	15	1	0.318181818181818	-8	1	-0.4	2	10
CLCN6	0	15	0	2	261.03	522.06	15	1	1	NA	1	0	2	15
CLCNKB	1	2	0	1	25.41	50.82	15	1	1	1	1	0.333333333333333	1	3
CLDN1	0	3	0	0	38.28	76.56	15	1	1	NA	1	NA	0	3
CLDN11	1	5	1	4	54.78	109.56	15	1	1	-0.25	1	-0.0333333333333334	5	6
CLDN12	1	5	1	0	61.05	122.1	15	1	0.285714285714286	-Inf	1	-0.833333333333333	1	6
CLDN14	0	2	0	2	68.97	137.94	15	1	1	NA	1	0	2	2
CLDN15	5	2	0	0	70.95	141.9	15	1	1	NA	1	NA	0	7
CLDN16	0	4	0	0	77.22	154.44	15	1	1	NA	1	NA	0	4
CLDN16L	2	5	2	1	81.51	163.02	15	1	0.5	-4	1	-0.380952380952381	3	7
CLDN18	0	3	0	0	74.91	149.82	15	1	1	NA	1	NA	0	3
CLDN19	1	5	0	1	60.72	121.44	15	1	1	1	1	0.166666666666667	1	6
CLDN2	3	2	1	2	42.57	85.14	15	1	1	0.666666666666667	1	0.266666666666667	3	5
CLDN25	1	11	0	1	105.6	211.2	15	1	1	1	1	0.0833333333333333	1	12
CLDN3	0	4	0	0	21.12	42.24	15	1	1	NA	1	NA	0	4
CLDN34	0	5	0	0	69.96	139.92	15	1	1	NA	1	NA	0	5
CLDN4	0	2	0	0	25.74	51.48	15	1	1	NA	1	NA	0	2
CLDN5	0	3	0	0	23.43	46.86	15	1	1	NA	1	NA	0	3
CLDN8	0	3	0	1	70.29	140.58	15	1	1	NA	1	0	1	3
CLDND1	1	9	1	3	84.48	168.96	15	1	0.505494505494505	-2	1	-0.15	4	10
CLEC16A	3	10	0	2	295.68	591.36	15	1	1	1	1	0.230769230769231	2	13
CLEC18B	0	5	0	2	38.61	77.22	15	1	1	NA	1	0	2	5
CLEC3A	2	3	0	1	58.08	116.16	15	1	1	1	1	0.4	1	5
CLEC5A	2	0	0	0	5.28	10.56	15	1	1	NA	1	NA	0	2
CLGN	4	6	0	1	194.04	388.08	15	1	1	1	1	0.4	1	10
CLIC5	0	2	0	0	94.38	188.76	15	1	1	NA	1	NA	0	2
CLINT1	4	6	1	1	231	462	15	1	1	-0.5	1	-0.1	2	10
CLIP1	13	26	4	5	681.12	1362.24	15	1	0.701467355707327	-0.6	1	-0.111111111111111	9	39
CLIP2	4	14	2	5	253.77	507.54	15	1	1	-0.4	1	-0.0634920634920635	7	18
CLIP4	3	6	0	1	189.75	379.5	15	1	1	1	1	0.333333333333333	1	9
CLK1	0	9	0	3	151.14	302.28	15	1	1	NA	1	0	3	9
CLK2	0	3	0	0	124.74	249.48	15	1	1	NA	1	NA	0	3
CLK3	3	11	0	3	127.38	254.76	15	1	1	1	1	0.214285714285714	3	14
CLMN	6	12	2	0	254.76	509.52	15	1	0.147368421052632	-Inf	1	-0.666666666666667	2	18
CLMP	2	3	0	2	85.8	171.6	15	1	1	1	1	0.4	2	5
CLN5	1	6	0	1	117.48	234.96	15	1	1	1	1	0.142857142857143	1	7
CLN6	0	6	0	0	90.09	180.18	15	1	1	NA	1	NA	0	6
CLN8	3	2	0	0	63.69	127.38	15	1	1	NA	1	NA	0	5
CLNK	8	8	0	3	164.01	328.02	15	1	0.228070175438596	1	1	0.5	3	16
CLNS1A	0	7	0	1	61.71	123.42	15	1	1	NA	1	0	1	7
CLOCK	6	10	0	1	286.77	573.54	15	1	1	1	1	0.375	1	16
CLP1	0	3	0	2	63.69	127.38	15	1	1	NA	1	0	2	3
CLPS	0	1	0	1	8.58	17.16	15	1	1	NA	1	0	1	1
CLPTM1L	0	12	0	1	150.15	300.3	15	1	1	NA	1	0	1	12
CLPX	0	7	0	2	167.97	335.94	15	1	1	NA	1	0	2	7
CLRN1	0	4	0	2	63.36	126.72	15	1	1	NA	1	0	2	4
CLRN2	1	3	0	0	82.5	165	15	1	1	NA	1	NA	0	4
CLRN3	8	6	1	2	65.34	130.68	15	1	0.576470588235294	0.625	1	0.238095238095238	3	14
CLSPN	17	23	4	3	384.12	768.24	15	1	0.683844393659626	-0.803921568627451	1	-0.146428571428571	7	40
CLSTN1	2	9	0	2	310.2	620.4	15	1	1	1	1	0.181818181818182	2	11
CLSTN2	9	12	1	2	291.06	582.12	15	1	1	0.333333333333333	1	0.0952380952380952	3	21
CLSTN3	9	14	1	0	342.21	684.42	15	1	0.416666666666667	-Inf	1	-0.608695652173913	1	23
CLTB	0	1	0	1	20.46	40.92	15	1	1	NA	1	0	1	1
CLTC	0	24	0	4	602.58	1205.16	15	1	1	NA	1	0	4	24
CLTCL1	1	17	1	7	576.18	1152.36	15	1	0.529230769230769	-1.42857142857143	1	-0.0694444444444444	8	18
CLUH	3	14	0	4	423.39	846.78	15	1	1	1	1	0.176470588235294	4	17
CLUL1	11	2	3	0	103.29	206.58	15	1	1	-Inf	1	-0.153846153846154	3	13
CLVS1	0	1	0	1	46.53	93.06	15	1	1	NA	1	0	1	1
CMAS	2	1	1	0	101.64	203.28	15	1	1	-Inf	1	-0.333333333333333	1	3
CMBL	1	4	0	0	73.92	147.84	15	1	1	NA	1	NA	0	5
CMBLL	0	2	0	1	61.05	122.1	15	1	1	NA	1	0	1	2
CMC1	0	1	0	1	29.04	58.08	15	1	1	NA	1	0	1	1
CMIP	0	8	0	1	214.5	429	15	1	1	NA	1	0	1	8
CMPK1	0	2	0	1	63.36	126.72	15	1	1	NA	1	0	1	2
CMPK2	3	4	0	1	59.73	119.46	15	1	1	1	1	0.428571428571429	1	7
CMTM3	2	2	0	0	52.47	104.94	15	1	1	NA	1	NA	0	4
CMTM6	3	2	0	0	49.17	98.34	15	1	1	NA	1	NA	0	5
CMTM8	1	1	1	0	28.71	57.42	15	1	1	-Inf	1	-0.5	1	2
CMTR1	5	18	1	6	287.76	575.52	15	1	1	0.4	1	0.0745341614906832	7	23
CMYA5	104	47	9	5	1255.32	2510.64	15	1	0.7669193735252	0.186538461538462	1	0.0458845789971617	14	151
CNDP1	3	9	2	1	177.54	355.08	15	1	0.241758241758242	-5	1	-0.416666666666667	3	12
CNDP2	1	6	0	0	175.56	351.12	15	1	1	NA	1	NA	0	7
CNGA1	0	8	0	3	222.09	444.18	15	1	1	NA	1	0	3	8
CNGA2	8	14	5	4	212.19	424.38	15	1	0.432768776901872	-1.1875	1	-0.191919191919192	9	22
CNGA3	3	17	1	5	261.03	522.06	15	1	1	-0.133333333333333	1	-0.0166666666666667	6	20
CNGB1	8	14	2	1	257.73	515.46	15	1	0.543478260869565	-2.5	1	-0.303030303030303	3	22
CNGB3	4	6	0	1	246.84	493.68	15	1	1	1	1	0.4	1	10
CNIH4	1	2	0	0	37.62	75.24	15	1	1	NA	1	NA	0	3
CNKSR1	2	2	0	1	49.83	99.66	15	1	1	1	1	0.5	1	4
CNKSR2	2	16	1	3	288.42	576.84	15	1	0.47012987012987	-1.66666666666667	1	-0.138888888888889	4	18
CNKSR2L	1	7	0	1	307.56	615.12	15	1	1	1	1	0.125	1	8
CNKSR3	2	8	1	2	196.35	392.7	15	1	1	-1	1	-0.133333333333333	3	10
CNMD	4	7	1	1	121.77	243.54	15	1	1	-0.75	1	-0.136363636363636	2	11
CNN2	7	1	1	0	41.91	83.82	15	1	1	-Inf	1	-0.125	1	8
CNN3	0	2	0	0	124.08	248.16	15	1	1	NA	1	NA	0	2
CNOT10	2	13	2	3	246.84	493.68	15	1	0.248710010319917	-3.33333333333333	1	-0.266666666666667	5	15
CNOT11	0	4	0	3	92.07	184.14	15	1	1	NA	1	0	3	4
CNOT4	3	2	1	0	262.35	524.7	15	1	1	-Inf	1	-0.4	1	5
CNOT6	0	2	0	2	175.89	351.78	15	1	1	NA	1	0	2	2
CNOT7	0	6	0	1	78.54	157.08	15	1	1	NA	1	0	1	6
CNOT8	0	5	0	1	80.19	160.38	15	1	1	NA	1	0	1	5
CNOT9	0	4	0	2	57.42	114.84	15	1	1	NA	1	0	2	4
CNP	2	6	0	1	117.15	234.3	15	1	1	1	1	0.25	1	8
CNP1	2	0	0	0	21.78	43.56	15	1	1	NA	1	NA	0	2
CNPPD1	4	4	0	2	63.69	127.38	15	1	0.466666666666667	1	1	0.5	2	8
CNR1	0	6	0	1	191.73	383.46	15	1	1	NA	1	0	1	6
CNST	5	8	1	1	208.56	417.12	15	1	1	-0.6	1	-0.115384615384615	2	13
CNTF	0	4	0	1	14.52	29.04	15	1	1	NA	1	0	1	4
CNTFR	1	3	0	2	98.67	197.34	15	1	1	1	1	0.25	2	4
CNTLN	9	7	1	0	185.13	370.26	15	1	1	-Inf	1	-0.4375	1	16
CNTN1	1	12	1	1	301.95	603.9	15	1	0.257142857142857	-11	1	-0.423076923076923	2	13
CNTN2	6	15	1	5	284.46	568.92	15	1	1	0.5	1	0.119047619047619	6	21
CNTN3	9	16	5	7	306.24	612.48	15	1	1	-0.26984126984127	1	-0.0566666666666667	12	25
CNTN4	2	19	0	3	320.76	641.52	15	1	1	1	1	0.0952380952380952	3	21
CNTN5	5	3	1	0	51.81	103.62	15	1	1	-Inf	1	-0.375	1	8
CNTN6	16	9	3	1	323.4	646.8	15	1	1	-0.6875	1	-0.11	4	25
CNTNAP1	0	7	0	4	114.84	229.68	15	1	1	NA	1	0	4	7
CNTNAP2	2	2	0	0	98.34	196.68	15	1	1	NA	1	NA	0	4
CNTNAP5	11	25	1	3	404.25	808.5	15	1	1	0.242424242424242	1	0.0555555555555556	4	36
CNTRL	24	28	4	4	597.63	1195.26	15	1	1	-0.166666666666667	1	-0.0384615384615384	8	52
COA7	2	3	2	0	53.46	106.92	15	1	0.428571428571428	-Inf	1	-0.6	2	5
COBLL1	14	10	1	2	389.73	779.46	15	1	0.569230769230769	0.642857142857143	1	0.25	3	24
COCH	2	6	0	1	215.82	431.64	15	1	1	1	1	0.25	1	8
COG1	7	12	5	4	167.97	335.94	15	1	0.431884057971014	-1.14285714285714	1	-0.187134502923977	9	19
COG3	0	10	0	0	200.64	401.28	15	1	1	NA	1	NA	0	10
COG5	5	10	4	0	228.69	457.38	15	1	0.0325077399380804	-Inf	1	-0.666666666666667	4	15
COG6	1	3	1	1	212.85	425.7	15	1	1	-2	1	-0.25	2	4
COG7	2	10	1	1	204.93	409.86	15	1	0.395604395604396	-4	1	-0.333333333333333	2	12
COG8	0	2	0	1	26.07	52.14	15	1	1	NA	1	0	1	2
COIL	5	7	0	0	138.27	276.54	15	1	1	NA	1	NA	0	12
COL10A1	0	10	0	3	186.12	372.24	15	1	1	NA	1	0	3	10
COL11A1	5	21	2	1	575.19	1150.38	15	1	0.136015325670498	-7.4	1	-0.474358974358974	3	26
COL12A1	6	34	1	2	1035.54	2071.08	15	1	0.421440726035167	-1.83333333333333	1	-0.183333333333333	3	40
COL13A1	6	13	4	3	174.24	348.48	15	1	0.369169960474308	-1.88888888888889	1	-0.255639097744361	7	19
COL14A1	11	31	2	2	510.18	1020.36	15	1	0.565352207617122	-1.81818181818182	1	-0.238095238095238	4	42
COL15A1	20	5	3	2	452.76	905.52	15	1	0.565035858139306	0.625	1	0.2	5	25
COL16A1	1	1	1	1	48.18	96.36	15	1	1	0	1	0	2	2
COL17A1	16	28	5	2	546.15	1092.3	15	1	0.109106491810415	-3.375	1	-0.350649350649351	7	44
COL18A1	3	8	2	5	140.25	280.5	15	1	1	-0.0666666666666667	1	-0.012987012987013	7	11
COL19A1	9	5	0	0	129.36	258.72	15	1	1	NA	1	NA	0	14
COL1A1	2	1	0	1	22.11	44.22	15	1	1	1	1	0.666666666666667	1	3
COL1A2	0	15	0	5	456.39	912.78	15	1	1	NA	1	0	5	15
COL20A1	16	29	7	10	428.01	856.02	15	1	0.771247443840337	-0.26875	1	-0.0562091503267974	17	45
COL21A1	4	13	0	1	290.07	580.14	15	1	1	1	1	0.235294117647059	1	17
COL22A1	18	29	7	4	586.08	1172.16	15	1	0.179365000908315	-1.81944444444444	1	-0.253384912959381	11	47
COL23A1	2	0	0	0	8.91	17.82	15	1	1	NA	1	NA	0	2
COL24A1	20	14	1	3	530.64	1061.28	15	1	0.306780464675201	0.766666666666667	1	0.338235294117647	4	34
COL26A1	2	6	1	3	133.32	266.64	15	1	1	0	1	0	4	8
COL28A1	18	21	4	5	474.21	948.42	15	1	1	0.0666666666666667	1	0.0170940170940171	9	39
COL2A1L	26	18	12	5	281.49	562.98	15	1	0.557838160474778	-0.661538461538462	1	-0.114973262032086	17	44
COL3A1	4	20	0	1	430.98	861.96	15	1	1	1	1	0.166666666666667	1	24
COL4A1	5	20	2	3	557.04	1114.08	15	1	0.565035858139306	-1.66666666666667	1	-0.2	5	25
COL4A2	10	26	4	6	526.02	1052.04	15	1	0.464634621999785	-0.733333333333333	1	-0.122222222222222	10	36
COL4A3	22	20	5	3	495.33	990.66	15	1	0.7105393369619	-0.515151515151515	1	-0.101190476190476	8	42
COL4A3BP	0	2	0	0	159.72	319.44	15	1	1	NA	1	NA	0	2
COL4A4	22	18	6	1	502.59	1005.18	15	1	0.215411752230616	-3.90909090909091	1	-0.307142857142857	7	40
COL4A5	6	17	0	2	517.11	1034.22	15	1	1	1	1	0.260869565217391	2	23
COL4A6	12	20	2	3	518.43	1036.86	15	1	1	-0.111111111111111	1	-0.025	5	32
COL5A1	4	28	1	8	526.02	1052.04	15	1	1	0.125	1	0.0138888888888889	9	32
COL5A2	3	16	0	3	376.86	753.72	15	1	1	1	1	0.157894736842105	3	19
COL6A1	5	9	5	4	186.78	373.56	15	1	0.417283618252793	-1.25	1	-0.198412698412698	9	14
COL6A2	3	13	0	5	316.14	632.28	15	1	0.548872180451128	1	1	0.1875	5	16
COL6A3	11	58	4	3	1020.69	2041.38	15	1	0.025127548418266	-6.03030303030303	1	-0.412008281573499	7	69
COL6A6	59	35	10	8	780.45	1560.9	15	1	0.603306744342217	0.258474576271186	1	0.0721040189125295	18	94
COL8A1	1	8	1	2	104.28	208.56	15	1	0.454545454545454	-3	1	-0.222222222222222	3	9
COL8A2	1	7	1	1	86.46	172.92	15	1	0.377777777777778	-6	1	-0.375	2	8
COL9A1	5	12	3	0	220.77	441.54	15	1	0.0491228070175438	-Inf	1	-0.705882352941176	3	17
COL9A2	0	4	0	2	36.96	73.92	15	1	1	NA	1	0	2	4
COL9A3	2	4	0	2	200.97	401.94	15	1	1	1	1	0.333333333333333	2	6
COLCA2	0	4	0	1	45.87	91.74	15	1	1	NA	1	0	1	4
COLEC10	2	6	1	1	105.93	211.86	15	1	1	-2	1	-0.25	2	8
COLEC11	1	6	0	1	99.99	199.98	15	1	1	1	1	0.142857142857143	1	7
COLEC12	4	10	3	3	269.94	539.88	15	1	0.612616099071208	-1.5	1	-0.214285714285714	6	14
COLGALT2	3	6	2	1	201.3	402.6	15	1	0.522727272727273	-3	1	-0.333333333333333	3	9
COLQ	3	10	2	1	174.57	349.14	15	1	0.214285714285714	-5.66666666666667	1	-0.435897435897436	3	13
COMMD1	2	1	2	0	39.93	79.86	15	1	1	-Inf	1	-0.333333333333333	2	3
COMMD2	1	2	0	0	55.44	110.88	15	1	1	NA	1	NA	0	3
COMMD5	1	1	0	0	71.94	143.88	15	1	1	NA	1	NA	0	2
COMMD6	3	6	2	0	32.67	65.34	15	1	0.181818181818182	-Inf	1	-0.666666666666667	2	9
COMMD7	0	3	0	1	63.03	126.06	15	1	1	NA	1	0	1	3
COMMD8	0	2	0	0	24.09	48.18	15	1	1	NA	1	NA	0	2
COMMD9	2	4	1	3	62.7	125.4	15	1	1	0.333333333333333	1	0.0833333333333333	4	6
COMT	3	1	0	0	99.66	199.32	15	1	1	NA	1	NA	0	4
COMTD1	1	2	1	1	79.2	158.4	15	1	1	-1	1	-0.166666666666667	2	3
COPA	0	13	0	5	294.03	588.06	15	1	1	NA	1	0	5	13
COPB1	7	29	1	6	357.72	715.44	15	1	1	0.30952380952381	1	0.0515873015873016	7	36
COPB2	1	12	1	2	301.62	603.24	15	1	0.35	-5	1	-0.256410256410256	3	13
COPE	0	4	0	1	46.2	92.4	15	1	1	NA	1	0	1	4
COPG2	1	11	1	2	247.5	495	15	1	0.371428571428571	-4.5	1	-0.25	3	12
COPRS	6	0	2	0	58.74	117.48	15	1	1	NA	1	0	2	6
COPS2	0	2	0	0	106.59	213.18	15	1	1	NA	1	NA	0	2
COPS4	0	7	0	1	105.93	211.86	15	1	1	NA	1	0	1	7
COPS7B	0	4	0	0	109.89	219.78	15	1	1	NA	1	NA	0	4
COPS8	2	0	0	0	48.84	97.68	15	1	1	NA	1	NA	0	2
COQ2	3	6	0	0	123.42	246.84	15	1	1	NA	1	NA	0	9
COQ3	3	3	0	0	104.28	208.56	15	1	1	NA	1	NA	0	6
COQ6	3	5	2	1	114.18	228.36	15	1	0.545454545454546	-2.33333333333333	1	-0.291666666666667	3	8
COQ8A	1	7	0	0	206.91	413.82	15	1	1	NA	1	NA	0	8
COQ9	1	2	1	0	84.81	169.62	15	1	1	-Inf	1	-0.666666666666667	1	3
COR8	6	4	1	2	89.43	178.86	15	1	0.559440559440559	0.666666666666667	1	0.266666666666667	3	10
CORIN	10	18	2	2	405.57	811.14	15	1	0.619577308120134	-0.8	1	-0.142857142857143	4	28
CORO1C	1	8	0	4	159.72	319.44	15	1	1	1	1	0.111111111111111	4	9
CORO2A	8	6	1	1	152.46	304.92	15	1	1	0.25	1	0.0714285714285714	2	14
CORO2B	1	4	0	2	57.75	115.5	15	1	1	1	1	0.2	2	5
COTL1	0	2	0	1	36.96	73.92	15	1	1	NA	1	0	1	2
COX10	2	4	0	1	60.06	120.12	15	1	1	1	1	0.333333333333333	1	6
COX18	3	5	1	0	62.04	124.08	15	1	0.444444444444444	-Inf	1	-0.625	1	8
COX20	0	2	0	1	33.66	67.32	15	1	1	NA	1	0	1	2
COX5A	0	2	0	1	33	66	15	1	1	NA	1	0	1	2
COX7B	0	2	0	0	18.48	36.96	15	1	1	NA	1	NA	0	2
CP	14	8	2	0	369.27	738.54	15	1	0.536231884057971	-Inf	1	-0.363636363636364	2	22
CPA1	2	3	1	0	34.65	69.3	15	1	1	-Inf	1	-0.6	1	5
CPA2	2	5	0	1	123.09	246.18	15	1	1	1	1	0.285714285714286	1	7
CPA5	3	10	0	4	68.31	136.62	15	1	0.541176470588235	1	1	0.230769230769231	4	13
CPA6	2	8	1	0	149.16	298.32	15	1	0.272727272727273	-Inf	1	-0.8	1	10
CPAMD8	2	26	0	5	598.95	1197.9	15	1	1	1	1	0.0714285714285714	5	28
CPB1	1	2	0	0	86.79	173.58	15	1	1	NA	1	NA	0	3
CPB2	0	2	0	0	146.52	293.04	15	1	1	NA	1	NA	0	2
CPD	7	28	2	6	308.88	617.76	15	1	1	-0.333333333333333	1	-0.05	8	35
CPE	1	7	0	1	130.68	261.36	15	1	1	1	1	0.125	1	8
CPEB1	1	8	1	2	143.88	287.76	15	1	0.454545454545454	-3	1	-0.222222222222222	3	9
CPEB2	0	2	0	1	133.98	267.96	15	1	1	NA	1	0	1	2
CPEB3	0	2	0	0	157.74	315.48	15	1	1	NA	1	NA	0	2
CPEB4	0	5	0	1	184.47	368.94	15	1	1	NA	1	0	1	5
CPED1	6	2	0	0	113.52	227.04	15	1	1	NA	1	NA	0	8
CPLX2	0	2	0	2	9.57	19.14	15	1	1	NA	1	0	2	2
CPLX3	0	1	0	1	7.92	15.84	15	1	1	NA	1	0	1	1
CPLX4	0	3	0	1	57.42	114.84	15	1	1	NA	1	0	1	3
CPM	7	11	0	3	137.61	275.22	15	1	0.521052631578947	1	1	0.388888888888889	3	18
CPN1	1	7	0	1	107.25	214.5	15	1	1	1	1	0.125	1	8
CPNE1	4	9	3	0	142.56	285.12	15	1	0.0624999999999999	-Inf	1	-0.692307692307692	3	13
CPNE2	1	10	1	1	173.25	346.5	15	1	0.294871794871795	-9	1	-0.409090909090909	2	11
CPNE3	4	2	0	0	157.74	315.48	15	1	1	NA	1	NA	0	6
CPNE7	0	3	0	2	27.06	54.12	15	1	1	NA	1	0	2	3
CPNE8	0	5	0	0	165	330	15	1	1	NA	1	NA	0	5
CPNE9	2	2	2	1	39.6	79.2	15	1	1	-1	1	-0.166666666666667	3	4
CPO	6	6	0	0	145.86	291.72	15	1	1	NA	1	NA	0	12
CPOX	0	2	0	1	58.74	117.48	15	1	1	NA	1	0	1	2
CPPED1	2	3	0	0	89.76	179.52	15	1	1	NA	1	NA	0	5
CPQ	2	2	0	0	89.43	178.86	15	1	1	NA	1	NA	0	4
CPS1	8	17	1	0	462.99	925.98	15	1	0.346153846153846	-Inf	1	-0.68	1	25
CPSF2	0	9	0	1	255.09	510.18	15	1	1	NA	1	0	1	9
CPSF3	0	8	0	1	153.45	306.9	15	1	1	NA	1	0	1	8
CPSF4	0	2	0	0	64.68	129.36	15	1	1	NA	1	NA	0	2
CPSF4L	1	2	0	0	10.23	20.46	15	1	1	NA	1	NA	0	3
CPT2	3	9	0	3	209.88	419.76	15	1	1	1	1	0.25	3	12
CPXM2	7	12	0	1	228.36	456.72	15	1	1	1	1	0.368421052631579	1	19
CPZ	5	12	2	0	177.87	355.74	15	1	0.12280701754386	-Inf	1	-0.705882352941176	2	17
CR1L	25	19	2	6	225.06	450.12	15	1	0.133738601823708	0.746666666666667	1	0.318181818181818	8	44
CRACR2B	9	15	3	2	226.05	452.1	15	1	0.622079070354932	-1.5	1	-0.225	5	24
CRAMP1	4	20	0	4	349.14	698.28	15	1	1	1	1	0.166666666666667	4	24
CRAT	1	12	0	4	198.99	397.98	15	1	1	1	1	0.0769230769230769	4	13
CRB1	15	19	2	1	439.56	879.12	15	1	0.584298584298584	-1.53333333333333	1	-0.225490196078431	3	34
CRB2	21	24	3	3	478.5	957	15	1	1	-0.142857142857143	1	-0.0333333333333333	6	45
CRBN	0	5	0	2	103.95	207.9	15	1	1	NA	1	0	2	5
CRCBL	26	21	6	3	401.28	802.56	15	1	0.717551438572526	-0.615384615384615	1	-0.113475177304964	9	47
CRCP	0	2	0	0	37.29	74.58	15	1	1	NA	1	NA	0	2
CREB1	0	2	0	0	108.24	216.48	15	1	1	NA	1	NA	0	2
CREB3	2	2	0	1	45.54	91.08	15	1	1	1	1	0.5	1	4
CREB3L1	1	3	0	1	161.04	322.08	15	1	1	1	1	0.25	1	4
CREB3L2	3	7	2	3	201.3	402.6	15	1	1	-0.555555555555556	1	-0.1	5	10
CREB3L3	1	4	0	2	15.84	31.68	15	1	1	1	1	0.2	2	5
CREBRF	0	8	0	4	202.62	405.24	15	1	1	NA	1	0	4	8
CREG1	0	2	0	0	30.69	61.38	15	1	1	NA	1	NA	0	2
CREG2	1	5	0	2	67.32	134.64	15	1	1	1	1	0.166666666666667	2	6
CRELD2	3	2	1	0	95.7	191.4	15	1	1	-Inf	1	-0.4	1	5
CREM	2	2	0	1	115.5	231	15	1	1	1	1	0.5	1	4
CRH	1	0	1	0	33	66	15	1	1	NA	1	0	1	1
CRHR1	0	10	0	1	100.32	200.64	15	1	1	NA	1	0	1	10
CRHR2	0	3	0	1	105.27	210.54	15	1	1	NA	1	0	1	3
CRIM1	0	13	0	1	245.52	491.04	15	1	1	NA	1	0	1	13
CRIPT	0	3	0	1	26.4	52.8	15	1	1	NA	1	0	1	3
CRISP2	2	2	0	0	85.8	171.6	15	1	1	NA	1	NA	0	4
CRISPLD1	2	5	0	0	142.23	284.46	15	1	1	NA	1	NA	0	7
CRISPLD2	1	8	1	2	154.11	308.22	15	1	0.454545454545454	-3	1	-0.222222222222222	3	9
CRK	0	2	0	1	60.39	120.78	15	1	1	NA	1	0	1	2
CRLF2	4	7	0	0	122.76	245.52	15	1	1	NA	1	NA	0	11
CRLF3	1	6	1	2	134.97	269.94	15	1	1	-2	1	-0.19047619047619	3	7
CRMP1	0	5	0	0	164.34	328.68	15	1	1	NA	1	NA	0	5
CRNKL1	7	10	1	2	228.36	456.72	15	1	1	0.285714285714286	1	0.0784313725490196	3	17
CROCC	1	1	1	0	22.77	45.54	15	1	1	-Inf	1	-0.5	1	2
CROT	9	10	1	1	214.5	429	15	1	1	-0.111111111111111	1	-0.0263157894736842	2	19
CRP	2	3	1	1	11.22	22.44	15	1	1	-0.5	1	-0.1	2	5
CRTAC1	3	8	1	4	98.67	197.34	15	1	1	0.333333333333333	1	0.0727272727272727	5	11
CRTAM	12	12	4	1	145.2	290.4	15	1	0.343185550082102	-3	1	-0.3	5	24
CRTAP	2	3	1	0	79.2	158.4	15	1	1	-Inf	1	-0.6	1	5
CRY1	0	6	0	0	203.94	407.88	15	1	1	NA	1	NA	0	6
CRY2	0	7	0	2	166.65	333.3	15	1	1	NA	1	0	2	7
CRY4	7	8	2	2	172.92	345.84	15	1	1	-0.142857142857143	1	-0.0333333333333333	4	15
CRYAA	1	1	1	0	40.92	81.84	15	1	1	-Inf	1	-0.5	1	2
CRYBA4	0	1	0	1	10.56	21.12	15	1	1	NA	1	0	1	1
CRYBB1	3	4	2	3	29.04	58.08	15	1	1	0.111111111111111	1	0.0285714285714285	5	7
CRYBB3	0	1	0	1	19.47	38.94	15	1	1	NA	1	0	1	1
CRYBG3	61	36	9	2	869.22	1738.44	15	1	0.321886757777011	-1.65573770491803	1	-0.189315838800375	11	97
CRYGN	1	4	0	0	97.02	194.04	15	1	1	NA	1	NA	0	5
CRYGS	1	1	0	0	30.03	60.06	15	1	1	NA	1	NA	0	2
CRYL1	3	3	1	1	119.79	239.58	15	1	1	0	1	0	2	6
CRYM	1	1	0	0	70.95	141.9	15	1	1	NA	1	NA	0	2
CRYZ	3	5	2	2	97.35	194.7	15	1	1	-0.666666666666667	1	-0.125	4	8
CRYZL1	3	5	2	2	80.52	161.04	15	1	1	-0.666666666666667	1	-0.125	4	8
CS	1	2	1	0	33.33	66.66	15	1	1	-Inf	1	-0.666666666666667	1	3
CSDE1	0	6	0	0	241.89	483.78	15	1	1	NA	1	NA	0	6
CSE1L	2	16	0	2	495.33	990.66	15	1	1	1	1	0.111111111111111	2	18
CSF1	6	4	1	0	83.49	166.98	15	1	1	-Inf	1	-0.4	1	10
CSF1R	22	21	4	5	326.37	652.74	15	1	1	0.236363636363636	1	0.0671834625322998	9	43
CSF2	10	6	1	1	45.54	91.08	15	1	1	0.4	1	0.125	2	16
CSF2RA	16	4	0	0	127.05	254.1	15	1	1	NA	1	NA	0	20
CSF2RB	13	11	3	3	198.99	397.98	15	1	1	0.153846153846154	1	0.0416666666666666	6	24
CSF3	0	1	0	1	6.6	13.2	15	1	1	NA	1	0	1	1
CSF3R	5	6	2	3	86.46	172.92	15	1	1	0.2	1	0.0545454545454545	5	11
CSGALNACT1	3	8	0	0	134.31	268.62	15	1	1	NA	1	NA	0	11
CSGALNACT2	0	4	0	0	184.8	369.6	15	1	1	NA	1	NA	0	4
CSMD1	7	15	0	1	461.34	922.68	15	1	1	1	1	0.318181818181818	1	22
CSMD2	7	53	4	14	939.84	1879.68	15	1	0.266360415542105	-1.16326530612245	1	-0.105555555555556	18	60
CSMD3	3	26	0	3	478.17	956.34	15	1	1	1	1	0.103448275862069	3	29
CSNK1D	0	4	0	0	176.22	352.44	15	1	1	NA	1	NA	0	4
CSNK1E	0	4	0	1	105.6	211.2	15	1	1	NA	1	0	1	4
CSNK1G1	0	9	0	4	129.36	258.72	15	1	1	NA	1	0	4	9
CSNK2A2	1	1	1	0	64.02	128.04	15	1	1	-Inf	1	-0.5	1	2
CSPG4	18	25	10	8	386.76	773.52	15	1	0.403144972811836	-0.736111111111111	1	-0.136950904392765	18	43
CSPP1	15	15	4	0	357.06	714.12	15	1	0.113011040193203	-Inf	1	-0.5	4	30
CSRNP1	3	9	3	0	162.69	325.38	15	1	0.0439560439560439	-Inf	1	-0.75	3	12
CSRNP2	2	2	0	0	68.31	136.62	15	1	1	NA	1	NA	0	4
CSRNP3	4	4	0	0	249.15	498.3	15	1	1	NA	1	NA	0	8
CSRP1	0	3	0	1	45.54	91.08	15	1	1	NA	1	0	1	3
CSRP2	0	7	0	2	72.93	145.86	15	1	1	NA	1	0	2	7
CSRP3	1	3	0	0	58.08	116.16	15	1	1	NA	1	NA	0	4
CST3	4	1	0	0	26.73	53.46	15	1	1	NA	1	NA	0	5
CST7	3	5	0	1	52.47	104.94	15	1	1	1	1	0.375	1	8
CSTA-CSTB	6	1	0	1	35.31	70.62	15	1	0.25	1	1	0.857142857142857	1	7
CSTF1	0	3	0	0	151.8	303.6	15	1	1	NA	1	NA	0	3
CSTF2	0	7	0	4	151.47	302.94	15	1	1	NA	1	0	4	7
CSTF3	1	7	1	2	222.75	445.5	15	1	0.490909090909091	-2.5	1	-0.208333333333333	3	8
CTBP1	1	2	0	0	132	264	15	1	1	NA	1	NA	0	3
CTBP2	3	5	2	1	126.72	253.44	15	1	0.545454545454546	-2.33333333333333	1	-0.291666666666667	3	8
CTBPL	0	3	0	0	131.34	262.68	15	1	1	NA	1	NA	0	3
CTC1	23	13	5	2	342.54	685.08	15	1	1	-0.41304347826087	1	-0.0753968253968255	7	36
CTCF	0	9	0	0	201.63	403.26	15	1	1	NA	1	NA	0	9
CTDP1	5	13	3	2	238.26	476.52	15	1	0.296858747659663	-2.9	1	-0.322222222222222	5	18
CTDSPL	0	3	0	0	91.08	182.16	15	1	1	NA	1	NA	0	3
CTGFL	2	2	1	2	46.2	92.4	15	1	1	0.5	1	0.166666666666667	3	4
CTH	1	4	1	1	122.1	244.2	15	1	1	-3	1	-0.3	2	5
CTHRC1	0	4	0	1	72.93	145.86	15	1	1	NA	1	0	1	4
CTIF	1	2	0	0	74.25	148.5	15	1	1	NA	1	NA	0	3
CTNNA2	0	2	0	0	183.48	366.96	15	1	1	NA	1	NA	0	2
CTNNA3	9	10	3	1	330.33	660.66	15	1	0.590062111801242	-2.33333333333333	1	-0.276315789473684	4	19
CTNNAL1	3	5	2	0	222.42	444.84	15	1	0.444444444444445	-Inf	1	-0.625	2	8
CTNNB1	0	10	0	3	220.77	441.54	15	1	1	NA	1	0	3	10
CTNNBL1	1	10	0	2	181.5	363	15	1	1	1	1	0.0909090909090909	2	11
CTNND1	1	9	0	1	117.15	234.3	15	1	1	1	1	0.1	1	10
CTNND2	4	5	2	3	352.11	704.22	15	1	1	0.166666666666667	1	0.0444444444444444	5	9
CTNS	3	5	2	0	128.37	256.74	15	1	0.444444444444445	-Inf	1	-0.625	2	8
CTPS1	0	8	0	1	168.63	337.26	15	1	1	NA	1	0	1	8
CTPS2	0	9	0	2	165.66	331.32	15	1	1	NA	1	0	2	9
CTR9	1	13	1	2	351.45	702.9	15	1	0.330882352941176	-5.5	1	-0.261904761904762	3	14
CTRL	2	3	0	2	43.89	87.78	15	1	1	1	1	0.4	2	5
CTSA	10	8	0	1	181.17	362.34	15	1	0.473684210526316	1	1	0.555555555555556	1	18
CTSB	1	1	1	1	61.71	123.42	15	1	1	0	1	0	2	2
CTSC	1	7	0	2	131.34	262.68	15	1	1	1	1	0.125	2	8
CTSD	1	9	1	2	91.08	182.16	15	1	0.423076923076923	-3.5	1	-0.233333333333333	3	10
CTSE	7	5	2	2	64.68	129.36	15	1	1	0.285714285714286	1	0.0833333333333334	4	12
CTSEAL	2	8	0	3	147.84	295.68	15	1	1	1	1	0.2	3	10
CTSG	2	4	0	0	85.14	170.28	15	1	1	NA	1	NA	0	6
CTSH	0	8	0	1	69.63	139.26	15	1	1	NA	1	0	1	8
CTSK	1	7	0	2	83.49	166.98	15	1	1	1	1	0.125	2	8
CTSO	3	0	0	0	58.08	116.16	15	1	1	NA	1	NA	0	3
CTSS	3	7	2	0	106.26	212.52	15	1	0.151515151515152	-Inf	1	-0.7	2	10
CTSV	1	8	0	1	73.92	147.84	15	1	1	1	1	0.111111111111111	1	9
CTSZ	0	4	0	0	72.6	145.2	15	1	1	NA	1	NA	0	4
CTTN	0	5	0	0	156.09	312.18	15	1	1	NA	1	NA	0	5
CTTNBP2	5	10	1	2	334.62	669.24	15	1	1	0	1	0	3	15
CTTNBP2NL	1	5	1	0	161.04	322.08	15	1	0.285714285714286	-Inf	1	-0.833333333333333	1	6
CTU2	0	3	0	2	11.88	23.76	15	1	1	NA	1	0	2	3
CTXN3	2	2	0	0	50.49	100.98	15	1	1	NA	1	NA	0	4
CUBN	55	54	14	10	1310.1	2620.2	15	1	0.508188809888563	-0.374545454545455	1	-0.0787461773700306	24	109
CUEDC1	0	6	0	2	76.56	153.12	15	1	1	NA	1	0	2	6
CUEDC2	1	8	0	1	73.92	147.84	15	1	1	1	1	0.111111111111111	1	9
CUL1	0	7	0	2	232.65	465.3	15	1	1	NA	1	0	2	7
CUL2	1	6	1	0	227.04	454.08	15	1	0.25	-Inf	1	-0.857142857142857	1	7
CUL3	0	8	0	1	222.09	444.18	15	1	1	NA	1	0	1	8
CUL4A	0	4	0	0	203.61	407.22	15	1	1	NA	1	NA	0	4
CUL4B	0	7	0	0	216.48	432.96	15	1	1	NA	1	NA	0	7
CUL5	0	4	0	2	258.39	516.78	15	1	1	NA	1	0	2	4
CUL9	5	13	2	1	220.77	441.54	15	1	0.247368421052632	-4.2	1	-0.388888888888889	3	18
CUTA	0	1	0	1	30.69	61.38	15	1	1	NA	1	0	1	1
CUX1	1	4	1	1	55.11	110.22	15	1	1	-3	1	-0.3	2	5
CUX2	0	5	0	2	192.06	384.12	15	1	1	NA	1	0	2	5
CUZD1	12	16	4	3	166.65	333.3	15	1	0.677217109920113	-0.777777777777778	1	-0.142857142857143	7	28
CWC15	0	5	0	1	69.96	139.92	15	1	1	NA	1	0	1	5
CWC22	3	8	1	0	268.62	537.24	15	1	0.333333333333333	-Inf	1	-0.727272727272727	1	11
CWC25	1	6	0	0	99.99	199.98	15	1	1	NA	1	NA	0	7
CWC27	1	3	0	0	77.55	155.1	15	1	1	NA	1	NA	0	4
CWF19L1	1	7	0	0	148.17	296.34	15	1	1	NA	1	NA	0	8
CWF19L2	7	6	2	1	124.08	248.16	15	1	1	-0.714285714285714	1	-0.128205128205128	3	13
CWH43	12	7	3	0	240.57	481.14	15	1	0.522727272727273	-Inf	1	-0.368421052631579	3	19
CX3CL1	13	7	2	3	176.55	353.1	15	1	0.357707509881423	0.641025641025641	1	0.25	5	20
CX3CR1	6	3	0	0	87.45	174.9	15	1	1	NA	1	NA	0	9
CXADR	3	2	1	0	103.62	207.24	15	1	1	-Inf	1	-0.4	1	5
CXCL13L3	4	3	1	0	30.36	60.72	15	1	1	-Inf	1	-0.428571428571429	1	7
CXCR1	1	1	0	1	31.02	62.04	15	1	1	1	1	0.5	1	2
CXCR4	1	6	0	2	114.51	229.02	15	1	1	1	1	0.142857142857143	2	7
CXCR5	1	8	0	0	145.86	291.72	15	1	1	NA	1	NA	0	9
CXorf21	0	7	0	0	69.63	139.26	15	1	1	NA	1	NA	0	7
CXorf23	1	10	0	3	222.75	445.5	15	1	1	1	1	0.0909090909090909	3	11
CXorf40B	0	2	0	0	24.75	49.5	15	1	1	NA	1	NA	0	2
CYB561	0	1	0	1	15.18	30.36	15	1	1	NA	1	0	1	1
CYB561A3	0	2	0	0	18.81	37.62	15	1	1	NA	1	NA	0	2
CYB5A	0	1	0	1	20.46	40.92	15	1	1	NA	1	0	1	1
CYB5B	1	1	1	1	43.23	86.46	15	1	1	0	1	0	2	2
CYB5D2	1	1	0	0	10.23	20.46	15	1	1	NA	1	NA	0	2
CYB5R2	1	4	0	0	102.63	205.26	15	1	1	NA	1	NA	0	5
CYB5R3	0	6	0	0	97.35	194.7	15	1	1	NA	1	NA	0	6
CYBB	5	7	1	0	189.09	378.18	15	1	0.461538461538462	-Inf	1	-0.583333333333333	1	12
CYBRD1	3	6	0	2	73.26	146.52	15	1	1	1	1	0.333333333333333	2	9
CYCS	0	2	0	1	14.19	28.38	15	1	1	NA	1	0	1	2
CYFIP1	0	14	0	3	413.82	827.64	15	1	1	NA	1	0	3	14
CYFIP2	0	15	0	2	372.57	745.14	15	1	1	NA	1	0	2	15
CYLD	1	12	0	4	297.33	594.66	15	1	1	1	1	0.0769230769230769	4	13
CYP11A1	1	2	0	2	37.62	75.24	15	1	1	1	1	0.333333333333333	2	3
CYP19A1	4	7	0	1	169.29	338.58	15	1	1	1	1	0.363636363636364	1	11
CYP1A1	8	10	4	5	114.84	229.68	15	1	1	0	1	0	9	18
CYP1A2	8	16	4	5	148.83	297.66	15	1	0.69045948489775	-0.6	1	-0.111111111111111	9	24
CYP1B1	1	2	0	0	77.88	155.76	15	1	1	NA	1	NA	0	3
CYP1C1	5	7	0	1	79.53	159.06	15	1	1	1	1	0.416666666666667	1	12
CYP20A1	3	3	0	0	129.03	258.06	15	1	1	NA	1	NA	0	6
CYP24A1	1	4	0	1	125.4	250.8	15	1	1	1	1	0.2	1	5
CYP26A1	2	7	0	3	96.36	192.72	15	1	1	1	1	0.222222222222222	3	9
CYP26B1	2	3	1	2	92.07	184.14	15	1	1	0.25	1	0.0666666666666667	3	5
CYP26C1	2	2	0	0	66.99	133.98	15	1	1	NA	1	NA	0	4
CYP27C1	4	1	4	0	148.17	296.34	15	1	1	-Inf	1	-0.2	4	5
CYP2AB1	7	9	1	2	192.39	384.78	15	1	1	0.357142857142857	1	0.104166666666667	3	16
CYP2AB2	11	8	0	1	156.75	313.5	15	1	0.45	1	1	0.578947368421053	1	19
CYP2AB3	4	8	1	1	134.31	268.62	15	1	1	-1	1	-0.166666666666667	2	12
CYP2AB4	4	8	1	0	185.79	371.58	15	1	0.384615384615385	-Inf	1	-0.666666666666667	1	12
CYP2AB5	1	6	1	2	104.28	208.56	15	1	1	-2	1	-0.19047619047619	3	7
CYP2AC1-CYP2AC2	14	7	1	0	200.97	401.94	15	1	1	-Inf	1	-0.333333333333333	1	21
CYP2AC7	2	11	0	3	298.32	596.64	15	1	1	1	1	0.153846153846154	3	13
CYP2C23a-CYP2C23b	6	10	0	1	153.78	307.56	15	1	1	1	1	0.375	1	16
CYP2C45-RP11-400G3.5	3	3	0	0	153.12	306.24	15	1	1	NA	1	NA	0	6
CYP2D6	3	8	0	2	137.61	275.22	15	1	1	1	1	0.272727272727273	2	11
CYP2J19	5	6	2	3	168.3	336.6	15	1	1	0.2	1	0.0545454545454545	5	11
CYP2J21-CYP2J22-CYP2J23	10	14	0	4	140.91	281.82	15	1	0.265201465201465	1	1	0.416666666666667	4	24
CYP2R1	3	6	3	1	163.68	327.36	15	1	0.265734265734266	-5	1	-0.416666666666667	4	9
CYP2U1	0	3	0	0	103.95	207.9	15	1	1	NA	1	NA	0	3
CYP2W2	3	8	0	0	178.2	356.4	15	1	1	NA	1	NA	0	11
CYP39A1	11	6	0	1	183.81	367.62	15	1	0.388888888888889	1	1	0.647058823529412	1	17
CYP3A4	0	15	0	4	180.84	361.68	15	1	1	NA	1	0	4	15
CYP3A5	0	12	0	5	151.47	302.94	15	1	1	NA	1	0	5	12
CYP46A1	4	7	0	0	141.57	283.14	15	1	1	NA	1	NA	0	11
CYP4A22	4	9	2	3	154.44	308.88	15	1	1	-0.5	1	-0.0923076923076923	5	13
CYP4V2	17	8	1	0	324.72	649.44	15	1	1	-Inf	1	-0.32	1	25
CYP51A1	15	16	4	2	369.27	738.54	15	1	0.65988065988066	-1.13333333333333	1	-0.182795698924731	6	31
CYP7A1	3	1	0	0	171.93	343.86	15	1	1	NA	1	NA	0	4
CYP8B1	15	27	5	10	298.98	597.96	15	1	1	0.1	1	0.0238095238095238	15	42
CYR61	0	4	0	1	100.98	201.96	15	1	1	NA	1	0	1	4
CYSLTR1	0	2	0	0	78.21	156.42	15	1	1	NA	1	NA	0	2
CYSLTR2	5	6	2	1	72.27	144.54	15	1	1	-1.4	1	-0.212121212121212	3	11
CYTH4	1	3	0	1	118.47	236.94	15	1	1	1	1	0.25	1	4
CYTIP	2	8	1	1	83.49	166.98	15	1	0.454545454545455	-3	1	-0.3	2	10
CYTL1	1	3	0	0	35.64	71.28	15	1	1	NA	1	NA	0	4
CYYR1	3	1	0	0	26.4	52.8	15	1	1	NA	1	NA	0	4
CZH18ORF25	2	6	1	2	52.8	105.6	15	1	1	-0.5	1	-0.0833333333333333	3	8
CZH18ORF32	1	4	0	0	24.42	48.84	15	1	1	NA	1	NA	0	5
CZH5ORF34	4	4	0	0	156.42	312.84	15	1	1	NA	1	NA	0	8
CZH5ORF42	35	20	1	0	553.41	1106.82	15	1	1	-Inf	1	-0.363636363636364	1	55
CZH9orf24	3	6	0	0	34.98	69.96	15	1	1	NA	1	NA	0	9
CZH9ORF3	12	10	1	0	197.01	394.02	15	1	1	-Inf	1	-0.454545454545455	1	22
CZH9orf64	0	3	0	0	52.8	105.6	15	1	1	NA	1	NA	0	3
CZH9orf72	1	3	0	1	124.41	248.82	15	1	1	1	1	0.25	1	4
D2HGDH	3	11	0	2	131.67	263.34	15	1	1	1	1	0.214285714285714	2	14
DAAM1	2	11	1	2	251.46	502.92	15	1	0.489285714285714	-1.75	1	-0.179487179487179	3	13
DAAM2	4	10	0	1	327.03	654.06	15	1	1	1	1	0.285714285714286	1	14
DAB2	14	8	0	0	300.3	600.6	15	1	1	NA	1	NA	0	22
DAB2IP	5	8	3	3	302.28	604.56	15	1	1	-0.6	1	-0.115384615384615	6	13
DACH1	0	4	0	0	60.39	120.78	15	1	1	NA	1	NA	0	4
DACH2	1	3	0	0	116.49	232.98	15	1	1	NA	1	NA	0	4
DACT1	4	17	0	3	214.17	428.34	15	1	1	1	1	0.19047619047619	3	21
DACT2	5	9	1	2	238.26	476.52	15	1	1	0.1	1	0.0238095238095238	3	14
DAD1	1	2	0	0	31.02	62.04	15	1	1	NA	1	NA	0	3
DAGLA	0	11	0	2	305.91	611.82	15	1	1	NA	1	0	2	11
DAGLB	5	6	1	0	202.29	404.58	15	1	1	-Inf	1	-0.545454545454545	1	11
DALRD3	6	8	0	2	90.42	180.84	15	1	0.5	1	1	0.428571428571429	2	14
DAO	3	5	0	2	81.84	163.68	15	1	1	1	1	0.375	2	8
DAP	4	2	0	1	46.2	92.4	15	1	0.428571428571429	1	1	0.666666666666667	1	6
DAP3	4	3	0	0	117.81	235.62	15	1	1	NA	1	NA	0	7
DAPK1	2	23	0	2	383.79	767.58	15	1	1	1	1	0.08	2	25
DAPK2	3	11	0	4	170.61	341.22	15	1	1	1	1	0.214285714285714	4	14
DAPP1	2	5	2	2	82.83	165.66	15	1	0.575757575757576	-1.5	1	-0.214285714285714	4	7
DARS	0	6	0	1	134.97	269.94	15	1	1	NA	1	0	1	6
DARS2	5	7	3	3	203.28	406.56	15	1	1	-0.4	1	-0.0833333333333333	6	12
DAW1	2	5	1	0	163.02	326.04	15	1	0.375	-Inf	1	-0.714285714285714	1	7
DAZAP1	0	5	0	1	107.25	214.5	15	1	1	NA	1	0	1	5
DAZL	2	4	0	1	79.53	159.06	15	1	1	1	1	0.333333333333333	1	6
DBF4	2	4	0	0	179.19	358.38	15	1	1	NA	1	NA	0	6
DBF4B	9	5	1	3	166.32	332.64	15	1	0.274509803921569	0.814814814814815	1	0.392857142857143	4	14
DBH	5	6	2	3	110.22	220.44	15	1	1	0.2	1	0.0545454545454545	5	11
DBNDD2	0	1	0	1	48.18	96.36	15	1	1	NA	1	0	1	1
DBNL	0	4	0	3	33.66	67.32	15	1	1	NA	1	0	3	4
DBR1	2	6	0	1	149.16	298.32	15	1	1	1	1	0.25	1	8
DBT	0	3	0	0	146.85	293.7	15	1	1	NA	1	NA	0	3
DBX2	2	3	0	1	62.04	124.08	15	1	1	1	1	0.4	1	5
DCAF1	10	16	2	0	574.2	1148.4	15	1	0.174603174603175	-Inf	1	-0.615384615384615	2	26
DCAF10	0	7	0	2	145.86	291.72	15	1	1	NA	1	0	2	7
DCAF12	0	3	0	0	79.2	158.4	15	1	1	NA	1	NA	0	3
DCAF13	1	9	0	1	152.46	304.92	15	1	1	1	1	0.1	1	10
DCAF17	2	5	1	1	190.41	380.82	15	1	1	-1.5	1	-0.214285714285714	2	7
DCAF4	4	5	0	1	145.53	291.06	15	1	1	1	1	0.444444444444444	1	9
DCAF5	6	11	3	0	256.74	513.48	15	1	0.0736842105263158	-Inf	1	-0.647058823529412	3	17
DCAF6	5	13	1	1	276.21	552.42	15	1	0.521052631578947	-1.6	1	-0.222222222222222	2	18
DCAF7	0	2	0	0	99.99	199.98	15	1	1	NA	1	NA	0	2
DCAKD	2	2	1	0	33.99	67.98	15	1	1	-Inf	1	-0.5	1	4
DCBLD1	2	11	1	2	217.14	434.28	15	1	0.489285714285714	-1.75	1	-0.179487179487179	3	13
DCBLD2	0	11	0	2	160.38	320.76	15	1	1	NA	1	0	2	11
DCDC2	7	4	1	0	107.58	215.16	15	1	1	-Inf	1	-0.363636363636364	1	11
DCDC2B	5	5	1	1	82.5	165	15	1	1	0	1	0	2	10
DCHS2	32	35	3	1	844.8	1689.6	15	1	0.357011635027557	-2.28125	1	-0.272388059701493	4	67
DCK	0	4	0	0	82.5	165	15	1	1	NA	1	NA	0	4
DCLK1	1	7	0	0	246.51	493.02	15	1	1	NA	1	NA	0	8
DCLK2	3	5	0	0	191.4	382.8	15	1	1	NA	1	NA	0	8
DCLK3	9	3	0	1	158.73	317.46	15	1	0.307692307692307	1	1	0.75	1	12
DCLRE1A	21	9	0	0	258.72	517.44	15	1	1	NA	1	NA	0	30
DCLRE1B	5	1	1	0	56.43	112.86	15	1	1	-Inf	1	-0.166666666666667	1	6
DCLRE1C	3	7	2	1	133.65	267.3	15	1	0.510489510489511	-3.66666666666667	1	-0.366666666666667	3	10
DCP1A	2	5	0	2	166.32	332.64	15	1	1	1	1	0.285714285714286	2	7
DCP1B	4	7	2	1	201.3	402.6	15	1	0.538461538461539	-2.5	1	-0.303030303030303	3	11
DCP2	2	7	0	1	87.12	174.24	15	1	1	1	1	0.222222222222222	1	9
DCSTAMP	4	4	0	0	132.33	264.66	15	1	1	NA	1	NA	0	8
DCT	6	8	2	0	178.2	356.4	15	1	0.466666666666667	-Inf	1	-0.571428571428571	2	14
DCTN1	1	9	1	4	201.96	403.92	15	1	1	-1.25	1	-0.1	5	10
DCTN4	0	7	0	2	119.46	238.92	15	1	1	NA	1	0	2	7
DCTN5	0	2	0	0	48.84	97.68	15	1	1	NA	1	NA	0	2
DCUN1D1-DCUN1D2	0	2	0	0	73.26	146.52	15	1	1	NA	1	NA	0	2
DCUN1D3	3	6	0	0	108.24	216.48	15	1	1	NA	1	NA	0	9
DCUN1D4	0	2	0	1	80.52	161.04	15	1	1	NA	1	0	1	2
DCX	0	2	0	0	70.29	140.58	15	1	1	NA	1	NA	0	2
DCXR	1	2	0	0	62.04	124.08	15	1	1	NA	1	NA	0	3
DD1CR	3	11	0	0	125.73	251.46	15	1	1	NA	1	NA	0	14
DDAH1	0	2	0	0	49.17	98.34	15	1	1	NA	1	NA	0	2
DDB1	1	17	0	3	343.53	687.06	15	1	1	1	1	0.0555555555555556	3	18
DDB2	5	7	1	1	202.62	405.24	15	1	1	-0.4	1	-0.0833333333333333	2	12
DDEFL1	15	23	2	6	250.8	501.6	15	1	0.690520335665715	0.488888888888889	1	0.144736842105263	8	38
DDHD1	2	5	0	2	195.36	390.72	15	1	1	1	1	0.285714285714286	2	7
DDHD2	6	9	4	3	211.2	422.4	15	1	0.651702786377709	-1	1	-0.171428571428571	7	15
DDI2	11	8	1	3	294.03	588.06	15	1	0.316770186335404	0.757575757575758	1	0.328947368421053	4	19
DDIAS	42	16	19	8	315.48	630.96	15	1	1	0.0952380952380952	1	0.020434227330779	27	58
DDIT3	4	2	1	0	17.49	34.98	15	1	1	-Inf	1	-0.333333333333333	1	6
DDO	6	2	2	1	74.91	149.82	15	1	1	0.333333333333333	1	0.0833333333333334	3	8
DDOST	0	4	0	1	86.13	172.26	15	1	1	NA	1	0	1	4
DDR1	2	15	0	4	280.83	561.66	15	1	1	1	1	0.117647058823529	4	17
DDRGK1	3	4	0	1	82.5	165	15	1	1	1	1	0.428571428571429	1	7
DDTNFR23	5	4	0	1	121.11	242.22	15	1	1	1	1	0.555555555555556	1	9
DDX10	2	10	1	1	166.32	332.64	15	1	0.395604395604396	-4	1	-0.333333333333333	2	12
DDX11	5	16	2	4	264.66	529.32	15	1	0.633363737711564	-0.6	1	-0.0952380952380952	6	21
DDX17	1	4	1	0	134.64	269.28	15	1	0.333333333333333	-Inf	1	-0.8	1	5
DDX18	5	6	4	2	154.77	309.54	15	1	0.619909502262443	-1.4	1	-0.212121212121212	6	11
DDX19B	2	13	0	0	133.98	267.96	15	1	1	NA	1	NA	0	15
DDX20	7	6	0	2	207.24	414.48	15	1	0.466666666666667	1	1	0.538461538461538	2	13
DDX21	2	11	0	3	168.3	336.6	15	1	1	1	1	0.153846153846154	3	13
DDX23	0	6	0	3	46.2	92.4	15	1	1	NA	1	0	3	6
DDX24	6	10	0	1	221.1	442.2	15	1	1	1	1	0.375	1	16
DDX25	0	2	0	1	33	66	15	1	1	NA	1	0	1	2
DDX27	5	16	2	1	235.29	470.58	15	1	0.193675889328063	-5.4	1	-0.428571428571429	3	21
DDX28	0	3	0	0	34.98	69.96	15	1	1	NA	1	NA	0	3
DDX31	8	14	3	1	187.11	374.22	15	1	0.278929765886288	-4.25	1	-0.386363636363636	4	22
DDX3X	0	11	0	3	215.16	430.32	15	1	1	NA	1	0	3	11
DDX4	0	5	0	1	174.24	348.48	15	1	1	NA	1	0	1	5
DDX41	0	12	0	4	143.88	287.76	15	1	1	NA	1	0	4	12
DDX42	1	11	1	4	242.55	485.1	15	1	0.514705882352941	-1.75	1	-0.116666666666667	5	12
DDX43	3	5	0	0	174.57	349.14	15	1	1	NA	1	NA	0	8
DDX47	4	6	0	0	145.86	291.72	15	1	1	NA	1	NA	0	10
DDX49	3	9	2	2	117.15	234.3	15	1	0.546703296703297	-2	1	-0.25	4	12
DDX5	0	6	0	2	192.39	384.78	15	1	1	NA	1	0	2	6
DDX51	5	7	1	0	165.99	331.98	15	1	0.461538461538462	-Inf	1	-0.583333333333333	1	12
DDX54	5	7	2	3	111.54	223.08	15	1	1	0.0666666666666667	1	0.0166666666666667	5	12
DDX55	3	3	0	0	182.49	364.98	15	1	1	NA	1	NA	0	6
DDX59	9	6	4	0	180.51	361.02	15	1	0.255417956656347	-Inf	1	-0.4	4	15
DDX6	0	2	0	1	175.89	351.78	15	1	1	NA	1	0	1	2
DDX60	30	27	3	4	516.45	1032.9	15	1	0.703910808557933	0.325	1	0.0977443609022556	7	57
DEAF1	0	6	0	1	151.47	302.94	15	1	1	NA	1	0	1	6
DECR2	1	3	0	0	32.01	64.02	15	1	1	NA	1	NA	0	4
DEF6	0	4	0	2	99.66	199.32	15	1	1	NA	1	0	2	4
DEGS1	1	5	1	2	74.58	149.16	15	1	1	-1.5	1	-0.166666666666667	3	6
DEGS2	2	8	0	1	112.2	224.4	15	1	1	1	1	0.2	1	10
DEK	1	1	0	0	115.17	230.34	15	1	1	NA	1	NA	0	2
DELE	5	11	1	1	142.89	285.78	15	1	1	-1.2	1	-0.1875	2	16
DENND1A	4	8	2	0	329.34	658.68	15	1	0.164835164835165	-Inf	1	-0.666666666666667	2	12
DENND1B	3	3	0	1	195.36	390.72	15	1	1	1	1	0.5	1	6
DENND2A	5	8	2	0	292.38	584.76	15	1	0.2	-Inf	1	-0.615384615384615	2	13
DENND2C	16	13	1	1	365.31	730.62	15	1	1	0.1875	1	0.0517241379310345	2	29
DENND2D	0	8	0	2	114.51	229.02	15	1	1	NA	1	0	2	8
DENND3	12	26	2	4	355.74	711.48	15	1	1	-0.0833333333333333	1	-0.0175438596491228	6	38
DENND4A	3	20	1	3	582.78	1165.56	15	1	0.495441595441595	-1.22222222222222	1	-0.119565217391304	4	23
DENND5A	0	20	0	4	422.73	845.46	15	1	1	NA	1	0	4	20
DENND5B	2	19	2	6	461.67	923.34	15	1	0.300029472443266	-2.16666666666667	1	-0.154761904761905	8	21
DENND6A	0	4	0	1	156.42	312.84	15	1	1	NA	1	0	1	4
DENND6B	2	9	2	1	171.27	342.54	15	1	0.175824175824176	-8	1	-0.484848484848485	3	11
DEPDC1	13	14	5	4	228.03	456.06	15	1	1	-0.346153846153846	1	-0.0740740740740741	9	27
DEPDC1B	5	6	0	0	132.33	264.66	15	1	1	NA	1	NA	0	11
DEPDC6	2	3	1	0	110.88	221.76	15	1	1	-Inf	1	-0.6	1	5
DEPDC7	2	6	1	0	141.9	283.8	15	1	0.333333333333333	-Inf	1	-0.75	1	8
DEPTOR	2	4	1	0	98.01	196.02	15	1	0.428571428571428	-Inf	1	-0.666666666666667	1	6
DERA	0	2	0	0	30.36	60.72	15	1	1	NA	1	NA	0	2
DERL1	0	2	0	0	60.06	120.12	15	1	1	NA	1	NA	0	2
DERL3	2	2	1	0	23.1	46.2	15	1	1	-Inf	1	-0.5	1	4
DES	0	1	0	1	40.59	81.18	15	1	1	NA	1	0	1	1
DESI2	1	1	1	0	72.27	144.54	15	1	1	-Inf	1	-0.5	1	2
DET1	1	6	0	2	136.95	273.9	15	1	1	1	1	0.142857142857143	2	7
DEUP1	10	6	2	1	213.51	427.02	15	1	1	-0.2	1	-0.0416666666666666	3	16
DFFA	3	3	1	1	81.84	163.68	15	1	1	0	1	0	2	6
DFFB	0	2	0	0	72.6	145.2	15	1	1	NA	1	NA	0	2
DFNA5	18	7	10	3	230.34	460.68	15	1	1	-0.296296296296296	1	-0.0492307692307693	13	25
DFNB59	9	6	1	1	137.61	275.22	15	1	1	0.333333333333333	1	0.1	2	15
DGAT2	1	4	0	1	99.66	199.32	15	1	1	1	1	0.2	1	5
DGCR2	1	10	0	0	173.25	346.5	15	1	1	NA	1	NA	0	11
DGKD	0	14	0	3	411.51	823.02	15	1	1	NA	1	0	3	14
DGKE	4	8	0	0	153.12	306.24	15	1	1	NA	1	NA	0	12
DGKG	4	14	4	3	167.31	334.62	15	1	0.156330351570626	-3.66666666666667	1	-0.349206349206349	7	18
DGKI	0	7	0	0	290.4	580.8	15	1	1	NA	1	NA	0	7
DGKQ	5	8	3	1	182.49	364.98	15	1	0.294117647058823	-3.8	1	-0.365384615384615	4	13
DGKZ	3	9	1	2	267.63	535.26	15	1	1	-0.5	1	-0.0833333333333333	3	12
DGUOK	4	4	0	1	115.17	230.34	15	1	1	1	1	0.5	1	8
DHCR24	0	3	0	0	145.86	291.72	15	1	1	NA	1	NA	0	3
DHCR7	3	4	1	0	152.79	305.58	15	1	1	-Inf	1	-0.571428571428571	1	7
DHODH	3	10	1	1	73.92	147.84	15	1	0.476190476190476	-2.33333333333333	1	-0.269230769230769	2	13
DHRS11	0	6	0	2	142.56	285.12	15	1	1	NA	1	0	2	6
DHRS12	1	11	0	3	90.75	181.5	15	1	1	1	1	0.0833333333333333	3	12
DHRS3	0	2	0	0	81.84	163.68	15	1	1	NA	1	NA	0	2
DHRS7	0	7	0	1	87.12	174.24	15	1	1	NA	1	0	1	7
DHRS7B	1	9	1	1	89.43	178.86	15	1	0.318181818181818	-8	1	-0.4	2	10
DHRS7C	0	4	0	0	53.79	107.58	15	1	1	NA	1	NA	0	4
DHRSX	1	5	0	0	112.53	225.06	15	1	1	NA	1	NA	0	6
DHTKD1	8	11	3	2	287.76	575.52	15	1	0.629917184265011	-1.0625	1	-0.178947368421053	5	19
DHX15	0	5	0	2	198.66	397.32	15	1	1	NA	1	0	2	5
DHX29	4	12	0	1	306.24	612.48	15	1	1	1	1	0.25	1	16
DHX30	0	24	0	6	345.84	691.68	15	1	1	NA	1	0	6	24
DHX32	7	3	2	1	242.55	485.1	15	1	1	0.142857142857143	1	0.0333333333333333	3	10
DHX33	1	8	1	2	218.46	436.92	15	1	0.454545454545454	-3	1	-0.222222222222222	3	9
DHX34	3	5	3	1	45.54	91.08	15	1	0.545454545454546	-4	1	-0.375	4	8
DHX35	3	7	1	2	192.39	384.78	15	1	1	-0.166666666666667	1	-0.0333333333333333	3	10
DHX36	0	15	0	3	235.29	470.58	15	1	1	NA	1	0	3	15
DHX37	6	12	0	0	184.47	368.94	15	1	1	NA	1	NA	0	18
DHX38	3	16	0	1	402.6	805.2	15	1	1	1	1	0.157894736842105	1	19
DHX40	2	11	1	3	209.88	419.76	15	1	1	-0.833333333333333	1	-0.0961538461538461	4	13
DHX57	11	30	2	5	461.34	922.68	15	1	1	-0.0909090909090908	1	-0.0174216027874564	7	41
DHX58	5	2	1	1	49.83	99.66	15	1	1	0.6	1	0.214285714285714	2	7
DHX8	2	15	1	1	315.48	630.96	15	1	0.298245614035088	-6.5	1	-0.382352941176471	2	17
DIABLO	0	4	0	1	51.15	102.3	15	1	1	NA	1	0	1	4
DIAPH2	2	2	0	1	111.21	222.42	15	1	1	1	1	0.5	1	4
DIAPH3	7	5	1	0	172.92	345.84	15	1	1	-Inf	1	-0.416666666666667	1	12
DICER1	0	17	0	0	584.43	1168.86	15	1	1	NA	1	NA	0	17
DIEXF	2	20	0	3	215.49	430.98	15	1	1	1	1	0.0909090909090909	3	22
DIO1	0	5	0	1	59.4	118.8	15	1	1	NA	1	0	1	5
DIO3	0	2	0	0	18.15	36.3	15	1	1	NA	1	NA	0	2
DIP2A	9	8	3	1	441.21	882.42	15	1	0.603007518796992	-1.66666666666667	1	-0.220588235294118	4	17
DIP2B	2	26	1	9	513.48	1026.96	15	1	1	-0.444444444444444	1	-0.0285714285714286	10	28
DIP2C	2	18	0	1	576.18	1152.36	15	1	1	1	1	0.1	1	20
DIRAS1	0	1	0	1	30.03	60.06	15	1	1	NA	1	0	1	1
DIRAS2	0	3	0	0	33.33	66.66	15	1	1	NA	1	NA	0	3
DIRC2	0	4	0	0	123.75	247.5	15	1	1	NA	1	NA	0	4
DIS3	4	8	1	0	189.42	378.84	15	1	0.384615384615385	-Inf	1	-0.666666666666667	1	12
DIS3L	9	11	4	1	313.5	627	15	1	0.321739130434783	-3.88888888888889	1	-0.35	5	20
DIS3L2	12	25	1	11	340.89	681.78	15	1	0.142337341441286	0.810606060606061	1	0.240990990990991	12	37
DISC1	8	10	1	0	193.71	387.42	15	1	0.473684210526316	-Inf	1	-0.555555555555556	1	18
DISP1	13	19	4	5	542.52	1085.04	15	1	1	-0.169230769230769	1	-0.0381944444444444	9	32
DISP2	7	27	2	10	524.37	1048.74	15	1	1	0.228571428571429	1	0.0392156862745098	12	34
DISP3	0	18	0	2	394.68	789.36	15	1	1	NA	1	0	2	18
DIXDC1	6	17	2	0	224.07	448.14	15	1	0.0933333333333333	-Inf	1	-0.739130434782609	2	23
DKC1	2	10	0	1	144.54	289.08	15	1	1	1	1	0.166666666666667	1	12
DKK3	7	6	2	1	131.01	262.02	15	1	1	-0.714285714285714	1	-0.128205128205128	3	13
DLAT	2	19	0	3	176.22	352.44	15	1	1	1	1	0.0952380952380952	3	21
DLC1	11	25	1	2	528.99	1057.98	15	1	1	-0.136363636363636	1	-0.0277777777777777	3	36
DLD	0	3	0	0	133.98	267.96	15	1	1	NA	1	NA	0	3
DLEC1	40	19	7	3	509.52	1019.04	15	1	1	-0.108333333333333	1	-0.0220338983050847	10	59
DLEU7	2	1	1	0	45.21	90.42	15	1	1	-Inf	1	-0.333333333333333	1	3
DLG1	0	6	0	1	237.6	475.2	15	1	1	NA	1	0	1	6
DLG2	2	6	0	1	130.68	261.36	15	1	1	1	1	0.25	1	8
DLG2-DLG3	0	4	0	0	99.33	198.66	15	1	1	NA	1	NA	0	4
DLG3	2	10	2	5	153.78	307.56	15	1	0.602683178534572	-1	1	-0.119047619047619	7	12
DLG5	5	18	0	0	589.71	1179.42	15	1	1	NA	1	NA	0	23
DLGAP1L	1	6	0	1	145.86	291.72	15	1	1	1	1	0.142857142857143	1	7
DLGAP2	1	7	1	2	218.13	436.26	15	1	0.490909090909091	-2.5	1	-0.208333333333333	3	8
DLGAP3	4	8	2	5	133.32	266.64	15	1	1	0.2	1	0.0476190476190476	7	12
DLGAP4	4	9	1	0	276.54	553.08	15	1	0.357142857142857	-Inf	1	-0.692307692307692	1	13
DLGAP5	12	10	3	1	222.09	444.18	15	1	0.61371237458194	-1.5	1	-0.204545454545455	4	22
DLK1	2	5	0	1	112.86	225.72	15	1	1	1	1	0.285714285714286	1	7
DLK2	2	5	0	0	106.26	212.52	15	1	1	NA	1	NA	0	7
DLL1	2	6	1	2	161.37	322.74	15	1	1	-0.5	1	-0.0833333333333333	3	8
DLL4	0	9	0	2	196.02	392.04	15	1	1	NA	1	0	2	9
DLST	1	2	0	2	111.87	223.74	15	1	1	1	1	0.333333333333333	2	3
DLX3	0	1	0	1	10.89	21.78	15	1	1	NA	1	0	1	1
DMAP1	0	6	0	2	148.17	296.34	15	1	1	NA	1	0	2	6
DMBT1	4	4	0	1	96.69	193.38	15	1	1	1	1	0.5	1	8
DMBT1L-DMBT1L3	23	19	5	2	267.63	535.26	15	1	0.682985275164136	-1.06521739130435	1	-0.166666666666667	7	42
DMBX1	0	3	0	0	78.54	157.08	15	1	1	NA	1	NA	0	3
DMC1	0	8	0	3	91.74	183.48	15	1	1	NA	1	0	3	8
DMD	12	22	3	0	490.05	980.1	15	1	0.0585585585585586	-Inf	1	-0.647058823529412	3	34
DMGDH	1	9	0	2	199.98	399.96	15	1	1	1	1	0.1	2	10
DMP1	3	5	2	0	47.52	95.04	15	1	0.444444444444445	-Inf	1	-0.625	2	8
DMRT1	1	2	0	0	52.47	104.94	15	1	1	NA	1	NA	0	3
DMRT2	0	2	0	0	106.26	212.52	15	1	1	NA	1	NA	0	2
DMRTB1	2	8	0	0	75.24	150.48	15	1	1	NA	1	NA	0	10
DMTF1	2	10	1	1	273.9	547.8	15	1	0.395604395604396	-4	1	-0.333333333333333	2	12
DMXL1	12	28	2	0	783.42	1566.84	15	1	0.105691056910569	-Inf	1	-0.7	2	40
DMXL2	7	34	4	4	892.98	1785.96	15	1	0.063404132386341	-3.85714285714286	1	-0.329268292682927	8	41
DNA2	14	18	3	4	541.53	1083.06	15	1	1	0.0357142857142857	1	0.00892857142857145	7	32
DNAAF2	3	2	1	0	70.62	141.24	15	1	1	-Inf	1	-0.4	1	5
DNAAF5	6	8	1	0	204.93	409.86	15	1	0.466666666666667	-Inf	1	-0.571428571428571	1	14
DNAH1	47	65	9	14	1456.29	2912.58	15	1	1	0.110942249240122	1	0.0283385093167702	23	112
DNAH10	34	59	6	5	1410.75	2821.5	15	1	0.328219260756603	-1.08235294117647	1	-0.179863147605083	11	93
DNAH12	19	52	3	6	1261.92	2523.84	15	1	0.700493206922893	-0.368421052631579	1	-0.0657276995305164	9	71
DNAH14	9	2	3	0	99.66	199.32	15	1	1	-Inf	1	-0.181818181818182	3	11
DNAH17	23	67	7	22	1101.54	2203.08	15	1	1	0.0731225296442688	1	0.0141762452107279	29	90
DNAH3	25	47	2	3	1346.73	2693.46	15	1	1	-0.253333333333333	1	-0.0527777777777778	5	72
DNAH5	22	43	7	7	1295.91	2591.82	15	1	0.359812432588545	-0.954545454545455	1	-0.161538461538462	14	65
DNAH5L	34	50	5	6	1471.8	2943.6	15	1	0.755704879007164	-0.225490196078431	1	-0.0497835497835498	11	84
DNAH7	20	40	4	4	1154.34	2308.68	15	1	0.439072907891752	-1	1	-0.166666666666667	8	60
DNAH8	22	45	2	6	1211.1	2422.2	15	1	1	0.318181818181818	1	0.0783582089552239	8	67
DNAH9	20	58	2	9	1017.72	2035.44	15	1	0.724958218542992	0.355555555555556	1	0.0745920745920746	11	78
DNAI1	3	9	0	0	177.54	355.08	15	1	1	NA	1	NA	0	12
DNAI2	2	2	1	1	93.39	186.78	15	1	1	0	1	0	2	4
DNAJA1	2	6	0	0	83.16	166.32	15	1	1	NA	1	NA	0	8
DNAJA2	0	3	0	2	109.23	218.46	15	1	1	NA	1	0	2	3
DNAJA4	1	4	0	1	104.28	208.56	15	1	1	1	1	0.2	1	5
DNAJB11	0	3	0	0	94.71	189.42	15	1	1	NA	1	NA	0	3
DNAJB13	3	2	0	1	29.37	58.74	15	1	1	1	1	0.6	1	5
DNAJB14	2	6	0	0	84.48	168.96	15	1	1	NA	1	NA	0	8
DNAJB4	0	2	0	0	126.39	252.78	15	1	1	NA	1	NA	0	2
DNAJB5	0	6	0	2	66.33	132.66	15	1	1	NA	1	0	2	6
DNAJB6	1	3	1	0	84.81	169.62	15	1	0.4	-Inf	1	-0.75	1	4
DNAJB8	10	3	2	1	88.11	176.22	15	1	1	0.4	1	0.102564102564103	3	13
DNAJB9	0	5	0	0	61.05	122.1	15	1	1	NA	1	NA	0	5
DNAJC1	6	5	1	1	153.12	306.24	15	1	1	0.166666666666667	1	0.0454545454545454	2	11
DNAJC10	2	4	0	0	247.5	495	15	1	1	NA	1	NA	0	6
DNAJC11	2	4	2	1	135.96	271.92	15	1	0.523809523809524	-3	1	-0.333333333333333	3	6
DNAJC12	0	5	0	1	52.47	104.94	15	1	1	NA	1	0	1	5
DNAJC13	4	31	1	8	682.77	1365.54	15	1	1	0.03125	1	0.00317460317460318	9	35
DNAJC16	1	11	0	1	216.81	433.62	15	1	1	1	1	0.0833333333333333	1	12
DNAJC17	2	5	1	0	88.44	176.88	15	1	0.375	-Inf	1	-0.714285714285714	1	7
DNAJC18	2	4	0	1	109.23	218.46	15	1	1	1	1	0.333333333333333	1	6
DNAJC2	1	7	0	0	219.12	438.24	15	1	1	NA	1	NA	0	8
DNAJC21	4	6	0	1	131.01	262.02	15	1	1	1	1	0.4	1	10
DNAJC24	1	4	0	2	41.58	83.16	15	1	1	1	1	0.2	2	5
DNAJC25	2	1	0	0	70.29	140.58	15	1	1	NA	1	NA	0	3
DNAJC27	1	3	0	2	43.89	87.78	15	1	1	1	1	0.25	2	4
DNAJC28	3	8	3	0	126.39	252.78	15	1	0.0549450549450549	-Inf	1	-0.727272727272727	3	11
DNAJC3	3	6	1	0	160.05	320.1	15	1	0.4	-Inf	1	-0.666666666666667	1	9
DNAJC5	0	7	0	2	49.17	98.34	15	1	1	NA	1	0	2	7
DNAJC5B	4	3	1	1	61.05	122.1	15	1	1	0.25	1	0.0714285714285714	2	7
DNAJC6	3	9	1	4	295.02	590.04	15	1	1	0.25	1	0.05	5	12
DNAJC7	0	6	0	1	149.16	298.32	15	1	1	NA	1	0	1	6
DNAJC8	0	2	0	0	83.16	166.32	15	1	1	NA	1	NA	0	2
DNAJC9	1	1	0	0	50.16	100.32	15	1	1	NA	1	NA	0	2
DNAL1	0	3	0	2	52.47	104.94	15	1	1	NA	1	0	2	3
DNAL4	0	5	0	1	41.25	82.5	15	1	1	NA	1	0	1	5
DNALI1	1	3	0	1	29.37	58.74	15	1	1	1	1	0.25	1	4
DNASE1L3	3	5	1	4	86.13	172.26	15	1	1	0.583333333333333	1	0.175	5	8
DNASE2B	3	5	1	0	123.75	247.5	15	1	0.444444444444444	-Inf	1	-0.625	1	8
DND1	4	1	0	0	61.71	123.42	15	1	1	NA	1	NA	0	5
DNER	0	10	0	5	196.68	393.36	15	1	1	NA	1	0	5	10
DNLZ	0	2	0	1	25.08	50.16	15	1	1	NA	1	0	1	2
DNM1	1	8	0	2	257.73	515.46	15	1	1	1	1	0.111111111111111	2	9
DNM1L	0	5	0	1	164.34	328.68	15	1	1	NA	1	0	1	5
DNMBP	7	8	1	1	201.63	403.26	15	1	1	-0.142857142857143	1	-0.0333333333333333	2	15
DNMT3B	2	6	0	3	118.47	236.94	15	1	1	1	1	0.25	3	8
DNPEP	1	3	1	1	60.72	121.44	15	1	1	-2	1	-0.25	2	4
DNTT	2	1	0	0	95.37	190.74	15	1	1	NA	1	NA	0	3
DNTTIP2	12	8	0	2	186.78	373.56	15	1	0.194805194805195	1	1	0.6	2	20
DOC2B	0	6	0	1	94.71	189.42	15	1	1	NA	1	0	1	6
DOCK1	5	27	1	7	343.2	686.4	15	1	1	0.228571428571429	1	0.03125	8	32
DOCK10	6	22	2	5	646.8	1293.6	15	1	0.647844009683963	-0.466666666666667	1	-0.0714285714285714	7	28
DOCK11	8	23	1	4	667.92	1335.84	15	1	1	0.28125	1	0.0580645161290322	5	31
DOCK2	5	22	0	2	490.38	980.76	15	1	1	1	1	0.185185185185185	2	27
DOCK2L	7	20	1	4	334.62	669.24	15	1	1	0.285714285714286	1	0.0592592592592592	5	27
DOCK4	3	20	0	1	645.15	1290.3	15	1	1	1	1	0.130434782608696	1	23
DOCK5	4	28	1	5	564.63	1129.26	15	1	1	-0.4	1	-0.0416666666666667	6	32
DOCK7	1	18	0	2	514.47	1028.94	15	1	1	1	1	0.0526315789473684	2	19
DOCK8	7	20	2	1	495.66	991.32	15	1	0.206896551724138	-4.71428571428571	1	-0.407407407407407	3	27
DOCK9	4	24	0	2	711.48	1422.96	15	1	1	1	1	0.142857142857143	2	28
DOHH	1	1	1	0	17.82	35.64	15	1	1	-Inf	1	-0.5	1	2
DOK1	0	14	0	2	119.13	238.26	15	1	1	NA	1	0	2	14
DOK2	3	0	1	0	33.99	67.98	15	1	1	NA	1	0	1	3
DOK5	1	5	1	0	81.51	163.02	15	1	0.285714285714286	-Inf	1	-0.833333333333333	1	6
DOK7	1	6	0	0	160.05	320.1	15	1	1	NA	1	NA	0	7
DOLK	3	6	1	3	150.48	300.96	15	1	1	0.333333333333333	1	0.0833333333333333	4	9
DOLPP1	2	4	1	1	84.81	169.62	15	1	1	-1	1	-0.166666666666667	2	6
DONSON	2	9	1	2	168.63	337.26	15	1	1	-1.25	1	-0.151515151515151	3	11
DOPEY1	12	37	2	6	772.2	1544.4	15	1	1	-0.0277777777777777	1	-0.00510204081632654	8	49
DOT1L	5	15	0	0	527.67	1055.34	15	1	1	NA	1	NA	0	20
DPAGT1	1	4	0	0	118.47	236.94	15	1	1	NA	1	NA	0	5
DPCD	0	3	0	0	53.79	107.58	15	1	1	NA	1	NA	0	3
DPEP1	0	1	0	1	8.91	17.82	15	1	1	NA	1	0	1	1
DPEP2	3	5	0	0	135.63	271.26	15	1	1	NA	1	NA	0	8
DPF3	3	5	0	2	143.55	287.1	15	1	1	1	1	0.375	2	8
DPH1	4	3	1	2	50.49	100.98	15	1	1	0.625	1	0.238095238095238	3	7
DPH2	2	5	0	2	41.91	83.82	15	1	1	1	1	0.285714285714286	2	7
DPH5	0	6	0	1	81.18	162.36	15	1	1	NA	1	0	1	6
DPH6	5	6	2	0	125.07	250.14	15	1	0.461538461538462	-Inf	1	-0.545454545454545	2	11
DPH7	9	9	3	2	127.38	254.76	15	1	1	-0.5	1	-0.1	5	18
DPP10	5	5	1	0	170.28	340.56	15	1	1	-Inf	1	-0.5	1	10
DPP4	2	6	0	0	261.69	523.38	15	1	1	NA	1	NA	0	8
DPP6	7	12	1	1	252.45	504.9	15	1	1	-0.714285714285714	1	-0.131578947368421	2	19
DPP7	2	3	0	0	91.74	183.48	15	1	1	NA	1	NA	0	5
DPP8	0	13	0	2	291.72	583.44	15	1	1	NA	1	0	2	13
DPP9	3	13	2	5	264.66	529.32	15	1	0.621385479509049	-0.733333333333333	1	-0.0982142857142857	7	16
DPT	1	5	1	0	51.48	102.96	15	1	0.285714285714286	-Inf	1	-0.833333333333333	1	6
DPY19L1	3	4	0	0	171.93	343.86	15	1	1	NA	1	NA	0	7
DPY19L3	3	9	1	0	305.91	611.82	15	1	0.307692307692308	-Inf	1	-0.75	1	12
DPY19L4	2	8	0	2	204.93	409.86	15	1	1	1	1	0.2	2	10
DPYD	9	10	0	2	323.4	646.8	15	1	0.485714285714286	1	1	0.473684210526316	2	19
DPYS	4	3	0	0	180.18	360.36	15	1	1	NA	1	NA	0	7
DPYSL2	3	12	1	5	197.01	394.02	15	1	1	0.2	1	0.0333333333333334	6	15
DPYSL4	8	9	1	3	184.47	368.94	15	1	0.603007518796992	0.625	1	0.220588235294118	4	17
DR1	0	2	0	1	31.35	62.7	15	1	1	NA	1	0	1	2
DRAM1	4	4	1	1	73.26	146.52	15	1	1	0	1	0	2	8
DRAM2	2	5	0	0	94.71	189.42	15	1	1	NA	1	NA	0	7
DRAXIN	1	8	1	4	98.01	196.02	15	1	1	-1	1	-0.0888888888888889	5	9
DRC1	15	13	0	5	150.81	301.62	15	1	0.0487536656891496	1	1	0.535714285714286	5	28
DRC3	6	11	2	0	172.59	345.18	15	1	0.16374269005848	-Inf	1	-0.647058823529412	2	17
DRC7	11	15	1	0	265.32	530.64	15	1	0.444444444444444	-Inf	1	-0.576923076923077	1	26
DRCC1	8	4	0	0	100.32	200.64	15	1	1	NA	1	NA	0	12
DRD1	0	6	0	0	187.77	375.54	15	1	1	NA	1	NA	0	6
DRD2	1	6	0	1	150.81	301.62	15	1	1	1	1	0.142857142857143	1	7
DRD3	3	8	2	0	156.42	312.84	15	1	0.128205128205128	-Inf	1	-0.727272727272727	2	11
DRD5	4	18	1	1	187.44	374.88	15	1	0.380434782608696	-3.5	1	-0.318181818181818	2	22
DRG2	0	7	0	2	104.94	209.88	15	1	1	NA	1	0	2	7
DRGX	1	2	1	0	32.34	64.68	15	1	1	-Inf	1	-0.666666666666667	1	3
DROSHA	0	2	0	0	144.54	289.08	15	1	1	NA	1	NA	0	2
DRP2	2	8	0	5	153.78	307.56	15	1	0.523809523809524	1	1	0.2	5	10
DSC1	3	8	0	1	284.46	568.92	15	1	1	1	1	0.272727272727273	1	11
DSCAM	1	22	1	3	593.34	1186.68	15	1	0.279202279202279	-6.33333333333333	1	-0.206521739130435	4	23
DSCAML1	3	10	1	6	314.49	628.98	15	1	1	0.444444444444444	1	0.0879120879120879	7	13
DSCR3	0	4	0	1	81.18	162.36	15	1	1	NA	1	0	1	4
DSE	3	19	0	4	356.73	713.46	15	1	1	1	1	0.136363636363636	4	22
DSG2	22	25	1	2	406.56	813.12	15	1	1	0.431818181818182	1	0.134751773049645	3	47
DSG4	1	7	0	0	308.88	617.76	15	1	1	NA	1	NA	0	8
DSP	1	30	0	4	710.82	1421.64	15	1	1	1	1	0.032258064516129	4	31
DST	94	115	15	17	3206.61	6413.22	15	1	0.851090662590584	-0.0794743429286608	1	-0.0189892344497608	32	209
DSTN	2	0	0	0	48.18	96.36	15	1	1	NA	1	NA	0	2
DSTYK	0	15	0	3	255.42	510.84	15	1	1	NA	1	0	3	15
DTD1	0	6	0	1	46.86	93.72	15	1	1	NA	1	0	1	6
DTD2	1	1	0	0	41.25	82.5	15	1	1	NA	1	NA	0	2
DTHD1	24	19	1	0	289.74	579.48	15	1	1	-Inf	1	-0.441860465116279	1	43
DTL	7	22	3	3	218.46	436.92	15	1	0.32197072377338	-2.14285714285714	1	-0.258620689655172	6	29
DTNA	1	16	0	2	257.4	514.8	15	1	1	1	1	0.0588235294117647	2	17
DTNB	2	2	0	2	63.36	126.72	15	1	0.466666666666667	1	1	0.5	2	4
DTNBP1	5	4	0	0	89.76	179.52	15	1	1	NA	1	NA	0	9
DTWD1	0	3	0	0	57.75	115.5	15	1	1	NA	1	NA	0	3
DTWD2	1	3	0	0	49.5	99	15	1	1	NA	1	NA	0	4
DTX1	2	2	2	2	37.95	75.9	15	1	1	0	1	0	4	4
DTX2	2	4	1	1	99	198	15	1	1	-1	1	-0.166666666666667	2	6
DTX3L	23	11	3	3	236.61	473.22	15	1	0.64556661925083	0.521739130434783	1	0.176470588235294	6	34
DTX4	1	4	1	0	76.56	153.12	15	1	0.333333333333333	-Inf	1	-0.8	1	5
DTYMK	0	4	0	0	47.19	94.38	15	1	1	NA	1	NA	0	4
DUOX2	16	17	1	1	394.68	789.36	15	1	1	-0.0625	1	-0.0151515151515151	2	33
DUOXA1L	5	7	1	1	92.07	184.14	15	1	1	-0.4	1	-0.0833333333333333	2	12
DUOXA2	3	3	0	1	61.38	122.76	15	1	1	1	1	0.5	1	6
DUPD1	3	6	1	0	65.01	130.02	15	1	0.4	-Inf	1	-0.666666666666667	1	9
DUS1L	3	5	1	1	158.4	316.8	15	1	1	-0.666666666666667	1	-0.125	2	8
DUS2	2	6	0	0	144.54	289.08	15	1	1	NA	1	NA	0	8
DUS4L	3	6	2	0	90.75	181.5	15	1	0.181818181818182	-Inf	1	-0.666666666666667	2	9
DUSP1	0	5	0	0	71.61	143.22	15	1	1	NA	1	NA	0	5
DUSP10	2	3	1	1	120.78	241.56	15	1	1	-0.5	1	-0.1	2	5
DUSP11RC1I	8	15	2	2	218.13	436.26	15	1	0.612535612535613	-0.875	1	-0.152173913043478	4	23
DUSP12	4	4	0	0	58.41	116.82	15	1	1	NA	1	NA	0	8
DUSP13	4	3	2	1	80.19	160.38	15	1	1	-0.5	1	-0.0952380952380952	3	7
DUSP13L	2	3	1	2	43.56	87.12	15	1	1	0.25	1	0.0666666666666667	3	5
DUSP14	0	2	0	1	55.11	110.22	15	1	1	NA	1	0	1	2
DUSP15	1	4	1	1	60.72	121.44	15	1	1	-3	1	-0.3	2	5
DUSP16	4	8	1	0	185.46	370.92	15	1	0.384615384615385	-Inf	1	-0.666666666666667	1	12
DUSP19	0	2	0	0	28.38	56.76	15	1	1	NA	1	NA	0	2
DUSP26	0	2	0	0	23.1	46.2	15	1	1	NA	1	NA	0	2
DUSP27	11	16	2	3	389.07	778.14	15	1	1	0.0303030303030303	1	0.00740740740740736	5	27
DUSP28	0	5	0	3	36.96	73.92	15	1	1	NA	1	0	3	5
DUSP3	0	2	0	0	27.72	55.44	15	1	1	NA	1	NA	0	2
DUSP5	1	6	0	0	70.29	140.58	15	1	1	NA	1	NA	0	7
DUSP8	1	8	0	1	95.04	190.08	15	1	1	1	1	0.111111111111111	1	9
DUT	0	3	0	0	31.35	62.7	15	1	1	NA	1	NA	0	3
DVL1	0	5	0	0	196.68	393.36	15	1	1	NA	1	NA	0	5
DVL3	0	2	0	0	135.96	271.92	15	1	1	NA	1	NA	0	2
DYDC1	1	1	0	0	31.02	62.04	15	1	1	NA	1	NA	0	2
DYM	4	17	2	2	128.04	256.08	15	1	0.23399209486166	-3.25	1	-0.30952380952381	4	21
DYNC1H1	2	62	2	3	1534.17	3068.34	15	1	0.0240659062279859	-19.6666666666667	1	-0.36875	5	64
DYNC1I1	2	5	0	2	133.32	266.64	15	1	1	1	1	0.285714285714286	2	7
DYNC1I2	0	7	0	0	191.4	382.8	15	1	1	NA	1	NA	0	7
DYNC1LI1	1	5	0	1	129.69	259.38	15	1	1	1	1	0.166666666666667	1	6
DYNC1LI2	1	4	0	0	131.34	262.68	15	1	1	NA	1	NA	0	5
DYNC2H1	28	40	7	5	1271.16	2542.32	15	1	0.348697692562085	-1	1	-0.17156862745098	12	68
DYRK1A	0	7	0	3	261.69	523.38	15	1	1	NA	1	0	3	7
DYRK2	2	10	2	3	231.33	462.66	15	1	0.53781512605042	-2.33333333333333	1	-0.233333333333333	5	12
DYRK3	0	4	0	0	114.51	229.02	15	1	1	NA	1	NA	0	4
DYSF	6	25	3	8	442.53	885.06	15	1	0.675646374845952	-0.5625	1	-0.0791788856304985	11	31
DYX1C1	8	8	1	3	107.25	214.5	15	1	0.591331269349845	0.666666666666667	1	0.25	4	16
DZANK1	9	10	3	3	216.15	432.3	15	1	1	-0.111111111111111	1	-0.0263157894736842	6	19
DZIP1	9	12	3	2	251.79	503.58	15	1	0.634782608695652	-1	1	-0.171428571428571	5	21
DZIP1L	11	8	4	1	104.28	208.56	15	1	0.614624505928854	-1.90909090909091	1	-0.221052631578947	5	19
E2F1	1	2	1	1	36.63	73.26	15	1	1	-1	1	-0.166666666666667	2	3
E2F3	1	2	0	0	105.93	211.86	15	1	1	NA	1	NA	0	3
E2F4	1	8	0	0	87.45	174.9	15	1	1	NA	1	NA	0	9
E2F5	2	5	1	1	109.56	219.12	15	1	1	-1.5	1	-0.214285714285714	2	7
E2F7	4	19	1	3	265.98	531.96	15	1	1	-0.583333333333333	1	-0.0760869565217391	4	23
E2F8	21	12	0	1	258.72	517.44	15	1	0.382352941176471	1	1	0.636363636363636	1	33
E4F1	0	10	0	1	196.35	392.7	15	1	1	NA	1	0	1	10
EAAT5L	4	14	1	5	178.53	357.06	15	1	1	0.3	1	0.0555555555555556	6	18
EAF1	0	3	0	1	63.03	126.06	15	1	1	NA	1	0	1	3
EAF2	1	2	1	1	77.55	155.1	15	1	1	-1	1	-0.166666666666667	2	3
EAPP	2	6	0	1	101.31	202.62	15	1	1	1	1	0.25	1	8
EBF2	0	1	0	1	10.89	21.78	15	1	1	NA	1	0	1	1
ECD	6	6	2	1	154.11	308.22	15	1	1	-1	1	-0.166666666666667	3	12
ECEL1	0	4	0	2	91.41	182.82	15	1	1	NA	1	0	2	4
ECHDC1	3	3	2	0	73.59	147.18	15	1	0.464285714285714	-Inf	1	-0.5	2	6
ECHDC2	1	3	0	0	86.79	173.58	15	1	1	NA	1	NA	0	4
ECHDC3	0	7	0	0	89.43	178.86	15	1	1	NA	1	NA	0	7
ECHS1	2	7	0	0	43.89	87.78	15	1	1	NA	1	NA	0	9
ECI2	3	8	0	2	128.7	257.4	15	1	1	1	1	0.272727272727273	2	11
ECM2	9	14	0	2	194.37	388.74	15	1	0.52	1	1	0.391304347826087	2	23
ECSCR	3	3	0	2	81.84	163.68	15	1	0.464285714285714	1	1	0.5	2	6
ECT2	4	10	1	2	213.84	427.68	15	1	1	-0.25	1	-0.0476190476190476	3	14
EDA	1	5	1	1	90.09	180.18	15	1	0.464285714285714	-4	1	-0.333333333333333	2	6
EDA2R	7	16	4	3	139.92	279.84	15	1	0.371706454465075	-2.04761904761905	1	-0.267080745341615	7	23
EDAR	0	8	0	1	175.23	350.46	15	1	1	NA	1	0	1	8
EDBETA	2	2	0	1	13.86	27.72	15	1	1	1	1	0.5	1	4
EDC3	1	10	0	2	132.66	265.32	15	1	1	1	1	0.0909090909090909	2	11
EDC4	5	18	2	4	436.59	873.18	15	1	0.611936339522546	-0.8	1	-0.115942028985507	6	23
EDEM1	0	6	0	2	150.81	301.62	15	1	1	NA	1	0	2	6
EDEM2	1	8	0	1	131.67	263.34	15	1	1	1	1	0.111111111111111	1	9
EDEM3	3	7	1	0	296.34	592.68	15	1	0.363636363636364	-Inf	1	-0.7	1	10
EDF1	0	2	0	0	22.77	45.54	15	1	1	NA	1	NA	0	2
EDGH	2	4	1	0	64.35	128.7	15	1	0.428571428571428	-Inf	1	-0.666666666666667	1	6
EDIL3	1	4	0	0	84.15	168.3	15	1	1	NA	1	NA	0	5
EDKM	1	1	0	0	30.69	61.38	15	1	1	NA	1	NA	0	2
EDMTF1-EDMTF2-EDMTF3-LOC110231148	2	1	0	1	24.75	49.5	15	1	1	1	1	0.666666666666667	1	3
EDMTFH	0	2	0	1	32.34	64.68	15	1	1	NA	1	0	1	2
EDN1	5	2	0	0	47.85	95.7	15	1	1	NA	1	NA	0	7
EDN2	2	3	0	1	51.48	102.96	15	1	1	1	1	0.4	1	5
EDNRA	0	8	0	1	154.11	308.22	15	1	1	NA	1	0	1	8
EDNRB	1	5	0	0	102.96	205.92	15	1	1	NA	1	NA	0	6
EDNRB2	10	10	5	6	168.63	337.26	15	1	1	0.166666666666667	1	0.0454545454545455	11	20
EDPE	6	4	1	2	81.51	163.02	15	1	0.559440559440559	0.666666666666667	1	0.266666666666667	3	10
EDQCM	3	3	0	1	48.18	96.36	15	1	1	1	1	0.5	1	6
EDQM1	1	0	1	0	15.18	30.36	15	1	1	NA	1	0	1	1
EDQREP	1	1	1	1	51.81	103.62	15	1	1	0	1	0	2	2
EDRF1	9	26	3	3	380.16	760.32	15	1	0.334437775387711	-1.88888888888889	1	-0.242857142857143	6	35
EDWM	5	8	2	2	66.99	133.98	15	1	1	-0.6	1	-0.115384615384615	4	13
EDYM1	1	2	0	0	43.23	86.46	15	1	1	NA	1	NA	0	3
EDYM2	4	8	1	2	144.87	289.74	15	1	1	0	1	0	3	12
EED	0	5	0	3	113.19	226.38	15	1	1	NA	1	0	3	5
EEF1A1	0	8	0	1	186.78	373.56	15	1	1	NA	1	0	1	8
EEF1A2	0	5	0	3	84.15	168.3	15	1	1	NA	1	0	3	5
EEF1AKMT1	2	11	0	4	101.64	203.28	15	1	1	1	1	0.153846153846154	4	13
EEF1B2	0	3	0	0	52.8	105.6	15	1	1	NA	1	NA	0	3
EEF1E1	2	0	0	0	48.51	97.02	15	1	1	NA	1	NA	0	2
EEF2K	0	7	0	0	215.49	430.98	15	1	1	NA	1	NA	0	7
EEF2KMT	1	5	0	1	77.88	155.76	15	1	1	1	1	0.166666666666667	1	6
EEFSEC	4	6	0	0	118.8	237.6	15	1	1	NA	1	NA	0	10
EEPD1	1	20	0	3	186.45	372.9	15	1	1	1	1	0.0476190476190476	3	21
EFCAB1	2	2	1	1	49.83	99.66	15	1	1	0	1	0	2	4
EFCAB10	0	2	0	1	17.49	34.98	15	1	1	NA	1	0	1	2
EFCAB11	2	1	0	0	15.18	30.36	15	1	1	NA	1	NA	0	3
EFCAB14	8	3	3	0	124.08	248.16	15	1	1	-Inf	1	-0.272727272727273	3	11
EFCAB2	1	1	0	0	52.47	104.94	15	1	1	NA	1	NA	0	2
EFCAB5	23	12	1	1	376.53	753.06	15	1	1	0.478260869565217	1	0.157142857142857	2	35
EFCAB7	7	12	1	1	190.74	381.48	15	1	1	-0.714285714285714	1	-0.131578947368421	2	19
EFCC1	6	11	4	2	113.19	226.38	15	1	0.341288002615234	-2.66666666666667	1	-0.313725490196078	6	17
EFEMP1	0	5	0	1	159.72	319.44	15	1	1	NA	1	0	1	5
EFHB	10	5	3	0	222.75	445.5	15	1	0.522058823529412	-Inf	1	-0.333333333333333	3	15
EFHC1	6	8	2	1	220.44	440.88	15	1	0.576470588235294	-1.66666666666667	1	-0.238095238095238	3	14
EFHC2	12	9	1	1	239.91	479.82	15	1	1	0.25	1	0.0714285714285714	2	21
EFHD1	0	4	0	0	33.33	66.66	15	1	1	NA	1	NA	0	4
EFHD2	0	1	0	1	8.25	16.5	15	1	1	NA	1	0	1	1
EFL1	6	15	0	0	318.12	636.24	15	1	1	NA	1	NA	0	21
EFNA2	1	1	0	1	14.85	29.7	15	1	1	1	1	0.5	1	2
EFNA5	0	2	0	0	61.05	122.1	15	1	1	NA	1	NA	0	2
EFNB1	0	1	0	1	41.25	82.5	15	1	1	NA	1	0	1	1
EFNB2	0	4	0	0	70.95	141.9	15	1	1	NA	1	NA	0	4
EFR3A	1	8	1	0	226.05	452.1	15	1	0.2	-Inf	1	-0.888888888888889	1	9
EFR3B	3	11	3	5	148.17	296.34	15	1	0.624355005159959	-1.2	1	-0.160714285714286	8	14
EFTUD2	0	10	0	3	244.53	489.06	15	1	1	NA	1	0	3	10
EGF	25	19	7	4	484.44	968.88	15	1	0.745160502393836	-0.33	1	-0.0681818181818181	11	44
EGFL6	4	8	0	0	110.55	221.1	15	1	1	NA	1	NA	0	12
EGFL7	1	2	0	1	60.72	121.44	15	1	1	1	1	0.333333333333333	1	3
EGFLAM	9	10	1	1	234.3	468.6	15	1	1	-0.111111111111111	1	-0.0263157894736842	2	19
EGR1	0	3	0	0	122.43	244.86	15	1	1	NA	1	NA	0	3
EHBP1	16	12	4	2	385.11	770.22	15	1	1	-0.5	1	-0.0952380952380952	6	28
EHD3	0	5	0	2	164.34	328.68	15	1	1	NA	1	0	2	5
EHF	0	2	0	0	77.22	154.44	15	1	1	NA	1	NA	0	2
EHHADH	7	11	0	2	273.9	547.8	15	1	0.521052631578947	1	1	0.388888888888889	2	18
EHMT1	3	9	1	2	381.15	762.3	15	1	1	-0.5	1	-0.0833333333333333	3	12
EIF1-EIF1B	0	2	0	0	8.91	17.82	15	1	1	NA	1	NA	0	2
EIF1AY	0	3	0	0	28.05	56.1	15	1	1	NA	1	NA	0	3
EIF2A	4	6	0	1	235.95	471.9	15	1	1	1	1	0.4	1	10
EIF2AK1	8	6	0	0	223.08	446.16	15	1	1	NA	1	NA	0	14
EIF2AK2	15	7	0	3	143.22	286.44	15	1	0.0521739130434783	1	1	0.681818181818182	3	22
EIF2AK3	1	11	0	3	267.3	534.6	15	1	1	1	1	0.0833333333333333	3	12
EIF2B1	0	5	0	0	68.64	137.28	15	1	1	NA	1	NA	0	5
EIF2B2	0	8	0	1	77.55	155.1	15	1	1	NA	1	0	1	8
EIF2B3	1	3	0	0	114.18	228.36	15	1	1	NA	1	NA	0	4
EIF2B5	3	10	2	2	207.24	414.48	15	1	0.53781512605042	-2.33333333333333	1	-0.269230769230769	4	13
EIF2D	8	6	3	1	179.85	359.7	15	1	1	-1.25	1	-0.178571428571429	4	14
EIF2S1	0	5	0	1	67.98	135.96	15	1	1	NA	1	0	1	5
EIF2S2	0	2	0	1	92.4	184.8	15	1	1	NA	1	0	1	2
EIF2S3	0	5	0	0	149.16	298.32	15	1	1	NA	1	NA	0	5
EIF3A	1	21	0	2	338.25	676.5	15	1	1	1	1	0.0454545454545455	2	22
EIF3B	0	7	0	3	168.3	336.6	15	1	1	NA	1	0	3	7
EIF3D	1	26	1	7	245.52	491.04	15	1	0.410084033613445	-2.71428571428571	1	-0.087962962962963	8	27
EIF3E	0	8	0	1	132.66	265.32	15	1	1	NA	1	0	1	8
EIF3F	0	2	0	0	63.69	127.38	15	1	1	NA	1	NA	0	2
EIF3H	1	3	0	2	96.03	192.06	15	1	1	1	1	0.25	2	4
EIF3I	0	6	0	1	81.18	162.36	15	1	1	NA	1	0	1	6
EIF3L	0	18	0	5	118.14	236.28	15	1	1	NA	1	0	5	18
EIF3M	1	7	0	0	114.84	229.68	15	1	1	NA	1	NA	0	8
EIF4A2	0	4	0	0	136.62	273.24	15	1	1	NA	1	NA	0	4
EIF4A3	0	6	0	0	105.6	211.2	15	1	1	NA	1	NA	0	6
EIF4E	0	2	0	0	73.92	147.84	15	1	1	NA	1	NA	0	2
EIF4E1B	0	1	0	1	10.89	21.78	15	1	1	NA	1	0	1	1
EIF4G1	2	3	2	0	162.69	325.38	15	1	0.428571428571428	-Inf	1	-0.6	2	5
EIF4G2	3	9	1	4	340.89	681.78	15	1	1	0.25	1	0.05	5	12
EIF4G3	7	21	4	3	494.67	989.34	15	1	0.171455211673101	-3	1	-0.321428571428571	7	28
EIF5	0	3	0	1	119.79	239.58	15	1	1	NA	1	0	1	3
EIF5A2-LOC107050352-RPL22L1	0	7	0	2	62.37	124.74	15	1	1	NA	1	0	2	7
EIF5B	4	15	1	1	280.17	560.34	15	1	0.428571428571428	-2.75	1	-0.289473684210526	2	19
EIF6	0	2	0	1	51.15	102.3	15	1	1	NA	1	0	1	2
ELAC2	2	7	0	1	220.11	440.22	15	1	1	1	1	0.222222222222222	1	9
ELAVL1	0	2	0	0	95.37	190.74	15	1	1	NA	1	NA	0	2
ELAVL2	2	2	1	0	101.97	203.94	15	1	1	-Inf	1	-0.5	1	4
ELAVL4	1	7	0	3	156.09	312.18	15	1	1	1	1	0.125	3	8
ELF1	3	8	1	0	214.83	429.66	15	1	0.333333333333333	-Inf	1	-0.727272727272727	1	11
ELF2	1	3	0	1	172.92	345.84	15	1	1	1	1	0.25	1	4
ELF5	3	3	0	1	103.95	207.9	15	1	1	1	1	0.5	1	6
ELFN1	0	8	0	1	169.29	338.58	15	1	1	NA	1	0	1	8
ELFN2	1	6	1	3	201.3	402.6	15	1	1	-1	1	-0.107142857142857	4	7
ELK3	0	6	0	1	104.61	209.22	15	1	1	NA	1	0	1	6
ELK4	0	5	0	0	119.79	239.58	15	1	1	NA	1	NA	0	5
ELL	1	6	1	1	121.11	242.22	15	1	0.416666666666667	-5	1	-0.357142857142857	2	7
ELL2	10	7	0	1	135.96	271.92	15	1	0.444444444444444	1	1	0.588235294117647	1	17
ELMO1	1	2	0	0	91.08	182.16	15	1	1	NA	1	NA	0	3
ELMO2	0	10	0	0	264.99	529.98	15	1	1	NA	1	NA	0	10
ELMO3	3	6	2	2	133.65	267.3	15	1	1	-1	1	-0.166666666666667	4	9
ELMOD1	0	7	0	1	92.4	184.8	15	1	1	NA	1	0	1	7
ELMOD2	2	2	1	0	66.33	132.66	15	1	1	-Inf	1	-0.5	1	4
ELMSAN1	8	12	1	1	390.39	780.78	15	1	1	-0.5	1	-0.1	2	20
ELOVL1	1	8	0	1	90.75	181.5	15	1	1	1	1	0.111111111111111	1	9
ELOVL2	1	6	1	2	91.74	183.48	15	1	1	-2	1	-0.19047619047619	3	7
ELOVL3	2	5	0	3	56.43	112.86	15	1	1	1	1	0.285714285714286	3	7
ELOVL5	0	2	0	0	92.4	184.8	15	1	1	NA	1	NA	0	2
ELP2	9	9	4	1	238.92	477.84	15	1	0.339356295878035	-3	1	-0.3	5	18
ELP3	3	10	2	2	189.75	379.5	15	1	0.53781512605042	-2.33333333333333	1	-0.269230769230769	4	13
ELP4	3	7	0	0	101.97	203.94	15	1	1	NA	1	NA	0	10
EMB	3	4	0	0	66	132	15	1	1	NA	1	NA	0	7
EMC1	6	10	1	3	256.41	512.82	15	1	1	0.444444444444444	1	0.125	4	16
EMC3	0	3	0	0	50.82	101.64	15	1	1	NA	1	NA	0	3
EMC7	0	2	0	0	53.13	106.26	15	1	1	NA	1	NA	0	2
EMC8	0	5	0	0	36.63	73.26	15	1	1	NA	1	NA	0	5
EME1	2	2	0	0	75.24	150.48	15	1	1	NA	1	NA	0	4
EMG1	1	1	0	0	43.89	87.78	15	1	1	NA	1	NA	0	2
EMID1	2	3	1	0	91.41	182.82	15	1	1	-Inf	1	-0.6	1	5
EMILIN2	10	19	4	3	345.84	691.68	15	1	0.3939568838288	-1.53333333333333	1	-0.226600985221675	7	29
EMILIN3	2	11	2	1	146.19	292.38	15	1	0.135714285714286	-10	1	-0.512820512820513	3	13
EML1	3	10	0	2	279.51	559.02	15	1	1	1	1	0.230769230769231	2	13
EML4	1	12	0	2	279.18	558.36	15	1	1	1	1	0.0769230769230769	2	13
EML5	0	17	0	2	585.75	1171.5	15	1	1	NA	1	0	2	17
EML6	0	16	0	4	532.29	1064.58	15	1	1	NA	1	0	4	16
EMP1	1	2	0	0	34.98	69.96	15	1	1	NA	1	NA	0	3
EMSY	2	12	2	1	343.2	686.4	15	1	0.120588235294118	-11	1	-0.523809523809524	3	14
EMX1-EMX2	0	1	0	1	13.2	26.4	15	1	1	NA	1	0	1	1
ENC1	0	10	0	3	159.06	318.12	15	1	1	NA	1	0	3	10
ENDOD1	2	11	0	3	95.7	191.4	15	1	1	1	1	0.153846153846154	3	13
ENDOG	1	2	0	0	66	132	15	1	1	NA	1	NA	0	3
ENDOU	0	1	0	1	53.46	106.92	15	1	1	NA	1	0	1	1
ENDOV	4	4	1	1	57.75	115.5	15	1	1	0	1	0	2	8
ENG	3	5	1	3	51.48	102.96	15	1	1	0.444444444444444	1	0.125	4	8
ENGASE	7	9	4	5	125.07	250.14	15	1	1	-0.0285714285714285	1	-0.00694444444444442	9	16
ENKUR	2	3	1	0	57.42	114.84	15	1	1	-Inf	1	-0.6	1	5
ENO1	1	7	0	1	124.08	248.16	15	1	1	1	1	0.125	1	8
ENO2	1	8	0	0	133.32	266.64	15	1	1	NA	1	NA	0	9
ENO4	14	5	1	0	198.99	397.98	15	1	1	-Inf	1	-0.263157894736842	1	19
ENOPH1	0	3	0	0	52.14	104.28	15	1	1	NA	1	NA	0	3
ENOX1	0	8	0	2	157.41	314.82	15	1	1	NA	1	0	2	8
ENOX2	1	4	1	1	168.3	336.6	15	1	1	-3	1	-0.3	2	5
ENPEP	9	14	2	2	333.96	667.92	15	1	1	-0.555555555555556	1	-0.108695652173913	4	23
ENPP1	3	13	0	2	280.5	561	15	1	1	1	1	0.1875	2	16
ENPP2	0	7	0	2	272.91	545.82	15	1	1	NA	1	0	2	7
ENPP3	10	9	0	0	261.03	522.06	15	1	1	NA	1	NA	0	19
ENPP4	6	12	0	1	177.87	355.74	15	1	1	1	1	0.333333333333333	1	18
ENPP7	0	10	0	3	129.69	259.38	15	1	1	NA	1	0	3	10
ENSA	1	5	1	2	22.11	44.22	15	1	1	-1.5	1	-0.166666666666667	3	6
ENTPD1	2	8	1	1	142.89	285.78	15	1	0.454545454545455	-3	1	-0.3	2	10
ENTPD2	3	3	0	0	134.31	268.62	15	1	1	NA	1	NA	0	6
ENTPD2L	8	5	4	1	139.59	279.18	15	1	0.61484593837535	-1.5	1	-0.184615384615385	5	13
ENTPD3	5	11	2	4	150.48	300.96	15	1	1	-0.1	1	-0.0208333333333333	6	16
ENTPD4	2	16	1	7	184.47	368.94	15	1	1	-0.142857142857143	1	-0.0138888888888889	8	18
ENTPD5	2	5	0	0	139.92	279.84	15	1	1	NA	1	NA	0	7
ENTPD6	0	4	0	1	127.38	254.76	15	1	1	NA	1	0	1	4
ENTPD8	4	8	0	0	127.71	255.42	15	1	1	NA	1	NA	0	12
ENTPD8-ENTPD8L	5	10	1	4	102.3	204.6	15	1	1	0.5	1	0.133333333333333	5	15
EOGT	5	3	3	1	137.94	275.88	15	1	1	-0.8	1	-0.125	4	8
EP300	1	30	0	5	641.52	1283.04	15	1	1	1	1	0.032258064516129	5	31
EP400	8	35	4	6	580.8	1161.6	15	1	0.207330899825415	-1.91666666666667	1	-0.213953488372093	10	43
EPAS1	6	7	2	2	310.53	621.06	15	1	1	-0.166666666666667	1	-0.0384615384615384	4	13
EPB41	4	16	2	1	253.44	506.88	15	1	0.15527950310559	-7	1	-0.466666666666667	3	20
EPB41L1	14	12	0	0	473.22	946.44	15	1	1	NA	1	NA	0	26
EPB41L2	10	13	2	3	303.6	607.2	15	1	1	0.133333333333333	1	0.0347826086956521	5	23
EPB41L3	7	13	2	3	370.26	740.52	15	1	1	-0.238095238095238	1	-0.05	5	20
EPB41L4A	4	11	2	1	170.61	341.22	15	1	0.245098039215686	-4.5	1	-0.4	3	15
EPB41L5	6	8	4	0	210.54	421.08	15	1	0.0915032679738562	-Inf	1	-0.571428571428571	4	14
EPC2	6	5	2	2	236.61	473.22	15	1	1	0.166666666666667	1	0.0454545454545454	4	11
EPCAM	4	8	0	3	83.16	166.32	15	1	0.516483516483517	1	1	0.333333333333333	3	12
EPDR1	1	1	0	0	28.71	57.42	15	1	1	NA	1	NA	0	2
EPFIP1L	1	3	0	1	124.08	248.16	15	1	1	1	1	0.25	1	4
EPG5	15	33	2	1	660.99	1321.98	15	1	0.25469387755102	-3.4	1	-0.354166666666667	3	48
EPGN	0	1	0	1	61.71	123.42	15	1	1	NA	1	0	1	1
EPHA1	5	16	2	2	348.81	697.62	15	1	0.548458498023715	-2.2	1	-0.261904761904762	4	21
EPHA10	5	16	1	7	247.17	494.34	15	1	0.647214854111406	0.542857142857143	1	0.113095238095238	8	21
EPHA2	0	2	0	1	22.44	44.88	15	1	1	NA	1	0	1	2
EPHA4	1	3	1	0	386.1	772.2	15	1	0.4	-Inf	1	-0.75	1	4
EPHA5	1	9	0	1	163.35	326.7	15	1	1	1	1	0.1	1	10
EPHA6	0	2	0	0	84.81	169.62	15	1	1	NA	1	NA	0	2
EPHA7	0	6	0	0	302.61	605.22	15	1	1	NA	1	NA	0	6
EPHA8	2	11	1	2	220.11	440.22	15	1	0.489285714285714	-1.75	1	-0.179487179487179	3	13
EPHB1	1	12	1	1	185.79	371.58	15	1	0.257142857142857	-11	1	-0.423076923076923	2	13
EPHB2	0	10	0	5	293.04	586.08	15	1	1	NA	1	0	5	10
EPHB3	0	16	0	4	153.78	307.56	15	1	1	NA	1	0	4	16
EPHB6	11	20	5	3	391.71	783.42	15	1	0.234877888128662	-2.03030303030303	1	-0.270161290322581	8	31
EPHX1	4	4	2	0	182.16	364.32	15	1	0.466666666666667	-Inf	1	-0.5	2	8
EPHX1L	3	5	2	1	119.46	238.92	15	1	0.545454545454546	-2.33333333333333	1	-0.291666666666667	3	8
EPHX4	0	3	0	0	87.45	174.9	15	1	1	NA	1	NA	0	3
EPM2A	3	5	2	3	74.58	149.16	15	1	1	-0.111111111111111	1	-0.025	5	8
EPN3	1	2	0	1	71.61	143.22	15	1	1	1	1	0.333333333333333	1	3
EPPKL	10	18	5	5	317.46	634.92	15	1	0.472559158648277	-0.8	1	-0.142857142857143	10	28
EPRS	7	16	0	1	513.15	1026.3	15	1	1	1	1	0.304347826086957	1	23
EPS15	1	4	0	1	208.89	417.78	15	1	1	1	1	0.2	1	5
EPS15L1	4	17	1	5	374.55	749.1	15	1	1	0.15	1	0.0238095238095238	6	21
EPS8	5	10	1	1	231.99	463.98	15	1	1	-1	1	-0.166666666666667	2	15
EPS8L2	2	7	0	1	214.5	429	15	1	1	1	1	0.222222222222222	1	9
EPSTI1	4	1	0	0	70.62	141.24	15	1	1	NA	1	NA	0	5
EPT1L	0	6	0	1	103.62	207.24	15	1	1	NA	1	0	1	6
ERAL1	6	2	2	1	105.27	210.54	15	1	1	0.333333333333333	1	0.0833333333333334	3	8
ERAP1	10	15	0	2	176.88	353.76	15	1	0.515669515669516	1	1	0.4	2	25
ERBB4	2	8	0	2	186.12	372.24	15	1	1	1	1	0.2	2	10
ERC1	1	5	0	0	122.76	245.52	15	1	1	NA	1	NA	0	6
ERC2	1	2	1	0	85.8	171.6	15	1	1	-Inf	1	-0.666666666666667	1	3
ERCC3	0	12	0	1	230.01	460.02	15	1	1	NA	1	0	1	12
ERCC4	19	22	1	0	366.63	733.26	15	1	0.476190476190476	-Inf	1	-0.536585365853659	1	41
ERCC5	14	10	3	1	295.68	591.36	15	1	1	-1.14285714285714	1	-0.166666666666667	4	24
ERCC6	14	15	3	2	437.25	874.5	15	1	1	-0.607142857142857	1	-0.117241379310345	5	29
ERCC6L	24	15	3	4	365.97	731.94	15	1	0.424363116229747	0.53125	1	0.186813186813187	7	39
ERCC6L2	18	20	3	0	373.89	747.78	15	1	0.231707317073171	-Inf	1	-0.526315789473684	3	38
EREG	0	3	0	0	52.14	104.28	15	1	1	NA	1	NA	0	3
ERG	0	6	0	1	165.99	331.98	15	1	1	NA	1	0	1	6
ERGIC1	1	1	0	0	109.23	218.46	15	1	1	NA	1	NA	0	2
ERGIC2	0	4	0	0	110.88	221.76	15	1	1	NA	1	NA	0	4
ERGIC3	1	4	1	2	118.14	236.28	15	1	1	-1	1	-0.133333333333333	3	5
ERH	0	4	0	0	30.36	60.72	15	1	1	NA	1	NA	0	4
ERI2	12	10	0	0	209.88	419.76	15	1	1	NA	1	NA	0	22
ERICH1	6	6	2	1	123.09	246.18	15	1	1	-1	1	-0.166666666666667	3	12
ERICH3	21	8	5	2	294.03	588.06	15	1	1	0.0476190476190477	1	0.00985221674876846	7	29
ERICH5	5	5	4	3	63.69	127.38	15	1	1	-0.333333333333333	1	-0.0714285714285714	7	10
ERICH6B	10	9	3	4	180.18	360.36	15	1	1	0.325	1	0.0977443609022556	7	19
ERLEC1	0	2	0	0	108.57	217.14	15	1	1	NA	1	NA	0	2
ERLIN1	1	3	0	0	69.63	139.26	15	1	1	NA	1	NA	0	4
ERLIN2	3	7	3	3	77.55	155.1	15	1	0.606643356643357	-1.33333333333333	1	-0.2	6	10
ERMARD	5	10	2	4	183.48	366.96	15	1	1	0	1	0	6	15
ERMN	4	6	0	0	55.77	111.54	15	1	1	NA	1	NA	0	10
ERMP1	2	8	1	0	183.48	366.96	15	1	0.272727272727273	-Inf	1	-0.8	1	10
ERN1	5	19	1	1	324.72	649.44	15	1	0.415384615384615	-2.8	1	-0.291666666666667	2	24
ERN2	5	8	3	2	175.23	350.46	15	1	0.607843137254902	-1.4	1	-0.215384615384615	5	13
ERO1A	1	10	0	4	116.16	232.32	15	1	1	1	1	0.0909090909090909	4	11
ERO1B	0	5	0	1	151.47	302.94	15	1	1	NA	1	0	1	5
ERP29	0	4	0	0	94.38	188.76	15	1	1	NA	1	NA	0	4
ERP44	0	3	0	2	124.08	248.16	15	1	1	NA	1	0	2	3
ERRFI1	3	7	0	0	115.17	230.34	15	1	1	NA	1	NA	0	10
ES1ML1	0	3	0	1	47.52	95.04	15	1	1	NA	1	0	1	3
ES1ML2	5	1	2	0	95.04	190.08	15	1	1	-Inf	1	-0.166666666666667	2	6
ESCO1	8	17	2	5	333.96	667.92	15	1	1	0.15	1	0.0342857142857143	7	25
ESCO2	6	13	0	3	77.55	155.1	15	1	0.532467532467532	1	1	0.315789473684211	3	19
ESD	2	6	0	0	86.79	173.58	15	1	1	NA	1	NA	0	8
ESF1	10	11	2	1	163.02	326.04	15	1	1	-1.2	1	-0.19047619047619	3	21
ESM1	1	2	0	0	48.84	97.68	15	1	1	NA	1	NA	0	3
ESPL1	61	52	0	2	409.53	819.06	15	1	0.218306636155606	1	1	0.539823008849557	2	113
ESPN	6	13	0	0	161.7	323.4	15	1	1	NA	1	NA	0	19
ESR1	1	5	0	0	152.46	304.92	15	1	1	NA	1	NA	0	6
ESR2	2	9	0	0	165.66	331.32	15	1	1	NA	1	NA	0	11
ESRP1	3	11	2	6	179.85	359.7	15	1	1	-0.222222222222222	1	-0.0357142857142857	8	14
ESRP2	2	9	1	0	246.18	492.36	15	1	0.25	-Inf	1	-0.818181818181818	1	11
ESRRB	0	4	0	1	153.45	306.9	15	1	1	NA	1	0	1	4
ESYT2	3	7	1	4	201.96	403.92	15	1	1	0.416666666666667	1	0.1	5	10
ESYT3	7	14	1	5	263.34	526.68	15	1	0.633363737711564	0.6	1	0.166666666666667	6	21
ETAA1	16	8	4	1	231	462	15	1	1	-1	1	-0.133333333333333	5	24
ETF1	0	1	0	1	134.31	268.62	15	1	1	NA	1	0	1	1
ETFA	0	7	0	0	90.75	181.5	15	1	1	NA	1	NA	0	7
ETFBKMT	4	12	1	7	107.58	215.16	15	1	0.631093544137022	0.571428571428571	1	0.125	8	16
ETFDH	0	13	0	2	167.64	335.28	15	1	1	NA	1	0	2	13
ETNK1	1	1	1	0	111.21	222.42	15	1	1	-Inf	1	-0.5	1	2
ETNK2	0	4	0	3	42.57	85.14	15	1	1	NA	1	0	3	4
ETNPPL	3	6	0	0	143.88	287.76	15	1	1	NA	1	NA	0	9
ETS1	0	3	0	0	99.33	198.66	15	1	1	NA	1	NA	0	3
ETS2	0	6	0	1	146.52	293.04	15	1	1	NA	1	0	1	6
ETV3	1	6	1	5	71.94	143.88	15	1	1	-0.2	1	-0.0238095238095238	6	7
ETV3L	0	1	0	1	10.89	21.78	15	1	1	NA	1	0	1	1
ETV4	0	2	0	0	78.54	157.08	15	1	1	NA	1	NA	0	2
ETV5	0	3	0	2	77.55	155.1	15	1	1	NA	1	0	2	3
ETV6	0	3	0	1	88.11	176.22	15	1	1	NA	1	0	1	3
EVA1A	5	6	1	0	141.57	283.14	15	1	1	-Inf	1	-0.545454545454545	1	11
EVA1B	0	1	0	1	10.89	21.78	15	1	1	NA	1	0	1	1
EVA1C	3	4	2	0	74.25	148.5	15	1	0.444444444444445	-Inf	1	-0.571428571428571	2	7
EVA1CL	1	3	0	1	39.93	79.86	15	1	1	1	1	0.25	1	4
EVC	8	15	2	0	308.55	617.1	15	1	0.15	-Inf	1	-0.652173913043478	2	23
EVC2	19	9	6	0	340.89	681.78	15	1	0.162192989239381	-Inf	1	-0.321428571428571	6	28
EVI5	0	6	0	0	276.54	553.08	15	1	1	NA	1	NA	0	6
EVI5L	0	2	0	1	21.12	42.24	15	1	1	NA	1	0	1	2
EVL	1	5	1	0	123.09	246.18	15	1	0.285714285714286	-Inf	1	-0.833333333333333	1	6
EVPL	8	25	1	6	534.27	1068.54	15	1	1	0.479166666666667	1	0.0995670995670996	7	33
EVX2	2	0	0	0	95.7	191.4	15	1	1	NA	1	NA	0	2
EXD2	4	11	0	4	179.52	359.04	15	1	0.530443756449948	1	1	0.266666666666667	4	15
EXD3	13	9	3	0	240.24	480.48	15	1	0.28	-Inf	1	-0.409090909090909	3	22
EXFABP	2	4	0	0	94.71	189.42	15	1	1	NA	1	NA	0	6
EXO1	9	8	2	1	265.98	531.96	15	1	1	-0.777777777777778	1	-0.137254901960784	3	17
EXOC3	0	10	0	1	170.61	341.22	15	1	1	NA	1	0	1	10
EXOC3L	15	2	2	0	218.46	436.92	15	1	1	-Inf	1	-0.117647058823529	2	17
EXOC3L1	5	8	0	3	165.99	331.98	15	1	0.508928571428571	1	1	0.384615384615385	3	13
EXOC3L4	12	12	1	1	218.79	437.58	15	1	1	0	1	0	2	24
EXOC4	5	15	0	3	276.54	553.08	15	1	1	1	1	0.25	3	20
EXOC6	0	4	0	0	238.59	477.18	15	1	1	NA	1	NA	0	4
EXOC6B	2	4	0	0	160.05	320.1	15	1	1	NA	1	NA	0	6
EXOC7	1	15	1	4	230.01	460.02	15	1	0.428571428571429	-2.75	1	-0.1375	5	16
EXOC8	1	2	0	0	102.96	205.92	15	1	1	NA	1	NA	0	3
EXOG	2	3	2	0	103.95	207.9	15	1	0.428571428571428	-Inf	1	-0.6	2	5
EXOSC10	10	12	3	1	257.73	515.46	15	1	0.59304347826087	-2.6	1	-0.295454545454545	4	22
EXOSC2	1	3	0	1	54.78	109.56	15	1	1	1	1	0.25	1	4
EXOSC7	7	3	2	0	114.51	229.02	15	1	1	-Inf	1	-0.3	2	10
EXOSC8	1	4	0	0	79.2	158.4	15	1	1	NA	1	NA	0	5
EXOSC9	8	7	1	1	148.5	297	15	1	1	0.125	1	0.0333333333333333	2	15
EXPH5	35	31	6	2	706.86	1413.72	15	1	0.285890339858363	-1.65714285714286	1	-0.21969696969697	8	66
EXT1	0	2	0	0	180.18	360.36	15	1	1	NA	1	NA	0	2
EXT2	2	8	2	1	214.17	428.34	15	1	0.202797202797203	-7	1	-0.466666666666667	3	10
EXTL1	3	6	1	3	66	132	15	1	1	0.333333333333333	1	0.0833333333333333	4	9
EXTL2	3	3	0	1	94.05	188.1	15	1	1	1	1	0.5	1	6
EXTL3	1	12	1	6	249.48	498.96	15	1	1	-1	1	-0.0659340659340659	7	13
EYA4	1	6	0	0	173.25	346.5	15	1	1	NA	1	NA	0	7
EYS	12	17	1	3	338.25	676.5	15	1	1	0.527777777777778	1	0.163793103448276	4	29
EZH1	2	12	1	1	173.25	346.5	15	1	0.35	-5	1	-0.357142857142857	2	14
EZR	1	11	1	1	215.49	430.98	15	1	0.274725274725275	-10	1	-0.416666666666667	2	12
F10	2	8	0	2	141.24	282.48	15	1	1	1	1	0.2	2	10
F11	4	11	1	2	218.79	437.58	15	1	1	-0.375	1	-0.0666666666666667	3	15
F13B	1	0	1	0	8.91	17.82	15	1	1	NA	1	0	1	1
F2	7	12	0	0	211.86	423.72	15	1	1	NA	1	NA	0	19
F2R	1	2	0	0	94.38	188.76	15	1	1	NA	1	NA	0	3
F2RL1	5	4	0	0	87.45	174.9	15	1	1	NA	1	NA	0	9
F2RL3	4	9	2	1	136.29	272.58	15	1	0.517857142857143	-3.5	1	-0.358974358974359	3	13
F3	2	6	0	0	79.86	159.72	15	1	1	NA	1	NA	0	8
F5	25	38	3	8	753.39	1506.78	15	1	0.517565904312938	0.43	1	0.124098124098124	11	63
F7	1	8	1	1	140.58	281.16	15	1	0.345454545454545	-7	1	-0.388888888888889	2	9
F8	29	36	8	8	531.96	1063.92	15	1	0.782736368532173	-0.241379310344828	1	-0.0538461538461538	16	65
F9	3	10	0	2	132	264	15	1	1	1	1	0.230769230769231	2	13
FAAH	1	6	0	2	161.04	322.08	15	1	1	1	1	0.142857142857143	2	7
FAAH2	1	7	0	4	77.88	155.76	15	1	1	1	1	0.125	4	8
FAAHL	4	5	2	0	181.5	363	15	1	0.454545454545455	-Inf	1	-0.555555555555556	2	9
FAAP100	4	5	4	2	92.73	185.46	15	1	0.608391608391608	-1.5	1	-0.222222222222222	6	9
FAAP24	4	5	0	0	69.63	139.26	15	1	1	NA	1	NA	0	9
FABP1	4	2	0	0	50.49	100.98	15	1	1	NA	1	NA	0	6
FABP2	3	1	2	0	34.65	69.3	15	1	1	-Inf	1	-0.25	2	4
FABP6	0	2	0	0	32.01	64.02	15	1	1	NA	1	NA	0	2
FABP7	1	1	0	0	36.63	73.26	15	1	1	NA	1	NA	0	2
FADD	0	2	0	0	50.16	100.32	15	1	1	NA	1	NA	0	2
FADS1	2	4	0	0	116.16	232.32	15	1	1	NA	1	NA	0	6
FADS1L1	1	5	1	0	148.5	297	15	1	0.285714285714286	-Inf	1	-0.833333333333333	1	6
FADS1L2	3	4	2	0	144.54	289.08	15	1	0.444444444444445	-Inf	1	-0.571428571428571	2	7
FADS2	3	3	0	0	126.06	252.12	15	1	1	NA	1	NA	0	6
FADS6	1	2	0	0	66	132	15	1	1	NA	1	NA	0	3
FAF1	0	8	0	0	192.06	384.12	15	1	1	NA	1	NA	0	8
FAF2	0	6	0	0	108.57	217.14	15	1	1	NA	1	NA	0	6
FAH	2	1	0	0	135.63	271.26	15	1	1	NA	1	NA	0	3
FAHD1	1	1	0	0	32.67	65.34	15	1	1	NA	1	NA	0	2
FAIM2	0	2	0	0	65.67	131.34	15	1	1	NA	1	NA	0	2
FAM102B-LOC429054	3	3	1	0	65.67	131.34	15	1	1	-Inf	1	-0.5	1	6
FAM103A1	0	2	0	0	45.87	91.74	15	1	1	NA	1	NA	0	2
FAM105A	5	7	0	0	142.56	285.12	15	1	1	NA	1	NA	0	12
FAM105B	0	2	0	1	102.96	205.92	15	1	1	NA	1	0	1	2
FAM107A	4	5	2	1	59.73	119.46	15	1	1	-1.5	1	-0.222222222222222	3	9
FAM109A	1	1	0	0	30.36	60.72	15	1	1	NA	1	NA	0	2
FAM109B	2	1	2	1	23.1	46.2	15	1	1	0	1	0	3	3
FAM110A	3	0	2	0	22.44	44.88	15	1	1	NA	1	0	2	3
FAM110B	0	8	0	5	143.22	286.44	15	1	1	NA	1	0	5	8
FAM110C	3	7	1	2	84.81	169.62	15	1	1	-0.166666666666667	1	-0.0333333333333333	3	10
FAM114A1	3	7	1	1	191.4	382.8	15	1	1	-1.33333333333333	1	-0.2	2	10
FAM114A2	3	8	0	1	125.4	250.8	15	1	1	1	1	0.272727272727273	1	11
FAM117A	3	12	0	2	86.13	172.26	15	1	1	1	1	0.2	2	15
FAM117B	1	11	0	1	122.43	244.86	15	1	1	1	1	0.0833333333333333	1	12
FAM120A	3	3	1	2	302.94	605.88	15	1	1	0.5	1	0.166666666666667	3	6
FAM120B	2	9	0	1	165.33	330.66	15	1	1	1	1	0.181818181818182	1	11
FAM122A	0	3	0	1	71.28	142.56	15	1	1	NA	1	0	1	3
FAM122B	0	3	0	0	63.36	126.72	15	1	1	NA	1	NA	0	3
FAM124A	6	7	0	1	241.23	482.46	15	1	1	1	1	0.461538461538462	1	13
FAM124B	6	5	2	1	140.58	281.16	15	1	1	-0.666666666666667	1	-0.121212121212121	3	11
FAM126A	1	4	0	0	172.26	344.52	15	1	1	NA	1	NA	0	5
FAM126B	0	4	0	1	189.42	378.84	15	1	1	NA	1	0	1	4
FAM129A	11	7	2	0	288.75	577.5	15	1	0.521052631578947	-Inf	1	-0.388888888888889	2	18
FAM129B	1	3	1	1	70.29	140.58	15	1	1	-2	1	-0.25	2	4
FAM131A	1	1	1	1	22.11	44.22	15	1	1	0	1	0	2	2
FAM133B	4	2	3	0	58.41	116.82	15	1	0.5	-Inf	1	-0.333333333333333	3	6
FAM134B	2	5	0	1	134.64	269.28	15	1	1	1	1	0.285714285714286	1	7
FAM134C	2	4	0	1	110.22	220.44	15	1	1	1	1	0.333333333333333	1	6
FAM135A	16	23	1	5	551.43	1102.86	15	1	0.384623317691951	0.7125	1	0.243589743589744	6	39
FAM135B	13	17	5	1	404.25	808.5	15	1	0.17741935483871	-5.53846153846154	1	-0.4	6	30
FAM13B	1	5	0	1	264	528	15	1	1	1	1	0.166666666666667	1	6
FAM13C	6	13	0	0	367.62	735.24	15	1	1	NA	1	NA	0	19
FAM149B1	13	9	3	1	207.57	415.14	15	1	1	-1.07692307692308	1	-0.159090909090909	4	22
FAM160A2	1	7	0	2	141.24	282.48	15	1	1	1	1	0.125	2	8
FAM160B1	2	11	1	3	233.31	466.62	15	1	1	-0.833333333333333	1	-0.0961538461538461	4	13
FAM161B	7	9	2	0	184.8	369.6	15	1	0.470588235294118	-Inf	1	-0.5625	2	16
FAM162A	3	4	1	1	51.81	103.62	15	1	1	-0.333333333333333	1	-0.0714285714285715	2	7
FAM162B	0	2	0	1	50.49	100.98	15	1	1	NA	1	0	1	2
FAM163A	0	4	0	2	27.72	55.44	15	1	1	NA	1	0	2	4
FAM163B	2	1	1	1	15.51	31.02	15	1	1	0.5	1	0.166666666666667	2	3
FAM166A	2	10	0	2	76.89	153.78	15	1	1	1	1	0.166666666666667	2	12
FAM167A	1	6	1	3	82.5	165	15	1	1	-1	1	-0.107142857142857	4	7
FAM167B	0	2	0	0	10.23	20.46	15	1	1	NA	1	NA	0	2
FAM168A	7	2	5	0	69.63	139.26	15	1	0.505494505494505	-Inf	1	-0.222222222222222	5	9
FAM169A	4	4	0	0	124.08	248.16	15	1	1	NA	1	NA	0	8
FAM169B	2	1	0	0	111.54	223.08	15	1	1	NA	1	NA	0	3
FAM171A1	2	13	1	5	318.45	636.9	15	1	1	-0.3	1	-0.0333333333333333	6	15
FAM171B	10	15	2	0	237.93	475.86	15	1	0.188034188034188	-Inf	1	-0.6	2	25
FAM172A	0	3	0	1	52.14	104.28	15	1	1	NA	1	0	1	3
FAM172BP	14	7	1	0	134.31	268.62	15	1	1	-Inf	1	-0.333333333333333	1	21
FAM173B	4	0	0	0	49.83	99.66	15	1	1	NA	1	NA	0	4
FAM174A	1	1	0	0	19.8	39.6	15	1	1	NA	1	NA	0	2
FAM174B	1	1	0	0	18.81	37.62	15	1	1	NA	1	NA	0	2
FAM175A	4	5	2	1	105.93	211.86	15	1	1	-1.5	1	-0.222222222222222	3	9
FAM175B	2	10	0	1	125.07	250.14	15	1	1	1	1	0.166666666666667	1	12
FAM177A1	0	2	0	0	70.95	141.9	15	1	1	NA	1	NA	0	2
FAM179A	33	13	2	1	420.75	841.5	15	1	1	0.212121212121212	1	0.0507246376811594	3	46
FAM179B	5	11	1	2	343.2	686.4	15	1	1	-0.1	1	-0.0208333333333333	3	16
FAM180A	3	1	0	0	62.37	124.74	15	1	1	NA	1	NA	0	4
FAM180B	5	4	0	1	57.75	115.5	15	1	1	1	1	0.555555555555556	1	9
FAM181A	3	4	1	0	61.71	123.42	15	1	1	-Inf	1	-0.571428571428571	1	7
FAM181B	2	2	1	0	16.5	33	15	1	1	-Inf	1	-0.5	1	4
FAM183A	1	1	0	0	29.37	58.74	15	1	1	NA	1	NA	0	2
FAM184A	1	4	0	0	171.6	343.2	15	1	1	NA	1	NA	0	5
FAM184B	6	13	0	1	209.22	418.44	15	1	1	1	1	0.315789473684211	1	19
FAM185A	2	3	1	1	67.65	135.3	15	1	1	-0.5	1	-0.1	2	5
FAM187A	1	2	0	0	44.88	89.76	15	1	1	NA	1	NA	0	3
FAM188A	2	2	2	0	116.82	233.64	15	1	0.466666666666667	-Inf	1	-0.5	2	4
FAM188B	11	4	1	2	242.22	484.44	15	1	0.245098039215686	0.818181818181818	1	0.4	3	15
FAM189A1	7	4	0	0	197.34	394.68	15	1	1	NA	1	NA	0	11
FAM189A2	5	4	0	0	120.45	240.9	15	1	1	NA	1	NA	0	9
FAM192A	0	4	0	0	57.09	114.18	15	1	1	NA	1	NA	0	4
FAM193A	3	19	1	3	530.97	1061.94	15	1	0.510702341137124	-1.11111111111111	1	-0.113636363636364	4	22
FAM193B	4	9	0	6	141.24	282.48	15	1	0.255417956656347	1	1	0.307692307692308	6	13
FAM194A	7	5	1	3	133.32	266.64	15	1	0.569230769230769	0.761904761904762	1	0.333333333333333	4	12
FAM196A	1	8	0	2	120.78	241.56	15	1	1	1	1	0.111111111111111	2	9
FAM198A	7	9	4	2	112.2	224.4	15	1	0.635117204776648	-1.57142857142857	1	-0.229166666666667	6	16
FAM198B	7	12	1	1	193.38	386.76	15	1	1	-0.714285714285714	1	-0.131578947368421	2	19
FAM199X	0	5	0	0	80.52	161.04	15	1	1	NA	1	NA	0	5
FAM204A	1	1	0	1	54.12	108.24	15	1	1	1	1	0.5	1	2
FAM206A	1	1	1	0	58.41	116.82	15	1	1	-Inf	1	-0.5	1	2
FAM207A	1	3	0	0	48.18	96.36	15	1	1	NA	1	NA	0	4
FAM208A	15	15	2	2	459.36	918.72	15	1	1	0	1	0	4	30
FAM20A	3	11	1	3	76.56	153.12	15	1	1	-0.222222222222222	1	-0.0357142857142857	4	14
FAM20C	0	1	0	1	90.09	180.18	15	1	1	NA	1	0	1	1
FAM20CL	5	3	2	2	87.45	174.9	15	1	1	0.4	1	0.125	4	8
FAM210A	0	4	0	1	61.38	122.76	15	1	1	NA	1	0	1	4
FAM210B	1	4	0	0	30.69	61.38	15	1	1	NA	1	NA	0	5
FAM212B	5	6	1	1	87.12	174.24	15	1	1	-0.2	1	-0.0454545454545455	2	11
FAM214A	16	23	4	1	330	660	15	1	0.160485005635318	-4.75	1	-0.38974358974359	5	39
FAM214B	5	4	1	1	84.48	168.96	15	1	1	0.2	1	0.0555555555555556	2	9
FAM217B	17	14	2	1	397.98	795.96	15	1	1	-0.647058823529412	1	-0.118279569892473	3	31
FAM219B	1	1	1	0	18.81	37.62	15	1	1	-Inf	1	-0.5	1	2
FAM221A	1	1	0	0	79.53	159.06	15	1	1	NA	1	NA	0	2
FAM222B	1	1	1	0	90.42	180.84	15	1	1	-Inf	1	-0.5	1	2
FAM228	7	6	1	0	80.85	161.7	15	1	1	-Inf	1	-0.461538461538462	1	13
FAM234B	5	3	2	0	177.54	355.08	15	1	1	-Inf	1	-0.375	2	8
FAM26D	4	2	1	0	95.7	191.4	15	1	1	-Inf	1	-0.333333333333333	1	6
FAM26E	5	5	1	0	101.97	203.94	15	1	1	-Inf	1	-0.5	1	10
FAM26F	5	8	1	0	85.8	171.6	15	1	0.428571428571428	-Inf	1	-0.615384615384615	1	13
FAM35A	25	17	2	1	284.79	569.58	15	1	1	-0.36	1	-0.0714285714285714	3	42
FAM3B	3	2	1	1	78.87	157.74	15	1	1	0.333333333333333	1	0.1	2	5
FAM3C	0	2	0	0	54.45	108.9	15	1	1	NA	1	NA	0	2
FAM3D	0	4	0	0	56.1	112.2	15	1	1	NA	1	NA	0	4
FAM45A	1	3	1	0	114.51	229.02	15	1	0.4	-Inf	1	-0.75	1	4
FAM46A	0	5	0	2	126.06	252.12	15	1	1	NA	1	0	2	5
FAM46B	0	5	0	2	96.03	192.06	15	1	1	NA	1	0	2	5
FAM46C	0	8	0	3	169.95	339.9	15	1	1	NA	1	0	3	8
FAM46D	0	3	0	1	102.96	205.92	15	1	1	NA	1	0	1	3
FAM49A	0	3	0	0	73.59	147.18	15	1	1	NA	1	NA	0	3
FAM49AL	0	2	0	1	10.89	21.78	15	1	1	NA	1	0	1	2
FAM49B	0	2	0	1	93.72	187.44	15	1	1	NA	1	0	1	2
FAM53A	0	2	0	0	150.15	300.3	15	1	1	NA	1	NA	0	2
FAM53B	1	3	1	1	48.18	96.36	15	1	1	-2	1	-0.25	2	4
FAM63A	2	8	0	1	83.49	166.98	15	1	1	1	1	0.2	1	10
FAM63B	0	3	0	0	89.43	178.86	15	1	1	NA	1	NA	0	3
FAM64A	8	3	1	0	109.23	218.46	15	1	1	-Inf	1	-0.272727272727273	1	11
FAM65A	1	10	1	2	192.06	384.12	15	1	0.395604395604396	-4	1	-0.242424242424242	3	11
FAM65B	4	10	1	2	321.42	642.84	15	1	1	-0.25	1	-0.0476190476190476	3	14
FAM65C	5	11	0	0	277.2	554.4	15	1	1	NA	1	NA	0	16
FAM69A	1	4	0	1	164.34	328.68	15	1	1	1	1	0.2	1	5
FAM69B	1	3	0	0	103.62	207.24	15	1	1	NA	1	NA	0	4
FAM69C	3	7	1	3	120.12	240.24	15	1	1	0.222222222222222	1	0.05	4	10
FAM71D	4	2	0	0	103.95	207.9	15	1	1	NA	1	NA	0	6
FAM72A	1	1	0	1	30.03	60.06	15	1	1	1	1	0.5	1	2
FAM76A	0	6	0	1	65.34	130.68	15	1	1	NA	1	0	1	6
FAM76B	0	6	0	0	66.33	132.66	15	1	1	NA	1	NA	0	6
FAM78A	5	4	2	1	94.38	188.76	15	1	1	-0.6	1	-0.111111111111111	3	9
FAM78B	0	4	0	2	75.24	150.48	15	1	1	NA	1	0	2	4
FAM81A	0	2	0	0	105.27	210.54	15	1	1	NA	1	NA	0	2
FAM83A	0	12	0	1	117.15	234.3	15	1	1	NA	1	0	1	12
FAM83B	6	12	1	1	393.36	786.72	15	1	1	-1	1	-0.166666666666667	2	18
FAM83C	4	6	0	2	154.77	309.54	15	1	0.515151515151515	1	1	0.4	2	10
FAM83D	9	10	2	3	184.47	368.94	15	1	1	0.259259259259259	1	0.0736842105263157	5	19
FAM83F	1	4	0	0	132	264	15	1	1	NA	1	NA	0	5
FAM83G	1	8	1	4	132.66	265.32	15	1	1	-1	1	-0.0888888888888889	5	9
FAM83H	6	23	1	2	557.7	1115.4	15	1	0.536290322580645	-0.916666666666667	1	-0.126436781609195	3	29
FAM89A	2	4	1	2	46.2	92.4	15	1	1	0	1	0	3	6
FAM91A1	3	24	0	1	293.37	586.74	15	1	1	1	1	0.111111111111111	1	27
FAM96B	0	4	0	0	34.32	68.64	15	1	1	NA	1	NA	0	4
FAM98A	0	6	0	2	132.33	264.66	15	1	1	NA	1	0	2	6
FAM98B	3	3	0	0	124.74	249.48	15	1	1	NA	1	NA	0	6
FAN1	23	23	6	6	327.69	655.38	15	1	1	0	1	0	12	46
FANCA	18	24	3	6	428.34	856.68	15	1	0.719654554865151	0.333333333333333	1	0.0952380952380952	9	42
FANCB	18	13	4	3	245.19	490.38	15	1	1	0.0370370370370371	1	0.00921658986175122	7	31
FANCC	1	4	0	0	93.72	187.44	15	1	1	NA	1	NA	0	5
FANCD2	13	23	7	9	425.7	851.4	15	1	0.75871393498504	-0.376068376068376	1	-0.0763888888888889	16	36
FANCD2OS	0	2	0	0	3.96	7.92	15	1	1	NA	1	NA	0	2
FANCE	6	11	2	3	85.8	171.6	15	1	1	-0.222222222222222	1	-0.0470588235294118	5	17
FANCF	4	3	0	0	48.84	97.68	15	1	1	NA	1	NA	0	7
FANCG	9	9	3	2	124.08	248.16	15	1	1	-0.5	1	-0.1	5	18
FANCI	10	19	5	3	402.6	805.2	15	1	0.228105714822982	-2.16666666666667	1	-0.280172413793103	8	29
FANCL	5	8	1	1	105.27	210.54	15	1	1	-0.6	1	-0.115384615384615	2	13
FANCM	40	29	8	7	496.65	993.3	15	1	0.779440437948565	0.171428571428571	1	0.0463768115942029	15	69
FAP	2	7	0	1	208.56	417.12	15	1	1	1	1	0.222222222222222	1	9
FAR1	0	7	0	1	184.14	368.28	15	1	1	NA	1	0	1	7
FARP1	1	9	1	3	230.34	460.68	15	1	0.505494505494505	-2	1	-0.15	4	10
FARP2	6	16	3	1	411.84	823.68	15	1	0.103946488294314	-7	1	-0.477272727272727	4	22
FARSB	1	7	0	1	172.92	345.84	15	1	1	1	1	0.125	1	8
FAS	12	3	0	0	131.67	263.34	15	1	1	NA	1	NA	0	15
FASLG	3	4	1	0	91.08	182.16	15	1	1	-Inf	1	-0.571428571428571	1	7
FASN	27	35	1	0	978.45	1956.9	15	1	0.444444444444444	-Inf	1	-0.564516129032258	1	62
FASTKD1	14	13	1	0	285.12	570.24	15	1	1	-Inf	1	-0.481481481481482	1	27
FASTKD2	10	12	0	1	206.58	413.16	15	1	1	1	1	0.454545454545455	1	22
FASTKD3	9	10	2	2	230.01	460.02	15	1	1	-0.111111111111111	1	-0.0263157894736842	4	19
FAT1	23	63	5	6	1687.29	3374.58	15	1	0.2871649943852	-1.28260869565217	1	-0.187103594080338	11	86
FAT2	21	65	10	11	1238.49	2476.98	15	1	0.0579292898531015	-1.81385281385281	1	-0.232004429678848	21	86
FAT4	18	66	4	12	912.45	1824.9	15	1	0.747697992586533	-0.222222222222222	1	-0.0357142857142857	16	84
FAXC	2	4	0	0	127.71	255.42	15	1	1	NA	1	NA	0	6
FAXDC2	3	4	2	1	95.7	191.4	15	1	1	-1.66666666666667	1	-0.238095238095238	3	7
FBLIM1	1	1	1	0	31.02	62.04	15	1	1	-Inf	1	-0.5	1	2
FBLN1	7	9	2	0	276.54	553.08	15	1	0.470588235294118	-Inf	1	-0.5625	2	16
FBLN2	2	13	2	3	244.86	489.72	15	1	0.248710010319917	-3.33333333333333	1	-0.266666666666667	5	15
FBLN5	1	4	0	2	137.61	275.22	15	1	1	1	1	0.2	2	5
FBLN7	0	1	0	1	40.26	80.52	15	1	1	NA	1	0	1	1
FBN3	4	48	3	16	1019.7	2039.4	15	1	0.374960636332893	-1.25	1	-0.0809716599190283	19	52
FBRSL1	0	5	0	0	273.57	547.14	15	1	1	NA	1	NA	0	5
FBXL14	0	3	0	3	75.9	151.8	15	1	1	NA	1	0	3	3
FBXL17	3	5	0	0	89.43	178.86	15	1	1	NA	1	NA	0	8
FBXL18	0	13	0	2	167.97	335.94	15	1	1	NA	1	0	2	13
FBXL2	0	4	0	0	67.32	134.64	15	1	1	NA	1	NA	0	4
FBXL21	2	7	1	1	165.33	330.66	15	1	0.490909090909091	-2.5	1	-0.277777777777778	2	9
FBXL3	0	6	0	2	110.88	221.76	15	1	1	NA	1	0	2	6
FBXL4	1	5	1	1	150.48	300.96	15	1	0.464285714285714	-4	1	-0.333333333333333	2	6
FBXL5	5	5	2	1	244.2	488.4	15	1	1	-1	1	-0.166666666666667	3	10
FBXL7	0	5	0	1	108.57	217.14	15	1	1	NA	1	0	1	5
FBXL8	7	7	3	1	98.67	197.34	15	1	0.588235294117647	-2	1	-0.25	4	14
FBXO15	0	7	0	2	103.95	207.9	15	1	1	NA	1	0	2	7
FBXO16	3	4	1	1	134.97	269.94	15	1	1	-0.333333333333333	1	-0.0714285714285715	2	7
FBXO18	3	4	0	1	25.74	51.48	15	1	1	1	1	0.428571428571429	1	7
FBXO2	0	8	0	1	87.78	175.56	15	1	1	NA	1	0	1	8
FBXO21	0	8	0	2	142.89	285.78	15	1	1	NA	1	0	2	8
FBXO22	0	9	0	0	128.37	256.74	15	1	1	NA	1	NA	0	9
FBXO25	0	2	0	1	114.18	228.36	15	1	1	NA	1	0	1	2
FBXO28	0	2	0	0	66	132	15	1	1	NA	1	NA	0	2
FBXO3	0	7	0	0	126.72	253.44	15	1	1	NA	1	NA	0	7
FBXO30	2	12	1	1	274.23	548.46	15	1	0.35	-5	1	-0.357142857142857	2	14
FBXO31	2	6	0	1	114.84	229.68	15	1	1	1	1	0.25	1	8
FBXO32	0	8	0	3	124.41	248.82	15	1	1	NA	1	0	3	8
FBXO33	0	3	0	1	130.68	261.36	15	1	1	NA	1	0	1	3
FBXO34	4	14	1	6	178.53	357.06	15	1	1	0.416666666666667	1	0.0793650793650794	7	18
FBXO38	7	9	0	0	393.03	786.06	15	1	1	NA	1	NA	0	16
FBXO39	3	6	0	1	191.73	383.46	15	1	1	1	1	0.333333333333333	1	9
FBXO4	3	6	0	2	93.06	186.12	15	1	1	1	1	0.333333333333333	2	9
FBXO41	2	6	1	5	113.19	226.38	15	1	1	0.4	1	0.0833333333333333	6	8
FBXO42	4	2	0	1	39.93	79.86	15	1	0.428571428571429	1	1	0.666666666666667	1	6
FBXO43	8	14	0	0	214.5	429	15	1	1	NA	1	NA	0	22
FBXO45	1	0	1	0	22.44	44.88	15	1	1	NA	1	0	1	1
FBXO47	1	1	0	0	136.62	273.24	15	1	1	NA	1	NA	0	2
FBXO48	1	3	1	0	31.35	62.7	15	1	0.4	-Inf	1	-0.75	1	4
FBXO5	11	7	1	0	169.62	339.24	15	1	1	-Inf	1	-0.388888888888889	1	18
FBXO6	4	3	1	0	69.3	138.6	15	1	1	-Inf	1	-0.428571428571429	1	7
FBXO7	0	3	0	0	138.93	277.86	15	1	1	NA	1	NA	0	3
FBXO8	0	2	0	0	110.55	221.1	15	1	1	NA	1	NA	0	2
FBXO9	1	4	0	1	126.39	252.78	15	1	1	1	1	0.2	1	5
FBXW11	0	12	0	4	193.71	387.42	15	1	1	NA	1	0	4	12
FBXW2	1	12	0	1	223.08	446.16	15	1	1	1	1	0.0769230769230769	1	13
FBXW4	0	5	0	1	88.44	176.88	15	1	1	NA	1	0	1	5
FBXW5	1	12	0	0	145.86	291.72	15	1	1	NA	1	NA	0	13
FBXW7	0	4	0	0	161.37	322.74	15	1	1	NA	1	NA	0	4
FBXW8	1	3	0	0	159.06	318.12	15	1	1	NA	1	NA	0	4
FCER2	4	2	0	0	58.41	116.82	15	1	1	NA	1	NA	0	6
FCGBP	22	33	3	3	808.83	1617.66	15	1	0.681740088116834	-0.5	1	-0.1	6	55
FCGBPL	29	22	7	5	295.68	591.36	15	1	1	-0.0620689655172413	1	-0.0147058823529412	12	51
FCHO2	1	3	0	0	119.79	239.58	15	1	1	NA	1	NA	0	4
FCN2-LOC112531347	3	3	0	0	51.81	103.62	15	1	1	NA	1	NA	0	6
FDFT1	3	6	0	2	86.46	172.92	15	1	1	1	1	0.333333333333333	2	9
FDPS	0	8	0	0	83.82	167.64	15	1	1	NA	1	NA	0	8
FDX1L	1	3	0	0	63.36	126.72	15	1	1	NA	1	NA	0	4
FDXR	1	5	1	1	85.8	171.6	15	1	0.464285714285714	-4	1	-0.333333333333333	2	6
FEM1A	0	14	0	5	180.51	361.02	15	1	1	NA	1	0	5	14
FEM1B	2	13	1	5	196.35	392.7	15	1	1	-0.3	1	-0.0333333333333333	6	15
FEM1C	0	3	0	0	103.29	206.58	15	1	1	NA	1	NA	0	3
FEN1	0	5	0	2	81.51	163.02	15	1	1	NA	1	0	2	5
FER	3	0	0	0	44.55	89.1	15	1	1	NA	1	NA	0	3
FER1L4	21	27	7	5	472.89	945.78	15	1	0.519640652450366	-0.8	1	-0.145833333333333	12	48
FER1L6	24	23	7	4	648.45	1296.9	15	1	0.518054292223344	-0.677083333333333	1	-0.125725338491296	11	47
FERMT1	1	11	0	2	213.84	427.68	15	1	1	1	1	0.0833333333333333	2	12
FERMT2	1	4	0	1	167.31	334.62	15	1	1	1	1	0.2	1	5
FETUB	11	6	2	0	134.31	268.62	15	1	1	-Inf	1	-0.352941176470588	2	17
FEZ1	1	2	0	0	49.17	98.34	15	1	1	NA	1	NA	0	3
FEZ2	1	1	1	0	75.24	150.48	15	1	1	-Inf	1	-0.5	1	2
FEZF1	0	2	0	0	30.69	61.38	15	1	1	NA	1	NA	0	2
FFAR4	2	2	0	0	73.92	147.84	15	1	1	NA	1	NA	0	4
FGA	8	12	0	1	304.92	609.84	15	1	1	1	1	0.4	1	20
FGB	0	8	0	1	162.69	325.38	15	1	1	NA	1	0	1	8
FGD4	5	5	1	0	259.38	518.76	15	1	1	-Inf	1	-0.5	1	10
FGD5	29	32	1	3	635.91	1271.82	15	1	0.617710918114144	0.632183908045977	1	0.225409836065574	4	61
FGD6	14	14	2	1	477.51	955.02	15	1	1	-1	1	-0.166666666666667	3	28
FGF12	2	1	2	0	80.52	161.04	15	1	1	-Inf	1	-0.333333333333333	2	3
FGF13	2	0	0	0	36.63	73.26	15	1	1	NA	1	NA	0	2
FGF14	0	2	0	1	56.1	112.2	15	1	1	NA	1	0	1	2
FGF18	0	2	0	0	38.28	76.56	15	1	1	NA	1	NA	0	2
FGF19	0	2	0	0	24.42	48.84	15	1	1	NA	1	NA	0	2
FGF2	0	2	0	0	40.59	81.18	15	1	1	NA	1	NA	0	2
FGF20	1	1	0	0	39.6	79.2	15	1	1	NA	1	NA	0	2
FGF3	1	1	0	0	32.67	65.34	15	1	1	NA	1	NA	0	2
FGF4	0	1	0	1	39.27	78.54	15	1	1	NA	1	0	1	1
FGF8	0	1	0	1	16.83	33.66	15	1	1	NA	1	0	1	1
FGFBP1	3	3	1	1	57.42	114.84	15	1	1	0	1	0	2	6
FGFBP2	0	4	0	0	55.77	111.54	15	1	1	NA	1	NA	0	4
FGFR1	0	5	0	4	85.47	170.94	15	1	1	NA	1	0	4	5
FGFR1OP	1	3	0	0	126.39	252.78	15	1	1	NA	1	NA	0	4
FGFR2	0	10	0	2	252.12	504.24	15	1	1	NA	1	0	2	10
FGFR3	1	13	1	1	267.3	534.6	15	1	0.241666666666667	-12	1	-0.428571428571429	2	14
FGFRL1	1	9	0	3	134.64	269.28	15	1	1	1	1	0.1	3	10
FGG	3	11	1	1	173.25	346.5	15	1	0.45	-2.66666666666667	1	-0.285714285714286	2	14
FGGY	3	5	1	0	156.75	313.5	15	1	0.444444444444444	-Inf	1	-0.625	1	8
FGL1L	17	7	5	1	113.52	227.04	15	1	1	-1.05882352941176	1	-0.125	6	24
FGL2	4	2	2	1	124.08	248.16	15	1	1	0	1	0	3	6
FH	0	3	0	1	141.57	283.14	15	1	1	NA	1	0	1	3
FHAD1-LOC112529958	19	19	6	7	278.52	557.04	15	1	1	0.142857142857143	1	0.0384615384615384	13	38
FHDC1	13	18	2	0	352.11	704.22	15	1	0.198863636363636	-Inf	1	-0.580645161290323	2	31
FHL1	3	3	0	1	167.97	335.94	15	1	1	1	1	0.5	1	6
FHL2	1	3	1	0	82.5	165	15	1	0.4	-Inf	1	-0.75	1	4
FHL3	0	4	0	1	66.66	133.32	15	1	1	NA	1	0	1	4
FHL5	4	4	1	0	101.31	202.62	15	1	1	-Inf	1	-0.5	1	8
FHOD3	2	7	0	1	334.95	669.9	15	1	1	1	1	0.222222222222222	1	9
FIBCD1	0	3	0	1	40.26	80.52	15	1	1	NA	1	0	1	3
FICD	1	5	1	0	68.64	137.28	15	1	0.285714285714286	-Inf	1	-0.833333333333333	1	6
FIG4	2	10	1	0	285.45	570.9	15	1	0.230769230769231	-Inf	1	-0.833333333333333	1	12
FIGN	0	9	0	0	248.16	496.32	15	1	1	NA	1	NA	0	9
FIGNL2	1	6	1	5	76.23	152.46	15	1	1	-0.2	1	-0.0238095238095238	6	7
FILIP1	2	9	1	2	358.71	717.42	15	1	1	-1.25	1	-0.151515151515151	3	11
FILIP1L	1	4	1	0	78.21	156.42	15	1	0.333333333333333	-Inf	1	-0.8	1	5
FIP1L1	1	3	1	0	148.5	297	15	1	0.4	-Inf	1	-0.75	1	4
FKBP10	3	2	0	0	72.93	145.86	15	1	1	NA	1	NA	0	5
FKBP14	2	7	0	7	81.84	163.68	15	1	0.475	1	1	0.222222222222222	7	9
FKBP15	9	26	1	7	362.01	724.02	15	1	0.656292179204679	0.587301587301587	1	0.132142857142857	8	35
FKBP1B	0	1	0	1	21.45	42.9	15	1	1	NA	1	0	1	1
FKBP1C	0	2	0	1	18.15	36.3	15	1	1	NA	1	0	1	2
FKBP4	2	6	1	0	152.13	304.26	15	1	0.333333333333333	-Inf	1	-0.75	1	8
FKBP5	2	5	0	0	101.31	202.62	15	1	1	NA	1	NA	0	7
FKBP6	1	3	0	0	98.34	196.68	15	1	1	NA	1	NA	0	4
FKBP8	0	2	0	2	21.78	43.56	15	1	1	NA	1	0	2	2
FKBP9	1	12	1	1	172.59	345.18	15	1	0.257142857142857	-11	1	-0.423076923076923	2	13
FLAD1	1	1	1	1	44.88	89.76	15	1	1	0	1	0	2	2
FLCN	0	5	0	1	239.25	478.5	15	1	1	NA	1	0	1	5
FLII	0	9	0	6	66.33	132.66	15	1	1	NA	1	0	6	9
FLNB	4	49	2	8	953.7	1907.4	15	1	0.239768431535024	-2.0625	1	-0.124528301886792	10	53
FLOT1	0	1	0	1	10.89	21.78	15	1	1	NA	1	0	1	1
FLOT2	1	2	0	1	86.79	173.58	15	1	1	1	1	0.333333333333333	1	3
FLRT2	5	9	0	2	260.37	520.74	15	1	1	1	1	0.357142857142857	2	14
FLRT3	2	10	1	3	219.45	438.9	15	1	1	-0.666666666666667	1	-0.0833333333333333	4	12
FLT1	7	15	5	4	284.46	568.92	15	1	0.253449801154013	-1.67857142857143	1	-0.237373737373737	9	22
FLT3	7	23	1	4	311.19	622.38	15	1	1	0.178571428571429	1	0.0333333333333333	5	30
FLT4	2	17	0	4	391.71	783.42	15	1	1	1	1	0.105263157894737	4	19
FLVCR1	1	5	0	3	142.56	285.12	15	1	1	1	1	0.166666666666667	3	6
FLVCR2	7	4	1	1	112.86	225.72	15	1	1	0.428571428571429	1	0.136363636363636	2	11
FMN1	5	16	0	0	271.59	543.18	15	1	1	NA	1	NA	0	21
FMNL1	3	5	2	3	142.56	285.12	15	1	1	-0.111111111111111	1	-0.025	5	8
FMO3	3	13	2	3	113.85	227.7	15	1	0.552803577571379	-1.88888888888889	1	-0.2125	5	16
FMOD	1	3	1	2	72.27	144.54	15	1	1	-0.5	1	-0.0833333333333333	3	4
FN1	5	38	0	5	809.49	1618.98	15	1	1	1	1	0.116279069767442	5	43
FN3K	2	3	0	1	95.37	190.74	15	1	1	1	1	0.4	1	5
FN3KRP	1	3	1	0	94.05	188.1	15	1	0.4	-Inf	1	-0.75	1	4
FNBP1	3	11	0	4	179.85	359.7	15	1	1	1	1	0.214285714285714	4	14
FNBP4	2	3	1	3	81.18	162.36	15	1	1	0.5	1	0.15	4	5
FNDC1	17	26	2	4	619.41	1238.82	15	1	1	0.235294117647059	1	0.062015503875969	6	43
FNDC3A	0	13	0	2	394.02	788.04	15	1	1	NA	1	0	2	13
FNDC3AL	2	21	0	4	342.54	685.08	15	1	1	1	1	0.0869565217391304	4	23
FNDC3B	1	11	0	3	398.64	797.28	15	1	1	1	1	0.0833333333333333	3	12
FNDC4	3	1	0	0	97.02	194.04	15	1	1	NA	1	NA	0	4
FNDC5	0	2	0	0	58.08	116.16	15	1	1	NA	1	NA	0	2
FNDC7	13	7	1	0	198.66	397.32	15	1	1	-Inf	1	-0.35	1	20
FNIP1	9	23	4	3	374.22	748.44	15	1	0.193837800648946	-2.40740740740741	1	-0.290178571428571	7	32
FNIP2	10	20	0	1	330.66	661.32	15	1	1	1	1	0.333333333333333	1	30
FNTA	1	9	1	1	71.94	143.88	15	1	0.318181818181818	-8	1	-0.4	2	10
FOCAD	18	16	3	1	462	924	15	1	0.613086770981508	-1.66666666666667	1	-0.220588235294118	4	34
FOLH1	2	6	0	0	204.6	409.2	15	1	1	NA	1	NA	0	8
FOPNL	1	2	0	0	41.91	83.82	15	1	1	NA	1	NA	0	3
FOS	0	5	0	1	30.36	60.72	15	1	1	NA	1	0	1	5
FOSL2	0	1	0	1	58.08	116.16	15	1	1	NA	1	0	1	1
FOXA2	0	3	0	1	48.51	97.02	15	1	1	NA	1	0	1	3
FOXD3	0	1	0	1	16.17	32.34	15	1	1	NA	1	0	1	1
FOXE3	0	2	0	0	25.74	51.48	15	1	1	NA	1	NA	0	2
FOXI1	3	5	0	1	140.25	280.5	15	1	1	1	1	0.375	1	8
FOXI3	2	2	1	1	77.22	154.44	15	1	1	0	1	0	2	4
FOXJ1	1	12	0	8	94.71	189.42	15	1	1	1	1	0.0769230769230769	8	13
FOXJ2	2	2	0	0	155.1	310.2	15	1	1	NA	1	NA	0	4
FOXK1	2	3	2	1	171.6	343.2	15	1	1	-2	1	-0.266666666666667	3	5
FOXK2	3	6	1	3	188.76	377.52	15	1	1	0.333333333333333	1	0.0833333333333333	4	9
FOXM1	5	7	2	2	261.03	522.06	15	1	1	-0.4	1	-0.0833333333333333	4	12
FOXN1	4	5	1	1	157.74	315.48	15	1	1	-0.25	1	-0.0555555555555556	2	9
FOXN2	0	6	0	0	135.3	270.6	15	1	1	NA	1	NA	0	6
FOXN3	8	2	0	0	116.49	232.98	15	1	1	NA	1	NA	0	10
FOXN4	2	5	2	3	120.78	241.56	15	1	1	-0.666666666666667	1	-0.114285714285714	5	7
FOXO1	1	2	0	1	156.09	312.18	15	1	1	1	1	0.333333333333333	1	3
FOXO3	2	7	0	3	178.2	356.4	15	1	1	1	1	0.222222222222222	3	9
FOXO4	5	8	1	2	108.24	216.48	15	1	1	0.2	1	0.0512820512820513	3	13
FOXP1	2	3	0	2	201.3	402.6	15	1	1	1	1	0.4	2	5
FOXP2	0	4	0	0	155.76	311.52	15	1	1	NA	1	NA	0	4
FPGT	9	11	1	1	191.4	382.8	15	1	1	-0.222222222222222	1	-0.05	2	20
FRA10AC1	2	4	1	2	76.89	153.78	15	1	1	0	1	0	3	6
FRAS1	34	73	9	7	1299.21	2598.42	15	1	0.0888953154562983	-1.76050420168067	1	-0.244742990654206	16	107
FREM1	25	17	2	1	467.28	934.56	15	1	1	-0.36	1	-0.0714285714285714	3	42
FREM2	19	55	5	2	1021.35	2042.7	15	1	0.0218147066248332	-6.23684210526316	1	-0.457528957528958	7	74
FREM3	11	27	2	2	435.27	870.54	15	1	0.575609756097561	-1.45454545454545	1	-0.210526315789474	4	38
FRG1	0	6	0	1	56.43	112.86	15	1	1	NA	1	0	1	6
FRK	1	6	0	1	138.6	277.2	15	1	1	1	1	0.142857142857143	1	7
FRMD1	5	9	2	1	252.12	504.24	15	1	0.536764705882353	-2.6	1	-0.309523809523809	3	14
FRMD3	0	4	0	0	80.52	161.04	15	1	1	NA	1	NA	0	4
FRMD4A	0	10	0	0	261.03	522.06	15	1	1	NA	1	NA	0	10
FRMD4B	4	10	2	2	307.23	614.46	15	1	0.568627450980392	-1.5	1	-0.214285714285714	4	14
FRMD5	1	3	1	2	109.23	218.46	15	1	1	-0.5	1	-0.0833333333333333	3	4
FRMD7	6	2	5	0	116.49	232.98	15	1	0.487179487179487	-Inf	1	-0.25	5	8
FRMPD1	17	23	1	3	465.63	931.26	15	1	0.633704355769018	0.549019607843137	1	0.175	4	40
FRMPD2	28	24	5	7	672.21	1344.42	15	1	0.530679519550973	0.387755102040816	1	0.121794871794872	12	52
FRMPD3	21	25	4	6	405.57	811.14	15	1	1	0.206349206349206	1	0.0565217391304347	10	46
FRMPD4	9	12	3	2	531.63	1063.26	15	1	0.634782608695652	-1	1	-0.171428571428571	5	21
FRRS1	9	10	3	2	190.74	381.48	15	1	1	-0.666666666666667	1	-0.126315789473684	5	19
FRRS1L	0	3	0	1	68.97	137.94	15	1	1	NA	1	0	1	3
FRS2	0	4	0	0	159.72	319.44	15	1	1	NA	1	NA	0	4
FRS3	1	3	0	3	83.82	167.64	15	1	1	1	1	0.25	3	4
FRY	0	32	0	8	933.57	1867.14	15	1	1	NA	1	0	8	32
FRYL	0	36	0	1	891	1782	15	1	1	NA	1	0	1	36
FRZB	0	4	0	2	50.82	101.64	15	1	1	NA	1	0	2	4
FSBP	0	3	0	0	91.74	183.48	15	1	1	NA	1	NA	0	3
FSCN1	0	1	0	1	41.25	82.5	15	1	1	NA	1	0	1	1
FSCN2	1	1	1	1	30.03	60.06	15	1	1	0	1	0	2	2
FSD2	9	9	0	0	270.93	541.86	15	1	1	NA	1	NA	0	18
FSHB	1	2	0	0	42.24	84.48	15	1	1	NA	1	NA	0	3
FST	0	3	0	0	65.01	130.02	15	1	1	NA	1	NA	0	3
FSTL4	5	10	2	3	199.98	399.96	15	1	1	-0.333333333333333	1	-0.0666666666666667	5	15
FSTL5	3	6	1	0	194.37	388.74	15	1	0.4	-Inf	1	-0.666666666666667	1	9
FTCD	4	10	1	2	149.16	298.32	15	1	1	-0.25	1	-0.0476190476190476	3	14
FTL	2	2	0	0	59.07	118.14	15	1	1	NA	1	NA	0	4
FTO	8	5	0	0	194.7	389.4	15	1	1	NA	1	NA	0	13
FTSJ3	6	10	2	1	146.52	293.04	15	1	0.545923632610939	-2.33333333333333	1	-0.291666666666667	3	16
FUBP1	0	7	0	0	198	396	15	1	1	NA	1	NA	0	7
FUBP3	1	5	1	0	152.46	304.92	15	1	0.285714285714286	-Inf	1	-0.833333333333333	1	6
FUCA1	2	6	0	0	102.3	204.6	15	1	1	NA	1	NA	0	8
FUCA2	6	5	0	0	130.02	260.04	15	1	1	NA	1	NA	0	11
FUNDC1	0	1	0	1	28.38	56.76	15	1	1	NA	1	0	1	1
FUNDC2	1	1	1	0	26.73	53.46	15	1	1	-Inf	1	-0.5	1	2
FUT10	2	7	0	0	135.3	270.6	15	1	1	NA	1	NA	0	9
FUT11	3	6	1	0	111.87	223.74	15	1	0.4	-Inf	1	-0.666666666666667	1	9
FUT4	1	1	0	0	59.07	118.14	15	1	1	NA	1	NA	0	2
FUT7	5	8	0	0	102.96	205.92	15	1	1	NA	1	NA	0	13
FUT8	1	2	0	0	97.02	194.04	15	1	1	NA	1	NA	0	3
FUT9	0	4	0	1	115.17	230.34	15	1	1	NA	1	0	1	4
FXN	3	1	0	0	35.31	70.62	15	1	1	NA	1	NA	0	4
FXR1	0	10	0	1	177.54	355.08	15	1	1	NA	1	0	1	10
FXYD6	2	0	0	0	53.79	107.58	15	1	1	NA	1	NA	0	2
FYB	11	9	0	1	185.13	370.26	15	1	0.476190476190476	1	1	0.55	1	20
FYCO1	23	13	5	0	469.26	938.52	15	1	0.15957742080977	-Inf	1	-0.361111111111111	5	36
FYN	3	3	3	2	166.98	333.96	15	1	1	-0.5	1	-0.1	5	6
FYTTD1	1	3	0	0	105.27	210.54	15	1	1	NA	1	NA	0	4
FYTTD1L	4	2	2	0	87.78	175.56	15	1	1	-Inf	1	-0.333333333333333	2	6
FZD1	1	9	0	1	140.25	280.5	15	1	1	1	1	0.1	1	10
FZD10	0	2	0	0	149.49	298.98	15	1	1	NA	1	NA	0	2
FZD3	1	7	0	3	181.17	362.34	15	1	1	1	1	0.125	3	8
FZD4	0	4	0	0	190.41	380.82	15	1	1	NA	1	NA	0	4
FZD5	1	5	0	1	79.2	158.4	15	1	1	1	1	0.166666666666667	1	6
FZD6	4	14	1	0	275.22	550.44	15	1	0.263157894736842	-Inf	1	-0.777777777777778	1	18
FZD7	0	9	0	0	94.71	189.42	15	1	1	NA	1	NA	0	9
FZD8	0	5	0	1	103.29	206.58	15	1	1	NA	1	0	1	5
FZD9	1	11	0	0	152.79	305.58	15	1	1	NA	1	NA	0	12
FZR1	0	5	0	1	116.16	232.32	15	1	1	NA	1	0	1	5
G0S2	0	3	0	1	27.72	55.44	15	1	1	NA	1	0	1	3
G2E3	5	7	0	0	251.13	502.26	15	1	1	NA	1	NA	0	12
G3BP1	0	4	0	0	127.71	255.42	15	1	1	NA	1	NA	0	4
G3BP2	0	4	0	1	128.37	256.74	15	1	1	NA	1	0	1	4
G6PC	1	3	0	1	42.24	84.48	15	1	1	1	1	0.25	1	4
G6PC2	1	3	0	1	122.1	244.2	15	1	1	1	1	0.25	1	4
GAA	4	5	2	1	102.96	205.92	15	1	1	-1.5	1	-0.222222222222222	3	9
GAAGSD	5	10	1	2	144.54	289.08	15	1	1	0	1	0	3	15
GAB2	8	13	0	3	187.77	375.54	15	1	0.525691699604743	1	1	0.380952380952381	3	21
GAB3	1	6	0	3	114.18	228.36	15	1	1	1	1	0.142857142857143	3	7
GABBR2	2	2	0	0	128.7	257.4	15	1	1	NA	1	NA	0	4
GABPA	0	6	0	0	124.41	248.82	15	1	1	NA	1	NA	0	6
GABPB1	0	4	0	1	160.05	320.1	15	1	1	NA	1	0	1	4
GABPB2	6	5	0	1	109.56	219.12	15	1	1	1	1	0.545454545454545	1	11
GABRA1	2	3	1	0	76.56	153.12	15	1	1	-Inf	1	-0.6	1	5
GABRA2	0	2	0	0	99.99	199.98	15	1	1	NA	1	NA	0	2
GABRA3	0	6	0	1	154.77	309.54	15	1	1	NA	1	0	1	6
GABRA4	0	2	0	0	153.12	306.24	15	1	1	NA	1	NA	0	2
GABRA6	0	6	0	2	74.25	148.5	15	1	1	NA	1	0	2	6
GABRD	0	4	0	1	161.04	322.08	15	1	1	NA	1	0	1	4
GABRE	0	7	0	1	164.67	329.34	15	1	1	NA	1	0	1	7
GABRG1	1	1	1	0	155.1	310.2	15	1	1	-Inf	1	-0.5	1	2
GABRP	3	7	1	1	113.85	227.7	15	1	1	-1.33333333333333	1	-0.2	2	10
GABRR1	1	6	1	2	137.61	275.22	15	1	1	-2	1	-0.19047619047619	3	7
GABRR2	3	7	1	0	175.89	351.78	15	1	0.363636363636364	-Inf	1	-0.7	1	10
GABRR3	2	6	1	1	167.31	334.62	15	1	1	-2	1	-0.25	2	8
GAD1	1	7	0	2	164.34	328.68	15	1	1	1	1	0.125	2	8
GAD2	0	6	0	1	156.42	312.84	15	1	1	NA	1	0	1	6
GADD45G	1	1	1	1	17.16	34.32	15	1	1	0	1	0	2	2
GADL1	1	3	0	0	136.29	272.58	15	1	1	NA	1	NA	0	4
GAK	12	11	0	1	243.21	486.42	15	1	1	1	1	0.521739130434783	1	23
GAL3ST2	9	10	0	1	192.72	385.44	15	1	1	1	1	0.473684210526316	1	19
GAL3ST4	6	9	2	2	168.63	337.26	15	1	1	-0.5	1	-0.1	4	15
GALC	1	6	0	1	211.53	423.06	15	1	1	1	1	0.142857142857143	1	7
GALE	0	5	0	0	27.72	55.44	15	1	1	NA	1	NA	0	5
GALK1	4	6	1	0	73.92	147.84	15	1	0.454545454545455	-Inf	1	-0.6	1	10
GALK2	1	3	0	0	125.07	250.14	15	1	1	NA	1	NA	0	4
GALM	1	4	1	1	53.46	106.92	15	1	1	-3	1	-0.3	2	5
GALNT1	0	6	0	0	138.6	277.2	15	1	1	NA	1	NA	0	6
GALNT10	0	10	0	1	200.97	401.94	15	1	1	NA	1	0	1	10
GALNT11	0	13	0	3	220.11	440.22	15	1	1	NA	1	0	3	13
GALNT12	2	5	1	0	150.15	300.3	15	1	0.375	-Inf	1	-0.714285714285714	1	7
GALNT13	3	17	1	2	158.4	316.8	15	1	0.452851496329757	-1.83333333333333	1	-0.183333333333333	3	20
GALNT14	4	10	2	0	198.66	397.32	15	1	0.125	-Inf	1	-0.714285714285714	2	14
GALNT15	8	12	2	2	204.93	409.86	15	1	1	-0.5	1	-0.1	4	20
GALNT16	0	5	0	1	170.61	341.22	15	1	1	NA	1	0	1	5
GALNT2	2	6	2	0	167.31	334.62	15	1	0.133333333333333	-Inf	1	-0.75	2	8
GALNT3	8	5	1	0	180.18	360.36	15	1	1	-Inf	1	-0.384615384615385	1	13
GALNT5	1	12	0	2	121.11	242.22	15	1	1	1	1	0.0769230769230769	2	13
GALNT7	2	5	1	0	197.34	394.68	15	1	0.375	-Inf	1	-0.714285714285714	1	7
GALNT9	3	10	0	3	217.47	434.94	15	1	1	1	1	0.230769230769231	3	13
GALNTL6	0	5	0	0	133.65	267.3	15	1	1	NA	1	NA	0	5
GALR1L	5	7	0	1	113.85	227.7	15	1	1	1	1	0.416666666666667	1	12
GALR2	2	0	1	0	43.23	86.46	15	1	1	NA	1	0	1	2
GALR3	6	4	0	2	111.54	223.08	15	1	0.454545454545454	1	1	0.6	2	10
GAN	0	8	0	1	198.99	397.98	15	1	1	NA	1	0	1	8
GANC	3	7	0	1	241.23	482.46	15	1	1	1	1	0.3	1	10
GAP43	2	7	2	4	79.2	158.4	15	1	1	-0.75	1	-0.111111111111111	6	9
GAPDH	0	9	0	8	119.13	238.26	15	1	1	NA	1	0	8	9
GAPVD1	1	17	1	3	397.65	795.3	15	1	0.337662337662338	-4.66666666666667	1	-0.194444444444444	4	18
GAR1	2	6	0	1	44.88	89.76	15	1	1	1	1	0.25	1	8
GAREM1	4	18	0	2	293.04	586.08	15	1	1	1	1	0.181818181818182	2	22
GAREM2	1	3	1	2	42.24	84.48	15	1	1	-0.5	1	-0.0833333333333333	3	4
GARNL3	16	20	10	8	404.25	808.5	15	1	0.5658264064686	-0.5625	1	-0.111111111111111	18	36
GARS	0	10	0	3	211.53	423.06	15	1	1	NA	1	0	3	10
GART	9	12	6	0	375.87	751.74	15	1	0.0200297287253809	-Inf	1	-0.571428571428571	6	21
GART-B	10	16	2	3	389.73	779.46	15	1	1	-0.0666666666666667	1	-0.0153846153846154	5	26
GAS2L2	3	2	2	1	20.13	40.26	15	1	1	-0.333333333333333	1	-0.0666666666666667	3	5
GAS2L3	11	9	0	1	283.8	567.6	15	1	0.476190476190476	1	1	0.55	1	20
GAS6	3	13	0	4	196.35	392.7	15	1	1	1	1	0.1875	4	16
GASTL	4	1	0	0	66.33	132.66	15	1	1	NA	1	NA	0	5
GATA4	1	1	1	1	68.64	137.28	15	1	1	0	1	0	2	2
GATA6	0	6	0	2	64.02	128.04	15	1	1	NA	1	0	2	6
GATAD1	2	4	2	0	82.5	165	15	1	0.428571428571429	-Inf	1	-0.666666666666667	2	6
GATB	5	2	0	0	160.05	320.1	15	1	1	NA	1	NA	0	7
GATM	1	4	0	0	129.69	259.38	15	1	1	NA	1	NA	0	5
GATSL2	2	7	0	2	103.62	207.24	15	1	1	1	1	0.222222222222222	2	9
GBA2	4	5	1	3	94.38	188.76	15	1	1	0.583333333333333	1	0.194444444444444	4	9
GBE	21	20	0	2	354.42	708.84	15	1	0.488372093023256	1	1	0.51219512195122	2	41
GBE1	1	6	1	1	192.06	384.12	15	1	0.416666666666667	-5	1	-0.357142857142857	2	7
GBF1	4	24	0	3	541.2	1082.4	15	1	1	1	1	0.142857142857143	3	28
GBGT1	4	4	1	0	119.13	238.26	15	1	1	-Inf	1	-0.5	1	8
GBP7-LOC112531454-LOC112531455	8	6	0	0	104.28	208.56	15	1	1	NA	1	NA	0	14
GBX2	1	2	0	0	29.37	58.74	15	1	1	NA	1	NA	0	3
GC	6	9	0	0	131.67	263.34	15	1	1	NA	1	NA	0	15
GCAT	1	4	1	0	47.85	95.7	15	1	0.333333333333333	-Inf	1	-0.8	1	5
GCC1	6	3	2	2	133.98	267.96	15	1	1	0.5	1	0.166666666666667	4	9
GCC2	20	17	3	3	492.69	985.38	15	1	1	0.15	1	0.0405405405405406	6	37
GCG	2	0	1	0	77.88	155.76	15	1	1	NA	1	0	1	2
GCGR	1	5	0	2	97.35	194.7	15	1	1	1	1	0.166666666666667	2	6
GCH1	0	2	0	0	57.42	114.84	15	1	1	NA	1	NA	0	2
GCHFR	2	2	2	0	11.55	23.1	15	1	0.466666666666667	-Inf	1	-0.5	2	4
GCLC	0	11	0	1	229.02	458.04	15	1	1	NA	1	0	1	11
GCLM	1	1	1	1	71.28	142.56	15	1	1	0	1	0	2	2
GCM1	1	5	0	2	99	198	15	1	1	1	1	0.166666666666667	2	6
GCM2	4	10	0	1	180.18	360.36	15	1	1	1	1	0.285714285714286	1	14
GCNA	9	15	3	1	125.4	250.8	15	1	0.284981684981685	-4	1	-0.375	4	24
GCNT1	1	10	0	0	106.92	213.84	15	1	1	NA	1	NA	0	11
GCNT2	3	4	0	1	57.75	115.5	15	1	1	1	1	0.428571428571429	1	7
GCNT3	6	7	1	1	89.76	179.52	15	1	1	-0.166666666666667	1	-0.0384615384615384	2	13
GCNT4	2	5	0	1	138.6	277.2	15	1	1	1	1	0.285714285714286	1	7
GCNT7	4	12	1	0	136.29	272.58	15	1	0.294117647058824	-Inf	1	-0.75	1	16
GCOM1	0	4	0	0	138.6	277.2	15	1	1	NA	1	NA	0	4
GCSH	0	1	0	1	44.22	88.44	15	1	1	NA	1	0	1	1
GDA	2	4	0	0	95.7	191.4	15	1	1	NA	1	NA	0	6
GDAP1	5	3	0	0	110.22	220.44	15	1	1	NA	1	NA	0	8
GDAP2	1	8	0	2	167.64	335.28	15	1	1	1	1	0.111111111111111	2	9
GDE1	1	3	0	0	66	132	15	1	1	NA	1	NA	0	4
GDF10	2	10	1	2	115.17	230.34	15	1	0.516483516483516	-1.5	1	-0.166666666666667	3	12
GDF15	1	3	0	3	17.82	35.64	15	1	1	1	1	0.25	3	4
GDF2	8	9	4	2	175.56	351.12	15	1	0.64040536122916	-1.25	1	-0.196078431372549	6	17
GDF3	3	3	0	1	62.37	124.74	15	1	1	1	1	0.5	1	6
GDF5	4	4	2	1	161.37	322.74	15	1	1	-1	1	-0.166666666666667	3	8
GDF7	2	2	1	1	19.47	38.94	15	1	1	0	1	0	2	4
GDF9	3	15	0	2	144.87	289.74	15	1	1	1	1	0.166666666666667	2	18
GDPD1	0	2	0	0	85.14	170.28	15	1	1	NA	1	NA	0	2
GDPD2	4	8	1	0	140.25	280.5	15	1	0.384615384615385	-Inf	1	-0.666666666666667	1	12
GDPD4	2	11	0	1	238.26	476.52	15	1	1	1	1	0.153846153846154	1	13
GDPD5	1	9	1	2	199.98	399.96	15	1	0.423076923076923	-3.5	1	-0.233333333333333	3	10
GDPGP1	1	1	0	0	7.92	15.84	15	1	1	NA	1	NA	0	2
GEMIN2	1	3	0	1	63.69	127.38	15	1	1	1	1	0.25	1	4
GEMIN4	13	22	3	9	227.37	454.74	15	1	0.505401526483564	0.435897435897436	1	0.121428571428571	12	35
GEMIN5	12	15	1	2	376.53	753.06	15	1	1	0.375	1	0.111111111111111	3	27
GEMIN8	4	1	3	0	50.82	101.64	15	1	1	-Inf	1	-0.2	3	5
GEN1	22	17	1	2	302.61	605.22	15	1	0.581271777003484	0.613636363636364	1	0.230769230769231	3	39
GET4	0	6	0	1	75.24	150.48	15	1	1	NA	1	0	1	6
GFAP	1	3	1	1	49.17	98.34	15	1	1	-2	1	-0.25	2	4
GFI1	2	2	0	0	94.05	188.1	15	1	1	NA	1	NA	0	4
GFI1B	2	6	0	1	93.72	187.44	15	1	1	1	1	0.25	1	8
GFM1	3	17	0	4	249.48	498.96	15	1	1	1	1	0.15	4	20
GFM2	6	7	2	1	172.26	344.52	15	1	1	-1.33333333333333	1	-0.205128205128205	3	13
GFOD1	2	9	0	0	97.35	194.7	15	1	1	NA	1	NA	0	11
GFOD2	3	11	0	1	173.25	346.5	15	1	1	1	1	0.214285714285714	1	14
GFPT1	0	11	0	0	233.64	467.28	15	1	1	NA	1	NA	0	11
GFPT2	0	5	0	0	175.89	351.78	15	1	1	NA	1	NA	0	5
GFRA1	3	2	0	0	105.93	211.86	15	1	1	NA	1	NA	0	5
GFRA2	1	1	0	0	27.72	55.44	15	1	1	NA	1	NA	0	2
GFRA3	1	7	0	0	158.07	316.14	15	1	1	NA	1	NA	0	8
GFRA4	0	11	0	5	124.41	248.82	15	1	1	NA	1	0	5	11
GFRAL	6	9	1	1	132	264	15	1	1	-0.5	1	-0.1	2	15
GGA1	2	6	0	0	102.96	205.92	15	1	1	NA	1	NA	0	8
GGA2	10	11	5	2	257.07	514.14	15	1	0.395531400966184	-1.75	1	-0.238095238095238	7	21
GGA3	1	10	0	0	204.93	409.86	15	1	1	NA	1	NA	0	11
GGACT	0	2	0	0	48.51	97.02	15	1	1	NA	1	NA	0	2
GGCT	0	2	0	0	41.58	83.16	15	1	1	NA	1	NA	0	2
GGGT5L	5	22	1	2	307.56	615.12	15	1	0.501477832512315	-1.2	1	-0.148148148148148	3	27
GGH	6	7	3	0	102.96	205.92	15	1	0.2125	-Inf	1	-0.538461538461538	3	13
GGPS1	0	5	0	1	119.46	238.92	15	1	1	NA	1	0	1	5
GGT7	6	8	0	1	187.11	374.22	15	1	1	1	1	0.428571428571429	1	14
GHITM	3	2	1	0	60.39	120.78	15	1	1	-Inf	1	-0.4	1	5
GHR	0	7	0	0	147.18	294.36	15	1	1	NA	1	NA	0	7
GHRH	0	2	0	1	46.2	92.4	15	1	1	NA	1	0	1	2
GHRHR	2	3	0	0	115.83	231.66	15	1	1	NA	1	NA	0	5
GHRHR-LR	3	6	0	1	124.41	248.82	15	1	1	1	1	0.333333333333333	1	9
GHRL	3	5	1	0	52.47	104.94	15	1	0.444444444444444	-Inf	1	-0.625	1	8
GHSR	0	4	0	0	103.29	206.58	15	1	1	NA	1	NA	0	4
GID4	1	2	1	0	46.53	93.06	15	1	1	-Inf	1	-0.666666666666667	1	3
GID8	0	5	0	2	47.85	95.7	15	1	1	NA	1	0	2	5
GIF	1	2	0	1	56.1	112.2	15	1	1	1	1	0.333333333333333	1	3
GIGYF2	0	6	0	0	316.47	632.94	15	1	1	NA	1	NA	0	6
GIMD1	4	1	1	0	51.48	102.96	15	1	1	-Inf	1	-0.2	1	5
GIN1	3	5	0	1	140.91	281.82	15	1	1	1	1	0.375	1	8
GINM1	5	3	0	1	67.65	135.3	15	1	0.444444444444444	1	1	0.625	1	8
GINS1	0	2	0	1	26.07	52.14	15	1	1	NA	1	0	1	2
GINS2	0	3	0	0	17.49	34.98	15	1	1	NA	1	NA	0	3
GINS3	0	1	0	1	58.08	116.16	15	1	1	NA	1	0	1	1
GINS4	0	2	0	0	49.5	99	15	1	1	NA	1	NA	0	2
GIP	1	1	0	0	49.83	99.66	15	1	1	NA	1	NA	0	2
GIT2	0	10	0	6	208.56	417.12	15	1	1	NA	1	0	6	10
GJA1	0	4	0	1	124.74	249.48	15	1	1	NA	1	0	1	4
GJA3	2	6	1	1	87.78	175.56	15	1	1	-2	1	-0.25	2	8
GJA4	2	9	2	4	66	132	15	1	0.584033613445378	-1.25	1	-0.151515151515151	6	11
GJA5	1	4	0	3	94.38	188.76	15	1	1	1	1	0.2	3	5
GJA8	1	3	1	0	103.95	207.9	15	1	0.4	-Inf	1	-0.75	1	4
GJA9	8	7	2	0	129.36	258.72	15	1	0.485294117647059	-Inf	1	-0.466666666666667	2	15
GJB1	1	1	0	0	66	132	15	1	1	NA	1	NA	0	2
GJB2	0	1	0	1	82.5	165	15	1	1	NA	1	0	1	1
GJB3	0	4	0	1	92.4	184.8	15	1	1	NA	1	0	1	4
GJB5	1	1	0	0	32.34	64.68	15	1	1	NA	1	NA	0	2
GJB6	0	5	0	1	120.78	241.56	15	1	1	NA	1	0	1	5
GJC1	0	2	0	0	121.44	242.88	15	1	1	NA	1	NA	0	2
GJC2	1	7	1	1	112.86	225.72	15	1	0.377777777777778	-6	1	-0.375	2	8
GJD2	0	2	0	0	110.22	220.44	15	1	1	NA	1	NA	0	2
GJD4	9	6	1	0	128.7	257.4	15	1	1	-Inf	1	-0.4	1	15
GK	2	4	0	0	116.49	232.98	15	1	1	NA	1	NA	0	6
GK5	5	10	2	5	120.12	240.24	15	1	1	0.2	1	0.0476190476190476	7	15
GKAP1	5	2	0	0	82.5	165	15	1	1	NA	1	NA	0	7
GKN1	4	1	0	0	65.01	130.02	15	1	1	NA	1	NA	0	5
GLA	2	2	0	0	57.75	115.5	15	1	1	NA	1	NA	0	4
GLB1L	1	1	1	0	26.4	52.8	15	1	1	-Inf	1	-0.5	1	2
GLB1L2	5	15	1	3	244.2	488.4	15	1	1	0	1	0	4	20
GLCCI1	2	3	1	0	111.21	222.42	15	1	1	-Inf	1	-0.6	1	5
GLCE	2	12	1	3	153.45	306.9	15	1	1	-1	1	-0.107142857142857	4	14
GLDC	8	16	1	0	257.07	514.14	15	1	0.36	-Inf	1	-0.666666666666667	1	24
GLDN	3	7	0	3	157.74	315.48	15	1	0.527972027972028	1	1	0.3	3	10
GLE1	8	7	3	1	196.68	393.36	15	1	0.602683178534572	-1.625	1	-0.216666666666667	4	15
GLI1	9	13	2	0	300.96	601.92	15	1	0.199275362318841	-Inf	1	-0.590909090909091	2	22
GLI2	7	16	2	2	400.29	800.58	15	1	0.581538461538461	-1.28571428571429	1	-0.195652173913043	4	23
GLIPR1L	13	6	2	0	124.74	249.48	15	1	1	-Inf	1	-0.315789473684211	2	19
GLIPR2	0	4	0	1	36.3	72.6	15	1	1	NA	1	0	1	4
GLIS3	16	5	1	2	148.83	297.66	15	1	0.193675889328063	0.84375	1	0.428571428571429	3	21
GLMN	5	7	0	0	201.96	403.92	15	1	1	NA	1	NA	0	12
GLMP	5	6	0	0	90.42	180.84	15	1	1	NA	1	NA	0	11
GLO1	3	2	1	1	36.63	73.26	15	1	1	0.333333333333333	1	0.1	2	5
GLOD4	2	5	0	1	74.58	149.16	15	1	1	1	1	0.285714285714286	1	7
GLOD5	4	6	0	0	60.39	120.78	15	1	1	NA	1	NA	0	10
GLP1R	1	4	0	0	148.5	297	15	1	1	NA	1	NA	0	5
GLP2R	1	1	0	0	60.39	120.78	15	1	1	NA	1	NA	0	2
GLRA1	0	6	0	1	107.25	214.5	15	1	1	NA	1	0	1	6
GLRA4	1	4	1	3	34.32	68.64	15	1	1	-0.333333333333333	1	-0.05	4	5
GLRB	2	4	0	1	171.6	343.2	15	1	1	1	1	0.333333333333333	1	6
GLRX	1	3	0	1	16.17	32.34	15	1	1	1	1	0.25	1	4
GLRX2	0	2	0	0	36.96	73.92	15	1	1	NA	1	NA	0	2
GLRX3	0	5	0	1	68.64	137.28	15	1	1	NA	1	0	1	5
GLS	0	3	0	0	155.76	311.52	15	1	1	NA	1	NA	0	3
GLT1D1	3	6	0	0	104.28	208.56	15	1	1	NA	1	NA	0	9
GLT8D1	2	4	1	0	96.36	192.72	15	1	0.428571428571428	-Inf	1	-0.666666666666667	1	6
GLT8D2	1	2	1	1	132	264	15	1	1	-1	1	-0.166666666666667	2	3
GLTP	0	2	0	1	15.18	30.36	15	1	1	NA	1	0	1	2
GLTSCR1L	7	15	0	0	393.03	786.06	15	1	1	NA	1	NA	0	22
GLUL	0	8	0	4	102.96	205.92	15	1	1	NA	1	0	4	8
GLYCTK	7	6	3	0	144.54	289.08	15	1	0.25	-Inf	1	-0.461538461538462	3	13
GLYR1	1	7	0	3	186.12	372.24	15	1	1	1	1	0.125	3	8
GMCL1	1	7	0	2	103.29	206.58	15	1	1	1	1	0.125	2	8
GMEB2	0	7	0	3	105.6	211.2	15	1	1	NA	1	0	3	7
GMNC	7	2	0	0	75.9	151.8	15	1	1	NA	1	NA	0	9
GMNN	2	7	0	2	78.54	157.08	15	1	1	1	1	0.222222222222222	2	9
GMPR	25	12	14	4	209.88	419.76	15	1	0.536392588262237	-0.68	1	-0.102102102102102	18	37
GMPS	1	7	1	1	230.67	461.34	15	1	0.377777777777778	-6	1	-0.375	2	8
GMSRAL	12	4	2	0	108.9	217.8	15	1	1	-Inf	1	-0.25	2	16
GNA11	0	4	0	0	108.24	216.48	15	1	1	NA	1	NA	0	4
GNA12	0	3	0	0	85.47	170.94	15	1	1	NA	1	NA	0	3
GNA13	0	2	0	1	119.13	238.26	15	1	1	NA	1	0	1	2
GNAI2	0	5	0	0	47.19	94.38	15	1	1	NA	1	NA	0	5
GNAO1	0	5	0	3	100.65	201.3	15	1	1	NA	1	0	3	5
GNAQ	2	5	0	0	75.57	151.14	15	1	1	NA	1	NA	0	7
GNAT2	0	3	0	1	46.86	93.72	15	1	1	NA	1	0	1	3
GNAT3	2	4	1	0	67.32	134.64	15	1	0.428571428571428	-Inf	1	-0.666666666666667	1	6
GNB1L	5	3	1	0	101.97	203.94	15	1	1	-Inf	1	-0.375	1	8
GNB4	0	3	0	0	102.96	205.92	15	1	1	NA	1	NA	0	3
GNB5	0	4	0	0	104.61	209.22	15	1	1	NA	1	NA	0	4
GNE	0	6	0	0	170.94	341.88	15	1	1	NA	1	NA	0	6
GNG12	1	2	1	0	19.14	38.28	15	1	1	-Inf	1	-0.666666666666667	1	3
GNG2	0	1	0	1	10.89	21.78	15	1	1	NA	1	0	1	1
GNG4	1	0	1	0	32.01	64.02	15	1	1	NA	1	0	1	1
GNGT2	1	1	0	0	18.48	36.96	15	1	1	NA	1	NA	0	2
GNL2	6	9	0	4	216.15	432.3	15	1	0.255417956656347	1	1	0.4	4	15
GNL3	15	8	2	0	199.65	399.3	15	1	1	-Inf	1	-0.347826086956522	2	23
GNOT2	1	0	1	0	9.24	18.48	15	1	1	NA	1	0	1	1
GNPAT	3	13	1	2	186.45	372.9	15	1	0.530443756449948	-1.16666666666667	1	-0.145833333333333	3	16
GNPDA1	0	5	0	1	90.09	180.18	15	1	1	NA	1	0	1	5
GNPNAT1	0	2	0	0	61.38	122.76	15	1	1	NA	1	NA	0	2
GNPTAB	7	14	1	1	470.25	940.5	15	1	1	-1	1	-0.166666666666667	2	21
GNPTG	0	3	0	1	84.15	168.3	15	1	1	NA	1	0	1	3
GNRH1	3	0	1	0	31.35	62.7	15	1	1	NA	1	0	1	3
GNRHR	0	4	0	4	47.85	95.7	15	1	1	NA	1	0	4	4
GNS	2	14	0	2	168.3	336.6	15	1	1	1	1	0.125	2	16
GOLGA1	5	9	1	0	251.13	502.26	15	1	0.4	-Inf	1	-0.642857142857143	1	14
GOLGA2	4	10	0	0	264.66	529.32	15	1	1	NA	1	NA	0	14
GOLGA3	6	20	2	2	408.21	816.42	15	1	0.283524904214559	-2.33333333333333	1	-0.269230769230769	4	26
GOLGA4	14	16	0	2	438.57	877.14	15	1	0.491935483870968	1	1	0.466666666666667	2	30
GOLGA5	7	14	2	3	282.48	564.96	15	1	1	-0.333333333333333	1	-0.0666666666666667	5	21
GOLGB1	54	55	6	4	1186.68	2373.36	15	1	0.743012135832904	-0.527777777777778	1	-0.104587155963303	10	109
GOLM1	4	5	0	0	96.69	193.38	15	1	1	NA	1	NA	0	9
GOLPH3L	11	10	1	5	130.02	260.04	15	1	0.181902638424377	0.818181818181818	1	0.357142857142857	6	21
GOLT1B	0	2	0	0	28.71	57.42	15	1	1	NA	1	NA	0	2
GON4L	16	25	0	3	573.54	1147.08	15	1	0.289640591966173	1	1	0.390243902439024	3	41
GOPC	0	3	0	1	118.14	236.28	15	1	1	NA	1	0	1	3
GORAB	5	9	1	3	108.57	217.14	15	1	1	0.4	1	0.107142857142857	4	14
GORASP1	4	7	1	1	125.07	250.14	15	1	1	-0.75	1	-0.136363636363636	2	11
GORASP2	2	14	0	1	135.3	270.6	15	1	1	1	1	0.125	1	16
GOSR1	5	2	0	1	52.14	104.28	15	1	0.375	1	1	0.714285714285714	1	7
GOSR2	0	3	0	2	54.45	108.9	15	1	1	NA	1	0	2	3
GOT1	0	2	0	1	58.08	116.16	15	1	1	NA	1	0	1	2
GP1BA-LOC101750889	8	9	1	1	146.85	293.7	15	1	1	-0.125	1	-0.0294117647058824	2	17
GP1BB	2	0	1	0	69.96	139.92	15	1	1	NA	1	0	1	2
GPA33	3	3	1	0	107.91	215.82	15	1	1	-Inf	1	-0.5	1	6
GPALPP1	10	11	1	1	192.39	384.78	15	1	1	-0.1	1	-0.0238095238095238	2	21
GPAM	0	18	0	2	271.92	543.84	15	1	1	NA	1	0	2	18
GPAT3	0	3	0	2	149.82	299.64	15	1	1	NA	1	0	2	3
GPAT4	0	6	0	0	177.87	355.74	15	1	1	NA	1	NA	0	6
GPATCH1	4	13	1	1	264	528	15	1	0.467836257309941	-2.25	1	-0.264705882352941	2	17
GPATCH11	1	4	1	1	52.14	104.28	15	1	1	-3	1	-0.3	2	5
GPATCH2L	3	8	1	0	151.14	302.28	15	1	0.333333333333333	-Inf	1	-0.727272727272727	1	11
GPATCH3	0	4	0	1	61.05	122.1	15	1	1	NA	1	0	1	4
GPATCH8	11	11	2	1	276.21	552.42	15	1	1	-1	1	-0.166666666666667	3	22
GPBP1	1	5	0	1	83.82	167.64	15	1	1	1	1	0.166666666666667	1	6
GPBP1L1	2	5	0	1	144.21	288.42	15	1	1	1	1	0.285714285714286	1	7
GPC1	1	7	0	0	120.45	240.9	15	1	1	NA	1	NA	0	8
GPC2	4	2	1	0	68.97	137.94	15	1	1	-Inf	1	-0.333333333333333	1	6
GPC3	2	5	0	0	111.21	222.42	15	1	1	NA	1	NA	0	7
GPC4	0	7	0	1	181.83	363.66	15	1	1	NA	1	0	1	7
GPC5	3	1	0	0	36.96	73.92	15	1	1	NA	1	NA	0	4
GPCPD1	0	9	0	1	215.49	430.98	15	1	1	NA	1	0	1	9
GPD1L	0	4	0	2	108.9	217.8	15	1	1	NA	1	0	2	4
GPD1L2	0	4	0	1	105.27	210.54	15	1	1	NA	1	0	1	4
GPD2	0	7	0	3	208.56	417.12	15	1	1	NA	1	0	3	7
GPER1	0	5	0	0	128.37	256.74	15	1	1	NA	1	NA	0	5
GPHB5	2	4	0	1	35.97	71.94	15	1	1	1	1	0.333333333333333	1	6
GPI	0	4	0	0	146.19	292.38	15	1	1	NA	1	NA	0	4
GPLD1	12	11	4	2	298.32	596.64	15	1	0.662835249042146	-0.833333333333333	1	-0.144927536231884	6	23
GPM6A	0	3	0	0	106.59	213.18	15	1	1	NA	1	NA	0	3
GPN1	3	4	1	0	142.23	284.46	15	1	1	-Inf	1	-0.571428571428571	1	7
GPN3	0	5	0	2	111.54	223.08	15	1	1	NA	1	0	2	5
GPNMB	8	11	2	2	183.15	366.3	15	1	1	-0.375	1	-0.0789473684210527	4	19
GPR1	1	4	0	0	135.96	271.92	15	1	1	NA	1	NA	0	5
GPR107	4	7	1	2	157.74	315.48	15	1	1	0.125	1	0.0303030303030303	3	11
GPR119	1	9	0	2	66.33	132.66	15	1	1	1	1	0.1	2	10
GPR12	0	3	0	1	113.52	227.04	15	1	1	NA	1	0	1	3
GPR135	0	7	0	2	59.4	118.8	15	1	1	NA	1	0	2	7
GPR137B	2	4	0	0	117.81	235.62	15	1	1	NA	1	NA	0	6
GPR137C	1	5	0	1	68.31	136.62	15	1	1	1	1	0.166666666666667	1	6
GPR139	0	1	0	1	131.34	262.68	15	1	1	NA	1	0	1	1
GPR141	5	1	1	0	133.32	266.64	15	1	1	-Inf	1	-0.166666666666667	1	6
GPR143	2	3	1	0	130.35	260.7	15	1	1	-Inf	1	-0.6	1	5
GPR146	2	5	1	0	131.01	262.02	15	1	0.375	-Inf	1	-0.714285714285714	1	7
GPR148	3	4	0	0	113.52	227.04	15	1	1	NA	1	NA	0	7
GPR149	4	8	4	1	165	330	15	1	0.131221719457014	-7	1	-0.466666666666667	5	12
GPR15	3	12	0	0	107.58	215.16	15	1	1	NA	1	NA	0	15
GPR153	2	8	1	0	79.53	159.06	15	1	0.272727272727273	-Inf	1	-0.8	1	10
GPR155	3	11	1	2	299.97	599.94	15	1	1	-0.833333333333333	1	-0.119047619047619	3	14
GPR157	0	3	0	1	59.07	118.14	15	1	1	NA	1	0	1	3
GPR158	13	17	2	1	347.49	694.98	15	1	0.579362170087977	-1.61538461538462	1	-0.233333333333333	3	30
GPR160	12	5	6	2	114.18	228.36	15	1	1	-0.25	1	-0.0441176470588235	8	17
GPR161	2	10	1	1	185.46	370.92	15	1	0.395604395604396	-4	1	-0.333333333333333	2	12
GPR162	1	10	1	2	162.69	325.38	15	1	0.395604395604396	-4	1	-0.242424242424242	3	11
GPR17	2	2	0	0	117.48	234.96	15	1	1	NA	1	NA	0	4
GPR174	1	7	0	2	100.32	200.64	15	1	1	1	1	0.125	2	8
GPR18	0	8	0	2	94.05	188.1	15	1	1	NA	1	0	2	8
GPR180	1	2	0	0	109.56	219.12	15	1	1	NA	1	NA	0	3
GPR182	0	2	0	0	76.89	153.78	15	1	1	NA	1	NA	0	2
GPR183	3	10	0	0	122.1	244.2	15	1	1	NA	1	NA	0	13
GPR183,UBAC2	2	0	1	0	21.45	42.9	15	1	1	NA	1	0	1	2
GPR19	6	2	1	0	124.41	248.82	15	1	1	-Inf	1	-0.25	1	8
GPR20	1	5	1	1	143.55	287.1	15	1	0.464285714285714	-4	1	-0.333333333333333	2	6
GPR21	0	4	0	0	75.9	151.8	15	1	1	NA	1	NA	0	4
GPR22	1	1	1	0	132.33	264.66	15	1	1	-Inf	1	-0.5	1	2
GPR26	1	3	0	0	128.7	257.4	15	1	1	NA	1	NA	0	4
GPR34L	2	4	2	2	122.43	244.86	15	1	1	-1	1	-0.166666666666667	4	6
GPR35	4	8	0	0	99.33	198.66	15	1	1	NA	1	NA	0	12
GPR35L	13	7	2	0	137.94	275.88	15	1	1	-Inf	1	-0.35	2	20
GPR37	0	6	0	0	108.57	217.14	15	1	1	NA	1	NA	0	6
GPR37L1	2	4	1	3	81.18	162.36	15	1	1	0.333333333333333	1	0.0833333333333333	4	6
GPR39	3	3	0	0	84.81	169.62	15	1	1	NA	1	NA	0	6
GPR50	0	8	0	1	82.5	165	15	1	1	NA	1	0	1	8
GPR52	3	3	2	0	127.71	255.42	15	1	0.464285714285714	-Inf	1	-0.5	2	6
GPR55	3	5	0	0	126.72	253.44	15	1	1	NA	1	NA	0	8
GPR6	0	4	0	1	46.86	93.72	15	1	1	NA	1	0	1	4
GPR62	2	3	0	3	76.56	153.12	15	1	0.464285714285714	1	1	0.4	3	5
GPR63	0	3	0	0	146.52	293.04	15	1	1	NA	1	NA	0	3
GPR68	0	7	0	2	87.45	174.9	15	1	1	NA	1	0	2	7
GPR78	0	5	0	0	78.21	156.42	15	1	1	NA	1	NA	0	5
GPR83	5	5	2	3	111.87	223.74	15	1	1	0.333333333333333	1	0.1	5	10
GPR83L	0	7	0	2	163.35	326.7	15	1	1	NA	1	0	2	7
GPR87	0	5	0	2	138.6	277.2	15	1	1	NA	1	0	2	5
GPR89B	0	3	0	0	133.98	267.96	15	1	1	NA	1	NA	0	3
GPRC5A	7	6	0	1	114.18	228.36	15	1	1	1	1	0.538461538461538	1	13
GPRC5B	1	6	0	1	124.08	248.16	15	1	1	1	1	0.142857142857143	1	7
GPRC5C	2	2	1	2	42.57	85.14	15	1	1	0.5	1	0.166666666666667	3	4
GPRC6A	6	15	1	2	335.94	671.88	15	1	1	-0.25	1	-0.0476190476190476	3	21
GPRIN1	0	2	0	2	39.6	79.2	15	1	1	NA	1	0	2	2
GPRIN2	15	11	2	1	240.57	481.14	15	1	1	-0.466666666666667	1	-0.0897435897435898	3	26
GPRIN3	21	14	6	5	191.4	382.8	15	1	1	0.2	1	0.0545454545454546	11	35
GPS1	8	14	1	1	315.81	631.62	15	1	1	-0.75	1	-0.136363636363636	2	22
GPSM1	1	15	0	2	208.56	417.12	15	1	1	1	1	0.0625	2	16
GPSM2	2	12	0	1	242.22	484.44	15	1	1	1	1	0.142857142857143	1	14
GPT2	0	4	0	2	127.71	255.42	15	1	1	NA	1	0	2	4
GPX1	0	4	0	2	13.86	27.72	15	1	1	NA	1	0	2	4
GPX4	0	1	0	1	14.19	28.38	15	1	1	NA	1	0	1	1
GPX7	2	3	2	0	76.23	152.46	15	1	0.428571428571428	-Inf	1	-0.6	2	5
GPX8	0	5	0	0	59.73	119.46	15	1	1	NA	1	NA	0	5
GRAMD1B	0	7	0	0	227.37	454.74	15	1	1	NA	1	NA	0	7
GRAMD1C	3	9	2	3	227.7	455.4	15	1	0.600032320620556	-1	1	-0.15	5	12
GRAMD3	3	7	0	3	109.56	219.12	15	1	0.527972027972028	1	1	0.3	3	10
GRAMD4	1	5	0	1	186.78	373.56	15	1	1	1	1	0.166666666666667	1	6
GRAP2	0	3	0	1	70.29	140.58	15	1	1	NA	1	0	1	3
GRB14	4	1	1	1	119.13	238.26	15	1	1	0.75	1	0.3	2	5
GREB1L	7	27	4	6	632.28	1264.56	15	1	0.237179071194058	-1.57142857142857	1	-0.194117647058824	10	34
GREM1	0	3	0	0	35.64	71.28	15	1	1	NA	1	NA	0	3
GREM2	0	4	0	0	58.08	116.16	15	1	1	NA	1	NA	0	4
GRHL1	0	10	0	0	191.73	383.46	15	1	1	NA	1	NA	0	10
GRHL2	0	4	0	1	205.92	411.84	15	1	1	NA	1	0	1	4
GRHL3	6	13	0	0	222.42	444.84	15	1	1	NA	1	NA	0	19
GRIA1	1	9	0	0	265.32	530.64	15	1	1	NA	1	NA	0	10
GRIA2-GRIA3-GRIA4	0	4	0	1	180.84	361.68	15	1	1	NA	1	0	1	4
GRIA4	1	7	0	1	239.58	479.16	15	1	1	1	1	0.125	1	8
GRID2	2	7	1	1	147.18	294.36	15	1	0.490909090909091	-2.5	1	-0.277777777777778	2	9
GRID2IP	2	14	1	8	218.13	436.26	15	1	1	0.125	1	0.0138888888888889	9	16
GRIFIN	0	5	0	1	38.61	77.22	15	1	1	NA	1	0	1	5
GRIK1	1	5	1	3	304.26	608.52	15	1	1	-0.666666666666667	1	-0.0833333333333333	4	6
GRIK3	2	5	1	3	189.42	378.84	15	1	1	0.166666666666667	1	0.0357142857142857	4	7
GRIK4	7	25	6	13	242.22	484.44	15	1	0.514920717922887	-0.648351648351648	1	-0.0970394736842105	19	32
GRIN2A	1	19	0	1	463.65	927.3	15	1	1	1	1	0.05	1	20
GRIN2B	10	13	3	4	357.06	714.12	15	1	1	0.025	1	0.00621118012422361	7	23
GRIN2C	0	4	0	4	96.36	192.72	15	1	1	NA	1	0	4	4
GRIN3A	8	12	0	2	242.88	485.76	15	1	0.515151515151515	1	1	0.4	2	20
GRIN3B	7	6	2	5	101.31	202.62	15	1	0.374226006191951	0.657142857142857	1	0.252747252747253	7	13
GRIP1	5	11	2	4	334.29	668.58	15	1	1	-0.1	1	-0.0208333333333333	6	16
GRIP2	4	14	1	3	316.8	633.6	15	1	1	-0.166666666666667	1	-0.0277777777777778	4	18
GRK6	0	8	0	3	137.28	274.56	15	1	1	NA	1	0	3	8
GRK7	3	10	0	3	240.24	480.48	15	1	1	1	1	0.230769230769231	3	13
GRM1	4	18	2	4	252.78	505.56	15	1	0.580602006688963	-1.25	1	-0.151515151515151	6	22
GRM3	5	26	0	0	317.79	635.58	15	1	1	NA	1	NA	0	31
GRM4	2	3	1	2	198	396	15	1	1	0.25	1	0.0666666666666667	3	5
GRM5	4	14	2	1	297.66	595.32	15	1	0.184210526315789	-6	1	-0.444444444444444	3	18
GRM7	8	19	0	2	268.62	537.24	15	1	1	1	1	0.296296296296296	2	27
GRM8	1	5	0	0	92.4	184.8	15	1	1	NA	1	NA	0	6
GRPEL1	0	5	0	1	68.64	137.28	15	1	1	NA	1	0	1	5
GRPR	0	6	0	2	131.34	262.68	15	1	1	NA	1	0	2	6
GRSF1	8	7	0	1	103.95	207.9	15	1	1	1	1	0.533333333333333	1	15
GRTP1	2	6	0	3	114.18	228.36	15	1	1	1	1	0.25	3	8
GRXCR1	2	7	1	0	82.17	164.34	15	1	0.3	-Inf	1	-0.777777777777778	1	9
GSAP	15	14	3	2	262.35	524.7	15	1	1	-0.4	1	-0.0827586206896551	5	29
GSC2	0	4	0	2	25.08	50.16	15	1	1	NA	1	0	2	4
GSE1	1	3	1	2	44.88	89.76	15	1	1	-0.5	1	-0.0833333333333333	3	4
GSG1	1	1	0	0	80.19	160.38	15	1	1	NA	1	NA	0	2
GSG2	9	9	0	0	184.47	368.94	15	1	1	NA	1	NA	0	18
GSK3B	1	1	0	0	122.76	245.52	15	1	1	NA	1	NA	0	2
GSKIP	0	2	0	0	39.93	79.86	15	1	1	NA	1	NA	0	2
GSL	1	5	1	3	66	132	15	1	1	-0.666666666666667	1	-0.0833333333333333	4	6
GSN	4	10	0	1	235.62	471.24	15	1	1	1	1	0.285714285714286	1	14
GSPT1	5	7	0	0	150.15	300.3	15	1	1	NA	1	NA	0	12
GSR	2	8	0	2	97.68	195.36	15	1	1	1	1	0.2	2	10
GSTA4L	4	2	1	1	91.41	182.82	15	1	1	0.5	1	0.166666666666667	2	6
GSTAL3	1	4	0	0	60.06	120.12	15	1	1	NA	1	NA	0	5
GSTCD	9	12	1	5	210.87	421.74	15	1	0.36252153643458	0.733333333333333	1	0.261904761904762	6	21
GSTK1	2	2	0	0	56.1	112.2	15	1	1	NA	1	NA	0	4
GSTO1	3	4	0	0	80.52	161.04	15	1	1	NA	1	NA	0	7
GSTT1	0	4	0	1	66.99	133.98	15	1	1	NA	1	0	1	4
GSTT1L	2	0	1	0	60.06	120.12	15	1	1	NA	1	0	1	2
GSTZ1	0	5	0	0	56.1	112.2	15	1	1	NA	1	NA	0	5
GTDC1	10	6	4	1	204.27	408.54	15	1	0.624355005159959	-1.4	1	-0.175	5	16
GTF2A1L	4	9	0	1	135.3	270.6	15	1	1	1	1	0.307692307692308	1	13
GTF2B	0	4	0	0	116.16	232.32	15	1	1	NA	1	NA	0	4
GTF2E1L	7	18	2	1	154.11	308.22	15	1	0.234432234432234	-4.14285714285714	1	-0.386666666666667	3	25
GTF2E2	0	3	0	1	107.58	215.16	15	1	1	NA	1	0	1	3
GTF2F2	0	2	0	0	46.86	93.72	15	1	1	NA	1	NA	0	2
GTF2H1	0	2	0	0	156.75	313.5	15	1	1	NA	1	NA	0	2
GTF2H2	3	5	1	0	66.66	133.32	15	1	0.444444444444444	-Inf	1	-0.625	1	8
GTF2H3	1	3	0	0	79.53	159.06	15	1	1	NA	1	NA	0	4
GTF2I	6	10	0	2	290.73	581.46	15	1	0.529411764705882	1	1	0.375	2	16
GTF2IRD1	0	12	0	7	263.67	527.34	15	1	1	NA	1	0	7	12
GTF3A	3	0	1	0	86.46	172.92	15	1	1	NA	1	0	1	3
GTF3C3	2	17	0	4	336.6	673.2	15	1	1	1	1	0.105263157894737	4	19
GTF3C4	2	11	0	1	203.61	407.22	15	1	1	1	1	0.153846153846154	1	13
GTF3C6	3	4	1	0	71.61	143.22	15	1	1	-Inf	1	-0.571428571428571	1	7
GTPBP1	0	11	0	3	175.56	351.12	15	1	1	NA	1	0	3	11
GTPBP10	8	5	0	1	119.13	238.26	15	1	0.428571428571428	1	1	0.615384615384615	1	13
GTPBP2	1	7	0	2	178.53	357.06	15	1	1	1	1	0.125	2	8
GTPBP4	1	4	0	0	189.09	378.18	15	1	1	NA	1	NA	0	5
GTPBP6	5	9	1	2	113.19	226.38	15	1	1	0.1	1	0.0238095238095238	3	14
GTPBP8	0	2	0	0	55.44	110.88	15	1	1	NA	1	NA	0	2
GTSE1	16	14	2	3	208.23	416.46	15	1	0.658148303309594	0.416666666666667	1	0.133333333333333	5	30
GTSF1	1	4	0	0	44.55	89.1	15	1	1	NA	1	NA	0	5
GUCA1A	1	3	0	0	62.7	125.4	15	1	1	NA	1	NA	0	4
GUCA1C	1	0	1	0	62.04	124.08	15	1	1	NA	1	0	1	1
GUCY1A2	1	8	1	0	208.89	417.78	15	1	0.2	-Inf	1	-0.888888888888889	1	9
GUCY1A3	4	11	2	2	252.12	504.24	15	1	0.557275541795666	-1.75	1	-0.233333333333333	4	15
GUCY1B3	1	5	0	0	282.15	564.3	15	1	1	NA	1	NA	0	6
GUCY1B4	2	12	2	2	269.94	539.88	15	1	0.197058823529412	-5	1	-0.357142857142857	4	14
GUCY2C	3	11	0	2	319.11	638.22	15	1	1	1	1	0.214285714285714	2	14
GUCY2F	8	24	5	5	396	792	15	1	0.2382921318963	-2	1	-0.25	10	32
GUF1	4	10	1	2	197.01	394.02	15	1	1	-0.25	1	-0.0476190476190476	3	14
GUK1	0	8	0	4	43.89	87.78	15	1	1	NA	1	0	4	8
GUSB	4	16	2	3	210.21	420.42	15	1	0.562281197063806	-1.66666666666667	1	-0.2	5	20
GXYLT2	0	3	0	0	107.91	215.82	15	1	1	NA	1	NA	0	3
GYG1	1	4	0	1	107.25	214.5	15	1	1	1	1	0.2	1	5
GYG2	6	13	1	0	153.12	306.24	15	1	0.35	-Inf	1	-0.684210526315789	1	19
GYS2	1	8	0	1	233.64	467.28	15	1	1	1	1	0.111111111111111	1	9
GZF1	21	37	3	10	468.6	937.2	15	1	0.520775475268533	0.471428571428571	1	0.131299734748011	13	58
GZMK	8	1	2	0	90.75	181.5	15	1	1	-Inf	1	-0.111111111111111	2	9
H1F0	3	5	1	3	41.91	83.82	15	1	1	0.444444444444444	1	0.125	4	8
H1FOO	4	5	0	0	35.64	71.28	15	1	1	NA	1	NA	0	9
H2AFV	0	2	0	0	6.6	13.2	15	1	1	NA	1	NA	0	2
H2AFY	0	7	0	0	114.51	229.02	15	1	1	NA	1	NA	0	7
H2AFY2	0	4	0	0	108.9	217.8	15	1	1	NA	1	NA	0	4
H2AFZ	0	5	0	1	35.97	71.94	15	1	1	NA	1	0	1	5
H6PD	4	11	1	0	179.52	359.04	15	1	0.3125	-Inf	1	-0.733333333333333	1	15
HAAO	5	5	0	0	94.71	189.42	15	1	1	NA	1	NA	0	10
HABP2	9	7	2	0	210.87	421.74	15	1	0.496732026143791	-Inf	1	-0.4375	2	16
HACD3	0	6	0	3	87.45	174.9	15	1	1	NA	1	0	3	6
HACD4	3	5	0	0	66.99	133.98	15	1	1	NA	1	NA	0	8
HACL1	1	7	1	2	172.26	344.52	15	1	0.490909090909091	-2.5	1	-0.208333333333333	3	8
HADH	2	7	0	2	92.4	184.8	15	1	1	1	1	0.222222222222222	2	9
HADHA	1	22	0	6	212.19	424.38	15	1	1	1	1	0.0434782608695652	6	23
HAGH	0	3	0	0	81.18	162.36	15	1	1	NA	1	NA	0	3
HAGHL	0	2	0	1	19.8	39.6	15	1	1	NA	1	0	1	2
HAL	0	7	0	1	242.55	485.1	15	1	1	NA	1	0	1	7
HAO1	5	5	3	1	93.72	187.44	15	1	0.58041958041958	-2	1	-0.25	4	10
HAO2	2	5	0	0	104.28	208.56	15	1	1	NA	1	NA	0	7
HAPLN1	3	6	1	1	78.87	157.74	15	1	1	-1	1	-0.166666666666667	2	9
HAPLN3	0	3	0	3	21.45	42.9	15	1	1	NA	1	0	3	3
HAPLN4	3	1	1	1	49.5	99	15	1	1	0.666666666666667	1	0.25	2	4
HARBI1	2	7	0	2	73.59	147.18	15	1	1	1	1	0.222222222222222	2	9
HARS	4	8	1	1	97.02	194.04	15	1	1	-1	1	-0.166666666666667	2	12
HARS2	3	8	0	1	91.74	183.48	15	1	1	1	1	0.272727272727273	1	11
HAS2	0	6	0	0	219.12	438.24	15	1	1	NA	1	NA	0	6
HAT1	2	2	0	0	119.13	238.26	15	1	1	NA	1	NA	0	4
HAUS1	15	5	0	0	51.48	102.96	15	1	1	NA	1	NA	0	20
HAUS2	2	4	0	0	56.43	112.86	15	1	1	NA	1	NA	0	6
HAUS3	14	8	2	1	202.95	405.9	15	1	1	-0.142857142857143	1	-0.0303030303030303	3	22
HAUS3L	6	2	1	0	75.57	151.14	15	1	1	-Inf	1	-0.25	1	8
HAVCR1	10	8	1	6	93.39	186.78	15	1	0.09	0.866666666666667	1	0.412698412698413	7	18
HBBA	0	2	0	0	20.13	40.26	15	1	1	NA	1	NA	0	2
HBE1	0	3	0	0	36.63	73.26	15	1	1	NA	1	NA	0	3
HBP1	3	5	0	1	171.27	342.54	15	1	1	1	1	0.375	1	8
HCCS	2	5	1	0	75.57	151.14	15	1	0.375	-Inf	1	-0.714285714285714	1	7
HCFC2	2	11	1	3	222.75	445.5	15	1	1	-0.833333333333333	1	-0.0961538461538461	4	13
HCK	1	5	0	2	101.31	202.62	15	1	1	1	1	0.166666666666667	2	6
HCLS1	3	3	0	0	166.98	333.96	15	1	1	NA	1	NA	0	6
HCN1	2	3	0	0	58.08	116.16	15	1	1	NA	1	NA	0	5
HCN2	0	3	0	0	98.01	196.02	15	1	1	NA	1	NA	0	3
HCN3	2	8	0	1	138.93	277.86	15	1	1	1	1	0.2	1	10
HCN4	1	14	0	1	298.98	597.96	15	1	1	1	1	0.0666666666666667	1	15
HCRTR2	5	2	1	0	115.83	231.66	15	1	1	-Inf	1	-0.285714285714286	1	7
HDAC1	0	11	0	1	163.02	326.04	15	1	1	NA	1	0	1	11
HDAC11	2	5	0	2	117.15	234.3	15	1	1	1	1	0.285714285714286	2	7
HDAC2	0	3	0	0	123.42	246.84	15	1	1	NA	1	NA	0	3
HDAC4	4	19	1	5	328.68	657.36	15	1	1	0.05	1	0.00724637681159421	6	23
HDAC7	3	9	1	7	136.62	273.24	15	1	0.618575851393189	0.571428571428571	1	0.125	8	12
HDAC8	0	6	0	1	70.62	141.24	15	1	1	NA	1	0	1	6
HDC	5	7	2	4	209.55	419.1	15	1	1	0.3	1	0.0833333333333334	6	12
HDDC2	0	2	0	0	50.49	100.98	15	1	1	NA	1	NA	0	2
HDGFRP2	0	5	0	1	67.32	134.64	15	1	1	NA	1	0	1	5
HDHD2	2	6	1	1	76.56	153.12	15	1	1	-2	1	-0.25	2	8
HDHD3	2	2	1	0	34.32	68.64	15	1	1	-Inf	1	-0.5	1	4
HDLBP	0	14	0	7	397.32	794.64	15	1	1	NA	1	0	7	14
HDX	1	7	1	1	247.5	495	15	1	0.377777777777778	-6	1	-0.375	2	8
HEATR1	12	24	3	4	638.22	1276.44	15	1	0.679761559929933	-0.5	1	-0.0952380952380952	7	36
HEATR3	4	11	0	3	188.43	376.86	15	1	1	1	1	0.266666666666667	3	15
HEATR5A	15	25	2	2	650.43	1300.86	15	1	0.633704355769019	-0.666666666666667	1	-0.125	4	40
HEATR5B	1	28	0	2	579.48	1158.96	15	1	1	1	1	0.0344827586206897	2	29
HEBP1	1	3	0	2	91.74	183.48	15	1	1	1	1	0.25	2	4
HEBP2	3	0	0	0	46.53	93.06	15	1	1	NA	1	NA	0	3
HECA	2	5	0	0	130.68	261.36	15	1	1	NA	1	NA	0	7
HECTD2	2	8	1	1	245.52	491.04	15	1	0.454545454545455	-3	1	-0.3	2	10
HECTD3	1	10	1	1	191.07	382.14	15	1	0.294871794871795	-9	1	-0.409090909090909	2	11
HECTD3L	3	9	0	5	111.54	223.08	15	1	0.514705882352941	1	1	0.25	5	12
HECTD4	5	61	3	9	1333.53	2667.06	15	1	0.100702400258642	-3.06666666666667	1	-0.174242424242424	12	66
HECW1	0	6	0	1	148.5	297	15	1	1	NA	1	0	1	6
HECW2	8	14	2	1	327.36	654.72	15	1	0.543478260869565	-2.5	1	-0.303030303030303	3	22
HEG1	36	30	3	8	434.61	869.22	15	1	0.114068690274509	0.6875	1	0.272727272727273	11	66
HELB	12	15	3	2	332.64	665.28	15	1	0.645439377085651	-0.875	1	-0.155555555555556	5	27
HELLS	0	9	0	3	219.78	439.56	15	1	1	NA	1	0	3	9
HELQ	7	13	1	0	289.08	578.16	15	1	0.380952380952381	-Inf	1	-0.65	1	20
HELZ	1	10	0	2	572.22	1144.44	15	1	1	1	1	0.0909090909090909	2	11
HELZ2	37	36	3	15	770.88	1541.76	15	1	0.0153908470098143	0.805405405405405	1	0.340182648401827	18	73
HEMGN	3	3	0	0	54.45	108.9	15	1	1	NA	1	NA	0	6
HEMK1	9	5	3	1	95.37	190.74	15	1	1	-0.666666666666667	1	-0.107142857142857	4	14
HENMT1	7	5	1	0	132	264	15	1	1	-Inf	1	-0.416666666666667	1	12
HEP21	0	3	0	2	21.78	43.56	15	1	1	NA	1	0	2	3
HEPACAM	0	4	0	0	30.03	60.06	15	1	1	NA	1	NA	0	4
HEPACAM2	1	7	1	2	148.17	296.34	15	1	0.490909090909091	-2.5	1	-0.208333333333333	3	8
HEPH	5	15	1	0	353.76	707.52	15	1	0.285714285714286	-Inf	1	-0.75	1	20
HEPHL1	6	25	1	6	392.04	784.08	15	1	1	0.305555555555556	1	0.0506912442396313	7	31
HERC1	8	36	0	1	1480.71	2961.42	15	1	1	1	1	0.181818181818182	1	44
HERC2	5	71	2	9	1584	3168	15	1	0.214321740146559	-2.15555555555556	1	-0.116028708133971	11	76
HERC4	3	7	3	2	275.88	551.76	15	1	0.328671328671329	-2.5	1	-0.3	5	10
HERPUD1	3	6	0	2	105.6	211.2	15	1	1	1	1	0.333333333333333	2	9
HERPUD2	3	5	1	0	101.64	203.28	15	1	0.444444444444444	-Inf	1	-0.625	1	8
HES1	0	2	0	0	17.82	35.64	15	1	1	NA	1	NA	0	2
HES5	1	2	1	0	47.19	94.38	15	1	1	-Inf	1	-0.666666666666667	1	3
HES6	3	3	2	0	71.61	143.22	15	1	0.464285714285714	-Inf	1	-0.5	2	6
HESX1	1	3	0	0	60.06	120.12	15	1	1	NA	1	NA	0	4
HEXA	3	3	1	1	85.47	170.94	15	1	1	0	1	0	2	6
HEXB	2	6	0	1	117.48	234.96	15	1	1	1	1	0.25	1	8
HEXDC	5	6	2	1	142.56	285.12	15	1	1	-1.4	1	-0.212121212121212	3	11
HEXDCL	5	2	2	0	59.73	119.46	15	1	1	-Inf	1	-0.285714285714286	2	7
HEY1	0	3	0	0	53.79	107.58	15	1	1	NA	1	NA	0	3
HEYL	1	2	0	0	49.17	98.34	15	1	1	NA	1	NA	0	3
HFM1	11	12	0	0	309.54	619.08	15	1	1	NA	1	NA	0	23
HGF	3	9	0	1	244.86	489.72	15	1	1	1	1	0.25	1	12
HGFAC	7	9	2	0	181.5	363	15	1	0.470588235294118	-Inf	1	-0.5625	2	16
HGSNAT	11	7	2	1	159.72	319.44	15	1	1	-0.272727272727273	1	-0.0555555555555555	3	18
HHAT	1	6	0	3	66.99	133.98	15	1	1	1	1	0.142857142857143	3	7
HHATL	4	7	3	4	106.26	212.52	15	1	1	-0.3125	1	-0.0649350649350649	7	11
HHIP	0	9	0	2	182.16	364.32	15	1	1	NA	1	0	2	9
HHIPL1	3	11	0	1	240.57	481.14	15	1	1	1	1	0.214285714285714	1	14
HHLA1-OC90	19	13	0	0	318.78	637.56	15	1	1	NA	1	NA	0	32
HHLA2	3	2	0	2	36.96	73.92	15	1	0.428571428571428	1	1	0.6	2	5
HIBADH	0	3	0	1	97.35	194.7	15	1	1	NA	1	0	1	3
HIBCH	5	5	1	0	133.98	267.96	15	1	1	-Inf	1	-0.5	1	10
HIC2	2	5	2	2	157.41	314.82	15	1	0.575757575757576	-1.5	1	-0.214285714285714	4	7
HID1	0	11	0	1	264.99	529.98	15	1	1	NA	1	0	1	11
HIF1A	0	10	0	1	228.69	457.38	15	1	1	NA	1	0	1	10
HIF1AN	0	5	0	1	97.35	194.7	15	1	1	NA	1	0	1	5
HIGD1A	1	1	0	0	28.38	56.76	15	1	1	NA	1	NA	0	2
HINFP	0	5	0	1	57.09	114.18	15	1	1	NA	1	0	1	5
HINT3	0	2	0	1	25.74	51.48	15	1	1	NA	1	0	1	2
HIP1	13	34	1	1	445.83	891.66	15	1	0.494047619047619	-1.61538461538462	1	-0.223404255319149	2	47
HIP1R	18	22	5	8	378.18	756.36	15	1	0.75575276857591	0.236111111111111	1	0.0653846153846154	13	40
HIPK1	1	8	1	2	351.78	703.56	15	1	0.454545454545454	-3	1	-0.222222222222222	3	9
HIPK2	1	10	1	5	202.62	405.24	15	1	1	-1	1	-0.0757575757575757	6	11
HIPK3	7	14	3	1	343.2	686.4	15	1	0.266798418972332	-5	1	-0.416666666666667	4	21
HIST1H103-HIST1H111R	2	6	2	0	33	66	15	1	0.133333333333333	-Inf	1	-0.75	2	8
HIST1H110-HISTH1	0	5	0	4	59.73	119.46	15	1	1	NA	1	0	4	5
HIST1H2A4L1-HIST1H2A4L3-HISTH2A4L1	0	6	0	4	20.46	40.92	15	1	1	NA	1	0	4	6
HIST1H2B5L	0	2	0	0	32.01	64.02	15	1	1	NA	1	NA	0	2
HIST1H3A-HIST1H3G-HIST2H3	0	2	0	0	39.27	78.54	15	1	1	NA	1	NA	0	2
HIST2H3L	0	2	0	1	44.88	89.76	15	1	1	NA	1	0	1	2
HIVEP1	35	43	1	1	824.67	1649.34	15	1	1	-0.228571428571429	1	-0.0512820512820513	2	78
HIVEP2	14	45	4	8	940.5	1881	15	1	0.484519681924948	-0.607142857142857	1	-0.096045197740113	12	59
HIVEP3	15	44	9	11	824.34	1648.68	15	1	0.157905038598295	-1.4	1	-0.195762711864407	20	59
HJURP	29	8	3	1	233.97	467.94	15	1	1	0.172413793103448	1	0.0337837837837838	4	37
HK2	2	8	1	7	142.89	285.78	15	1	1	0.428571428571429	1	0.075	8	10
HK3	2	6	0	2	65.01	130.02	15	1	1	1	1	0.25	2	8
HLCS	5	12	0	3	266.97	533.94	15	1	0.539473684210526	1	1	0.294117647058824	3	17
HM13	0	2	0	1	70.95	141.9	15	1	1	NA	1	0	1	2
HMBOX1	2	8	0	0	154.77	309.54	15	1	1	NA	1	NA	0	10
HMBS	1	2	0	0	97.68	195.36	15	1	1	NA	1	NA	0	3
HMCN1	19	43	1	4	1070.52	2141.04	15	1	1	0.434210526315789	1	0.106451612903226	5	62
HMG20A	0	5	0	0	113.85	227.7	15	1	1	NA	1	NA	0	5
HMG20B	0	3	0	1	30.36	60.72	15	1	1	NA	1	0	1	3
HMGB1	0	2	0	0	59.73	119.46	15	1	1	NA	1	NA	0	2
HMGB3	0	1	0	1	68.97	137.94	15	1	1	NA	1	0	1	1
HMGCL	0	4	0	0	39.27	78.54	15	1	1	NA	1	NA	0	4
HMGCLL1	4	4	1	0	110.88	221.76	15	1	1	-Inf	1	-0.5	1	8
HMGCR	1	12	0	3	221.43	442.86	15	1	1	1	1	0.0769230769230769	3	13
HMGCS1	5	6	4	1	154.77	309.54	15	1	0.307692307692308	-3.8	1	-0.345454545454546	5	11
HMGCS2	0	2	0	1	41.25	82.5	15	1	1	NA	1	0	1	2
HMGN1	2	0	1	0	11.22	22.44	15	1	1	NA	1	0	1	2
HMGXB3	6	20	1	3	354.75	709.5	15	1	1	-0.111111111111111	1	-0.0192307692307692	4	26
HMGXB4	2	2	0	0	170.28	340.56	15	1	1	NA	1	NA	0	4
HMMR	5	6	2	0	173.58	347.16	15	1	0.461538461538462	-Inf	1	-0.545454545454545	2	11
HMOX1	0	6	0	1	102.96	205.92	15	1	1	NA	1	0	1	6
HMP19	1	4	0	1	71.61	143.22	15	1	1	1	1	0.2	1	5
HNF1B	0	2	0	0	64.02	128.04	15	1	1	NA	1	NA	0	2
HNF4A	1	8	1	0	122.1	244.2	15	1	0.2	-Inf	1	-0.888888888888889	1	9
HNF4beta	3	15	1	5	174.57	349.14	15	1	1	0	1	0	6	18
HNF4G	1	4	1	0	119.79	239.58	15	1	0.333333333333333	-Inf	1	-0.8	1	5
HNMT	6	6	1	1	94.05	188.1	15	1	1	0	1	0	2	12
HNRNPA2B1	0	2	0	0	79.86	159.72	15	1	1	NA	1	NA	0	2
HNRNPA3	0	2	0	1	92.07	184.14	15	1	1	NA	1	0	1	2
HNRNPD	0	5	0	1	49.5	99	15	1	1	NA	1	0	1	5
HNRNPDL	0	2	0	0	50.82	101.64	15	1	1	NA	1	NA	0	2
HNRNPH2	0	8	0	2	119.13	238.26	15	1	1	NA	1	0	2	8
HNRNPK-HNRNPKL	0	4	0	0	92.4	184.8	15	1	1	NA	1	NA	0	4
HNRNPLL	0	4	0	3	141.9	283.8	15	1	1	NA	1	0	3	4
HNRNPR	0	4	0	0	179.52	359.04	15	1	1	NA	1	NA	0	4
HNRNPU-HNRNPUL1	0	4	0	0	161.04	322.08	15	1	1	NA	1	NA	0	4
HOGA1	0	3	0	2	33	66	15	1	1	NA	1	0	2	3
HOMER1	0	5	0	0	103.62	207.24	15	1	1	NA	1	NA	0	5
HOMER2	1	3	0	0	140.91	281.82	15	1	1	NA	1	NA	0	4
HOMER3	1	6	0	3	100.98	201.96	15	1	1	1	1	0.142857142857143	3	7
HOOK1	3	10	0	1	182.82	365.64	15	1	1	1	1	0.230769230769231	1	13
HORMAD2	8	9	2	2	128.7	257.4	15	1	1	-0.125	1	-0.0294117647058824	4	17
HOXA1	0	1	0	1	17.16	34.32	15	1	1	NA	1	0	1	1
HOXA10	1	3	1	2	52.8	105.6	15	1	1	-0.5	1	-0.0833333333333333	3	4
HOXA3	1	7	0	1	147.84	295.68	15	1	1	1	1	0.125	1	8
HOXA9	1	0	1	0	17.82	35.64	15	1	1	NA	1	0	1	1
HOXC9	0	1	0	1	48.51	97.02	15	1	1	NA	1	0	1	1
HOXCDX1L	0	1	0	1	73.59	147.18	15	1	1	NA	1	0	1	1
HOXD12	1	2	0	0	80.85	161.7	15	1	1	NA	1	NA	0	3
HOXD4	1	1	0	0	62.04	124.08	15	1	1	NA	1	NA	0	2
HOXD9	1	0	1	0	46.86	93.72	15	1	1	NA	1	0	1	1
HP1BP3	2	4	0	0	154.77	309.54	15	1	1	NA	1	NA	0	6
HPCA	1	0	1	0	33.66	67.32	15	1	1	NA	1	0	1	1
HPCAL4	0	3	0	0	26.07	52.14	15	1	1	NA	1	NA	0	3
HPD	0	2	0	0	64.68	129.36	15	1	1	NA	1	NA	0	2
HPF1	1	3	0	0	96.03	192.06	15	1	1	NA	1	NA	0	4
HPGD	0	5	0	0	77.55	155.1	15	1	1	NA	1	NA	0	5
HPGDS	0	3	0	0	75.9	151.8	15	1	1	NA	1	NA	0	3
HPRT1	0	2	0	1	62.37	124.74	15	1	1	NA	1	0	1	2
HPS1	2	4	1	3	91.74	183.48	15	1	1	0.333333333333333	1	0.0833333333333333	4	6
HPS3	11	11	2	0	392.04	784.08	15	1	0.481884057971015	-Inf	1	-0.5	2	22
HPS4	12	7	4	5	174.9	349.8	15	1	0.431884057971014	0.533333333333333	1	0.187134502923977	9	19
HPS5	8	17	1	2	382.8	765.6	15	1	1	-0.0625	1	-0.0133333333333333	3	25
HPSE	2	5	1	4	145.53	291.06	15	1	1	0.375	1	0.0857142857142857	5	7
HPSE2	0	4	0	0	96.36	192.72	15	1	1	NA	1	NA	0	4
HPX	1	3	0	0	23.1	46.2	15	1	1	NA	1	NA	0	4
HRAS	0	5	0	0	55.77	111.54	15	1	1	NA	1	NA	0	5
HRASLS	0	3	0	0	29.37	58.74	15	1	1	NA	1	NA	0	3
HRG	1	7	0	0	122.1	244.2	15	1	1	NA	1	NA	0	8
HRH1	9	8	0	0	200.31	400.62	15	1	1	NA	1	NA	0	17
HRH2	5	7	0	2	102.63	205.26	15	1	0.505494505494505	1	1	0.416666666666667	2	12
HRH2L	1	5	0	1	93.06	186.12	15	1	1	1	1	0.166666666666667	1	6
HRH3	2	5	0	1	106.59	213.18	15	1	1	1	1	0.285714285714286	1	7
HRH3L-HRH4	10	20	2	2	286.77	573.54	15	1	0.601518026565465	-1	1	-0.166666666666667	4	30
HS1BP3	5	8	1	0	114.84	229.68	15	1	0.428571428571428	-Inf	1	-0.615384615384615	1	13
HS2ST1	1	0	1	0	95.04	190.08	15	1	1	NA	1	0	1	1
HS3ST1	0	2	0	0	131.01	262.02	15	1	1	NA	1	NA	0	2
HS3ST1L	2	3	0	0	145.2	290.4	15	1	1	NA	1	NA	0	5
HS3ST3B1L	2	2	1	1	78.87	157.74	15	1	1	0	1	0	2	4
HS3ST4	1	6	0	1	101.64	203.28	15	1	1	1	1	0.142857142857143	1	7
HS3ST5	0	8	0	1	113.85	227.7	15	1	1	NA	1	0	1	8
HS6ST1	3	0	2	0	74.91	149.82	15	1	1	NA	1	0	2	3
HSCB	0	4	0	0	41.91	83.82	15	1	1	NA	1	NA	0	4
HSD11B1a	1	3	0	0	65.67	131.34	15	1	1	NA	1	NA	0	4
HSD11B1b	3	7	1	0	70.95	141.9	15	1	0.363636363636364	-Inf	1	-0.7	1	10
HSD11B1L	1	2	0	1	136.95	273.9	15	1	1	1	1	0.333333333333333	1	3
HSD17B11-HSD17B11L	1	2	0	1	33	66	15	1	1	1	1	0.333333333333333	1	3
HSD17B14	3	7	0	3	156.09	312.18	15	1	0.527972027972028	1	1	0.3	3	10
HSD17B2	3	15	0	3	112.2	224.4	15	1	1	1	1	0.166666666666667	3	18
HSD17B4	1	4	0	0	114.18	228.36	15	1	1	NA	1	NA	0	5
HSD3B1	0	1	0	1	21.45	42.9	15	1	1	NA	1	0	1	1
HSD3B7	4	6	1	2	102.63	205.26	15	1	1	0.25	1	0.0666666666666667	3	10
HSDL1	0	2	0	1	73.26	146.52	15	1	1	NA	1	0	1	2
HSDL2	11	5	4	1	162.36	324.72	15	1	1	-0.818181818181818	1	-0.1125	5	16
HSF1	2	1	0	1	64.02	128.04	15	1	1	1	1	0.666666666666667	1	3
HSF2	5	6	1	0	194.7	389.4	15	1	1	-Inf	1	-0.545454545454545	1	11
HSF2BP	2	5	0	1	87.45	174.9	15	1	1	1	1	0.285714285714286	1	7
HSF3	4	6	2	0	174.57	349.14	15	1	0.454545454545454	-Inf	1	-0.6	2	10
HSF4	4	9	3	1	170.94	341.88	15	1	0.25	-5.75	1	-0.442307692307692	4	13
HSF5	5	7	1	1	139.59	279.18	15	1	1	-0.4	1	-0.0833333333333333	2	12
HSFL1-HSFL2	5	1	1	1	47.52	95.04	15	1	0.464285714285714	0.8	1	0.333333333333333	2	6
HSP90AA1	0	16	0	0	268.62	537.24	15	1	1	NA	1	NA	0	16
HSP90AB1	6	22	4	4	213.51	427.02	15	1	0.179389590467258	-2.66666666666667	1	-0.285714285714286	8	28
HSP90B1	1	12	0	1	231.33	462.66	15	1	1	1	1	0.0769230769230769	1	13
HSPA12A	1	9	0	1	242.22	484.44	15	1	1	1	1	0.1	1	10
HSPA13	8	5	2	1	183.81	367.62	15	1	1	-0.25	1	-0.0512820512820512	3	13
HSPA14	2	6	0	0	125.4	250.8	15	1	1	NA	1	NA	0	8
HSPA2	0	9	0	1	102.63	205.26	15	1	1	NA	1	0	1	9
HSPA4	2	14	1	2	266.64	533.28	15	1	0.422084623323013	-2.5	1	-0.208333333333333	3	16
HSPA4L	7	11	0	1	295.68	591.36	15	1	1	1	1	0.388888888888889	1	18
HSPA5	0	13	0	2	151.8	303.6	15	1	1	NA	1	0	2	13
HSPA8	0	10	0	3	210.21	420.42	15	1	1	NA	1	0	3	10
HSPA9	2	14	2	3	196.02	392.04	15	1	0.228070175438597	-3.66666666666667	1	-0.275	5	16
HSPB1	0	2	0	1	9.9	19.8	15	1	1	NA	1	0	1	2
HSPB2	1	5	0	3	30.03	60.06	15	1	1	1	1	0.166666666666667	3	6
HSPB3	2	1	0	0	31.35	62.7	15	1	1	NA	1	NA	0	3
HSPBAP1	5	8	1	2	185.46	370.92	15	1	1	0.2	1	0.0512820512820513	3	13
HSPD1	1	14	0	2	202.29	404.58	15	1	1	1	1	0.0666666666666667	2	15
HSPG2	9	31	4	13	498.63	997.26	15	1	1	-0.0598290598290598	1	-0.0102941176470588	17	40
HSPH1	5	9	2	5	255.09	510.18	15	1	1	0.28	1	0.0714285714285715	7	14
HTATSF1	2	4	0	0	117.81	235.62	15	1	1	NA	1	NA	0	6
HTR1A	0	3	0	0	54.78	109.56	15	1	1	NA	1	NA	0	3
HTR1E	1	8	0	3	113.85	227.7	15	1	1	1	1	0.111111111111111	3	9
HTR1F	1	6	0	0	105.93	211.86	15	1	1	NA	1	NA	0	7
HTR2A	1	4	0	0	131.34	262.68	15	1	1	NA	1	NA	0	5
HTR2B	6	12	2	3	198	396	15	1	1	-0.333333333333333	1	-0.0666666666666667	5	18
HTR2C	0	7	0	0	143.88	287.76	15	1	1	NA	1	NA	0	7
HTR3A	6	9	2	2	111.21	222.42	15	1	1	-0.5	1	-0.1	4	15
HTR4	12	15	0	0	176.55	353.1	15	1	1	NA	1	NA	0	27
HTR5A	0	5	0	1	87.45	174.9	15	1	1	NA	1	0	1	5
HTR6	5	7	2	0	75.9	151.8	15	1	0.461538461538462	-Inf	1	-0.583333333333333	2	12
HTR7	0	3	0	1	110.22	220.44	15	1	1	NA	1	0	1	3
HTR7L	1	7	1	3	94.38	188.76	15	1	1	-1.33333333333333	1	-0.125	4	8
HTRA1	0	7	0	3	91.74	183.48	15	1	1	NA	1	0	3	7
HTRA2	1	1	0	0	66.66	133.32	15	1	1	NA	1	NA	0	2
HTRA3	1	8	0	0	126.06	252.12	15	1	1	NA	1	NA	0	9
HTT	2	15	0	2	425.7	851.4	15	1	1	1	1	0.117647058823529	2	17
HUNK	1	4	1	2	166.98	333.96	15	1	1	-1	1	-0.133333333333333	3	5
HVCN1	5	2	2	0	68.97	137.94	15	1	1	-Inf	1	-0.285714285714286	2	7
HYAL1	3	6	1	4	34.32	68.64	15	1	1	0.5	1	0.133333333333333	5	9
HYAL2	0	4	0	0	39.27	78.54	15	1	1	NA	1	NA	0	4
HYAL6	2	6	1	1	169.62	339.24	15	1	1	-2	1	-0.25	2	8
HYI	4	1	4	0	45.87	91.74	15	1	1	-Inf	1	-0.2	4	5
HYKK	6	4	2	0	84.48	168.96	15	1	0.515151515151515	-Inf	1	-0.4	2	10
HYOU1	7	15	1	1	339.24	678.48	15	1	1	-1.14285714285714	1	-0.181818181818182	2	22
IAH1	2	10	0	0	77.22	154.44	15	1	1	NA	1	NA	0	12
IAPP	2	2	0	0	42.24	84.48	15	1	1	NA	1	NA	0	4
IARS	9	18	0	4	340.89	681.78	15	1	0.295216907675195	1	1	0.333333333333333	4	27
IARS2	4	10	1	1	292.05	584.1	15	1	1	-1.5	1	-0.214285714285714	2	14
IBA57	1	4	1	0	82.5	165	15	1	0.333333333333333	-Inf	1	-0.8	1	5
IBTK	8	15	0	0	371.58	743.16	15	1	1	NA	1	NA	0	23
ICA1	4	8	0	0	165.99	331.98	15	1	1	NA	1	NA	0	12
ICE2	13	17	1	2	301.29	602.58	15	1	1	0.346153846153846	1	0.1	3	30
ICK	2	8	0	1	237.93	475.86	15	1	1	1	1	0.2	1	10
ICOS	4	2	0	1	78.54	157.08	15	1	0.428571428571429	1	1	0.666666666666667	1	6
ICOSLG	3	2	0	0	106.92	213.84	15	1	1	NA	1	NA	0	5
ID2-ID3	1	1	1	1	6.93	13.86	15	1	1	0	1	0	2	2
IDE	2	10	1	1	343.2	686.4	15	1	0.395604395604396	-4	1	-0.333333333333333	2	12
IDH1	0	5	0	1	120.12	240.24	15	1	1	NA	1	0	1	5
IDH2	0	5	0	1	47.52	95.04	15	1	1	NA	1	0	1	5
IDH3A	0	6	0	1	127.71	255.42	15	1	1	NA	1	0	1	6
IDH3B	0	4	0	2	45.21	90.42	15	1	1	NA	1	0	2	4
IDI1	1	5	1	1	61.38	122.76	15	1	0.464285714285714	-4	1	-0.333333333333333	2	6
IDNK	5	5	1	0	49.83	99.66	15	1	1	-Inf	1	-0.5	1	10
IDO2	5	8	4	1	88.77	177.54	15	1	0.294117647058823	-5.4	1	-0.415384615384615	5	13
IDS	3	11	2	1	154.77	309.54	15	1	0.191176470588235	-6.33333333333333	1	-0.452380952380952	3	14
IDUA	3	8	1	2	147.51	295.02	15	1	1	-0.333333333333333	1	-0.0606060606060606	3	11
IFFO1	0	2	0	0	86.79	173.58	15	1	1	NA	1	NA	0	2
IFFO2	2	3	1	0	79.86	159.72	15	1	1	-Inf	1	-0.6	1	5
IFI30	0	1	0	1	10.89	21.78	15	1	1	NA	1	0	1	1
IFI35	25	30	7	6	344.52	689.04	15	1	0.758848960182926	-0.4	1	-0.0839160839160839	13	55
IFI6	2	2	1	1	25.74	51.48	15	1	1	0	1	0	2	4
IFIH1	13	9	1	0	298.98	597.96	15	1	1	-Inf	1	-0.409090909090909	1	22
IFIT5	11	5	1	1	117.81	235.62	15	1	1	0.545454545454545	1	0.1875	2	16
IFITM5	1	6	0	3	40.26	80.52	15	1	1	1	1	0.142857142857143	3	7
IFNAR1	14	8	1	1	172.26	344.52	15	1	1	0.428571428571429	1	0.136363636363636	2	22
IFNAR2	12	8	0	1	106.26	212.52	15	1	0.428571428571429	1	1	0.6	1	20
IFNG	2	10	0	2	58.08	116.16	15	1	1	1	1	0.166666666666667	2	12
IFNGR1	12	15	0	0	125.73	251.46	15	1	1	NA	1	NA	0	27
IFNGR2	4	12	2	5	103.95	207.9	15	1	1	-0.2	1	-0.0357142857142857	7	16
IFNKL1	1	2	0	0	36.96	73.92	15	1	1	NA	1	NA	0	3
IFNL3A-IFNL3L-LOC112532795	2	1	1	1	23.1	46.2	15	1	1	0.5	1	0.166666666666667	2	3
IFRD1	0	4	0	0	146.85	293.7	15	1	1	NA	1	NA	0	4
IFT122	4	17	1	2	305.91	611.82	15	1	0.521245059288538	-1.125	1	-0.142857142857143	3	21
IFT140	14	24	5	0	457.38	914.76	15	1	0.0120798090168482	-Inf	1	-0.631578947368421	5	38
IFT172	10	25	2	4	677.49	1354.98	15	1	1	-0.25	1	-0.0476190476190476	6	35
IFT22	0	4	0	1	33	66	15	1	1	NA	1	0	1	4
IFT43	3	4	0	1	72.27	144.54	15	1	1	1	1	0.428571428571429	1	7
IFT52	1	7	0	1	105.27	210.54	15	1	1	1	1	0.125	1	8
IFT57	4	3	0	0	126.72	253.44	15	1	1	NA	1	NA	0	7
IFT80	2	12	0	1	186.12	372.24	15	1	1	1	1	0.142857142857143	1	14
IFT81	4	6	1	0	207.9	415.8	15	1	0.454545454545455	-Inf	1	-0.6	1	10
IFT88	1	19	0	2	284.13	568.26	15	1	1	1	1	0.05	2	20
IGBP1	2	2	0	1	56.76	113.52	15	1	1	1	1	0.5	1	4
IGDCC3	1	14	1	8	195.69	391.38	15	1	1	-0.75	1	-0.0444444444444444	9	15
IGDCC4	10	20	4	4	448.47	896.94	15	1	0.43317561044516	-1	1	-0.166666666666667	8	30
IGF1R	4	14	0	1	353.1	706.2	15	1	1	1	1	0.222222222222222	1	18
IGF2BP1	1	6	0	0	153.78	307.56	15	1	1	NA	1	NA	0	7
IGF2BP2	0	5	0	3	86.13	172.26	15	1	1	NA	1	0	3	5
IGF2BP3	0	7	0	1	167.97	335.94	15	1	1	NA	1	0	1	7
IGF2R	17	29	7	3	695.31	1390.62	15	1	0.0804041379727295	-2.98039215686275	1	-0.330434782608696	10	46
IGFBP2	2	5	1	0	42.24	84.48	15	1	0.375	-Inf	1	-0.714285714285714	1	7
IGFBP4	0	1	0	1	11.55	23.1	15	1	1	NA	1	0	1	1
IGFBP5	0	1	0	1	23.1	46.2	15	1	1	NA	1	0	1	1
IGFBP7	3	2	0	0	106.92	213.84	15	1	1	NA	1	NA	0	5
IGFN1	29	27	3	4	509.85	1019.7	15	1	0.707846071602086	0.301724137931034	1	0.0892857142857144	7	56
IGHMBP2	4	10	2	3	244.53	489.06	15	1	1	-0.666666666666667	1	-0.114285714285714	5	14
IGHVL	8	3	1	0	80.52	161.04	15	1	1	-Inf	1	-0.272727272727273	1	11
IGLL1	4	2	0	0	16.83	33.66	15	1	1	NA	1	NA	0	6
IGSF10	66	47	16	10	951.39	1902.78	15	1	0.827904174048912	-0.139393939393939	1	-0.0313138189244384	26	113
IGSF11	1	3	1	0	92.73	185.46	15	1	0.4	-Inf	1	-0.75	1	4
IGSF21	0	2	0	1	52.14	104.28	15	1	1	NA	1	0	1	2
IGSF3	5	15	4	5	271.26	542.52	15	1	0.39624992698456	-1.4	1	-0.194444444444444	9	20
IGSF5	2	0	0	0	127.38	254.76	15	1	1	NA	1	NA	0	2
IGSF9	8	8	1	5	95.04	190.08	15	1	0.333038478549314	0.8	1	0.333333333333333	6	16
IGSF9B	0	4	0	2	184.14	368.28	15	1	1	NA	1	0	2	4
IHH	0	1	0	1	12.21	24.42	15	1	1	NA	1	0	1	1
IK	0	8	0	2	163.68	327.36	15	1	1	NA	1	0	2	8
IKBIP	4	5	0	1	147.84	295.68	15	1	1	1	1	0.444444444444444	1	9
IKBKAP	4	11	0	0	263.67	527.34	15	1	1	NA	1	NA	0	15
IKBKB	3	10	0	0	223.41	446.82	15	1	1	NA	1	NA	0	13
IKBKE	2	7	1	0	137.61	275.22	15	1	0.3	-Inf	1	-0.777777777777778	1	9
IKZF3	1	4	1	2	122.43	244.86	15	1	1	-1	1	-0.133333333333333	3	5
IKZF4	0	2	0	0	57.75	115.5	15	1	1	NA	1	NA	0	2
IKZF5	0	3	0	0	124.41	248.82	15	1	1	NA	1	NA	0	3
IL10	1	9	0	2	49.17	98.34	15	1	1	1	1	0.1	2	10
IL10RA	6	5	1	1	146.19	292.38	15	1	1	0.166666666666667	1	0.0454545454545454	2	11
IL10RB	10	13	0	0	114.84	229.68	15	1	1	NA	1	NA	0	23
IL11RA	1	4	0	2	67.98	135.96	15	1	1	1	1	0.2	2	5
IL12A	1	2	0	0	27.06	54.12	15	1	1	NA	1	NA	0	3
IL12B	4	4	0	0	110.88	221.76	15	1	1	NA	1	NA	0	8
IL12RB1	5	2	2	1	45.54	91.08	15	1	1	0.2	1	0.0476190476190477	3	7
IL12RB2	27	15	3	3	257.73	515.46	15	1	0.658317165806463	0.444444444444444	1	0.142857142857143	6	42
IL13	3	0	1	0	36.96	73.92	15	1	1	NA	1	0	1	3
IL13RA1	9	5	0	1	110.55	221.1	15	1	0.4	1	1	0.642857142857143	1	14
IL13RA2	3	3	1	1	95.37	190.74	15	1	1	0	1	0	2	6
IL15	2	2	1	0	58.74	117.48	15	1	1	-Inf	1	-0.5	1	4
IL15RA	0	2	0	0	13.86	27.72	15	1	1	NA	1	NA	0	2
IL16	13	19	4	1	423.39	846.78	15	1	0.158964158964159	-4.84615384615385	1	-0.39375	5	32
IL17A	0	3	0	0	41.58	83.16	15	1	1	NA	1	NA	0	3
IL17B	3	0	1	0	30.69	61.38	15	1	1	NA	1	0	1	3
IL17F	2	4	0	0	49.17	98.34	15	1	1	NA	1	NA	0	6
IL17RC	4	2	1	1	30.69	61.38	15	1	1	0.5	1	0.166666666666667	2	6
IL17RD	3	5	0	0	171.93	343.86	15	1	1	NA	1	NA	0	8
IL17REL	5	7	0	0	146.19	292.38	15	1	1	NA	1	NA	0	12
IL18	1	5	0	2	78.54	157.08	15	1	1	1	1	0.166666666666667	2	6
IL1R1	5	11	2	0	152.79	305.58	15	1	0.137254901960784	-Inf	1	-0.6875	2	16
IL1R2	5	5	1	2	122.43	244.86	15	1	1	0.5	1	0.166666666666667	3	10
IL1RAP	4	12	0	4	205.26	410.52	15	1	0.537667698658411	1	1	0.25	4	16
IL1RAPL1	3	6	1	1	151.8	303.6	15	1	1	-1	1	-0.166666666666667	2	9
IL1RAPL2	1	5	1	1	125.73	251.46	15	1	0.464285714285714	-4	1	-0.333333333333333	2	6
IL1RL2	3	7	1	3	179.19	358.38	15	1	1	0.222222222222222	1	0.05	4	10
IL2	1	3	0	0	42.24	84.48	15	1	1	NA	1	NA	0	4
IL20	1	2	0	2	67.32	134.64	15	1	1	1	1	0.333333333333333	2	3
IL20RA	7	8	1	1	190.74	381.48	15	1	1	-0.142857142857143	1	-0.0333333333333333	2	15
IL21	1	3	1	0	43.23	86.46	15	1	0.4	-Inf	1	-0.75	1	4
IL21R	7	10	1	1	220.44	440.88	15	1	1	-0.428571428571429	1	-0.0882352941176471	2	17
IL22	3	3	0	1	59.4	118.8	15	1	1	1	1	0.5	1	6
IL22RA2	2	3	0	0	52.47	104.94	15	1	1	NA	1	NA	0	5
IL2RA	0	5	0	2	81.51	163.02	15	1	1	NA	1	0	2	5
IL2RB	11	12	0	4	198.33	396.66	15	1	0.122507122507122	1	1	0.478260869565217	4	23
IL2RG	1	1	1	1	45.54	91.08	15	1	1	0	1	0	2	2
IL3-KK34	12	4	4	0	79.2	158.4	15	1	0.537667698658411	-Inf	1	-0.25	4	16
IL31RA	14	12	2	1	248.49	496.98	15	1	1	-0.714285714285714	1	-0.128205128205128	3	26
IL4	4	0	1	0	32.34	64.68	15	1	1	NA	1	0	1	4
IL4I1	7	13	1	7	152.79	305.58	15	1	0.371480693219824	0.73469387755102	1	0.225	8	20
IL4R	18	17	2	0	359.04	718.08	15	1	0.48948948948949	-Inf	1	-0.485714285714286	2	35
IL5	6	2	1	0	50.49	100.98	15	1	1	-Inf	1	-0.25	1	8
IL5RA	4	5	0	1	114.84	229.68	15	1	1	1	1	0.444444444444444	1	9
IL6	3	2	0	1	51.48	102.96	15	1	1	1	1	0.6	1	5
IL6ST	8	16	0	2	253.77	507.54	15	1	1	1	1	0.333333333333333	2	24
IL7	2	2	0	0	49.5	99	15	1	1	NA	1	NA	0	4
IL7R	2	6	0	0	116.16	232.32	15	1	1	NA	1	NA	0	8
IL8L1	2	3	1	0	50.16	100.32	15	1	1	-Inf	1	-0.6	1	5
IL8L2	4	0	1	0	34.98	69.96	15	1	1	NA	1	0	1	4
IL9R	9	4	0	0	174.9	349.8	15	1	1	NA	1	NA	0	13
ILDR1	5	8	2	1	119.13	238.26	15	1	0.55	-2.2	1	-0.282051282051282	3	13
ILDR2	1	7	1	2	130.68	261.36	15	1	0.490909090909091	-2.5	1	-0.208333333333333	3	8
ILK	1	9	1	0	118.8	237.6	15	1	0.181818181818182	-Inf	1	-0.9	1	10
ILKAP	0	10	0	3	99.33	198.66	15	1	1	NA	1	0	3	10
IMMP1L	0	3	0	0	51.15	102.3	15	1	1	NA	1	NA	0	3
IMMT	3	16	1	3	174.24	348.48	15	1	1	-0.777777777777778	1	-0.0921052631578947	4	19
IMP3	1	1	0	0	11.55	23.1	15	1	1	NA	1	NA	0	2
IMPA2	0	3	0	0	89.1	178.2	15	1	1	NA	1	NA	0	3
IMPACT	3	4	0	0	99.33	198.66	15	1	1	NA	1	NA	0	7
IMPAD1	3	0	0	0	77.88	155.76	15	1	1	NA	1	NA	0	3
IMPG1	16	10	2	0	300.3	600.6	15	1	0.523809523809524	-Inf	1	-0.384615384615385	2	26
IMPG2	21	26	1	1	463.65	927.3	15	1	1	-0.238095238095238	1	-0.0531914893617021	2	47
INA	1	2	0	1	37.62	75.24	15	1	1	1	1	0.333333333333333	1	3
INF2	5	14	1	1	385.11	770.22	15	1	0.5	-1.8	1	-0.236842105263158	2	19
ING1	0	2	0	1	60.39	120.78	15	1	1	NA	1	0	1	2
ING3	1	3	0	0	107.25	214.5	15	1	1	NA	1	NA	0	4
ING4	0	3	0	0	58.41	116.82	15	1	1	NA	1	NA	0	3
ING5	0	2	0	0	36.3	72.6	15	1	1	NA	1	NA	0	2
INHA	0	2	0	0	33	66	15	1	1	NA	1	NA	0	2
INHBE	2	1	1	0	82.83	165.66	15	1	1	-Inf	1	-0.333333333333333	1	3
INO80	2	17	0	2	476.52	953.04	15	1	1	1	1	0.105263157894737	2	19
INO80C	0	3	0	2	51.48	102.96	15	1	1	NA	1	0	2	3
INO80D	1	4	0	0	246.18	492.36	15	1	1	NA	1	NA	0	5
INPP4B	6	14	2	2	361.35	722.7	15	1	0.578392621870883	-1.33333333333333	1	-0.2	4	20
INPP5D	2	13	1	2	377.52	755.04	15	1	0.442401960784314	-2.25	1	-0.2	3	15
INPP5E	1	9	1	0	161.7	323.4	15	1	0.181818181818182	-Inf	1	-0.9	1	10
INPP5F	7	10	1	1	376.2	752.4	15	1	1	-0.428571428571429	1	-0.0882352941176471	2	17
INPP5K	8	6	1	0	165.66	331.32	15	1	1	-Inf	1	-0.428571428571429	1	14
INPPL1	4	7	3	6	106.92	213.84	15	1	1	0.125	1	0.0303030303030303	9	11
INS-IGF2	0	3	0	2	34.32	68.64	15	1	1	NA	1	0	2	3
INSC	3	4	2	2	73.59	147.18	15	1	1	-0.333333333333333	1	-0.0714285714285715	4	7
INSIG1	1	1	0	0	56.1	112.2	15	1	1	NA	1	NA	0	2
INSIG2	0	1	0	1	70.29	140.58	15	1	1	NA	1	0	1	1
INSR	1	13	0	3	439.23	878.46	15	1	1	1	1	0.0714285714285714	3	14
INSRR	1	4	0	4	46.86	93.72	15	1	1	1	1	0.2	4	5
INTS1	4	27	1	1	683.43	1366.86	15	1	0.284090909090909	-5.75	1	-0.370967741935484	2	31
INTS10	1	8	1	0	196.68	393.36	15	1	0.2	-Inf	1	-0.888888888888889	1	9
INTS11	0	5	0	1	173.25	346.5	15	1	1	NA	1	0	1	5
INTS12	2	5	0	0	101.31	202.62	15	1	1	NA	1	NA	0	7
INTS2	21	45	0	10	806.85	1613.7	15	1	0.0535605381577256	1	1	0.318181818181818	10	66
INTS3	0	14	0	7	210.21	420.42	15	1	1	NA	1	0	7	14
INTS4	5	28	0	2	310.86	621.72	15	1	1	1	1	0.151515151515152	2	33
INTS6	1	9	0	2	256.41	512.82	15	1	1	1	1	0.1	2	10
INTS6L	2	10	2	2	252.45	504.9	15	1	0.244505494505494	-4	1	-0.333333333333333	4	12
INTS7	2	17	0	3	304.59	609.18	15	1	1	1	1	0.105263157894737	3	19
INTS8	1	16	0	1	284.13	568.26	15	1	1	1	1	0.0588235294117647	1	17
INTS9	2	10	1	0	172.26	344.52	15	1	0.230769230769231	-Inf	1	-0.833333333333333	1	12
INTU	9	16	2	2	340.23	680.46	15	1	0.622079070354932	-0.777777777777778	1	-0.14	4	25
INVS	15	16	4	0	352.11	704.22	15	1	0.108785332314744	-Inf	1	-0.516129032258065	4	31
IP6K2	0	7	0	0	131.01	262.02	15	1	1	NA	1	NA	0	7
IP6K3	0	3	0	0	103.62	207.24	15	1	1	NA	1	NA	0	3
IPCEF1	2	2	0	1	133.98	267.96	15	1	1	1	1	0.5	1	4
IPO11	2	8	1	4	222.42	444.84	15	1	1	0	1	0	5	10
IPO13	2	21	1	5	279.18	558.36	15	1	0.515325670498084	-1.1	1	-0.0797101449275362	6	23
IPO5	0	6	0	0	200.31	400.62	15	1	1	NA	1	NA	0	6
IPO7	0	13	0	3	298.98	597.96	15	1	1	NA	1	0	3	13
IPO8	2	9	0	3	288.75	577.5	15	1	1	1	1	0.181818181818182	3	11
IPO9	1	11	0	1	249.81	499.62	15	1	1	1	1	0.0833333333333333	1	12
IPP	3	9	1	0	152.79	305.58	15	1	0.307692307692308	-Inf	1	-0.75	1	12
IPPK	1	8	1	1	185.79	371.58	15	1	0.345454545454545	-7	1	-0.388888888888889	2	9
IQCA1	11	18	1	2	334.95	669.9	15	1	1	0.181818181818182	1	0.0459770114942529	3	29
IQCB1	4	10	0	1	161.37	322.74	15	1	1	1	1	0.285714285714286	1	14
IQCC	2	5	0	0	28.38	56.76	15	1	1	NA	1	NA	0	7
IQCD	10	6	1	1	123.09	246.18	15	1	1	0.4	1	0.125	2	16
IQCE	12	4	3	1	213.18	426.36	15	1	1	0	1	0	4	16
IQCG	4	4	0	1	117.81	235.62	15	1	1	1	1	0.5	1	8
IQCH	15	6	5	0	312.51	625.02	15	1	0.298114928549711	-Inf	1	-0.285714285714286	5	21
IQCK	6	2	0	0	84.48	168.96	15	1	1	NA	1	NA	0	8
IQGAP2	0	4	0	0	129.03	258.06	15	1	1	NA	1	NA	0	4
IQGAP3-LOC415616	11	31	3	8	743.49	1486.98	15	1	1	-0.0568181818181819	1	-0.0108225108225108	11	42
IQSEC1	1	10	1	0	411.18	822.36	15	1	0.166666666666667	-Inf	1	-0.909090909090909	1	11
IQSEC3	0	9	0	1	331.98	663.96	15	1	1	NA	1	0	1	9
IQUB	12	16	1	3	221.76	443.52	15	1	0.62908787541713	0.555555555555556	1	0.178571428571429	4	28
IRAK2	10	11	2	2	221.1	442.2	15	1	1	-0.1	1	-0.0238095238095238	4	21
IRAK4	1	4	1	0	107.25	214.5	15	1	0.333333333333333	-Inf	1	-0.8	1	5
IREB2	2	6	1	0	243.54	487.08	15	1	0.333333333333333	-Inf	1	-0.75	1	8
IRF1	0	6	0	2	83.49	166.98	15	1	1	NA	1	0	2	6
IRF2BP2	1	1	0	1	17.82	35.64	15	1	1	1	1	0.5	1	2
IRF6	3	3	1	0	129.69	259.38	15	1	1	-Inf	1	-0.5	1	6
IRF8	5	10	0	5	122.1	244.2	15	1	0.266318369453045	1	1	0.333333333333333	5	15
IRS2	3	7	2	0	96.03	192.06	15	1	0.151515151515152	-Inf	1	-0.7	2	10
IRX1	4	3	1	0	74.58	149.16	15	1	1	-Inf	1	-0.428571428571429	1	7
IRX2	0	2	0	0	50.82	101.64	15	1	1	NA	1	NA	0	2
IRX4	1	1	0	0	65.67	131.34	15	1	1	NA	1	NA	0	2
IRX6	6	7	1	2	35.64	71.28	15	1	1	0.416666666666667	1	0.128205128205128	3	13
ISCU	0	4	0	1	24.09	48.18	15	1	1	NA	1	0	1	4
ISLR	1	3	0	1	52.47	104.94	15	1	1	1	1	0.25	1	4
ISM1	0	4	0	0	146.52	293.04	15	1	1	NA	1	NA	0	4
ISM2	4	7	1	3	103.62	207.24	15	1	1	0.416666666666667	1	0.113636363636364	4	11
ISPD	2	5	0	1	132.33	264.66	15	1	1	1	1	0.285714285714286	1	7
IST1	1	6	1	0	119.46	238.92	15	1	0.25	-Inf	1	-0.857142857142857	1	7
ISX	4	1	0	0	105.93	211.86	15	1	1	NA	1	NA	0	5
ISY1	1	3	0	0	86.79	173.58	15	1	1	NA	1	NA	0	4
ITCH	4	11	0	0	271.59	543.18	15	1	1	NA	1	NA	0	15
ITFG1	1	12	1	1	213.18	426.36	15	1	0.257142857142857	-11	1	-0.423076923076923	2	13
ITFG2	2	7	0	3	139.92	279.84	15	1	1	1	1	0.222222222222222	3	9
ITGA1	4	10	1	1	276.87	553.74	15	1	1	-1.5	1	-0.214285714285714	2	14
ITGA11	4	10	3	5	236.28	472.56	15	1	1	-0.5	1	-0.0892857142857143	8	14
ITGA2	7	7	1	0	264	528	15	1	1	-Inf	1	-0.5	1	14
ITGA2B	2	2	1	0	65.01	130.02	15	1	1	-Inf	1	-0.5	1	4
ITGA4	5	10	2	3	292.05	584.1	15	1	1	-0.333333333333333	1	-0.0666666666666667	5	15
ITGA6	9	14	1	3	365.64	731.28	15	1	1	0.481481481481482	1	0.141304347826087	4	23
ITGA7	0	2	0	1	16.5	33	15	1	1	NA	1	0	1	2
ITGA8	2	7	1	0	319.11	638.22	15	1	0.3	-Inf	1	-0.777777777777778	1	9
ITGA9	3	0	0	0	63.03	126.06	15	1	1	NA	1	NA	0	3
ITGAV	0	19	0	4	322.41	644.82	15	1	1	NA	1	0	4	19
ITGB1	0	13	0	2	298.32	596.64	15	1	1	NA	1	0	2	13
ITGB1BP2	7	5	3	3	80.19	160.38	15	1	1	0.285714285714286	1	0.0833333333333334	6	12
ITGB2	12	12	0	3	289.41	578.82	15	1	0.230769230769231	1	1	0.5	3	24
ITGB3	34	26	2	9	432.96	865.92	15	1	0.0238254248303737	0.830065359477124	1	0.384848484848485	11	60
ITGB3BP	5	1	1	0	30.03	60.06	15	1	1	-Inf	1	-0.166666666666667	1	6
ITGB4	14	31	2	13	413.49	826.98	15	1	0.31181998516418	0.659340659340659	1	0.177777777777778	15	45
ITGB5	2	24	1	6	213.51	427.02	15	1	0.523460410557185	-1	1	-0.0659340659340659	7	26
ITGB6	4	12	0	0	279.51	559.02	15	1	1	NA	1	NA	0	16
ITGB8	5	6	0	1	233.97	467.94	15	1	1	1	1	0.454545454545455	1	11
ITGBL1	2	1	0	0	55.44	110.88	15	1	1	NA	1	NA	0	3
ITIH2	3	18	1	5	277.2	554.4	15	1	1	-0.2	1	-0.0238095238095238	6	21
ITIH3	7	16	2	2	301.95	603.9	15	1	0.581538461538461	-1.28571428571429	1	-0.195652173913043	4	23
ITIH5	6	14	0	2	311.19	622.38	15	1	1	1	1	0.3	2	20
ITK	1	4	1	1	175.89	351.78	15	1	1	-3	1	-0.3	2	5
ITM2A	0	10	0	3	63.36	126.72	15	1	1	NA	1	0	3	10
ITM2B	0	6	0	1	77.55	155.1	15	1	1	NA	1	0	1	6
ITM2C	0	7	0	2	76.89	153.78	15	1	1	NA	1	0	2	7
ITPA	0	2	0	1	20.79	41.58	15	1	1	NA	1	0	1	2
ITPK1	0	6	0	1	136.62	273.24	15	1	1	NA	1	0	1	6
ITPKA	0	3	0	1	117.15	234.3	15	1	1	NA	1	0	1	3
ITPKB	0	2	0	1	104.28	208.56	15	1	1	NA	1	0	1	2
ITPR1	2	31	1	10	787.38	1574.76	15	1	1	-0.55	1	-0.0303030303030303	11	33
ITPR3	2	25	1	9	539.55	1079.1	15	1	1	-0.388888888888889	1	-0.0259259259259259	10	27
ITPRIP	6	15	3	2	189.09	378.18	15	1	0.302219519610824	-2.75	1	-0.314285714285714	5	21
ITSN1	1	11	1	2	515.79	1031.58	15	1	0.371428571428571	-4.5	1	-0.25	3	12
ITSN2	4	19	1	1	470.25	940.5	15	1	0.366666666666667	-3.75	1	-0.326086956521739	2	23
IVD	4	4	0	1	100.65	201.3	15	1	1	1	1	0.5	1	8
IVNS1ABP	3	10	0	1	205.59	411.18	15	1	1	1	1	0.230769230769231	1	13
IWS1	1	7	0	1	186.45	372.9	15	1	1	1	1	0.125	1	8
IYD	6	4	1	0	89.1	178.2	15	1	1	-Inf	1	-0.4	1	10
JADE1	4	19	1	2	259.05	518.1	15	1	0.488461538461538	-1.375	1	-0.159420289855072	3	23
JADE2	4	8	2	3	176.88	353.76	15	1	1	-0.333333333333333	1	-0.0666666666666667	5	12
JADE3	0	12	0	5	219.12	438.24	15	1	1	NA	1	0	5	12
JAG1	0	13	0	3	391.38	782.76	15	1	1	NA	1	0	3	13
JAG2	1	11	0	1	388.74	777.48	15	1	1	1	1	0.0833333333333333	1	12
JAK1	2	11	0	3	301.95	603.9	15	1	1	1	1	0.153846153846154	3	13
JAK2	3	8	2	0	283.8	567.6	15	1	0.128205128205128	-Inf	1	-0.727272727272727	2	11
JAKMIP1	1	8	0	1	133.98	267.96	15	1	1	1	1	0.111111111111111	1	9
JAKMIP2	3	20	1	1	488.07	976.14	15	1	0.3	-5.66666666666667	1	-0.369565217391304	2	23
JAKMIP3	6	8	4	4	294.03	588.06	15	1	1	-0.333333333333333	1	-0.0714285714285715	8	14
JAM2	0	3	0	1	83.16	166.32	15	1	1	NA	1	0	1	3
JAM3	1	3	0	0	83.49	166.98	15	1	1	NA	1	NA	0	4
JAML	2	6	1	3	55.11	110.22	15	1	1	0	1	0	4	8
JARID2	2	8	1	5	295.68	591.36	15	1	1	0.2	1	0.0333333333333334	6	10
JAZF1	0	2	0	2	60.39	120.78	15	1	1	NA	1	0	2	2
JCHAIN	4	4	0	1	59.07	118.14	15	1	1	1	1	0.5	1	8
JDP2	0	1	0	1	51.48	102.96	15	1	1	NA	1	0	1	1
JKAMP	0	11	0	5	115.5	231	15	1	1	NA	1	0	5	11
JMJD1C	8	28	2	4	640.86	1281.72	15	1	0.616118537813018	-0.75	1	-0.111111111111111	6	36
JMJD4	0	6	0	0	159.06	318.12	15	1	1	NA	1	NA	0	6
JMJD6	1	10	1	2	114.51	229.02	15	1	0.395604395604396	-4	1	-0.242424242424242	3	11
JMY	12	11	3	3	222.09	444.18	15	1	1	0.0833333333333334	1	0.0217391304347826	6	23
JPH1	2	5	2	0	145.53	291.06	15	1	0.166666666666667	-Inf	1	-0.714285714285714	2	7
JPH2-LOC107054877	3	11	0	5	109.56	219.12	15	1	0.530443756449948	1	1	0.214285714285714	5	14
JPT1	1	2	0	1	39.27	78.54	15	1	1	1	1	0.333333333333333	1	3
JPT2	1	4	0	0	36.96	73.92	15	1	1	NA	1	NA	0	5
JUN	0	1	0	1	38.28	76.56	15	1	1	NA	1	0	1	1
JUND	0	1	0	1	9.9	19.8	15	1	1	NA	1	0	1	1
JUP	1	4	1	2	100.65	201.3	15	1	1	-1	1	-0.133333333333333	3	5
K123	3	8	1	0	84.48	168.96	15	1	0.333333333333333	-Inf	1	-0.727272727272727	1	11
KALRN	8	35	3	1	770.88	1541.76	15	1	0.0351526364477336	-12.125	1	-0.563953488372093	4	43
KANK1	6	21	2	0	286.44	572.88	15	1	0.0689655172413793	-Inf	1	-0.777777777777778	2	27
KANK3	1	3	0	2	113.52	227.04	15	1	1	1	1	0.25	2	4
KANK4	11	18	1	6	240.24	480.48	15	1	0.383902593295383	0.727272727272727	1	0.236453201970443	7	29
KANSL1	11	7	6	3	226.71	453.42	15	1	1	-0.272727272727273	1	-0.0555555555555555	9	18
KANSL1L	16	31	0	4	477.84	955.68	15	1	0.295238095238095	1	1	0.340425531914894	4	47
KANSL2	0	5	0	3	53.13	106.26	15	1	1	NA	1	0	3	5
KANSL3	3	8	2	3	190.41	380.82	15	1	1	-0.777777777777778	1	-0.127272727272727	5	11
KARS	3	11	1	2	218.46	436.92	15	1	1	-0.833333333333333	1	-0.119047619047619	3	14
KAT14	0	10	0	3	240.9	481.8	15	1	1	NA	1	0	3	10
KAT2B	4	10	1	1	256.08	512.16	15	1	1	-1.5	1	-0.214285714285714	2	14
KAT6A	8	32	1	2	658.02	1316.04	15	1	0.515112227534235	-1	1	-0.133333333333333	3	40
KAT6B	6	18	3	5	543.51	1087.02	15	1	0.654498160349106	-0.8	1	-0.125	8	24
KAT7	0	7	0	0	223.74	447.48	15	1	1	NA	1	NA	0	7
KATNAL2	1	6	0	0	126.06	252.12	15	1	1	NA	1	NA	0	7
KATNB1	0	10	0	1	197.67	395.34	15	1	1	NA	1	0	1	10
KATNBL1	5	3	4	0	112.53	225.06	15	1	0.490909090909091	-Inf	1	-0.375	4	8
KAZALD1	0	1	0	1	27.72	55.44	15	1	1	NA	1	0	1	1
KBP	2	9	0	1	143.88	287.76	15	1	1	1	1	0.181818181818182	1	11
KBTBD11	2	9	1	2	80.85	161.7	15	1	1	-1.25	1	-0.151515151515151	3	11
KBTBD12	6	12	2	6	231.99	463.98	15	1	1	0.333333333333333	1	0.0833333333333333	8	18
KBTBD13	2	5	1	3	100.65	201.3	15	1	1	0.166666666666667	1	0.0357142857142857	4	7
KBTBD2	1	8	0	2	204.6	409.2	15	1	1	1	1	0.111111111111111	2	9
KBTBD3	0	9	0	1	268.62	537.24	15	1	1	NA	1	0	1	9
KBTBD4	0	9	0	0	200.31	400.62	15	1	1	NA	1	NA	0	9
KBTBD8	0	3	0	0	158.4	316.8	15	1	1	NA	1	NA	0	3
KCNA1	0	5	0	0	126.72	253.44	15	1	1	NA	1	NA	0	5
KCNA10	3	16	2	5	165	330	15	1	0.587534204925509	-1.13333333333333	1	-0.12781954887218	7	19
KCNA2	0	9	0	1	190.08	380.16	15	1	1	NA	1	0	1	9
KCNA3	4	8	2	0	185.79	371.58	15	1	0.164835164835165	-Inf	1	-0.666666666666667	2	12
KCNA4	0	6	0	3	182.49	364.98	15	1	1	NA	1	0	3	6
KCNA5	3	10	0	0	133.65	267.3	15	1	1	NA	1	NA	0	13
KCNA6	3	8	1	1	159.72	319.44	15	1	1	-1.66666666666667	1	-0.227272727272727	2	11
KCNAB1	1	3	1	2	67.98	135.96	15	1	1	-0.5	1	-0.0833333333333333	3	4
KCNAB2	2	7	1	1	101.64	203.28	15	1	0.490909090909091	-2.5	1	-0.277777777777778	2	9
KCNB1	1	8	0	2	222.75	445.5	15	1	1	1	1	0.111111111111111	2	9
KCNB2	4	7	0	0	238.26	476.52	15	1	1	NA	1	NA	0	11
KCNC1	0	3	0	0	175.56	351.12	15	1	1	NA	1	NA	0	3
KCNC2	2	8	1	1	146.19	292.38	15	1	0.454545454545455	-3	1	-0.3	2	10
KCNC4	0	9	0	1	148.5	297	15	1	1	NA	1	0	1	9
KCND2	3	7	0	0	126.39	252.78	15	1	1	NA	1	NA	0	10
KCND3	3	5	0	2	191.73	383.46	15	1	1	1	1	0.375	2	8
KCNE1	1	5	1	2	56.76	113.52	15	1	1	-1.5	1	-0.166666666666667	3	6
KCNE2	1	4	0	0	56.76	113.52	15	1	1	NA	1	NA	0	5
KCNE4	2	5	0	1	61.38	122.76	15	1	1	1	1	0.285714285714286	1	7
KCNG1	0	2	0	0	156.09	312.18	15	1	1	NA	1	NA	0	2
KCNG2	3	7	1	3	167.97	335.94	15	1	1	0.222222222222222	1	0.05	4	10
KCNG3	0	2	0	1	118.14	236.28	15	1	1	NA	1	0	1	2
KCNG4	0	9	0	2	144.87	289.74	15	1	1	NA	1	0	2	9
KCNH2	0	1	0	1	41.91	83.82	15	1	1	NA	1	0	1	1
KCNH5	3	11	0	2	177.21	354.42	15	1	1	1	1	0.214285714285714	2	14
KCNH6	2	6	1	1	224.73	449.46	15	1	1	-2	1	-0.25	2	8
KCNH7	4	9	2	0	356.4	712.8	15	1	0.142857142857143	-Inf	1	-0.692307692307692	2	13
KCNH8	4	7	0	0	277.86	555.72	15	1	1	NA	1	NA	0	11
KCNJ1	0	4	0	0	123.09	246.18	15	1	1	NA	1	NA	0	4
KCNJ11	0	8	0	2	97.35	194.7	15	1	1	NA	1	0	2	8
KCNJ12	0	6	0	1	150.48	300.96	15	1	1	NA	1	0	1	6
KCNJ13	6	6	1	0	140.91	281.82	15	1	1	-Inf	1	-0.5	1	12
KCNJ14L	8	9	0	1	130.68	261.36	15	1	1	1	1	0.470588235294118	1	17
KCNJ15	0	4	0	0	154.44	308.88	15	1	1	NA	1	NA	0	4
KCNJ16	3	9	0	1	181.5	363	15	1	1	1	1	0.25	1	12
KCNJ2	0	8	0	3	125.73	251.46	15	1	1	NA	1	0	3	8
KCNJ3	0	6	0	3	92.4	184.8	15	1	1	NA	1	0	3	6
KCNJ4	0	7	0	1	150.81	301.62	15	1	1	NA	1	0	1	7
KCNJ5	3	3	0	0	124.74	249.48	15	1	1	NA	1	NA	0	6
KCNJ8	1	4	1	0	101.31	202.62	15	1	0.333333333333333	-Inf	1	-0.8	1	5
KCNJ9	2	6	1	4	115.5	231	15	1	1	0.25	1	0.05	5	8
KCNK10	3	11	1	1	193.38	386.76	15	1	0.45	-2.66666666666667	1	-0.285714285714286	2	14
KCNK12	1	7	0	2	114.84	229.68	15	1	1	1	1	0.125	2	8
KCNK13	2	3	0	1	146.85	293.7	15	1	1	1	1	0.4	1	5
KCNK15	1	0	1	0	42.9	85.8	15	1	1	NA	1	0	1	1
KCNK16	2	5	0	0	105.6	211.2	15	1	1	NA	1	NA	0	7
KCNK17	2	2	0	0	100.65	201.3	15	1	1	NA	1	NA	0	4
KCNK2	0	2	0	0	151.47	302.94	15	1	1	NA	1	NA	0	2
KCNK4	1	5	1	1	103.29	206.58	15	1	0.464285714285714	-4	1	-0.333333333333333	2	6
KCNK5	0	5	0	0	158.4	316.8	15	1	1	NA	1	NA	0	5
KCNK9	0	3	0	0	110.88	221.76	15	1	1	NA	1	NA	0	3
KCNMA1	1	4	0	0	164.01	328.02	15	1	1	NA	1	NA	0	5
KCNMB1	2	8	2	3	59.73	119.46	15	1	0.56043956043956	-1.66666666666667	1	-0.2	5	10
KCNMB4	0	1	0	1	41.91	83.82	15	1	1	NA	1	0	1	1
KCNN1	3	1	0	0	83.82	167.64	15	1	1	NA	1	NA	0	4
KCNN3	0	2	0	2	58.41	116.82	15	1	1	NA	1	0	2	2
KCNQ1	3	4	0	0	147.51	295.02	15	1	1	NA	1	NA	0	7
KCNQ2	0	8	0	4	240.9	481.8	15	1	1	NA	1	0	4	8
KCNQ3	3	8	0	0	245.52	491.04	15	1	1	NA	1	NA	0	11
KCNQ4	0	1	0	1	18.15	36.3	15	1	1	NA	1	0	1	1
KCNQ5	3	7	1	4	264.33	528.66	15	1	1	0.416666666666667	1	0.1	5	10
KCNRG	6	7	2	2	66	132	15	1	1	-0.166666666666667	1	-0.0384615384615384	4	13
KCNS1	1	1	1	1	61.05	122.1	15	1	1	0	1	0	2	2
KCNS2	0	2	0	0	152.79	305.58	15	1	1	NA	1	NA	0	2
KCNS3	2	8	0	0	220.44	440.88	15	1	1	NA	1	NA	0	10
KCNT1	1	22	1	9	298.32	596.64	15	1	0.520833333333333	-1.44444444444444	1	-0.0565217391304348	10	23
KCNT2	1	10	0	0	324.72	649.44	15	1	1	NA	1	NA	0	11
KCNU1	11	9	0	1	268.29	536.58	15	1	0.476190476190476	1	1	0.55	1	20
KCNV1	0	9	0	0	154.11	308.22	15	1	1	NA	1	NA	0	9
KCNV2	1	14	1	3	127.05	254.1	15	1	0.385964912280702	-3.66666666666667	1	-0.183333333333333	4	15
KCTD1	0	1	0	1	109.56	219.12	15	1	1	NA	1	0	1	1
KCTD14	3	4	1	1	90.75	181.5	15	1	1	-0.333333333333333	1	-0.0714285714285715	2	7
KCTD16	2	5	1	3	123.09	246.18	15	1	1	0.166666666666667	1	0.0357142857142857	4	7
KCTD17	0	3	0	0	64.68	129.36	15	1	1	NA	1	NA	0	3
KCTD18	9	5	1	2	95.7	191.4	15	1	0.536764705882353	0.722222222222222	1	0.30952380952381	3	14
KCTD19	17	14	1	4	265.32	530.64	15	1	0.337662337662338	0.794117647058824	1	0.348387096774193	5	31
KCTD20	3	8	1	0	157.74	315.48	15	1	0.333333333333333	-Inf	1	-0.727272727272727	1	11
KCTD21	0	3	0	0	91.74	183.48	15	1	1	NA	1	NA	0	3
KCTD3	5	14	1	0	213.18	426.36	15	1	0.3	-Inf	1	-0.736842105263158	1	19
KCTD4	1	7	1	3	128.37	256.74	15	1	1	-1.33333333333333	1	-0.125	4	8
KCTD8	0	2	0	0	21.78	43.56	15	1	1	NA	1	NA	0	2
KCTD9	0	6	0	1	104.94	209.88	15	1	1	NA	1	0	1	6
KDELC1	3	5	2	1	128.04	256.08	15	1	0.545454545454546	-2.33333333333333	1	-0.291666666666667	3	8
KDELC2	1	4	1	3	180.84	361.68	15	1	1	-0.333333333333333	1	-0.05	4	5
KDELR2	0	3	0	0	62.7	125.4	15	1	1	NA	1	NA	0	3
KDELR3	1	1	0	1	71.28	142.56	15	1	1	1	1	0.5	1	2
KDF1	4	8	1	1	144.21	288.42	15	1	1	-1	1	-0.166666666666667	2	12
KDM1A	3	10	0	1	281.82	563.64	15	1	1	1	1	0.230769230769231	1	13
KDM1B	0	6	0	0	235.95	471.9	15	1	1	NA	1	NA	0	6
KDM2A	0	10	0	2	284.79	569.58	15	1	1	NA	1	0	2	10
KDM2B	2	4	1	3	183.48	366.96	15	1	1	0.333333333333333	1	0.0833333333333333	4	6
KDM3A	5	21	0	3	469.92	939.84	15	1	1	1	1	0.192307692307692	3	26
KDM3B	7	16	1	0	676.17	1352.34	15	1	0.333333333333333	-Inf	1	-0.695652173913043	1	23
KDM4A	4	11	0	2	289.08	578.16	15	1	1	1	1	0.266666666666667	2	15
KDM4B	8	1	0	0	411.51	823.02	15	1	1	NA	1	NA	0	9
KDM4C	7	2	1	1	99.99	199.98	15	1	0.490909090909091	0.714285714285714	1	0.277777777777778	2	9
KDM5A	1	17	0	2	490.38	980.76	15	1	1	1	1	0.0555555555555556	2	18
KDM5B	2	15	1	2	509.19	1018.38	15	1	0.403508771929824	-2.75	1	-0.215686274509804	3	17
KDM6A	3	7	0	2	430.32	860.64	15	1	1	1	1	0.3	2	10
KDM7A	1	9	0	1	230.67	461.34	15	1	1	1	1	0.1	1	10
KDM8	0	10	0	2	99	198	15	1	1	NA	1	0	2	10
KDR	7	21	1	3	399.96	799.92	15	1	1	0	1	0	4	28
KEL	14	10	1	2	226.38	452.76	15	1	0.569230769230769	0.642857142857143	1	0.25	3	24
KERA	3	0	1	0	156.75	313.5	15	1	1	NA	1	0	1	3
KHDC4	3	2	0	0	111.21	222.42	15	1	1	NA	1	NA	0	5
KHDRBS1	0	3	0	1	112.86	225.72	15	1	1	NA	1	0	1	3
KHDRBS3	3	6	1	1	118.8	237.6	15	1	1	-1	1	-0.166666666666667	2	9
KIAA0040	0	2	0	0	32.67	65.34	15	1	1	NA	1	NA	0	2
KIAA0100	7	22	2	12	332.31	664.62	15	1	0.693384401507517	0.476190476190476	1	0.0985221674876847	14	29
KIAA0232	4	9	0	2	456.39	912.78	15	1	1	1	1	0.307692307692308	2	13
KIAA0319	16	14	2	1	414.48	828.96	15	1	1	-0.75	1	-0.133333333333333	3	30
KIAA0319L	7	15	1	3	336.27	672.54	15	1	1	0.285714285714286	1	0.0681818181818182	4	22
KIAA0355	1	6	0	0	365.31	730.62	15	1	1	NA	1	NA	0	7
KIAA0408	14	14	2	1	382.47	764.94	15	1	1	-1	1	-0.166666666666667	3	28
KIAA0430	5	24	0	0	620.4	1240.8	15	1	1	NA	1	NA	0	29
KIAA0513	0	2	0	1	32.67	65.34	15	1	1	NA	1	0	1	2
KIAA0753	16	8	1	1	259.71	519.42	15	1	1	0.5	1	0.166666666666667	2	24
KIAA0825	2	3	0	1	148.17	296.34	15	1	1	1	1	0.4	1	5
KIAA0895	6	8	0	1	160.05	320.1	15	1	1	1	1	0.428571428571429	1	14
KIAA0895L	0	2	0	1	58.08	116.16	15	1	1	NA	1	0	1	2
KIAA0922	8	17	2	3	482.79	965.58	15	1	1	-0.416666666666667	1	-0.08	5	25
KIAA1024	5	15	0	2	300.3	600.6	15	1	1	1	1	0.25	2	20
KIAA1024L	4	2	0	0	57.75	115.5	15	1	1	NA	1	NA	0	6
KIAA1107	35	16	4	0	569.25	1138.5	15	1	0.310539355822375	-Inf	1	-0.313725490196078	4	51
KIAA1109	9	55	3	7	1638.45	3276.9	15	1	0.350519098586199	-1.61904761904762	1	-0.159375	10	64
KIAA1143	1	0	1	0	41.58	83.16	15	1	1	NA	1	0	1	1
KIAA1147	0	4	0	0	114.84	229.68	15	1	1	NA	1	NA	0	4
KIAA1191	2	3	0	0	73.92	147.84	15	1	1	NA	1	NA	0	5
KIAA1210	16	12	2	2	349.14	698.28	15	1	1	0.25	1	0.0714285714285714	4	28
KIAA1211L	10	11	3	1	265.65	531.3	15	1	0.59304347826087	-2.3	1	-0.273809523809524	4	21
KIAA1217	9	17	1	5	432.3	864.6	15	1	0.636749165739711	0.622222222222222	1	0.179487179487179	6	26
KIAA1257	34	20	2	1	434.94	869.88	15	1	1	-0.176470588235294	1	-0.037037037037037	3	54
KIAA1324L	1	13	0	1	333.3	666.6	15	1	1	1	1	0.0714285714285714	1	14
KIAA1328	7	8	0	0	133.65	267.3	15	1	1	NA	1	NA	0	15
KIAA1429	3	38	3	8	558.69	1117.38	15	1	0.100641107506833	-3.75	1	-0.199556541019956	11	41
KIAA1456	2	5	0	2	155.43	310.86	15	1	1	1	1	0.285714285714286	2	7
KIAA1462	14	12	7	2	301.95	603.9	15	1	0.262069262936239	-2	1	-0.239316239316239	9	26
KIAA1468	1	7	0	2	247.5	495	15	1	1	1	1	0.125	2	8
KIAA1522	3	8	0	2	84.48	168.96	15	1	1	1	1	0.272727272727273	2	11
KIAA1524	10	15	5	0	232.65	465.3	15	1	0.0421455938697318	-Inf	1	-0.6	5	25
KIAA1549	25	25	8	2	588.39	1176.78	15	1	0.161652118602245	-3	1	-0.3	10	50
KIAA1549L	43	29	7	7	797.94	1595.88	15	1	0.561457272787182	0.325581395348837	1	0.0972222222222222	14	72
KIAA1551	44	25	4	2	618.09	1236.18	15	1	1	-0.136363636363636	1	-0.0289855072463768	6	69
KIAA1614	3	5	2	3	43.56	87.12	15	1	1	-0.111111111111111	1	-0.025	5	8
KIAA1644	4	2	0	0	88.44	176.88	15	1	1	NA	1	NA	0	6
KIAA1671	37	36	11	8	653.4	1306.8	15	1	0.615368882469683	-0.337837837837838	1	-0.0720980533525595	19	73
KIAA1683	13	1	1	0	81.51	163.02	15	1	1	-Inf	1	-0.0714285714285714	1	14
KIAA1755	8	7	4	2	144.54	289.08	15	1	0.659442724458204	-0.75	1	-0.133333333333333	6	15
KIAA1841	2	10	0	2	228.69	457.38	15	1	1	1	1	0.166666666666667	2	12
KIAA1958	2	5	1	0	82.5	165	15	1	0.375	-Inf	1	-0.714285714285714	1	7
KIAA2013	1	10	1	1	125.07	250.14	15	1	0.294871794871795	-9	1	-0.409090909090909	2	11
KIAA2026	15	16	3	1	497.31	994.62	15	1	0.602597402597402	-2.2	1	-0.266129032258065	4	31
KIDINS220	4	16	1	0	524.04	1048.08	15	1	0.238095238095238	-Inf	1	-0.8	1	20
KIF11	8	18	0	4	372.9	745.8	15	1	0.550446998722861	1	1	0.307692307692308	4	26
KIF12	0	3	0	2	17.49	34.98	15	1	1	NA	1	0	2	3
KIF13A	10	22	4	6	591.69	1183.38	15	1	0.707096660959079	-0.466666666666667	1	-0.0875	10	32
KIF13B	15	41	2	7	602.91	1205.82	15	1	1	0.219047619047619	1	0.0456349206349206	9	56
KIF14	18	17	4	5	480.15	960.3	15	1	1	0.244444444444444	1	0.0698412698412698	9	35
KIF15	10	19	2	3	415.14	830.28	15	1	1	-0.266666666666667	1	-0.0551724137931034	5	29
KIF16B	24	27	2	7	588.72	1177.44	15	1	0.275709426185027	0.678571428571429	1	0.248366013071895	9	51
KIF17	10	5	2	1	238.92	477.84	15	1	1	0	1	0	3	15
KIF18A	9	9	2	2	293.7	587.4	15	1	1	0	1	0	4	18
KIF18B	7	11	2	4	154.44	308.88	15	1	1	0.214285714285714	1	0.0555555555555556	6	18
KIF1A	1	11	0	5	263.34	526.68	15	1	1	1	1	0.0833333333333333	5	12
KIF1B	3	27	1	5	695.31	1390.62	15	1	0.53475935828877	-0.8	1	-0.0666666666666667	6	30
KIF1BP	3	9	2	2	138.6	277.2	15	1	0.546703296703297	-2	1	-0.25	4	12
KIF20A	2	10	0	1	256.41	512.82	15	1	1	1	1	0.166666666666667	1	12
KIF20AL	15	14	6	5	279.84	559.68	15	1	1	-0.12	1	-0.0282131661442006	11	29
KIF20B-KIF20BL	41	25	4	4	571.23	1142.46	15	1	0.703790937090439	0.390243902439024	1	0.121212121212121	8	66
KIF21A	3	7	0	1	159.39	318.78	15	1	1	1	1	0.3	1	10
KIF21B	2	6	2	0	334.95	669.9	15	1	0.133333333333333	-Inf	1	-0.75	2	8
KIF23	5	17	1	3	237.93	475.86	15	1	1	-0.133333333333333	1	-0.0227272727272727	4	22
KIF24	8	17	0	1	313.5	627	15	1	1	1	1	0.32	1	25
KIF25	6	11	1	4	190.74	381.48	15	1	1	0.541666666666667	1	0.152941176470588	5	17
KIF26A	12	28	2	2	635.25	1270.5	15	1	0.58129221884185	-1.33333333333333	1	-0.2	4	40
KIF26B	6	22	0	5	471.57	943.14	15	1	0.556325209829103	1	1	0.214285714285714	5	28
KIF27	4	9	1	0	283.14	566.28	15	1	0.357142857142857	-Inf	1	-0.692307692307692	1	13
KIF2A	2	4	0	0	151.47	302.94	15	1	1	NA	1	NA	0	6
KIF2B	9	14	3	3	243.54	487.08	15	1	0.669319186560566	-0.555555555555556	1	-0.108695652173913	6	23
KIF2C	7	12	1	1	262.68	525.36	15	1	1	-0.714285714285714	1	-0.131578947368421	2	19
KIF3C	0	3	0	1	96.69	193.38	15	1	1	NA	1	0	1	3
KIF4A	3	26	1	4	378.18	756.36	15	1	0.487860100051751	-1.16666666666667	1	-0.096551724137931	5	29
KIF5C	0	18	0	5	315.81	631.62	15	1	1	NA	1	0	5	18
KIF6	17	11	0	0	294.69	589.38	15	1	1	NA	1	NA	0	28
KIF7	7	20	1	6	308.22	616.44	15	1	1	0.523809523809524	1	0.116402116402116	7	27
KIF9	7	25	3	7	189.09	378.18	15	1	0.678326983318299	-0.530612244897959	1	-0.08125	10	32
KIFAP3	2	17	1	5	290.07	580.14	15	1	1	-0.7	1	-0.0614035087719298	6	19
KIFC3	4	12	0	2	222.75	445.5	15	1	1	1	1	0.25	2	16
KIN	1	9	0	0	123.42	246.84	15	1	1	NA	1	NA	0	10
KIRREL3	1	7	0	0	187.44	374.88	15	1	1	NA	1	NA	0	8
KIT	0	10	0	0	334.95	669.9	15	1	1	NA	1	NA	0	10
KIZ	16	8	2	1	194.37	388.74	15	1	1	0	1	0	3	24
KL	3	16	0	8	374.88	749.76	15	1	0.532307692307692	1	1	0.157894736842105	8	19
KLB	5	16	0	2	374.88	749.76	15	1	1	1	1	0.238095238095238	2	21
KLC1	2	3	0	0	174.9	349.8	15	1	1	NA	1	NA	0	5
KLF10	0	4	0	0	49.5	99	15	1	1	NA	1	NA	0	4
KLF13	3	6	0	0	100.65	201.3	15	1	1	NA	1	NA	0	9
KLF15	2	2	0	0	119.79	239.58	15	1	1	NA	1	NA	0	4
KLF2	0	4	0	1	62.04	124.08	15	1	1	NA	1	0	1	4
KLF3	1	1	0	1	88.11	176.22	15	1	1	1	1	0.5	1	2
KLF4	1	0	1	0	32.67	65.34	15	1	1	NA	1	0	1	1
KLF5	0	8	0	2	94.38	188.76	15	1	1	NA	1	0	2	8
KLF6	1	1	0	0	90.42	180.84	15	1	1	NA	1	NA	0	2
KLF7	1	5	1	0	103.62	207.24	15	1	0.285714285714286	-Inf	1	-0.833333333333333	1	6
KLF8	5	5	0	1	72.6	145.2	15	1	1	1	1	0.5	1	10
KLHDC1	1	2	0	0	105.27	210.54	15	1	1	NA	1	NA	0	3
KLHDC10	1	2	0	1	85.8	171.6	15	1	1	1	1	0.333333333333333	1	3
KLHDC2	0	7	0	1	119.79	239.58	15	1	1	NA	1	0	1	7
KLHDC3	0	10	0	3	117.81	235.62	15	1	1	NA	1	0	3	10
KLHDC4	5	11	1	4	170.61	341.22	15	1	1	0.45	1	0.1125	5	16
KLHDC7A	8	4	1	2	97.35	194.7	15	1	0.525274725274725	0.75	1	0.333333333333333	3	12
KLHDC8A	1	3	1	0	52.14	104.28	15	1	0.4	-Inf	1	-0.75	1	4
KLHDC8B	1	2	0	1	37.95	75.9	15	1	1	1	1	0.333333333333333	1	3
KLHL10	2	15	0	2	168.3	336.6	15	1	1	1	1	0.117647058823529	2	17
KLHL11	2	6	1	1	146.19	292.38	15	1	1	-2	1	-0.25	2	8
KLHL12	0	12	0	1	147.84	295.68	15	1	1	NA	1	0	1	12
KLHL14	0	4	0	0	139.26	278.52	15	1	1	NA	1	NA	0	4
KLHL17	0	4	0	2	76.23	152.46	15	1	1	NA	1	0	2	4
KLHL18	0	7	0	2	87.78	175.56	15	1	1	NA	1	0	2	7
KLHL2	3	5	1	1	165.66	331.32	15	1	1	-0.666666666666667	1	-0.125	2	8
KLHL21	1	11	1	1	90.09	180.18	15	1	0.274725274725275	-10	1	-0.416666666666667	2	12
KLHL23-SSB	7	13	0	2	277.53	555.06	15	1	1	1	1	0.35	2	20
KLHL24	0	2	0	0	148.5	297	15	1	1	NA	1	NA	0	2
KLHL25	1	15	1	4	166.32	332.64	15	1	0.428571428571429	-2.75	1	-0.1375	5	16
KLHL26	2	7	2	2	188.1	376.2	15	1	0.53006993006993	-2.5	1	-0.277777777777778	4	9
KLHL28	1	13	0	2	176.88	353.76	15	1	1	1	1	0.0714285714285714	2	14
KLHL29	2	6	0	0	137.28	274.56	15	1	1	NA	1	NA	0	8
KLHL3	2	13	1	4	203.28	406.56	15	1	1	-0.625	1	-0.0666666666666667	5	15
KLHL30	3	7	1	4	66.33	132.66	15	1	1	0.416666666666667	1	0.1	5	10
KLHL31	1	8	0	3	188.1	376.2	15	1	1	1	1	0.111111111111111	3	9
KLHL33	0	9	0	1	118.47	236.94	15	1	1	NA	1	0	1	9
KLHL34	6	7	1	0	189.42	378.84	15	1	1	-Inf	1	-0.538461538461538	1	13
KLHL35	2	14	1	4	191.73	383.46	15	1	1	-0.75	1	-0.075	5	16
KLHL36	0	8	0	2	162.03	324.06	15	1	1	NA	1	0	2	8
KLHL4	2	6	1	1	244.86	489.72	15	1	1	-2	1	-0.25	2	8
KLHL40	1	15	1	6	224.73	449.46	15	1	0.525691699604743	-1.5	1	-0.0803571428571428	7	16
KLHL41	1	5	1	1	220.77	441.54	15	1	0.464285714285714	-4	1	-0.333333333333333	2	6
KLHL42	0	4	0	0	106.92	213.84	15	1	1	NA	1	NA	0	4
KLHL5	3	15	0	0	282.15	564.3	15	1	1	NA	1	NA	0	18
KLHL6	2	13	0	4	183.48	366.96	15	1	1	1	1	0.133333333333333	4	15
KLHL7	0	5	0	0	145.53	291.06	15	1	1	NA	1	NA	0	5
KLHL8	3	14	1	4	220.44	440.88	15	1	1	-0.166666666666667	1	-0.0235294117647059	5	17
KLK7-LOC107055482	5	2	2	0	54.12	108.24	15	1	1	-Inf	1	-0.285714285714286	2	7
KMO	4	8	2	1	209.22	418.44	15	1	0.525274725274725	-3	1	-0.333333333333333	3	12
KMT2A	18	36	4	3	1256.31	2512.62	15	1	0.240278908892317	-1.66666666666667	1	-0.238095238095238	7	54
KMT2C	29	79	11	9	1672.44	3344.88	15	1	0.0180333846985938	-2.32950191570881	1	-0.281481481481481	20	108
KMT2E	3	11	1	1	472.56	945.12	15	1	0.45	-2.66666666666667	1	-0.285714285714286	2	14
KMT5A	0	2	0	1	83.82	167.64	15	1	1	NA	1	0	1	2
KMT5B	1	5	1	2	241.23	482.46	15	1	1	-1.5	1	-0.166666666666667	3	6
KNDC1	14	19	2	3	610.17	1220.34	15	1	1	0.0952380952380952	1	0.0242424242424242	5	33
KNG1	13	8	1	2	224.07	448.14	15	1	0.550395256916996	0.692307692307692	1	0.285714285714286	3	21
KNL1	50	29	7	0	804.21	1608.42	15	1	0.0898078718396993	-Inf	1	-0.367088607594937	7	79
KNOP1	7	4	2	0	120.45	240.9	15	1	1	-Inf	1	-0.363636363636364	2	11
KNSTRN	0	3	0	1	60.39	120.78	15	1	1	NA	1	0	1	3
KNTC1	24	26	3	3	628.32	1256.64	15	1	1	-0.0833333333333333	1	-0.02	6	50
KPNA1	0	5	0	0	164.01	328.02	15	1	1	NA	1	NA	0	5
KPNA2	0	11	0	1	223.08	446.16	15	1	1	NA	1	0	1	11
KPNA3	0	2	0	0	144.21	288.42	15	1	1	NA	1	NA	0	2
KPNA4	0	5	0	0	133.65	267.3	15	1	1	NA	1	NA	0	5
KPNA5	1	5	1	2	182.49	364.98	15	1	1	-1.5	1	-0.166666666666667	3	6
KPNA6	0	6	0	1	153.78	307.56	15	1	1	NA	1	0	1	6
KPNA7	2	12	0	3	139.59	279.18	15	1	1	1	1	0.142857142857143	3	14
KPNB1	1	6	0	2	237.27	474.54	15	1	1	1	1	0.142857142857143	2	7
KREMEN1	6	3	3	0	178.2	356.4	15	1	0.509090909090909	-Inf	1	-0.333333333333333	3	9
KRIT1	0	7	0	1	253.44	506.88	15	1	1	NA	1	0	1	7
KRR1	0	2	0	0	106.59	213.18	15	1	1	NA	1	NA	0	2
KRT10	0	4	0	1	132.66	265.32	15	1	1	NA	1	0	1	4
KRT14	0	6	0	3	71.61	143.22	15	1	1	NA	1	0	3	6
KRT15	5	6	0	0	125.07	250.14	15	1	1	NA	1	NA	0	11
KRT17	0	3	0	2	89.1	178.2	15	1	1	NA	1	0	2	3
KRT19	3	7	1	0	122.1	244.2	15	1	0.363636363636364	-Inf	1	-0.7	1	10
KRT20	4	2	0	0	99.33	198.66	15	1	1	NA	1	NA	0	6
KRT222	0	2	0	1	97.68	195.36	15	1	1	NA	1	0	1	2
KRT23	5	2	2	1	160.71	321.42	15	1	1	0.2	1	0.0476190476190477	3	7
KRT5	1	7	0	1	157.74	315.48	15	1	1	1	1	0.125	1	8
KRT6A	0	6	0	1	137.28	274.56	15	1	1	NA	1	0	1	6
KRT7	3	2	0	0	102.96	205.92	15	1	1	NA	1	NA	0	5
KRT75L4	1	10	0	1	125.4	250.8	15	1	1	1	1	0.0909090909090909	1	11
KRT8	3	6	0	1	88.11	176.22	15	1	1	1	1	0.333333333333333	1	9
KRT80	4	7	1	0	170.94	341.88	15	1	0.416666666666667	-Inf	1	-0.636363636363636	1	11
KRT9L	7	6	4	1	137.28	274.56	15	1	0.595588235294118	-2.42857142857143	1	-0.261538461538462	5	13
KRTC42L	2	4	1	2	114.18	228.36	15	1	1	0	1	0	3	6
KSR1	4	12	2	2	273.9	547.8	15	1	0.54922600619195	-2	1	-0.25	4	16
KSR2	0	3	0	1	89.76	179.52	15	1	1	NA	1	0	1	3
KTN1	6	15	5	4	430.65	861.3	15	1	0.225187406296852	-2.125	1	-0.26984126984127	9	21
KY	12	13	0	2	191.07	382.14	15	1	0.487179487179487	1	1	0.48	2	25
KYAT3	3	3	1	0	136.29	272.58	15	1	1	-Inf	1	-0.5	1	6
KYNU	7	5	1	1	150.15	300.3	15	1	1	0.285714285714286	1	0.0833333333333334	2	12
L2HGDH	1	8	0	4	134.64	269.28	15	1	1	1	1	0.111111111111111	4	9
L3HYPDH	0	2	0	1	35.64	71.28	15	1	1	NA	1	0	1	2
L3MBTL1	8	12	1	0	302.94	605.88	15	1	0.428571428571429	-Inf	1	-0.6	1	20
L3MBTL2	4	10	1	2	236.61	473.22	15	1	1	-0.25	1	-0.0476190476190476	3	14
L3MBTL3	4	11	1	0	260.04	520.08	15	1	0.3125	-Inf	1	-0.733333333333333	1	15
L3MBTL4	3	6	0	1	253.44	506.88	15	1	1	1	1	0.333333333333333	1	9
LACC1	7	2	2	0	178.86	357.72	15	1	1	-Inf	1	-0.222222222222222	2	9
LACTB	2	7	0	0	122.43	244.86	15	1	1	NA	1	NA	0	9
LACTB2	3	1	0	0	70.62	141.24	15	1	1	NA	1	NA	0	4
LACTBL1	1	11	0	3	149.16	298.32	15	1	1	1	1	0.0833333333333333	3	12
LAD1	3	1	0	1	63.69	127.38	15	1	0.4	1	1	0.75	1	4
LAG3	10	3	1	3	110.55	221.1	15	1	0.0987394957983192	0.9	1	0.519230769230769	4	13
LAMA1	27	39	4	7	925.65	1851.3	15	1	1	0.174603174603175	1	0.0454545454545455	11	66
LAMA2	17	34	6	1	969.21	1938.42	15	1	0.0125661044659093	-11	1	-0.523809523809524	7	51
LAMA3	37	40	7	7	1010.46	2020.92	15	1	1	-0.0810810810810811	1	-0.0194805194805195	14	77
LAMA4	14	16	2	4	520.08	1040.16	15	1	0.672244264274625	0.428571428571429	1	0.133333333333333	6	30
LAMA5	13	63	7	14	1011.12	2022.24	15	1	0.129508250126386	-1.42307692307692	1	-0.162280701754386	21	76
LAMB1	7	30	4	7	494.34	988.68	15	1	0.245673699794296	-1.44897959183673	1	-0.174447174447174	11	37
LAMB2	5	14	1	5	146.85	293.7	15	1	1	0.44	1	0.0964912280701754	6	19
LAMB3	9	15	5	2	206.91	413.82	15	1	0.197547892720306	-3.16666666666667	1	-0.339285714285714	7	24
LAMB4	26	27	3	6	572.55	1145.1	15	1	0.482593117971366	0.480769230769231	1	0.157232704402516	9	53
LAMC1	5	11	2	2	411.18	822.36	15	1	0.586790505675955	-1.2	1	-0.1875	4	16
LAMC2	16	15	2	1	347.16	694.32	15	1	1	-0.875	1	-0.150537634408602	3	31
LAMC3	10	15	4	9	182.16	364.32	15	1	0.728083756726693	0.333333333333333	1	0.0923076923076923	13	25
LAMP1	9	11	0	1	141.24	282.48	15	1	1	1	1	0.45	1	20
LAMP2	4	4	1	1	119.79	239.58	15	1	1	0	1	0	2	8
LAMP3	4	6	0	0	124.08	248.16	15	1	1	NA	1	NA	0	10
LAMP5	2	2	1	0	54.45	108.9	15	1	1	-Inf	1	-0.5	1	4
LAMTOR3	0	3	0	0	32.34	64.68	15	1	1	NA	1	NA	0	3
LAMTOR5	0	1	0	1	20.46	40.92	15	1	1	NA	1	0	1	1
LANCL1	1	10	0	2	100.65	201.3	15	1	1	1	1	0.0909090909090909	2	11
LANCL3	4	8	1	2	163.35	326.7	15	1	1	0	1	0	3	12
LAP3	6	9	0	0	160.71	321.42	15	1	1	NA	1	NA	0	15
LAPTM4A	1	2	0	0	76.23	152.46	15	1	1	NA	1	NA	0	3
LAPTM4B	0	2	0	1	46.86	93.72	15	1	1	NA	1	0	1	2
LAPTM5	3	3	2	1	58.41	116.82	15	1	1	-1	1	-0.166666666666667	3	6
LARGE1	0	8	0	1	168.63	337.26	15	1	1	NA	1	0	1	8
LARGE2	1	12	0	4	205.26	410.52	15	1	1	1	1	0.0769230769230769	4	13
LARP1	2	17	2	3	275.88	551.76	15	1	0.179277244494636	-4.66666666666667	1	-0.294736842105263	5	19
LARP1B	9	7	0	0	299.31	598.62	15	1	1	NA	1	NA	0	16
LARP4	4	7	3	1	258.39	516.78	15	1	0.282051282051282	-4.25	1	-0.386363636363636	4	11
LARP4B	30	21	4	3	510.51	1021.02	15	1	1	0.0666666666666667	1	0.0168067226890757	7	51
LARP6	3	9	1	2	147.18	294.36	15	1	1	-0.5	1	-0.0833333333333333	3	12
LARP7	1	9	0	2	178.2	356.4	15	1	1	1	1	0.1	2	10
LARS	2	22	0	3	362.34	724.68	15	1	1	1	1	0.0833333333333333	3	24
LARS2	5	13	0	3	260.37	520.74	15	1	0.548872180451128	1	1	0.277777777777778	3	18
LAS1L	2	8	0	0	133.32	266.64	15	1	1	NA	1	NA	0	10
LASP1	1	1	0	0	42.57	85.14	15	1	1	NA	1	NA	0	2
LAT2	6	3	0	1	42.9	85.8	15	1	0.4	1	1	0.666666666666667	1	9
LATS1	0	14	0	2	358.71	717.42	15	1	1	NA	1	0	2	14
LATS2	1	18	0	2	391.38	782.76	15	1	1	1	1	0.0526315789473684	2	19
LBFABP	0	2	0	0	28.71	57.42	15	1	1	NA	1	NA	0	2
LBH	1	3	0	2	24.42	48.84	15	1	1	1	1	0.25	2	4
LBR	2	8	1	2	194.04	388.08	15	1	1	-1	1	-0.133333333333333	3	10
LCA5	10	6	2	1	242.88	485.76	15	1	1	-0.2	1	-0.0416666666666666	3	16
LCA5L	13	12	1	1	134.97	269.94	15	1	1	0.0769230769230769	1	0.02	2	25
LCAT	0	11	0	2	145.53	291.06	15	1	1	NA	1	0	2	11
LCK	0	1	0	1	29.37	58.74	15	1	1	NA	1	0	1	1
LCLAT1	3	1	0	1	88.77	177.54	15	1	0.4	1	1	0.75	1	4
LCMT1	1	2	0	0	100.98	201.96	15	1	1	NA	1	NA	0	3
LCMT2	26	12	0	1	425.7	851.4	15	1	0.333333333333333	1	1	0.684210526315789	1	38
LCN15	1	4	0	0	40.59	81.18	15	1	1	NA	1	NA	0	5
LCOR	12	19	6	2	496.98	993.96	15	1	0.112266112266112	-3.75	1	-0.362903225806452	8	31
LCORL	2	1	0	0	205.92	411.84	15	1	1	NA	1	NA	0	3
LCP1	1	12	0	0	199.65	399.3	15	1	1	NA	1	NA	0	13
LCP2	5	7	0	4	187.77	375.54	15	1	0.244505494505495	1	1	0.416666666666667	4	12
LCT	23	43	2	8	662.97	1325.94	15	1	0.482358760387011	0.532608695652174	1	0.148484848484848	10	66
LCTL	11	11	4	4	197.01	394.02	15	1	1	0	1	0	8	22
LDAH	0	3	0	0	87.78	175.56	15	1	1	NA	1	NA	0	3
LDB1	0	2	0	1	79.2	158.4	15	1	1	NA	1	0	1	2
LDB3	1	3	0	0	100.65	201.3	15	1	1	NA	1	NA	0	4
LDHA	0	3	0	1	96.69	193.38	15	1	1	NA	1	0	1	3
LDHB	0	3	0	1	77.55	155.1	15	1	1	NA	1	0	1	3
LDHD	0	2	0	1	16.17	32.34	15	1	1	NA	1	0	1	2
LDLRAD3	11	3	1	0	175.89	351.78	15	1	1	-Inf	1	-0.214285714285714	1	14
LDLRAD4	0	5	0	2	98.67	197.34	15	1	1	NA	1	0	2	5
LEAP2	1	0	1	0	28.05	56.1	15	1	1	NA	1	0	1	1
LECT2	2	3	0	1	107.91	215.82	15	1	1	1	1	0.4	1	5
LEF1	0	2	0	0	95.04	190.08	15	1	1	NA	1	NA	0	2
LEKR1	16	14	7	1	238.26	476.52	15	1	0.114273516500621	-5.125	1	-0.341666666666667	8	30
LEMD2	1	7	0	1	112.86	225.72	15	1	1	1	1	0.125	1	8
LEMD3	0	7	0	1	161.04	322.08	15	1	1	NA	1	0	1	7
LEO1	0	9	0	1	162.03	324.06	15	1	1	NA	1	0	1	9
LEPR	16	17	1	3	347.49	694.98	15	1	0.608751608751609	0.645833333333333	1	0.234848484848485	4	33
LEPROT	0	4	0	3	32.34	64.68	15	1	1	NA	1	0	3	4
LEPROTL1	1	1	0	1	23.1	46.2	15	1	1	1	1	0.5	1	2
LETM1	5	8	1	1	220.44	440.88	15	1	1	-0.6	1	-0.115384615384615	2	13
LEXM	6	3	1	0	103.95	207.9	15	1	1	-Inf	1	-0.333333333333333	1	9
LFNG	0	3	0	1	26.4	52.8	15	1	1	NA	1	0	1	3
LGALS1	2	4	0	0	53.13	106.26	15	1	1	NA	1	NA	0	6
LGALS2	0	1	0	1	37.95	75.9	15	1	1	NA	1	0	1	1
LGALS3	3	7	0	0	59.07	118.14	15	1	1	NA	1	NA	0	10
LGALS8	6	4	1	2	88.44	176.88	15	1	0.559440559440559	0.666666666666667	1	0.266666666666667	3	10
LGI2	0	6	0	1	185.46	370.92	15	1	1	NA	1	0	1	6
LGMN	1	10	0	1	158.07	316.14	15	1	1	1	1	0.0909090909090909	1	11
LGR5	1	6	1	0	315.81	631.62	15	1	0.25	-Inf	1	-0.857142857142857	1	7
LGR6	0	2	0	1	213.18	426.36	15	1	1	NA	1	0	1	2
LGSN	8	10	1	0	223.41	446.82	15	1	0.473684210526316	-Inf	1	-0.555555555555556	1	18
LHCGR	3	16	2	4	244.86	489.72	15	1	0.562281197063806	-1.66666666666667	1	-0.175438596491228	6	19
LHFP	1	0	1	0	20.79	41.58	15	1	1	NA	1	0	1	1
LHFPL2	0	5	0	0	80.19	160.38	15	1	1	NA	1	NA	0	5
LHFPL5	0	1	0	1	27.72	55.44	15	1	1	NA	1	0	1	1
LHPP	2	5	0	0	83.16	166.32	15	1	1	NA	1	NA	0	7
LHX3	1	0	1	0	27.39	54.78	15	1	1	NA	1	0	1	1
LHX4-AS1	0	2	0	1	59.07	118.14	15	1	1	NA	1	0	1	2
LHX6	0	2	0	1	52.47	104.94	15	1	1	NA	1	0	1	2
LHX8	0	3	0	0	76.89	153.78	15	1	1	NA	1	NA	0	3
LHX9	1	3	1	0	74.91	149.82	15	1	0.4	-Inf	1	-0.75	1	4
LIAS	0	8	0	2	92.73	185.46	15	1	1	NA	1	0	2	8
LIFR	4	15	0	0	317.79	635.58	15	1	1	NA	1	NA	0	19
LIG3	2	16	0	3	251.79	503.58	15	1	1	1	1	0.111111111111111	3	18
LIG4	6	9	0	0	288.75	577.5	15	1	1	NA	1	NA	0	15
LIMA1	7	9	2	2	248.82	497.64	15	1	1	-0.285714285714286	1	-0.0625	4	16
LIMCH1	26	20	7	2	522.39	1044.78	15	1	0.289231035649908	-1.69230769230769	1	-0.21256038647343	9	46
LIMD1	3	11	2	4	133.65	267.3	15	1	0.612616099071207	-0.833333333333333	1	-0.119047619047619	6	14
LIMK1	3	4	1	1	92.73	185.46	15	1	1	-0.333333333333333	1	-0.0714285714285715	2	7
LIMS1	0	5	0	0	72.93	145.86	15	1	1	NA	1	NA	0	5
LIMS1-LIMS2	1	4	0	0	112.53	225.06	15	1	1	NA	1	NA	0	5
LIN54	0	11	0	0	244.2	488.4	15	1	1	NA	1	NA	0	11
LIN7A	0	2	0	0	56.76	113.52	15	1	1	NA	1	NA	0	2
LINC00954	10	24	4	1	374.88	749.76	15	1	0.0469416785206258	-8.6	1	-0.505882352941176	5	34
LINGO1	1	2	1	1	182.82	365.64	15	1	1	-1	1	-0.166666666666667	2	3
LINGO2	2	11	1	0	170.28	340.56	15	1	0.214285714285714	-Inf	1	-0.846153846153846	1	13
LIPA	0	5	0	1	126.06	252.12	15	1	1	NA	1	0	1	5
LIPC	2	5	1	0	160.38	320.76	15	1	0.375	-Inf	1	-0.714285714285714	1	7
LIPG	5	16	0	3	99	198	15	1	1	1	1	0.238095238095238	3	21
LIPI	3	7	2	2	150.15	300.3	15	1	0.580419580419581	-1.33333333333333	1	-0.2	4	10
LIPML2	3	6	0	0	117.48	234.96	15	1	1	NA	1	NA	0	9
LIPML3	1	3	0	0	95.37	190.74	15	1	1	NA	1	NA	0	4
LIPML4	7	10	1	2	221.76	443.52	15	1	1	0.285714285714286	1	0.0784313725490196	3	17
LIPT1	10	10	2	4	114.84	229.68	15	1	0.652173913043478	0.5	1	0.166666666666667	6	20
LITAF	2	4	0	0	61.05	122.1	15	1	1	NA	1	NA	0	6
LIX1	5	6	2	1	68.31	136.62	15	1	1	-1.4	1	-0.212121212121212	3	11
LLGL2	3	17	1	0	302.28	604.56	15	1	0.19047619047619	-Inf	1	-0.85	1	20
LMAN1	0	10	0	2	167.97	335.94	15	1	1	NA	1	0	2	10
LMAN2	0	4	0	1	42.57	85.14	15	1	1	NA	1	0	1	4
LMBR1	0	3	0	0	114.18	228.36	15	1	1	NA	1	NA	0	3
LMBRD1	2	7	0	0	196.35	392.7	15	1	1	NA	1	NA	0	9
LMBRD2	9	5	0	0	197.01	394.02	15	1	1	NA	1	NA	0	14
LMCD1	2	3	2	1	64.35	128.7	15	1	1	-2	1	-0.266666666666667	3	5
LMF1	6	8	3	5	225.39	450.78	15	1	1	0.2	1	0.0535714285714285	8	14
LMINA	5	3	0	0	122.76	245.52	15	1	1	NA	1	NA	0	8
LMLN	3	6	1	3	179.19	358.38	15	1	1	0.333333333333333	1	0.0833333333333333	4	9
LMNB1	3	6	1	1	109.56	219.12	15	1	1	-1	1	-0.166666666666667	2	9
LMNB2	1	5	0	2	147.18	294.36	15	1	1	1	1	0.166666666666667	2	6
LMO1	1	3	0	0	63.69	127.38	15	1	1	NA	1	NA	0	4
LMO7	19	21	2	2	559.35	1118.7	15	1	1	-0.105263157894737	1	-0.025	4	40
LMOD1	5	6	1	3	90.09	180.18	15	1	0.604395604395604	0.6	1	0.204545454545455	4	11
LMOD2	5	7	2	0	136.29	272.58	15	1	0.461538461538462	-Inf	1	-0.583333333333333	2	12
LMOD3	2	5	1	2	110.88	221.76	15	1	1	-0.25	1	-0.0476190476190476	3	7
LMTK2	22	17	1	1	477.18	954.36	15	1	1	0.227272727272727	1	0.0641025641025641	2	39
LMX1A	2	0	0	0	26.4	52.8	15	1	1	NA	1	NA	0	2
LMX1B	0	2	0	0	108.9	217.8	15	1	1	NA	1	NA	0	2
LNPEP	7	13	2	2	270.93	541.86	15	1	0.614624505928854	-0.857142857142857	1	-0.15	4	20
LNPK	3	4	2	0	148.83	297.66	15	1	0.444444444444445	-Inf	1	-0.571428571428571	2	7
LNX1	3	7	0	2	241.89	483.78	15	1	1	1	1	0.3	2	10
LOC100857197	1	2	0	1	41.91	83.82	15	1	1	1	1	0.333333333333333	1	3
LOC100857421-LOC107049109-LOC107053040-LOC107053041-LOC112532176-LOC112532200	14	2	1	0	121.77	243.54	15	1	1	-Inf	1	-0.125	1	16
LOC100857468	2	2	1	0	46.2	92.4	15	1	1	-Inf	1	-0.5	1	4
LOC100857560-LOC101749671-LOC107050609-LOC107052549-LOC107055882-LOC107055885-LOC107055896-LOC107055944-LOC107055956-LOC107055976-LOC112529950-LOC112531710-LOC112531711-LOC112531712-LOC420615-NUPL2	3	3	1	2	50.49	100.98	15	1	1	0.5	1	0.166666666666667	3	6
LOC100857632	6	6	2	3	195.69	391.38	15	1	1	0.333333333333333	1	0.1	5	12
LOC100857698-LOC100857710-LOC100858444-LOC100859148-LOC107049929-LOC107052804-LOC107052814	0	3	0	1	66.66	133.32	15	1	1	NA	1	0	1	3
LOC100857706	13	7	2	0	83.82	167.64	15	1	1	-Inf	1	-0.35	2	20
LOC100857820-LOC101747680-LOC107049164-LOC415661-LOC415662-LOC769668	13	14	4	1	133.65	267.3	15	1	0.338153503893215	-3.30769230769231	1	-0.318518518518519	5	27
LOC100857834	0	2	0	1	28.71	57.42	15	1	1	NA	1	0	1	2
LOC100857843	2	1	1	0	21.45	42.9	15	1	1	-Inf	1	-0.333333333333333	1	3
LOC100857883	2	5	2	1	47.52	95.04	15	1	0.5	-4	1	-0.380952380952381	3	7
LOC100857892	2	1	0	1	13.86	27.72	15	1	1	1	1	0.666666666666667	1	3
LOC100858068	0	1	0	1	6.27	12.54	15	1	1	NA	1	0	1	1
LOC100858131	18	10	6	2	198.33	396.66	15	1	0.690985626731227	-0.666666666666667	1	-0.107142857142857	8	28
LOC100858196	2	2	1	2	138.6	277.2	15	1	1	0.5	1	0.166666666666667	3	4
LOC100858293	1	1	0	1	9.9	19.8	15	1	1	1	1	0.5	1	2
LOC100858347	15	8	2	4	249.48	498.96	15	1	0.19806323944255	0.733333333333333	1	0.318840579710145	6	23
LOC100858360	2	1	0	0	47.85	95.7	15	1	1	NA	1	NA	0	3
LOC100858426	0	3	0	0	34.65	69.3	15	1	1	NA	1	NA	0	3
LOC100858460	7	2	1	0	121.11	242.22	15	1	1	-Inf	1	-0.222222222222222	1	9
LOC100858579	4	3	0	0	107.25	214.5	15	1	1	NA	1	NA	0	7
LOC100858647	9	1	0	0	38.61	77.22	15	1	1	NA	1	NA	0	10
LOC100858777	1	3	0	0	114.84	229.68	15	1	1	NA	1	NA	0	4
LOC100858941	1	1	0	0	46.86	93.72	15	1	1	NA	1	NA	0	2
LOC100858942	1	1	0	1	7.59	15.18	15	1	1	1	1	0.5	1	2
LOC100858953	13	6	9	5	111.87	223.74	15	1	1	0.169230769230769	1	0.0413533834586466	14	19
LOC100858995	3	2	2	0	49.17	98.34	15	1	1	-Inf	1	-0.4	2	5
LOC100859173	1	2	0	1	96.36	192.72	15	1	1	1	1	0.333333333333333	1	3
LOC100859230	5	5	3	0	86.79	173.58	15	1	0.230769230769231	-Inf	1	-0.5	3	10
LOC100859276-RBM14	1	2	1	1	31.68	63.36	15	1	1	-1	1	-0.166666666666667	2	3
LOC100859284	0	1	0	1	3.96	7.92	15	1	1	NA	1	0	1	1
LOC100859449	2	9	0	1	117.81	235.62	15	1	1	1	1	0.181818181818182	1	11
LOC100859549	4	5	1	0	55.77	111.54	15	1	1	-Inf	1	-0.555555555555556	1	9
LOC100859602	1	4	1	0	177.54	355.08	15	1	0.333333333333333	-Inf	1	-0.8	1	5
LOC100859615	1	1	0	0	19.14	38.28	15	1	1	NA	1	NA	0	2
LOC100859636	1	2	0	0	57.75	115.5	15	1	1	NA	1	NA	0	3
LOC100859726	2	2	0	2	43.89	87.78	15	1	0.466666666666667	1	1	0.5	2	4
LOC100859837	4	4	0	2	79.2	158.4	15	1	0.466666666666667	1	1	0.5	2	8
LOC100859848	4	7	0	1	44.55	89.1	15	1	1	1	1	0.363636363636364	1	11
LOC100859850	9	3	1	0	94.05	188.1	15	1	1	-Inf	1	-0.25	1	12
LOC101747255	6	6	2	3	73.26	146.52	15	1	1	0.333333333333333	1	0.1	5	12
LOC101747310	2	5	1	3	42.9	85.8	15	1	1	0.166666666666667	1	0.0357142857142857	4	7
LOC101747338	3	4	0	1	46.2	92.4	15	1	1	1	1	0.428571428571429	1	7
LOC101747367	2	6	1	0	110.55	221.1	15	1	0.333333333333333	-Inf	1	-0.75	1	8
LOC101747386	6	2	0	1	36.3	72.6	15	1	0.333333333333333	1	1	0.75	1	8
LOC101747521	3	7	2	2	103.95	207.9	15	1	0.580419580419581	-1.33333333333333	1	-0.2	4	10
LOC101747522	0	4	0	1	26.4	52.8	15	1	1	NA	1	0	1	4
LOC101747537	7	4	0	1	62.04	124.08	15	1	0.416666666666667	1	1	0.636363636363636	1	11
LOC101747588	13	6	6	1	226.05	452.1	15	1	0.628780784432958	-1.76923076923077	1	-0.172932330827068	7	19
LOC101747660	3	6	1	3	43.89	87.78	15	1	1	0.333333333333333	1	0.0833333333333333	4	9
LOC101747799	5	2	0	2	53.79	107.58	15	1	0.166666666666667	1	1	0.714285714285714	2	7
LOC101747820	0	2	0	2	18.15	36.3	15	1	1	NA	1	0	2	2
LOC101747844	3	5	0	0	109.56	219.12	15	1	1	NA	1	NA	0	8
LOC101747868	1	4	0	1	42.57	85.14	15	1	1	1	1	0.2	1	5
LOC101747958	4	4	1	1	74.58	149.16	15	1	1	0	1	0	2	8
LOC101747995	2	0	0	0	30.69	61.38	15	1	1	NA	1	NA	0	2
LOC101748011	7	3	4	1	73.26	146.52	15	1	1	-0.714285714285714	1	-0.1	5	10
LOC101748058	4	10	1	2	301.62	603.24	15	1	1	-0.25	1	-0.0476190476190476	3	14
LOC101748060	36	26	11	2	669.57	1339.14	15	1	0.113936913463819	-2.97222222222222	1	-0.265508684863524	13	62
LOC101748065	1	2	0	0	34.32	68.64	15	1	1	NA	1	NA	0	3
LOC101748113	12	9	3	0	161.7	323.4	15	1	0.266304347826087	-Inf	1	-0.428571428571429	3	21
LOC101748153	3	4	2	1	66	132	15	1	1	-1.66666666666667	1	-0.238095238095238	3	7
LOC101748207	9	5	1	0	132	264	15	1	1	-Inf	1	-0.357142857142857	1	14
LOC101748311	1	4	1	1	98.67	197.34	15	1	1	-3	1	-0.3	2	5
LOC101748328	10	1	0	0	134.64	269.28	15	1	1	NA	1	NA	0	11
LOC101748329	3	6	1	0	61.38	122.76	15	1	0.4	-Inf	1	-0.666666666666667	1	9
LOC101748521	6	18	2	3	336.93	673.86	15	1	0.596816976127321	-1	1	-0.15	5	24
LOC101748543	1	4	0	1	30.36	60.72	15	1	1	1	1	0.2	1	5
LOC101748650-THRSP-THRSPB	2	3	0	1	31.68	63.36	15	1	1	1	1	0.4	1	5
LOC101748683	21	17	6	6	188.76	377.52	15	1	1	0.19047619047619	1	0.0526315789473685	12	38
LOC101748694	5	10	3	2	117.48	234.96	15	1	0.347265221878225	-2	1	-0.266666666666667	5	15
LOC101748744	2	2	0	0	41.25	82.5	15	1	1	NA	1	NA	0	4
LOC101748751	6	9	1	1	72.6	145.2	15	1	1	-0.5	1	-0.1	2	15
LOC101748883	1	5	0	3	88.77	177.54	15	1	1	1	1	0.166666666666667	3	6
LOC101748951	9	10	0	1	177.87	355.74	15	1	1	1	1	0.473684210526316	1	19
LOC101749017	4	6	1	1	55.11	110.22	15	1	1	-0.5	1	-0.1	2	10
LOC101749023	1	7	0	1	206.58	413.16	15	1	1	1	1	0.125	1	8
LOC101749151	3	5	3	1	98.01	196.02	15	1	0.545454545454546	-4	1	-0.375	4	8
LOC101749175	1	2	0	0	6.27	12.54	15	1	1	NA	1	NA	0	3
LOC101749214	13	14	5	6	147.51	295.02	15	1	1	0.102564102564103	1	0.0269360269360269	11	27
LOC101749216	0	3	0	1	30.03	60.06	15	1	1	NA	1	0	1	3
LOC101749220	43	31	12	7	413.49	826.98	15	1	0.796453967837539	-0.235880398671096	1	-0.05049786628734	19	74
LOC101749223	3	24	0	5	643.83	1287.66	15	1	1	1	1	0.111111111111111	5	27
LOC101749275	14	9	0	1	206.25	412.5	15	1	0.416666666666667	1	1	0.608695652173913	1	23
LOC101749287	2	3	1	1	57.09	114.18	15	1	1	-0.5	1	-0.1	2	5
LOC101749307	3	3	1	0	56.43	112.86	15	1	1	-Inf	1	-0.5	1	6
LOC101749460	3	7	0	0	139.92	279.84	15	1	1	NA	1	NA	0	10
LOC101749502	4	4	0	0	66	132	15	1	1	NA	1	NA	0	8
LOC101749593	3	6	1	2	78.54	157.08	15	1	1	0	1	0	3	9
LOC101749599-UGT1A1	6	9	0	0	140.91	281.82	15	1	1	NA	1	NA	0	15
LOC101749641	4	5	0	1	120.12	240.24	15	1	1	1	1	0.444444444444444	1	9
LOC101749694	6	17	0	2	154.11	308.22	15	1	1	1	1	0.260869565217391	2	23
LOC101749834	4	4	2	1	139.92	279.84	15	1	1	-1	1	-0.166666666666667	3	8
LOC101749904-LOC107049162-LOC112532554	11	8	2	1	164.01	328.02	15	1	1	-0.454545454545455	1	-0.087719298245614	3	19
LOC101750112-LOC420486	1	6	0	0	152.46	304.92	15	1	1	NA	1	NA	0	7
LOC101750121	1	5	0	1	44.88	89.76	15	1	1	1	1	0.166666666666667	1	6
LOC101750367	2	3	0	0	54.78	109.56	15	1	1	NA	1	NA	0	5
LOC101750423	10	8	1	0	139.59	279.18	15	1	1	-Inf	1	-0.444444444444444	1	18
LOC101750445	1	1	0	1	17.49	34.98	15	1	1	1	1	0.5	1	2
LOC101750583	13	7	1	1	166.98	333.96	15	1	1	0.461538461538462	1	0.15	2	20
LOC101750612	11	12	4	3	180.51	361.02	15	1	1	-0.454545454545455	1	-0.093167701863354	7	23
LOC101750621	8	5	3	1	147.84	295.68	15	1	1	-0.875	1	-0.134615384615385	4	13
LOC101750658	3	2	0	0	49.83	99.66	15	1	1	NA	1	NA	0	5
LOC101750690	2	11	1	3	124.41	248.82	15	1	1	-0.833333333333333	1	-0.0961538461538461	4	13
LOC101750822	1	3	0	3	35.97	71.94	15	1	1	1	1	0.25	3	4
LOC101750842	7	5	2	1	221.1	442.2	15	1	1	-0.428571428571429	1	-0.0833333333333333	3	12
LOC101750892	6	6	0	0	149.49	298.98	15	1	1	NA	1	NA	0	12
LOC101750948	2	3	0	0	107.25	214.5	15	1	1	NA	1	NA	0	5
LOC101751416-LOC107049563-LOC107050168-LOC107052752-LOC107055859-LOC107055860	8	3	0	0	162.36	324.72	15	1	1	NA	1	NA	0	11
LOC101751418	11	5	2	1	60.72	121.44	15	1	1	0.0909090909090909	1	0.0208333333333334	3	16
LOC101751615-LOC770126	8	3	3	0	71.94	143.88	15	1	1	-Inf	1	-0.272727272727273	3	11
LOC101751669	0	4	0	3	43.56	87.12	15	1	1	NA	1	0	3	4
LOC101751687	1	0	1	0	7.59	15.18	15	1	1	NA	1	0	1	1
LOC101751717	0	1	0	1	15.84	31.68	15	1	1	NA	1	0	1	1
LOC101751874	33	26	6	5	514.8	1029.6	15	1	1	0.0545454545454546	1	0.0138674884437596	11	59
LOC101751902	0	5	0	2	31.68	63.36	15	1	1	NA	1	0	2	5
LOC101751992	1	2	0	1	13.53	27.06	15	1	1	1	1	0.333333333333333	1	3
LOC101752020-LOC107049176	1	1	0	0	27.06	54.12	15	1	1	NA	1	NA	0	2
LOC101752065	3	7	2	1	69.3	138.6	15	1	0.510489510489511	-3.66666666666667	1	-0.366666666666667	3	10
LOC101752158	9	8	3	1	113.85	227.7	15	1	0.603007518796992	-1.66666666666667	1	-0.220588235294118	4	17
LOC101752250	2	1	0	1	63.69	127.38	15	1	1	1	1	0.666666666666667	1	3
LOC107048987-LOC112532770-MT	9	12	0	0	125.4	250.8	15	1	1	NA	1	NA	0	21
LOC107048995	4	4	0	0	93.72	187.44	15	1	1	NA	1	NA	0	8
LOC107049011	3	6	2	1	164.67	329.34	15	1	0.522727272727273	-3	1	-0.333333333333333	3	9
LOC107049018	6	4	1	0	81.18	162.36	15	1	1	-Inf	1	-0.4	1	10
LOC107049033	9	4	0	1	163.35	326.7	15	1	0.357142857142857	1	1	0.692307692307692	1	13
LOC107049046-LOC107055485-RPL17	0	5	0	4	34.32	68.64	15	1	1	NA	1	0	4	5
LOC107049050-LOC418086	7	0	1	0	93.39	186.78	15	1	1	NA	1	0	1	7
LOC107049066	0	1	0	1	88.11	176.22	15	1	1	NA	1	0	1	1
LOC107049146	1	7	0	5	31.68	63.36	15	1	1	1	1	0.125	5	8
LOC107049165	1	1	0	1	57.09	114.18	15	1	1	1	1	0.5	1	2
LOC107049250	1	3	0	0	85.47	170.94	15	1	1	NA	1	NA	0	4
LOC107049469-LOC426064-LOC769729	3	2	0	0	29.7	59.4	15	1	1	NA	1	NA	0	5
LOC107049639-LOC107050249-LOC107050274-LOC112531365-LOC112531366-LOC112531367-LOC112531368-LOC112531369-LOC112531380-LOC112531381-LOC112531382-LOC112531383-LOC112531389-LOC112531391-LOC112531395-LOC112531398-LOC112531399-LOC112531413-LOC112531414-LOC112531417	13	6	0	0	33.33	66.66	15	1	1	NA	1	NA	0	19
LOC107049672	4	15	1	0	101.31	202.62	15	1	0.25	-Inf	1	-0.789473684210526	1	19
LOC107050083	3	1	2	0	64.68	129.36	15	1	1	-Inf	1	-0.25	2	4
LOC107050229	8	11	2	0	138.6	277.2	15	1	0.214285714285714	-Inf	1	-0.578947368421053	2	19
LOC107050254	2	0	0	0	32.34	64.68	15	1	1	NA	1	NA	0	2
LOC107050336	1	1	0	0	24.75	49.5	15	1	1	NA	1	NA	0	2
LOC107050437	28	46	8	6	848.1	1696.2	15	1	0.237957591031672	-1.19047619047619	1	-0.193050193050193	14	74
LOC107050638	2	4	2	2	67.32	134.64	15	1	1	-1	1	-0.166666666666667	4	6
LOC107050706	0	1	0	1	53.79	107.58	15	1	1	NA	1	0	1	1
LOC107050717	0	1	0	1	10.56	21.12	15	1	1	NA	1	0	1	1
LOC107050760	1	1	1	1	38.28	76.56	15	1	1	0	1	0	2	2
LOC107050879	1	10	1	5	306.24	612.48	15	1	1	-1	1	-0.0757575757575757	6	11
LOC107051508-LOC771972	2	1	0	1	46.86	93.72	15	1	1	1	1	0.666666666666667	1	3
LOC107051671	6	1	1	0	75.24	150.48	15	1	1	-Inf	1	-0.142857142857143	1	7
LOC107051674	5	0	0	0	16.83	33.66	15	1	1	NA	1	NA	0	5
LOC107051846	0	12	0	3	196.02	392.04	15	1	1	NA	1	0	3	12
LOC107051857	1	3	0	0	12.21	24.42	15	1	1	NA	1	NA	0	4
LOC107051902-LRRC63	14	6	3	2	112.53	225.06	15	1	1	0.357142857142857	1	0.1	5	20
LOC107052104	16	11	7	3	174.9	349.8	15	1	0.709907537256552	-0.604166666666667	1	-0.107407407407407	10	27
LOC107052138-LOC107052143-OR10A4-OR10A7	1	2	0	0	97.68	195.36	15	1	1	NA	1	NA	0	3
LOC107052456	5	3	0	1	28.38	56.76	15	1	0.444444444444444	1	1	0.625	1	8
LOC107052463	3	3	0	0	68.97	137.94	15	1	1	NA	1	NA	0	6
LOC107052576	1	0	1	0	59.73	119.46	15	1	1	NA	1	0	1	1
LOC107052690	3	1	1	0	69.63	139.26	15	1	1	-Inf	1	-0.25	1	4
LOC107052882	7	3	2	1	99	198	15	1	1	0.142857142857143	1	0.0333333333333333	3	10
LOC107053055	14	15	2	2	379.5	759	15	1	1	-0.0714285714285714	1	-0.0172413793103448	4	29
LOC107053414	14	24	2	2	512.82	1025.64	15	1	0.628339140534262	-0.714285714285714	1	-0.131578947368421	4	38
LOC107053700	5	5	1	1	41.25	82.5	15	1	1	0	1	0	2	10
LOC107053714	20	14	1	1	190.08	380.16	15	1	1	0.3	1	0.0882352941176471	2	34
LOC107053715	24	22	3	3	384.45	768.9	15	1	1	0.0833333333333334	1	0.0217391304347826	6	46
LOC107054051	0	2	0	0	41.58	83.16	15	1	1	NA	1	NA	0	2
LOC107054133	0	9	0	2	146.52	293.04	15	1	1	NA	1	0	2	9
LOC107054332-PARP11	0	2	0	0	80.52	161.04	15	1	1	NA	1	NA	0	2
LOC107054460-LOC107054461-LOC107054462-LOC107054465-LOC107054466-LOC107054467-LOC107054471-LOC107056903-LOC107056913-LOC107056929-LOC107056948-LOC107056991-LOC112531205-LOC112533411	18	17	9	10	135.96	271.92	15	1	1	0.15	1	0.0406015037593985	19	35
LOC107054473	5	8	3	1	87.12	174.24	15	1	0.294117647058823	-3.8	1	-0.365384615384615	4	13
LOC107054634	1	1	1	1	43.89	87.78	15	1	1	0	1	0	2	2
LOC107054696-ZNF692	1	3	1	0	26.73	53.46	15	1	0.4	-Inf	1	-0.75	1	4
LOC107054772-LOC112529957	0	2	0	0	12.21	24.42	15	1	1	NA	1	NA	0	2
LOC107054849	1	0	1	0	29.37	58.74	15	1	1	NA	1	0	1	1
LOC107055024	5	13	2	3	272.58	545.16	15	1	0.621385479509049	-0.733333333333333	1	-0.122222222222222	5	18
LOC107055037	9	4	1	0	76.23	152.46	15	1	1	-Inf	1	-0.307692307692308	1	13
LOC107055038	6	8	0	0	80.19	160.38	15	1	1	NA	1	NA	0	14
LOC107055072	2	0	0	0	11.55	23.1	15	1	1	NA	1	NA	0	2
LOC107055076	2	3	0	0	42.24	84.48	15	1	1	NA	1	NA	0	5
LOC107055419-LOC112530874-LOC431300	16	12	0	1	267.96	535.92	15	1	0.448275862068965	1	1	0.571428571428571	1	28
LOC107055427	12	5	0	0	271.59	543.18	15	1	1	NA	1	NA	0	17
LOC107055431-NEDD4L	11	15	1	2	278.85	557.7	15	1	1	0.318181818181818	1	0.0897435897435898	3	26
LOC107055922-RP1	54	46	7	1	1532.19	3064.38	15	1	0.134223613301755	-4.96296296296296	1	-0.335	8	100
LOC107056274	0	2	0	1	19.47	38.94	15	1	1	NA	1	0	1	2
LOC107056275	4	1	3	1	23.43	46.86	15	1	1	0.25	1	0.05	4	5
LOC107056277	0	1	0	1	18.48	36.96	15	1	1	NA	1	0	1	1
LOC107056410-MRPL16	1	1	0	0	12.21	24.42	15	1	1	NA	1	NA	0	2
LOC107056600	1	3	0	1	93.39	186.78	15	1	1	1	1	0.25	1	4
LOC107056693	2	5	0	0	250.8	501.6	15	1	1	NA	1	NA	0	7
LOC107056877	0	2	0	1	19.8	39.6	15	1	1	NA	1	0	1	2
LOC107057078	11	19	2	6	328.35	656.7	15	1	0.689282311373593	0.424242424242424	1	0.116666666666667	8	30
LOC107057310	5	14	2	5	195.36	390.72	15	1	1	-0.12	1	-0.0225563909774436	7	19
LOC107057318	0	3	0	0	45.21	90.42	15	1	1	NA	1	NA	0	3
LOC107057363	0	2	0	0	54.45	108.9	15	1	1	NA	1	NA	0	2
LOC107057394	4	12	0	1	153.78	307.56	15	1	1	1	1	0.25	1	16
LOC107057564	1	2	0	0	108.57	217.14	15	1	1	NA	1	NA	0	3
LOC107080643-LOC112533303	12	8	1	2	123.75	247.5	15	1	0.55957086391869	0.666666666666667	1	0.266666666666667	3	20
LOC112529925	17	26	6	3	640.2	1280.4	15	1	0.160954764884677	-2.05882352941176	1	-0.271317829457364	9	43
LOC112529930	5	2	1	1	46.53	93.06	15	1	1	0.6	1	0.214285714285714	2	7
LOC112529955	12	11	2	3	301.29	602.58	15	1	1	0.388888888888889	1	0.121739130434783	5	23
LOC112529965	1	2	1	1	98.67	197.34	15	1	1	-1	1	-0.166666666666667	2	3
LOC112529973	3	7	0	3	20.46	40.92	15	1	0.527972027972028	1	1	0.3	3	10
LOC112529978-TPRN	3	5	0	0	87.78	175.56	15	1	1	NA	1	NA	0	8
LOC112530162	0	6	0	1	64.68	129.36	15	1	1	NA	1	0	1	6
LOC112530196-TMEM79	2	7	1	0	56.43	112.86	15	1	0.3	-Inf	1	-0.777777777777778	1	9
LOC112530201	0	5	0	5	20.79	41.58	15	1	1	NA	1	0	5	5
LOC112530206	0	3	0	0	63.36	126.72	15	1	1	NA	1	NA	0	3
LOC112530287	1	1	0	1	25.74	51.48	15	1	1	1	1	0.5	1	2
LOC112530510-SAMSN1	4	4	0	1	156.09	312.18	15	1	1	1	1	0.5	1	8
LOC112530656	3	0	2	0	63.36	126.72	15	1	1	NA	1	0	2	3
LOC112530673	7	2	0	0	53.46	106.92	15	1	1	NA	1	NA	0	9
LOC112530906-SLC5A10	2	5	1	0	62.7	125.4	15	1	0.375	-Inf	1	-0.714285714285714	1	7
LOC112530909	19	7	5	2	205.92	411.84	15	1	1	0.0789473684210527	1	0.0164835164835164	7	26
LOC112530959	0	4	0	0	54.12	108.24	15	1	1	NA	1	NA	0	4
LOC112530976	3	1	0	0	59.4	118.8	15	1	1	NA	1	NA	0	4
LOC112531016-LOC112531021	1	2	1	2	22.11	44.22	15	1	1	0	1	0	3	3
LOC112531049-UTRIM39L	5	2	0	1	111.87	223.74	15	1	0.375	1	1	0.714285714285714	1	7
LOC112531372	0	4	0	0	133.65	267.3	15	1	1	NA	1	NA	0	4
LOC112531549	18	6	2	2	751.41	1502.82	15	1	0.554578754578754	0.666666666666667	1	0.25	4	24
LOC112531588	1	1	0	0	194.7	389.4	15	1	1	NA	1	NA	0	2
LOC112531692	5	10	3	4	111.87	223.74	15	1	1	-0.5	1	-0.0952380952380952	7	15
LOC112531842	4	1	0	0	62.04	124.08	15	1	1	NA	1	NA	0	5
LOC112531844	1	0	1	0	17.82	35.64	15	1	1	NA	1	0	1	1
LOC112531899	4	1	0	0	35.31	70.62	15	1	1	NA	1	NA	0	5
LOC112532100	7	1	0	0	312.18	624.36	15	1	1	NA	1	NA	0	8
LOC112532300	0	2	0	1	7.59	15.18	15	1	1	NA	1	0	1	2
LOC112532338	3	1	0	0	21.12	42.24	15	1	1	NA	1	NA	0	4
LOC112532351	9	12	1	1	296.34	592.68	15	1	1	-0.333333333333333	1	-0.0714285714285715	2	21
LOC112532477	2	1	0	0	97.68	195.36	15	1	1	NA	1	NA	0	3
LOC112532570-MUC	19	37	2	1	654.39	1308.78	15	1	0.286382232612507	-2.89473684210526	1	-0.327380952380952	3	56
LOC112532681	2	3	0	1	107.25	214.5	15	1	1	1	1	0.4	1	5
LOC112532692	0	1	0	1	58.74	117.48	15	1	1	NA	1	0	1	1
LOC112532694	2	9	1	4	76.23	152.46	15	1	1	-0.125	1	-0.0181818181818182	5	11
LOC112532762	12	6	4	0	104.94	209.88	15	1	0.54066985645933	-Inf	1	-0.333333333333333	4	18
LOC112532911	1	1	0	0	59.07	118.14	15	1	1	NA	1	NA	0	2
LOC112532977	11	9	1	1	137.61	275.22	15	1	1	0.181818181818182	1	0.05	2	20
LOC112532998	4	3	1	0	49.5	99	15	1	1	-Inf	1	-0.428571428571429	1	7
LOC112533016	3	5	1	0	35.97	71.94	15	1	0.444444444444444	-Inf	1	-0.625	1	8
LOC112533191-OR6B1-OR6B1L2	3	4	0	1	93.06	186.12	15	1	1	1	1	0.428571428571429	1	7
LOC112533211	15	4	3	2	58.41	116.82	15	1	0.568040654997177	0.6	1	0.189473684210526	5	19
LOC112533280	0	2	0	1	45.87	91.74	15	1	1	NA	1	0	1	2
LOC112533337	2	3	0	0	56.1	112.2	15	1	1	NA	1	NA	0	5
LOC112533511	3	9	1	2	108.57	217.14	15	1	1	-0.5	1	-0.0833333333333333	3	12
LOC112533543	3	9	0	5	71.94	143.88	15	1	0.514705882352941	1	1	0.25	5	12
LOC112533548-TRIM7	1	10	1	5	96.36	192.72	15	1	1	-1	1	-0.0757575757575757	6	11
LOC395159	0	3	0	1	49.5	99	15	1	1	NA	1	0	1	3
LOC395381	18	29	3	1	711.81	1423.62	15	1	0.29327731092437	-3.83333333333333	1	-0.367021276595745	4	47
LOC395944	9	26	2	2	599.61	1199.22	15	1	0.561877667140825	-1.88888888888889	1	-0.242857142857143	4	35
LOC395991	2	7	1	1	69.96	139.92	15	1	0.490909090909091	-2.5	1	-0.277777777777778	2	9
LOC396098	6	7	1	3	105.93	211.86	15	1	0.602941176470588	0.611111111111111	1	0.211538461538462	4	13
LOC396365	1	0	1	0	11.88	23.76	15	1	1	NA	1	0	1	1
LOC408038	1	3	0	0	60.39	120.78	15	1	1	NA	1	NA	0	4
LOC414835	27	55	9	11	790.35	1580.7	15	1	0.312395794856766	-0.666666666666667	1	-0.120731707317073	20	82
LOC415324	3	4	0	0	69.3	138.6	15	1	1	NA	1	NA	0	7
LOC415478	6	14	2	1	406.89	813.78	15	1	0.268774703557312	-3.66666666666667	1	-0.366666666666667	3	20
LOC415664	3	4	1	0	76.89	153.78	15	1	1	-Inf	1	-0.571428571428571	1	7
LOC415780	2	4	1	1	144.54	289.08	15	1	1	-1	1	-0.166666666666667	2	6
LOC415787	7	12	2	1	206.91	413.82	15	1	0.544155844155844	-2.42857142857143	1	-0.298245614035088	3	19
LOC416055	0	2	0	1	30.36	60.72	15	1	1	NA	1	0	1	2
LOC416090	2	2	2	1	68.31	136.62	15	1	1	-1	1	-0.166666666666667	3	4
LOC416147	5	21	0	0	231	462	15	1	1	NA	1	NA	0	26
LOC416169	12	22	6	6	265.65	531.3	15	1	0.494851091949339	-0.833333333333333	1	-0.147058823529412	12	34
LOC416263	4	9	1	2	107.91	215.82	15	1	1	-0.125	1	-0.0256410256410256	3	13
LOC416530	3	12	0	3	191.4	382.8	15	1	1	1	1	0.2	3	15
LOC416622	3	9	0	0	168.96	337.92	15	1	1	NA	1	NA	0	12
LOC416755	18	15	3	3	256.74	513.48	15	1	1	0.166666666666667	1	0.0454545454545454	6	33
LOC416924	11	16	2	2	221.1	442.2	15	1	1	-0.454545454545455	1	-0.0925925925925926	4	27
LOC417013	13	9	5	2	226.05	452.1	15	1	0.676507899896206	-0.730769230769231	1	-0.123376623376623	7	22
LOC417113	1	7	0	1	73.92	147.84	15	1	1	1	1	0.125	1	8
LOC417372	6	5	2	1	58.41	116.82	15	1	1	-0.666666666666667	1	-0.121212121212121	3	11
LOC417386	1	6	0	0	85.14	170.28	15	1	1	NA	1	NA	0	7
LOC417741	2	6	1	1	90.09	180.18	15	1	1	-2	1	-0.25	2	8
LOC417937	5	8	0	2	149.82	299.64	15	1	0.523809523809524	1	1	0.384615384615385	2	13
LOC417973	32	8	2	2	177.87	355.74	15	1	0.217567458066607	0.75	1	0.3	4	40
LOC418108	7	5	0	0	129.03	258.06	15	1	1	NA	1	NA	0	12
LOC418114	7	7	3	1	212.19	424.38	15	1	0.588235294117647	-2	1	-0.25	4	14
LOC418222	9	8	3	1	187.44	374.88	15	1	0.603007518796992	-1.66666666666667	1	-0.220588235294118	4	17
LOC418355	2	3	0	0	40.92	81.84	15	1	1	NA	1	NA	0	5
LOC418414	2	2	0	0	44.88	89.76	15	1	1	NA	1	NA	0	4
LOC418421	6	9	0	0	208.56	417.12	15	1	1	NA	1	NA	0	15
LOC418544	2	7	0	0	161.37	322.74	15	1	1	NA	1	NA	0	9
LOC418667	3	5	1	0	82.83	165.66	15	1	0.444444444444444	-Inf	1	-0.625	1	8
LOC418701	1	4	1	1	43.89	87.78	15	1	1	-3	1	-0.3	2	5
LOC418927	1	0	1	0	24.75	49.5	15	1	1	NA	1	0	1	1
LOC419074	1	16	0	1	233.97	467.94	15	1	1	1	1	0.0588235294117647	1	17
LOC419080	0	10	0	1	123.09	246.18	15	1	1	NA	1	0	1	10
LOC419112	0	3	0	0	70.62	141.24	15	1	1	NA	1	NA	0	3
LOC419250	2	6	0	3	103.62	207.24	15	1	1	1	1	0.25	3	8
LOC419333	13	10	2	0	256.08	512.16	15	1	0.5	-Inf	1	-0.434782608695652	2	23
LOC419409	4	9	0	0	173.25	346.5	15	1	1	NA	1	NA	0	13
LOC419429	0	8	0	3	170.61	341.22	15	1	1	NA	1	0	3	8
LOC419584	1	1	1	0	21.12	42.24	15	1	1	-Inf	1	-0.5	1	2
LOC419741	9	6	3	1	103.29	206.58	15	1	1	-1	1	-0.15	4	15
LOC419830	4	2	0	1	57.09	114.18	15	1	0.428571428571429	1	1	0.666666666666667	1	6
LOC419851-PFKFB2	15	11	2	4	241.23	482.46	15	1	0.382801878630577	0.633333333333333	1	0.243589743589744	6	26
LOC420160	3	6	1	4	63.69	127.38	15	1	1	0.5	1	0.133333333333333	5	9
LOC420294	10	14	4	2	183.48	366.96	15	1	0.377777777777778	-1.8	1	-0.25	6	24
LOC420734	3	2	0	0	50.49	100.98	15	1	1	NA	1	NA	0	5
LOC420748	17	6	0	0	232.98	465.96	15	1	1	NA	1	NA	0	23
LOC420807	4	5	1	1	106.59	213.18	15	1	1	-0.25	1	-0.0555555555555556	2	9
LOC420992	6	8	2	3	154.11	308.22	15	1	1	0.111111111111111	1	0.0285714285714285	5	14
LOC421081	9	3	1	0	66.33	132.66	15	1	1	-Inf	1	-0.25	1	12
LOC421106	17	16	5	0	288.75	577.5	15	1	0.0611664295874822	-Inf	1	-0.484848484848485	5	33
LOC421108	9	13	0	3	229.02	458.04	15	1	0.28	1	1	0.409090909090909	3	22
LOC421195	50	35	2	3	684.09	1368.18	15	1	0.646494681094575	0.533333333333333	1	0.188235294117647	5	85
LOC421285	24	21	8	8	221.76	443.52	15	1	1	0.125	1	0.0333333333333333	16	45
LOC421502	18	6	1	0	147.51	295.02	15	1	1	-Inf	1	-0.25	1	24
LOC421584	5	4	2	0	181.5	363	15	1	0.490909090909091	-Inf	1	-0.444444444444444	2	9
LOC421690	6	5	1	1	160.05	320.1	15	1	1	0.166666666666667	1	0.0454545454545454	2	11
LOC421856	0	1	0	1	97.02	194.04	15	1	1	NA	1	0	1	1
LOC421892	9	9	1	1	172.92	345.84	15	1	1	0	1	0	2	18
LOC421965	2	9	1	0	158.4	316.8	15	1	0.25	-Inf	1	-0.818181818181818	1	11
LOC422106	3	5	3	2	28.71	57.42	15	1	0.592074592074592	-1.5	1	-0.225	5	8
LOC422147	3	0	1	0	56.76	113.52	15	1	1	NA	1	0	1	3
LOC422150	2	2	0	0	99.66	199.32	15	1	1	NA	1	NA	0	4
LOC422171	17	22	1	3	436.92	873.84	15	1	0.628069038165465	0.568627450980392	1	0.185897435897436	4	39
LOC422177	6	3	2	1	55.77	111.54	15	1	1	0	1	0	3	9
LOC422295	2	1	1	0	85.14	170.28	15	1	1	-Inf	1	-0.333333333333333	1	3
LOC422304	4	1	2	0	25.41	50.82	15	1	1	-Inf	1	-0.2	2	5
LOC422308	8	17	1	5	274.56	549.12	15	1	0.642337640112946	0.575	1	0.153333333333333	6	25
LOC422320	3	12	0	4	230.01	460.02	15	1	1	1	1	0.2	4	15
LOC422426	19	13	2	1	297.99	595.98	15	1	1	-0.368421052631579	1	-0.0729166666666666	3	32
LOC422442	2	4	1	0	60.06	120.12	15	1	0.428571428571428	-Inf	1	-0.666666666666667	1	6
LOC422643	12	7	0	0	159.06	318.12	15	1	1	NA	1	NA	0	19
LOC422901	7	5	1	0	123.75	247.5	15	1	1	-Inf	1	-0.416666666666667	1	12
LOC422926	5	13	2	3	231.66	463.32	15	1	0.621385479509049	-0.733333333333333	1	-0.122222222222222	5	18
LOC422928	6	5	2	0	67.98	135.96	15	1	0.487179487179487	-Inf	1	-0.454545454545455	2	11
LOC423110	5	12	2	2	136.29	272.58	15	1	0.574269005847953	-1.4	1	-0.205882352941176	4	17
LOC423240	0	3	0	0	67.98	135.96	15	1	1	NA	1	NA	0	3
LOC423277	0	2	0	1	42.57	85.14	15	1	1	NA	1	0	1	2
LOC423462	7	3	0	0	75.24	150.48	15	1	1	NA	1	NA	0	10
LOC423629	7	4	2	0	66.33	132.66	15	1	1	-Inf	1	-0.363636363636364	2	11
LOC423693	3	8	0	0	194.37	388.74	15	1	1	NA	1	NA	0	11
LOC423719	1	4	1	3	18.81	37.62	15	1	1	-0.333333333333333	1	-0.05	4	5
LOC423731	5	2	2	0	85.47	170.94	15	1	1	-Inf	1	-0.285714285714286	2	7
LOC423752	13	15	1	2	193.71	387.42	15	1	1	0.423076923076923	1	0.130952380952381	3	28
LOC423967	6	4	0	0	33	66	15	1	1	NA	1	NA	0	10
LOC424109	1	3	0	0	84.48	168.96	15	1	1	NA	1	NA	0	4
LOC424167	16	15	1	1	356.73	713.46	15	1	1	0.0625	1	0.0161290322580645	2	31
LOC424300	26	36	2	3	553.08	1106.16	15	1	1	0.0769230769230769	1	0.0193548387096774	5	62
LOC424430	5	6	2	3	95.37	190.74	15	1	1	0.2	1	0.0545454545454545	5	11
LOC424473	11	15	2	2	207.24	414.48	15	1	1	-0.363636363636364	1	-0.0769230769230769	4	26
LOC424748	14	7	4	1	167.31	334.62	15	1	1	-1	1	-0.133333333333333	5	21
LOC424918	2	0	0	0	13.53	27.06	15	1	1	NA	1	NA	0	2
LOC424919	3	4	2	2	88.11	176.22	15	1	1	-0.333333333333333	1	-0.0714285714285715	4	7
LOC425001	4	5	0	1	83.49	166.98	15	1	1	1	1	0.444444444444444	1	9
LOC425049	2	9	0	0	211.2	422.4	15	1	1	NA	1	NA	0	11
LOC425431-NES	3	2	1	0	30.36	60.72	15	1	1	-Inf	1	-0.4	1	5
LOC425470	12	4	1	1	140.25	280.5	15	1	0.490196078431373	0.666666666666667	1	0.25	2	16
LOC425795	0	19	0	3	139.26	278.52	15	1	1	NA	1	0	3	19
LOC426037	2	2	1	1	29.37	58.74	15	1	1	0	1	0	2	4
LOC426385	1	3	0	2	75.57	151.14	15	1	1	1	1	0.25	2	4
LOC426456	3	0	0	0	20.46	40.92	15	1	1	NA	1	NA	0	3
LOC426514	0	2	0	1	30.69	61.38	15	1	1	NA	1	0	1	2
LOC426710	7	4	1	1	44.88	89.76	15	1	1	0.428571428571429	1	0.136363636363636	2	11
LOC426743	5	1	3	1	41.91	83.82	15	1	1	0.4	1	0.0833333333333334	4	6
LOC426821	8	6	1	1	70.29	140.58	15	1	1	0.25	1	0.0714285714285714	2	14
LOC426897	6	5	1	1	119.46	238.92	15	1	1	0.166666666666667	1	0.0454545454545454	2	11
LOC426957-LOC428289	2	3	0	3	23.76	47.52	15	1	0.464285714285714	1	1	0.4	3	5
LOC427400	1	4	0	0	71.94	143.88	15	1	1	NA	1	NA	0	5
LOC427533	0	8	0	4	87.12	174.24	15	1	1	NA	1	0	4	8
LOC427545	7	5	1	1	85.47	170.94	15	1	1	0.285714285714286	1	0.0833333333333334	2	12
LOC427594	1	4	0	2	102.96	205.92	15	1	1	1	1	0.2	2	5
LOC427656	1	4	0	1	64.02	128.04	15	1	1	1	1	0.2	1	5
LOC427665	2	4	1	1	92.73	185.46	15	1	1	-1	1	-0.166666666666667	2	6
LOC427775	1	4	0	1	80.85	161.7	15	1	1	1	1	0.2	1	5
LOC427778	15	10	2	4	151.47	302.94	15	1	0.369670003707823	0.666666666666667	1	0.266666666666667	6	25
LOC427783	4	3	0	0	62.04	124.08	15	1	1	NA	1	NA	0	7
LOC427799	0	1	0	1	36.63	73.26	15	1	1	NA	1	0	1	1
LOC427826	1	11	0	2	143.22	286.44	15	1	1	1	1	0.0833333333333333	2	12
LOC427933	4	4	1	0	113.85	227.7	15	1	1	-Inf	1	-0.5	1	8
LOC428094	4	11	0	2	199.98	399.96	15	1	1	1	1	0.266666666666667	2	15
LOC428144	2	3	1	1	63.03	126.06	15	1	1	-0.5	1	-0.1	2	5
LOC428250	51	44	12	11	768.57	1537.14	15	1	1	0.0588235294117647	1	0.0151029748283753	23	95
LOC428335	0	6	0	0	141.9	283.8	15	1	1	NA	1	NA	0	6
LOC428383	4	3	1	0	90.42	180.84	15	1	1	-Inf	1	-0.428571428571429	1	7
LOC428541	4	8	1	2	51.48	102.96	15	1	1	0	1	0	3	12
LOC428667	5	0	0	0	130.68	261.36	15	1	1	NA	1	NA	0	5
LOC428702	2	0	0	0	32.01	64.02	15	1	1	NA	1	NA	0	2
LOC428714	12	8	4	1	284.46	568.92	15	1	0.620553359683794	-1.66666666666667	1	-0.2	5	20
LOC428824	3	16	1	4	134.64	269.28	15	1	1	-0.333333333333333	1	-0.0421052631578948	5	19
LOC428967	1	2	0	0	151.47	302.94	15	1	1	NA	1	NA	0	3
LOC429098	4	7	0	3	140.25	280.5	15	1	0.505494505494506	1	1	0.363636363636364	3	11
LOC429348	1	1	0	0	30.69	61.38	15	1	1	NA	1	NA	0	2
LOC430422	15	19	3	4	284.13	568.26	15	1	1	0.05	1	0.0126050420168067	7	34
LOC430433-LOC776507	7	3	5	1	109.56	219.12	15	1	1	-1.14285714285714	1	-0.133333333333333	6	10
LOC430443	0	2	0	0	69.63	139.26	15	1	1	NA	1	NA	0	2
LOC431250	3	10	0	1	96.69	193.38	15	1	1	1	1	0.230769230769231	1	13
LOC431321	0	2	0	0	23.43	46.86	15	1	1	NA	1	NA	0	2
LOC431322	0	3	0	0	36.63	73.26	15	1	1	NA	1	NA	0	3
LOC768477	2	3	1	1	10.23	20.46	15	1	1	-0.5	1	-0.1	2	5
LOC768647	9	7	1	1	213.18	426.36	15	1	1	0.222222222222222	1	0.0625	2	16
LOC768760	7	12	4	1	192.06	384.12	15	1	0.142080745341615	-5.85714285714286	1	-0.431578947368421	5	19
LOC768978	1	18	0	2	179.52	359.04	15	1	1	1	1	0.0526315789473684	2	19
LOC769486	0	2	0	1	12.21	24.42	15	1	1	NA	1	0	1	2
LOC769510	20	32	4	8	257.73	515.46	15	1	1	0.2	1	0.0512820512820513	12	52
LOC769512	0	7	0	4	116.16	232.32	15	1	1	NA	1	0	4	7
LOC769646	7	3	2	2	38.61	77.22	15	1	0.58041958041958	0.571428571428571	1	0.2	4	10
LOC769726	3	3	1	0	104.94	209.88	15	1	1	-Inf	1	-0.5	1	6
LOC770026	4	6	0	1	79.2	158.4	15	1	1	1	1	0.4	1	10
LOC770271	11	8	2	2	58.74	117.48	15	1	1	0.272727272727273	1	0.0789473684210527	4	19
LOC770277	12	3	3	1	83.82	167.64	15	1	1	0.25	1	0.05	4	15
LOC770450	2	0	0	0	30.03	60.06	15	1	1	NA	1	NA	0	2
LOC770492	1	3	1	2	31.35	62.7	15	1	1	-0.5	1	-0.0833333333333333	3	4
LOC770548	2	2	2	0	22.11	44.22	15	1	0.466666666666667	-Inf	1	-0.5	2	4
LOC770653	1	4	0	0	23.1	46.2	15	1	1	NA	1	NA	0	5
LOC770881	2	3	0	0	85.8	171.6	15	1	1	NA	1	NA	0	5
LOC770936	2	1	0	0	73.92	147.84	15	1	1	NA	1	NA	0	3
LOC771012	9	7	1	0	157.08	314.16	15	1	1	-Inf	1	-0.4375	1	16
LOC771069	0	2	0	1	67.32	134.64	15	1	1	NA	1	0	1	2
LOC771085	9	7	2	1	137.94	275.88	15	1	1	-0.555555555555556	1	-0.104166666666667	3	16
LOC771308	3	5	0	0	109.89	219.78	15	1	1	NA	1	NA	0	8
LOC771362	4	5	0	1	209.22	418.44	15	1	1	1	1	0.444444444444444	1	9
LOC771388	4	3	0	1	102.96	205.92	15	1	1	1	1	0.571428571428571	1	7
LOC771422	0	15	0	2	160.05	320.1	15	1	1	NA	1	0	2	15
LOC771456	3	5	1	3	100.65	201.3	15	1	1	0.444444444444444	1	0.125	4	8
LOC771494	12	14	0	0	255.09	510.18	15	1	1	NA	1	NA	0	26
LOC771515	2	2	1	0	19.47	38.94	15	1	1	-Inf	1	-0.5	1	4
LOC771545	2	2	0	0	25.08	50.16	15	1	1	NA	1	NA	0	4
LOC771612	7	2	0	0	42.24	84.48	15	1	1	NA	1	NA	0	9
LOC771811	8	4	1	3	83.16	166.32	15	1	0.261538461538462	0.833333333333333	1	0.416666666666667	4	12
LOC771917	1	4	1	1	51.48	102.96	15	1	1	-3	1	-0.3	2	5
LOC771994	2	0	2	0	12.21	24.42	15	1	1	NA	1	0	2	2
LOC771995	3	4	1	2	106.92	213.84	15	1	1	0.333333333333333	1	0.0952380952380952	3	7
LOC772017	12	15	4	5	191.4	382.8	15	1	1	0	1	0	9	27
LOC776067	38	54	7	5	1149.39	2298.78	15	1	0.355436637324063	-0.989473684210526	1	-0.170289855072464	12	92
LOC776273	1	10	1	5	220.77	441.54	15	1	1	-1	1	-0.0757575757575757	6	11
LOC776275	0	3	0	2	23.76	47.52	15	1	1	NA	1	0	2	3
LOC776376	1	2	0	1	35.64	71.28	15	1	1	1	1	0.333333333333333	1	3
LOC776594	2	7	0	2	117.48	234.96	15	1	1	1	1	0.222222222222222	2	9
LOH11CR2A	7	9	1	2	191.73	383.46	15	1	1	0.357142857142857	1	0.104166666666667	3	16
LONP1	0	10	0	3	222.09	444.18	15	1	1	NA	1	0	3	10
LONP2	1	13	1	3	204.93	409.86	15	1	0.405228758169935	-3.33333333333333	1	-0.178571428571429	4	14
LONRF1	4	4	1	1	169.95	339.9	15	1	1	0	1	0	2	8
LONRF3	0	3	0	1	136.62	273.24	15	1	1	NA	1	0	1	3
LOX	0	4	0	1	41.91	83.82	15	1	1	NA	1	0	1	4
LOXHD1	4	27	0	5	562.98	1125.96	15	1	1	1	1	0.129032258064516	5	31
LOXL1	1	1	0	0	24.09	48.18	15	1	1	NA	1	NA	0	2
LOXL2	2	7	1	1	142.56	285.12	15	1	0.490909090909091	-2.5	1	-0.277777777777778	2	9
LOXL3	3	4	1	0	125.4	250.8	15	1	1	-Inf	1	-0.571428571428571	1	7
LOXL4	1	5	1	1	98.67	197.34	15	1	0.464285714285714	-4	1	-0.333333333333333	2	6
LPAR1	1	2	0	0	58.41	116.82	15	1	1	NA	1	NA	0	3
LPAR3	0	2	0	1	151.47	302.94	15	1	1	NA	1	0	1	2
LPAR4	2	7	2	4	145.2	290.4	15	1	1	-0.75	1	-0.111111111111111	6	9
LPAR5	6	3	0	0	82.17	164.34	15	1	1	NA	1	NA	0	9
LPCAT1	0	6	0	1	129.36	258.72	15	1	1	NA	1	0	1	6
LPCAT2	3	4	1	1	151.14	302.28	15	1	1	-0.333333333333333	1	-0.0714285714285715	2	7
LPCAT3	3	5	1	0	149.82	299.64	15	1	0.444444444444444	-Inf	1	-0.625	1	8
LPGAT1	0	3	0	0	106.26	212.52	15	1	1	NA	1	NA	0	3
LPIN2	4	6	0	1	297	594	15	1	1	1	1	0.4	1	10
LPL	1	3	0	0	86.79	173.58	15	1	1	NA	1	NA	0	4
LPO	6	8	0	0	229.02	458.04	15	1	1	NA	1	NA	0	14
LPP	0	2	0	0	42.9	85.8	15	1	1	NA	1	NA	0	2
LPXN	3	1	0	0	29.37	58.74	15	1	1	NA	1	NA	0	4
LRAT	2	6	0	0	36.3	72.6	15	1	1	NA	1	NA	0	8
LRBA	16	28	6	2	840.18	1680.36	15	1	0.0581308336328198	-4.25	1	-0.386363636363636	8	44
LRCH1	3	8	0	2	207.9	415.8	15	1	1	1	1	0.272727272727273	2	11
LRCH2	2	2	0	0	135.63	271.26	15	1	1	NA	1	NA	0	4
LRCH3	5	11	3	0	245.52	491.04	15	1	0.0577915376676986	-Inf	1	-0.6875	3	16
LRFN2	1	4	0	0	97.02	194.04	15	1	1	NA	1	NA	0	5
LRFN3	0	9	0	5	149.16	298.32	15	1	1	NA	1	0	5	9
LRG1	1	0	1	0	15.84	31.68	15	1	1	NA	1	0	1	1
LRGUK	8	15	0	5	211.86	423.72	15	1	0.280830280830281	1	1	0.347826086956522	5	23
LRIF1	17	18	0	2	215.49	430.98	15	1	0.48948948948949	1	1	0.485714285714286	2	35
LRIG1	4	13	3	4	303.6	607.2	15	1	0.374234334188568	-1.4375	1	-0.19327731092437	7	17
LRIG2	5	12	0	0	334.62	669.24	15	1	1	NA	1	NA	0	17
LRIG3	11	13	2	2	367.95	735.9	15	1	1	-0.181818181818182	1	-0.0416666666666667	4	24
LRIT1	5	5	2	1	216.48	432.96	15	1	1	-1	1	-0.166666666666667	3	10
LRIT2	4	4	1	0	84.81	169.62	15	1	1	-Inf	1	-0.5	1	8
LRIT3	18	18	5	4	372.24	744.48	15	1	1	-0.25	1	-0.0555555555555556	9	36
LRMP	17	12	4	4	430.32	860.64	15	1	0.704842672584608	0.294117647058823	1	0.0862068965517241	8	29
LRMPL	1	1	1	1	21.78	43.56	15	1	1	0	1	0	2	2
LRP1	1	77	1	11	939.84	1879.68	15	1	0.250187265917603	-6	1	-0.0705128205128205	12	78
LRP11	3	6	0	0	107.91	215.82	15	1	1	NA	1	NA	0	9
LRP12	3	14	0	1	263.34	526.68	15	1	1	1	1	0.176470588235294	1	17
LRP1B	17	44	4	3	1371.15	2742.3	15	1	0.190420745582408	-2.45098039215686	1	-0.292740046838407	7	61
LRP2	13	74	2	3	1562.22	3124.44	15	1	0.185455889168639	-2.79487179487179	1	-0.250574712643678	5	87
LRP3	3	12	1	1	283.8	567.6	15	1	0.426470588235294	-3	1	-0.3	2	15
LRP4	3	26	0	4	612.48	1224.96	15	1	1	1	1	0.103448275862069	4	29
LRP5	1	25	0	2	489.72	979.44	15	1	1	1	1	0.0384615384615385	2	26
LRP6	2	23	1	1	465.3	930.6	15	1	0.213675213675214	-10.5	1	-0.42	2	25
LRP8	8	12	3	2	315.15	630.3	15	1	0.623188405797101	-1.25	1	-0.2	5	20
LRPAP1	1	3	0	0	100.98	201.96	15	1	1	NA	1	NA	0	4
LRR1	3	9	0	1	92.4	184.8	15	1	1	1	1	0.25	1	12
LRRC1	6	15	4	3	221.76	443.52	15	1	0.207459207459207	-2.33333333333333	1	-0.285714285714286	7	21
LRRC14B	17	12	2	2	327.36	654.72	15	1	1	0.294117647058823	1	0.0862068965517241	4	29
LRRC15	2	4	2	2	67.32	134.64	15	1	1	-1	1	-0.166666666666667	4	6
LRRC17	0	5	0	0	157.74	315.48	15	1	1	NA	1	NA	0	5
LRRC18	2	4	0	0	77.88	155.76	15	1	1	NA	1	NA	0	6
LRRC23	2	3	1	1	64.35	128.7	15	1	1	-0.5	1	-0.1	2	5
LRRC27	3	11	1	1	273.24	546.48	15	1	0.45	-2.66666666666667	1	-0.285714285714286	2	14
LRRC28	1	3	1	0	99.99	199.98	15	1	0.4	-Inf	1	-0.75	1	4
LRRC30	9	9	1	1	143.88	287.76	15	1	1	0	1	0	2	18
LRRC31	11	11	5	1	218.13	436.26	15	1	0.196475022561979	-4	1	-0.333333333333333	6	22
LRRC32	4	11	1	0	224.73	449.46	15	1	0.3125	-Inf	1	-0.733333333333333	1	15
LRRC34	11	3	3	1	153.78	307.56	15	1	1	0.181818181818182	1	0.0357142857142857	4	14
LRRC38	1	1	0	0	97.35	194.7	15	1	1	NA	1	NA	0	2
LRRC39	4	1	1	0	107.58	215.16	15	1	1	-Inf	1	-0.2	1	5
LRRC40	3	14	0	2	186.78	373.56	15	1	1	1	1	0.176470588235294	2	17
LRRC41	14	19	2	4	188.1	376.2	15	1	1	0.321428571428571	1	0.0909090909090909	6	33
LRRC42	4	4	1	1	123.09	246.18	15	1	1	0	1	0	2	8
LRRC45	1	4	0	0	177.87	355.74	15	1	1	NA	1	NA	0	5
LRRC47	2	8	0	0	98.34	196.68	15	1	1	NA	1	NA	0	10
LRRC49	3	9	1	1	219.78	439.56	15	1	0.505494505494505	-2	1	-0.25	2	12
LRRC4C	1	7	1	2	272.25	544.5	15	1	0.490909090909091	-2.5	1	-0.208333333333333	3	8
LRRC56	11	8	1	2	206.91	413.82	15	1	0.571428571428571	0.636363636363636	1	0.245614035087719	3	19
LRRC57	0	2	0	0	61.05	122.1	15	1	1	NA	1	NA	0	2
LRRC59	0	3	0	1	60.72	121.44	15	1	1	NA	1	0	1	3
LRRC6	11	8	2	1	201.3	402.6	15	1	1	-0.454545454545455	1	-0.087719298245614	3	19
LRRC66	55	23	3	2	399.96	799.92	15	1	0.634683290811354	0.372727272727273	1	0.105128205128205	5	78
LRRC7	1	7	1	4	443.85	887.7	15	1	1	-0.75	1	-0.075	5	8
LRRC72	1	3	0	0	62.7	125.4	15	1	1	NA	1	NA	0	4
LRRC73	1	3	1	0	63.36	126.72	15	1	0.4	-Inf	1	-0.75	1	4
LRRC74A	7	4	4	1	171.6	343.2	15	1	1	-1.28571428571429	1	-0.163636363636364	5	11
LRRC75A	1	2	0	1	45.54	91.08	15	1	1	1	1	0.333333333333333	1	3
LRRC8A	1	14	0	2	246.84	493.68	15	1	1	1	1	0.0666666666666667	2	15
LRRC8C	0	6	0	1	277.86	555.72	15	1	1	NA	1	0	1	6
LRRC9	17	13	2	3	446.49	892.98	15	1	0.641809803100126	0.490196078431373	1	0.166666666666667	5	30
LRRCC1	12	12	2	1	268.95	537.9	15	1	1	-1	1	-0.166666666666667	3	24
LRRFIP1	11	10	0	1	382.8	765.6	15	1	1	1	1	0.523809523809524	1	21
LRRIQ1	25	9	2	1	373.56	747.12	15	1	1	0.28	1	0.0686274509803922	3	34
LRRIQ4	10	8	1	0	185.13	370.26	15	1	1	-Inf	1	-0.444444444444444	1	18
LRRK2	6	32	1	5	827.64	1655.28	15	1	1	-0.0666666666666667	1	-0.0087719298245614	6	38
LRRN1	0	20	0	1	297.33	594.66	15	1	1	NA	1	0	1	20
LRRN2	6	6	3	1	107.58	215.16	15	1	0.584615384615385	-2	1	-0.25	4	12
LRRN3	4	14	1	1	262.68	525.36	15	1	0.447368421052632	-2.5	1	-0.277777777777778	2	18
LRRN4	10	12	1	4	219.12	438.24	15	1	0.618481357611792	0.7	1	0.254545454545455	5	22
LRRTM2	1	2	1	0	102.3	204.6	15	1	1	-Inf	1	-0.666666666666667	1	3
LRRTM4	5	4	3	1	51.15	102.3	15	1	1	-1.4	1	-0.194444444444444	4	9
LRSAM1	7	6	1	3	240.24	480.48	15	1	0.576470588235294	0.714285714285714	1	0.288461538461538	4	13
LRTM2	1	6	0	0	98.01	196.02	15	1	1	NA	1	NA	0	7
LRWD1	7	12	1	0	229.02	458.04	15	1	0.4	-Inf	1	-0.631578947368421	1	19
LSG1	7	6	0	0	149.16	298.32	15	1	1	NA	1	NA	0	13
LSM10	1	1	1	0	13.86	27.72	15	1	1	-Inf	1	-0.5	1	2
LSM11	3	3	2	0	53.13	106.26	15	1	0.464285714285714	-Inf	1	-0.5	2	6
LSM14A	0	7	0	2	92.73	185.46	15	1	1	NA	1	0	2	7
LSM14B	0	2	0	1	118.8	237.6	15	1	1	NA	1	0	1	2
LSM3	0	2	0	0	24.42	48.84	15	1	1	NA	1	NA	0	2
LSM4	0	1	0	1	10.89	21.78	15	1	1	NA	1	0	1	1
LSM6	0	1	0	1	15.18	30.36	15	1	1	NA	1	0	1	1
LSM7	1	11	0	4	201.96	403.92	15	1	1	1	1	0.0833333333333333	4	12
LSMEM1	5	3	2	1	73.26	146.52	15	1	1	-0.2	1	-0.0416666666666666	3	8
LSP1	5	7	1	0	102.96	205.92	15	1	0.461538461538462	-Inf	1	-0.583333333333333	1	12
LSS	5	19	1	2	224.4	448.8	15	1	0.545299145299145	-0.9	1	-0.125	3	24
LTA4H	2	8	1	2	168.96	337.92	15	1	1	-1	1	-0.133333333333333	3	10
LTBP1	6	11	2	3	575.19	1150.38	15	1	1	-0.222222222222222	1	-0.0470588235294118	5	17
LTBP2	6	17	0	8	387.75	775.5	15	1	0.297643155262732	1	1	0.260869565217391	8	23
LTC4S	1	1	0	0	43.56	87.12	15	1	1	NA	1	NA	0	2
LTC4SL	0	3	0	1	44.22	88.44	15	1	1	NA	1	0	1	3
LTK	4	17	0	2	446.49	892.98	15	1	1	1	1	0.19047619047619	2	21
LTN1	18	20	6	5	533.28	1066.56	15	1	0.741643326683333	-0.333333333333333	1	-0.0717703349282297	11	38
LTV1	8	15	2	4	206.91	413.82	15	1	1	0.0625	1	0.0144927536231884	6	23
LUC7L2	0	5	0	0	140.58	281.16	15	1	1	NA	1	NA	0	5
LUC7L3	1	2	0	0	69.63	139.26	15	1	1	NA	1	NA	0	3
LURAP1	6	4	1	1	25.74	51.48	15	1	1	0.333333333333333	1	0.1	2	10
LURAP1L	2	1	0	0	57.42	114.84	15	1	1	NA	1	NA	0	3
LUZP1	14	13	3	2	371.91	743.82	15	1	1	-0.392857142857143	1	-0.0814814814814815	5	27
LUZP2	6	0	4	0	46.86	93.72	15	1	1	NA	1	0	4	6
LVRN	4	7	1	1	187.77	375.54	15	1	1	-0.75	1	-0.136363636363636	2	11
LY6CLEL	0	4	0	3	18.48	36.96	15	1	1	NA	1	0	3	4
LY75	7	14	3	1	511.17	1022.34	15	1	0.266798418972332	-5	1	-0.416666666666667	4	21
LY9	4	2	0	1	29.37	58.74	15	1	0.428571428571429	1	1	0.666666666666667	1	6
LY96	1	2	0	0	44.55	89.1	15	1	1	NA	1	NA	0	3
LYAR	4	3	2	0	102.96	205.92	15	1	0.5	-Inf	1	-0.428571428571429	2	7
LYG2	2	3	0	0	55.77	111.54	15	1	1	NA	1	NA	0	5
LYPD1	1	3	0	0	44.88	89.76	15	1	1	NA	1	NA	0	4
LYPD2	1	4	0	1	39.6	79.2	15	1	1	1	1	0.2	1	5
LYPD6	3	3	0	0	67.98	135.96	15	1	1	NA	1	NA	0	6
LYPD6B	3	2	2	1	72.93	145.86	15	1	1	-0.333333333333333	1	-0.0666666666666667	3	5
LYPLA1	1	3	0	1	60.06	120.12	15	1	1	1	1	0.25	1	4
LYPLA2	1	5	1	1	39.93	79.86	15	1	0.464285714285714	-4	1	-0.333333333333333	2	6
LYRM7	2	2	1	0	26.07	52.14	15	1	1	-Inf	1	-0.5	1	4
LYRM9	2	0	0	0	33.99	67.98	15	1	1	NA	1	NA	0	2
LYSMD2	0	2	0	0	64.02	128.04	15	1	1	NA	1	NA	0	2
LYSMD3	2	2	0	0	44.22	88.44	15	1	1	NA	1	NA	0	4
LYSMD4	3	4	1	0	57.42	114.84	15	1	1	-Inf	1	-0.571428571428571	1	7
LYST	35	44	10	10	1246.74	2493.48	15	1	0.802171886512673	-0.257142857142857	1	-0.0569620253164557	20	79
LYVE1	7	8	2	1	141.57	283.14	15	1	1	-1.28571428571429	1	-0.2	3	15
LZTFL1	0	7	0	2	76.23	152.46	15	1	1	NA	1	0	2	7
LZTR1	7	15	1	2	266.97	533.94	15	1	1	-0.0714285714285714	1	-0.0151515151515151	3	22
LZTS1	2	7	0	3	74.25	148.5	15	1	1	1	1	0.222222222222222	3	9
LZTS2	1	1	0	1	39.93	79.86	15	1	1	1	1	0.5	1	2
M1AP	12	7	6	2	209.55	419.1	15	1	0.675816357555488	-0.75	1	-0.118421052631579	8	19
M6PR	6	3	1	0	75.57	151.14	15	1	1	-Inf	1	-0.333333333333333	1	9
MAATS1	5	6	1	1	178.53	357.06	15	1	1	-0.2	1	-0.0454545454545455	2	11
MAB21L1	0	2	0	0	68.31	136.62	15	1	1	NA	1	NA	0	2
MAB21L2	0	3	0	1	74.58	149.16	15	1	1	NA	1	0	1	3
MAB21L3	2	3	0	0	123.42	246.84	15	1	1	NA	1	NA	0	5
MACC1	8	8	3	0	229.68	459.36	15	1	0.228070175438596	-Inf	1	-0.5	3	16
MACROD2	3	0	0	0	85.47	170.94	15	1	1	NA	1	NA	0	3
MAD1L1	0	2	0	0	135.3	270.6	15	1	1	NA	1	NA	0	2
MAD2L1	0	7	0	4	53.46	106.92	15	1	1	NA	1	0	4	7
MAD2L1BP	5	1	2	0	44.22	88.44	15	1	1	-Inf	1	-0.166666666666667	2	6
MAD2L2	0	3	0	2	48.84	97.68	15	1	1	NA	1	0	2	3
MADCAM1	5	5	0	1	62.04	124.08	15	1	1	1	1	0.5	1	10
MADD	7	16	1	2	475.53	951.06	15	1	1	-0.142857142857143	1	-0.0289855072463768	3	23
MAEA	0	3	0	0	121.77	243.54	15	1	1	NA	1	NA	0	3
MAEL	3	9	0	1	128.7	257.4	15	1	1	1	1	0.25	1	12
MAFB	0	2	0	1	28.71	57.42	15	1	1	NA	1	0	1	2
MAGI2	6	12	0	3	374.88	749.76	15	1	0.526315789473684	1	1	0.333333333333333	3	18
MAGI3	12	20	0	0	429	858	15	1	1	NA	1	NA	0	32
MAGOH	0	2	0	0	23.43	46.86	15	1	1	NA	1	NA	0	2
MAK	7	4	2	1	182.82	365.64	15	1	1	-0.142857142857143	1	-0.0303030303030303	3	11
MAK16	2	1	1	0	37.62	75.24	15	1	1	-Inf	1	-0.333333333333333	1	3
MAL	2	1	0	0	32.01	64.02	15	1	1	NA	1	NA	0	3
MALL	0	4	0	1	49.17	98.34	15	1	1	NA	1	0	1	4
MALSU1	1	1	0	1	47.19	94.38	15	1	1	1	1	0.5	1	2
MAMDC2	1	8	0	0	156.42	312.84	15	1	1	NA	1	NA	0	9
MAMDC4	7	22	2	1	230.01	460.02	15	1	0.183870967741935	-5.28571428571429	1	-0.425287356321839	3	29
MAML1	5	11	1	5	253.77	507.54	15	1	0.634112018012947	0.56	1	0.145833333333333	6	16
MAML3	6	9	1	1	176.88	353.76	15	1	1	-0.5	1	-0.1	2	15
MAMLD1	7	12	3	2	344.85	689.7	15	1	0.614624505928854	-1.57142857142857	1	-0.231578947368421	5	19
MAN1A1	1	4	0	0	127.71	255.42	15	1	1	NA	1	NA	0	5
MAN1B1	6	8	0	0	147.84	295.68	15	1	1	NA	1	NA	0	14
MAN1C1	4	2	0	0	120.78	241.56	15	1	1	NA	1	NA	0	6
MAN2A1	6	11	3	1	219.78	439.56	15	1	0.27218045112782	-4.5	1	-0.397058823529412	4	17
MAN2A2	3	14	1	5	196.35	392.7	15	1	1	0.0666666666666667	1	0.00980392156862747	6	17
MAN2B2	11	13	1	2	313.5	627	15	1	1	0.409090909090909	1	0.125	3	24
MAN2C1	14	15	4	3	208.23	416.46	15	1	1	-0.428571428571429	1	-0.0886699507389162	7	29
MANBA	10	20	4	0	249.48	498.96	15	1	0.021584440227704	-Inf	1	-0.666666666666667	4	30
MANEA	2	5	1	0	165.33	330.66	15	1	0.375	-Inf	1	-0.714285714285714	1	7
MANEAL	1	6	1	2	76.89	153.78	15	1	1	-2	1	-0.19047619047619	3	7
MANF	1	2	0	0	27.72	55.44	15	1	1	NA	1	NA	0	3
MANSC1	12	4	0	0	126.39	252.78	15	1	1	NA	1	NA	0	16
MANSC4	14	2	0	1	96.03	192.06	15	1	0.176470588235294	1	1	0.875	1	16
MAOA	2	6	0	1	175.23	350.46	15	1	1	1	1	0.25	1	8
MAOB	9	5	1	1	206.91	413.82	15	1	1	0.444444444444444	1	0.142857142857143	2	14
MAP1A	39	30	5	2	1047.09	2094.18	15	1	0.692009777377934	-0.923076923076923	1	-0.149068322981367	7	69
MAP1B	12	33	2	1	594.99	1189.98	15	1	0.199930619796485	-4.5	1	-0.4	3	45
MAP1LC3A	0	2	0	1	36.96	73.92	15	1	1	NA	1	0	1	2
MAP1LC3C	0	2	0	1	30.36	60.72	15	1	1	NA	1	0	1	2
MAP2	14	26	4	3	666.93	1333.86	15	1	0.402934711414654	-1.47619047619048	1	-0.221428571428571	7	40
MAP2K1	0	3	0	1	115.17	230.34	15	1	1	NA	1	0	1	3
MAP2K3	0	4	0	2	77.88	155.76	15	1	1	NA	1	0	2	4
MAP2K4	2	3	0	0	141.24	282.48	15	1	1	NA	1	NA	0	5
MAP2K5	1	5	0	1	111.87	223.74	15	1	1	1	1	0.166666666666667	1	6
MAP3K1	6	15	1	0	350.79	701.58	15	1	0.318181818181818	-Inf	1	-0.714285714285714	1	21
MAP3K13	4	12	0	2	332.64	665.28	15	1	1	1	1	0.25	2	16
MAP3K14	2	6	1	0	265.98	531.96	15	1	0.333333333333333	-Inf	1	-0.75	1	8
MAP3K15	9	16	3	3	437.25	874.5	15	1	0.652556564681148	-0.777777777777778	1	-0.14	6	25
MAP3K19	29	23	6	4	430.98	861.96	15	1	1	-0.189655172413793	1	-0.0423076923076923	10	52
MAP3K2	1	9	1	1	244.53	489.06	15	1	0.318181818181818	-8	1	-0.4	2	10
MAP3K20	2	8	2	3	253.77	507.54	15	1	0.56043956043956	-1.66666666666667	1	-0.2	5	10
MAP3K21	4	14	0	0	241.56	483.12	15	1	1	NA	1	NA	0	18
MAP3K3	4	4	2	2	168.3	336.6	15	1	1	0	1	0	4	8
MAP3K4	6	16	2	2	432.96	865.92	15	1	0.563344481605351	-1.66666666666667	1	-0.227272727272727	4	22
MAP3K5	0	11	0	2	380.49	760.98	15	1	1	NA	1	0	2	11
MAP3K6	2	1	1	1	33.99	67.98	15	1	1	0.5	1	0.166666666666667	2	3
MAP3K7	1	1	0	1	168.3	336.6	15	1	1	1	1	0.5	1	2
MAP3K8	1	10	1	1	141.24	282.48	15	1	0.294871794871795	-9	1	-0.409090909090909	2	11
MAP4	40	43	6	5	493.35	986.7	15	1	0.756363590504043	-0.29	1	-0.0635268346111719	11	83
MAP4K3	1	11	0	2	266.97	533.94	15	1	1	1	1	0.0833333333333333	2	12
MAP4K4	3	14	1	4	509.85	1019.7	15	1	1	-0.166666666666667	1	-0.0235294117647059	5	17
MAP6	0	2	0	0	55.44	110.88	15	1	1	NA	1	NA	0	2
MAP7	7	1	1	0	218.13	436.26	15	1	1	-Inf	1	-0.125	1	8
MAP7D1	1	1	1	1	18.81	37.62	15	1	1	0	1	0	2	2
MAP7D2	2	10	1	0	218.13	436.26	15	1	0.230769230769231	-Inf	1	-0.833333333333333	1	12
MAP7D3	8	4	2	1	264	528	15	1	1	0	1	0	3	12
MAP9	8	7	1	0	122.76	245.52	15	1	1	-Inf	1	-0.466666666666667	1	15
MAPK1	0	2	0	0	67.98	135.96	15	1	1	NA	1	NA	0	2
MAPK10	4	3	2	1	172.26	344.52	15	1	1	-0.5	1	-0.0952380952380952	3	7
MAPK12	6	6	0	0	128.04	256.08	15	1	1	NA	1	NA	0	12
MAPK13	0	2	0	0	116.49	232.98	15	1	1	NA	1	NA	0	2
MAPK14	0	3	0	0	92.07	184.14	15	1	1	NA	1	NA	0	3
MAPK15	8	4	0	0	208.56	417.12	15	1	1	NA	1	NA	0	12
MAPK6	0	5	0	1	266.97	533.94	15	1	1	NA	1	0	1	5
MAPK8IP3	15	22	9	6	504.9	1009.8	15	1	0.233722791200694	-1.2	1	-0.194594594594595	15	37
MAPK9	0	5	0	1	121.77	243.54	15	1	1	NA	1	0	1	5
MAPKAP1	0	4	0	2	167.31	334.62	15	1	1	NA	1	0	2	4
MAPKAPK3	0	3	0	1	103.29	206.58	15	1	1	NA	1	0	1	3
MAPKAPK5	0	3	0	2	128.37	256.74	15	1	1	NA	1	0	2	3
MAPKKK3L	0	7	0	1	153.78	307.56	15	1	1	NA	1	0	1	7
MAPRE1	0	3	0	0	46.86	93.72	15	1	1	NA	1	NA	0	3
MAPRE2	2	2	1	0	92.73	185.46	15	1	1	-Inf	1	-0.5	1	4
MAPT	6	4	0	1	140.91	281.82	15	1	0.454545454545455	1	1	0.6	1	10
MARC1	2	4	1	1	66.66	133.32	15	1	1	-1	1	-0.166666666666667	2	6
MARCH1	6	8	1	1	175.89	351.78	15	1	1	-0.333333333333333	1	-0.0714285714285715	2	14
MARCH3	0	1	0	1	53.79	107.58	15	1	1	NA	1	0	1	1
MARCH4	4	0	0	0	81.18	162.36	15	1	1	NA	1	NA	0	4
MARCH6	1	13	0	3	239.58	479.16	15	1	1	1	1	0.0714285714285714	3	14
MARCH7	12	10	0	2	344.52	689.04	15	1	0.478260869565217	1	1	0.545454545454545	2	22
MARCH8	3	5	2	1	151.8	303.6	15	1	0.545454545454546	-2.33333333333333	1	-0.291666666666667	3	8
MARCO	9	9	2	0	160.05	320.1	15	1	0.478947368421053	-Inf	1	-0.5	2	18
MARK1	1	5	0	2	199.32	398.64	15	1	1	1	1	0.166666666666667	2	6
MARK3	1	9	1	2	248.49	496.98	15	1	0.423076923076923	-3.5	1	-0.233333333333333	3	10
MARS	3	15	1	3	108.57	217.14	15	1	1	-0.666666666666667	1	-0.0833333333333333	4	18
MARS2	4	11	1	2	206.58	413.16	15	1	1	-0.375	1	-0.0666666666666667	3	15
MARVELD2	0	3	0	0	78.21	156.42	15	1	1	NA	1	NA	0	3
MAS1	3	2	1	0	89.76	179.52	15	1	1	-Inf	1	-0.4	1	5
MASP1	5	26	2	9	257.73	515.46	15	1	1	-0.155555555555555	1	-0.0205278592375367	11	31
MASP2	4	10	1	2	238.59	477.18	15	1	1	-0.25	1	-0.0476190476190476	3	14
MAST2	8	14	1	3	576.84	1153.68	15	1	1	0.416666666666667	1	0.113636363636364	4	22
MAST3	6	22	5	9	278.19	556.38	15	1	0.458815314975173	-1.03703703703704	1	-0.142857142857143	14	28
MAST4	13	20	0	1	578.16	1156.32	15	1	1	1	1	0.393939393939394	1	33
MASTL	9	14	1	5	276.54	553.08	15	1	0.632815460401667	0.688888888888889	1	0.22463768115942	6	23
MAT1A	1	7	0	0	119.13	238.26	15	1	1	NA	1	NA	0	8
MAT2A	2	2	1	1	81.84	163.68	15	1	1	0	1	0	2	4
MAT2B	3	4	1	1	100.32	200.64	15	1	1	-0.333333333333333	1	-0.0714285714285715	2	7
MATK	2	9	0	4	72.93	145.86	15	1	1	1	1	0.181818181818182	4	11
MATN1	0	5	0	3	141.57	283.14	15	1	1	NA	1	0	3	5
MATN2	4	17	1	3	376.86	753.72	15	1	1	-0.416666666666667	1	-0.0595238095238095	4	21
MATN3	2	5	1	1	105.93	211.86	15	1	1	-1.5	1	-0.214285714285714	2	7
MATN4	1	7	0	3	99.66	199.32	15	1	1	1	1	0.125	3	8
MATR3	2	8	0	2	237.27	474.54	15	1	1	1	1	0.2	2	10
MAU2	0	4	0	1	157.41	314.82	15	1	1	NA	1	0	1	4
MB	0	5	0	3	49.83	99.66	15	1	1	NA	1	0	3	5
MB21D1	8	4	0	0	68.31	136.62	15	1	1	NA	1	NA	0	12
MB21D2	1	5	1	0	146.85	293.7	15	1	0.285714285714286	-Inf	1	-0.833333333333333	1	6
MBD5	3	11	0	1	567.6	1135.2	15	1	1	1	1	0.214285714285714	1	14
MBIP	1	4	1	0	77.88	155.76	15	1	0.333333333333333	-Inf	1	-0.8	1	5
MBL2	2	0	0	0	72.27	144.54	15	1	1	NA	1	NA	0	2
MBNL1	9	6	4	1	96.03	192.06	15	1	0.612616099071207	-1.66666666666667	1	-0.2	5	15
MBOAT1	0	3	0	1	162.69	325.38	15	1	1	NA	1	0	1	3
MBOAT2	0	6	0	1	139.92	279.84	15	1	1	NA	1	0	1	6
MBP	0	4	0	0	83.16	166.32	15	1	1	NA	1	NA	0	4
MBTD1	3	3	0	1	179.19	358.38	15	1	1	1	1	0.5	1	6
MBTPS1	1	14	0	1	379.83	759.66	15	1	1	1	1	0.0666666666666667	1	15
MBTPS2	1	6	0	1	137.28	274.56	15	1	1	1	1	0.142857142857143	1	7
MC1R	0	2	0	1	48.18	96.36	15	1	1	NA	1	0	1	2
MC2R	0	5	0	0	93.72	187.44	15	1	1	NA	1	NA	0	5
MC5R	1	3	0	1	97.02	194.04	15	1	1	1	1	0.25	1	4
MCAM	0	4	0	4	31.02	62.04	15	1	1	NA	1	0	4	4
MCC	0	7	0	1	98.34	196.68	15	1	1	NA	1	0	1	7
MCCC1	8	12	2	0	296.34	592.68	15	1	0.194805194805195	-Inf	1	-0.6	2	20
MCCC2	2	10	0	1	120.78	241.56	15	1	1	1	1	0.166666666666667	1	12
MCCC2L	6	10	1	0	194.7	389.4	15	1	0.411764705882353	-Inf	1	-0.625	1	16
MCEE	2	0	1	0	44.88	89.76	15	1	1	NA	1	0	1	2
MCF2	8	12	1	0	338.91	677.82	15	1	0.428571428571429	-Inf	1	-0.6	1	20
MCF2L2	3	14	0	2	414.48	828.96	15	1	1	1	1	0.176470588235294	2	17
MCHR1	3	8	1	0	133.65	267.3	15	1	0.333333333333333	-Inf	1	-0.727272727272727	1	11
MCHR2	0	10	0	0	104.61	209.22	15	1	1	NA	1	NA	0	10
MCM10	5	8	1	3	145.86	291.72	15	1	1	0.466666666666667	1	0.134615384615385	4	13
MCM2	1	16	0	4	254.1	508.2	15	1	1	1	1	0.0588235294117647	4	17
MCM3	2	13	0	5	184.14	368.28	15	1	1	1	1	0.133333333333333	5	15
MCM3AP	14	28	3	1	448.14	896.28	15	1	0.135429114195545	-5	1	-0.416666666666667	4	42
MCM4	5	14	2	2	217.8	435.6	15	1	0.557312252964427	-1.8	1	-0.236842105263158	4	19
MCM5	1	8	1	5	178.53	357.06	15	1	1	-0.6	1	-0.0555555555555556	6	9
MCM6	1	7	0	0	282.48	564.96	15	1	1	NA	1	NA	0	8
MCM8	2	22	1	5	276.21	552.42	15	1	0.501477832512315	-1.2	1	-0.0833333333333333	6	24
MCM9	16	14	1	2	284.13	568.26	15	1	0.601173020527859	0.5625	1	0.2	3	30
MCMBP	1	8	0	0	162.69	325.38	15	1	1	NA	1	NA	0	9
MCMDC2	15	11	5	3	245.52	491.04	15	1	1	-0.222222222222222	1	-0.0480769230769231	8	26
MCOLN2	2	6	1	1	173.58	347.16	15	1	1	-2	1	-0.25	2	8
MCOLN3	2	8	1	1	177.87	355.74	15	1	0.454545454545455	-3	1	-0.3	2	10
MCPH1	11	5	0	1	178.53	357.06	15	1	0.352941176470588	1	1	0.6875	1	16
MCT2L	4	4	0	0	154.77	309.54	15	1	1	NA	1	NA	0	8
MCTP1	2	0	1	0	44.88	89.76	15	1	1	NA	1	0	1	2
MCTP2	5	5	0	0	222.75	445.5	15	1	1	NA	1	NA	0	10
MCTS1	1	2	0	0	42.9	85.8	15	1	1	NA	1	NA	0	3
MDC1	26	12	2	1	158.73	317.46	15	1	1	0.0769230769230769	1	0.0175438596491229	3	38
MDFI	0	1	0	1	21.12	42.24	15	1	1	NA	1	0	1	1
MDGA2	8	17	2	8	265.65	531.3	15	1	0.685781731191664	0.46875	1	0.12	10	25
MDH1	0	2	0	1	99	198	15	1	1	NA	1	0	1	2
MDH1B	23	12	3	1	231	462	15	1	1	-0.565217391304348	1	-0.0928571428571429	4	35
MDH2	0	4	0	1	78.87	157.74	15	1	1	NA	1	0	1	4
MDK	0	2	0	1	6.6	13.2	15	1	1	NA	1	0	1	2
MDM1	8	14	1	1	220.11	440.22	15	1	1	-0.75	1	-0.136363636363636	2	22
MDM2	3	11	1	3	128.04	256.08	15	1	1	-0.222222222222222	1	-0.0357142857142857	4	14
MDM4	3	9	1	1	190.41	380.82	15	1	0.505494505494505	-2	1	-0.25	2	12
MDN1	55	63	14	8	1651.32	3302.64	15	1	0.167762744172921	-1.00454545454545	1	-0.170261941448382	22	118
ME1	0	4	0	0	146.85	293.7	15	1	1	NA	1	NA	0	4
ME3	2	6	1	2	176.22	352.44	15	1	1	-0.5	1	-0.0833333333333333	3	8
MEAF6	1	1	0	0	40.59	81.18	15	1	1	NA	1	NA	0	2
MECOM	3	7	1	1	323.73	647.46	15	1	1	-1.33333333333333	1	-0.2	2	10
MECR	3	5	1	2	70.62	141.24	15	1	1	0.166666666666667	1	0.0416666666666667	3	8
MED1	3	16	1	5	399.96	799.92	15	1	1	-0.0666666666666667	1	-0.0087719298245614	6	19
MED12	0	27	0	0	588.72	1177.44	15	1	1	NA	1	NA	0	27
MED12L	6	20	3	3	472.89	945.78	15	1	0.314029477196885	-2.33333333333333	1	-0.269230769230769	6	26
MED13	2	19	0	1	675.18	1350.36	15	1	1	1	1	0.0952380952380952	1	21
MED13L	3	24	1	7	726.66	1453.32	15	1	1	-0.142857142857143	1	-0.0138888888888889	8	27
MED14	0	17	0	2	454.41	908.82	15	1	1	NA	1	0	2	17
MED16	2	15	0	4	242.55	485.1	15	1	1	1	1	0.117647058823529	4	17
MED17	1	6	0	2	165	330	15	1	1	1	1	0.142857142857143	2	7
MED18	2	0	1	0	38.28	76.56	15	1	1	NA	1	0	1	2
MED21	1	1	0	0	45.54	91.08	15	1	1	NA	1	NA	0	2
MED22	0	2	0	1	39.27	78.54	15	1	1	NA	1	0	1	2
MED24	1	8	0	2	120.45	240.9	15	1	1	1	1	0.111111111111111	2	9
MED26	2	5	1	1	227.04	454.08	15	1	1	-1.5	1	-0.214285714285714	2	7
MED28	1	0	1	0	42.24	84.48	15	1	1	NA	1	0	1	1
MED4	0	3	0	1	59.4	118.8	15	1	1	NA	1	0	1	3
MED8	0	6	0	1	93.72	187.44	15	1	1	NA	1	0	1	6
MEF2B	1	1	0	0	15.51	31.02	15	1	1	NA	1	NA	0	2
MEF2C	0	2	0	0	122.1	244.2	15	1	1	NA	1	NA	0	2
MEGF10	5	17	1	1	315.48	630.96	15	1	0.445652173913043	-2.4	1	-0.272727272727273	2	22
MEGF6	15	27	4	4	308.22	616.44	15	1	0.458820331186573	-0.8	1	-0.142857142857143	8	42
MEGF6L	1	2	0	0	437.58	875.16	15	1	1	NA	1	NA	0	3
MEGF9	1	8	0	0	132.99	265.98	15	1	1	NA	1	NA	0	9
MEI1	9	16	4	5	404.25	808.5	15	1	0.704115684093437	-0.422222222222222	1	-0.0844444444444444	9	25
MEI4	1	3	0	2	36.96	73.92	15	1	1	1	1	0.25	2	4
MEIKIN	18	8	5	0	145.86	291.72	15	1	0.291228937502575	-Inf	1	-0.307692307692308	5	26
MEIOB	3	5	0	0	137.28	274.56	15	1	1	NA	1	NA	0	8
MEIOC	10	12	2	2	292.38	584.76	15	1	1	-0.2	1	-0.0454545454545455	4	22
MELK	5	11	0	1	159.39	318.78	15	1	1	1	1	0.3125	1	16
MELTF	9	9	2	0	190.74	381.48	15	1	0.478947368421053	-Inf	1	-0.5	2	18
MEOX1	1	6	0	0	58.08	116.16	15	1	1	NA	1	NA	0	7
MEOX2	0	2	0	0	31.68	63.36	15	1	1	NA	1	NA	0	2
MEP1A	16	19	2	7	395.34	790.68	15	1	0.270385356303498	0.660714285714286	1	0.234920634920635	9	35
MEP1B	7	14	1	2	221.76	443.52	15	1	1	0	1	0	3	21
MEPE	5	4	1	1	51.15	102.3	15	1	1	0.2	1	0.0555555555555556	2	9
MERTK	9	26	5	10	278.19	556.38	15	1	0.732806913529232	-0.444444444444444	1	-0.0761904761904762	15	35
mesd	0	2	0	0	58.08	116.16	15	1	1	NA	1	NA	0	2
MESDC1	1	1	1	1	100.32	200.64	15	1	1	0	1	0	2	2
MEST	0	2	0	0	33.33	66.66	15	1	1	NA	1	NA	0	2
MET	4	16	1	0	420.75	841.5	15	1	0.238095238095238	-Inf	1	-0.8	1	20
METAP1	0	7	0	0	116.49	232.98	15	1	1	NA	1	NA	0	7
METAP2	0	5	0	1	113.19	226.38	15	1	1	NA	1	0	1	5
METRNL	0	2	0	0	96.03	192.06	15	1	1	NA	1	NA	0	2
METTL10	4	7	2	2	66	132	15	1	1	-0.75	1	-0.136363636363636	4	11
METTL11B	1	1	1	0	97.02	194.04	15	1	1	-Inf	1	-0.5	1	2
METTL16	0	3	0	0	136.62	273.24	15	1	1	NA	1	NA	0	3
METTL18	7	7	2	3	84.48	168.96	15	1	1	0.333333333333333	1	0.1	5	14
METTL21C	2	2	1	0	112.2	224.4	15	1	1	-Inf	1	-0.5	1	4
METTL21EP	0	4	0	0	90.42	180.84	15	1	1	NA	1	NA	0	4
METTL22	4	7	1	3	118.47	236.94	15	1	1	0.416666666666667	1	0.113636363636364	4	11
METTL23	3	5	1	2	66.33	132.66	15	1	1	0.166666666666667	1	0.0416666666666667	3	8
METTL24	1	3	0	0	61.71	123.42	15	1	1	NA	1	NA	0	4
METTL25	4	4	1	0	136.62	273.24	15	1	1	-Inf	1	-0.5	1	8
METTL2A	4	6	1	0	135.63	271.26	15	1	0.454545454545455	-Inf	1	-0.6	1	10
METTL4	10	6	1	0	180.84	361.68	15	1	1	-Inf	1	-0.375	1	16
METTL5	0	2	0	0	59.4	118.8	15	1	1	NA	1	NA	0	2
METTL6	4	4	2	0	98.34	196.68	15	1	0.466666666666667	-Inf	1	-0.5	2	8
METTL7A	3	7	0	3	99.99	199.98	15	1	0.527972027972028	1	1	0.3	3	10
METTL8	4	4	2	0	112.2	224.4	15	1	0.466666666666667	-Inf	1	-0.5	2	8
MEX3A	2	1	1	0	63.69	127.38	15	1	1	-Inf	1	-0.333333333333333	1	3
MEX3D	1	3	1	1	36.96	73.92	15	1	1	-2	1	-0.25	2	4
MFAP1	0	8	0	1	85.8	171.6	15	1	1	NA	1	0	1	8
MFAP2	0	2	0	0	28.05	56.1	15	1	1	NA	1	NA	0	2
MFAP3	1	5	1	2	136.95	273.9	15	1	1	-1.5	1	-0.166666666666667	3	6
MFAP3L	1	3	0	0	129.69	259.38	15	1	1	NA	1	NA	0	4
MFF	1	4	0	1	90.42	180.84	15	1	1	1	1	0.2	1	5
MFGE8	1	5	1	0	84.15	168.3	15	1	0.285714285714286	-Inf	1	-0.833333333333333	1	6
MFN1	3	9	0	1	203.28	406.56	15	1	1	1	1	0.25	1	12
MFN2	0	8	0	4	186.12	372.24	15	1	1	NA	1	0	4	8
MFNG	2	3	1	1	82.5	165	15	1	1	-0.5	1	-0.1	2	5
MFRP	0	1	0	1	9.9	19.8	15	1	1	NA	1	0	1	1
MFSD1	2	11	0	3	145.53	291.06	15	1	1	1	1	0.153846153846154	3	13
MFSD10	4	5	0	0	160.05	320.1	15	1	1	NA	1	NA	0	9
MFSD11	7	9	2	0	157.74	315.48	15	1	0.470588235294118	-Inf	1	-0.5625	2	16
MFSD12	2	3	1	2	66	132	15	1	1	0.25	1	0.0666666666666667	3	5
MFSD13A	2	9	1	5	160.71	321.42	15	1	1	0.1	1	0.0151515151515152	6	11
MFSD2A	0	9	0	1	107.25	214.5	15	1	1	NA	1	0	1	9
MFSD2B	5	4	2	1	164.67	329.34	15	1	1	-0.6	1	-0.111111111111111	3	9
MFSD4A	0	4	0	0	113.85	227.7	15	1	1	NA	1	NA	0	4
MFSD4B	7	8	3	1	103.29	206.58	15	1	0.582043343653251	-2.42857142857143	1	-0.283333333333333	4	15
MFSD5	1	4	0	0	18.81	37.62	15	1	1	NA	1	NA	0	5
MFSD6	5	17	0	0	297.99	595.98	15	1	1	NA	1	NA	0	22
MFSD8	4	6	1	0	196.02	392.04	15	1	0.454545454545455	-Inf	1	-0.6	1	10
MGA	16	30	2	0	680.13	1360.26	15	1	0.13563829787234	-Inf	1	-0.652173913043478	2	46
MGAM	7	7	3	2	94.05	188.1	15	1	1	-0.5	1	-0.1	5	14
MGARP	7	1	0	0	79.53	159.06	15	1	1	NA	1	NA	0	8
MGAT2	1	1	0	0	67.32	134.64	15	1	1	NA	1	NA	0	2
MGAT3	1	9	1	3	132	264	15	1	0.505494505494505	-2	1	-0.15	4	10
MGAT4A	3	7	0	1	174.9	349.8	15	1	1	1	1	0.3	1	10
MGAT4B	4	8	1	2	201.63	403.26	15	1	1	0	1	0	3	12
MGAT4C	3	6	0	0	252.12	504.24	15	1	1	NA	1	NA	0	9
MGAT4D	6	4	0	0	136.62	273.24	15	1	1	NA	1	NA	0	10
MGAT5	0	10	0	2	213.18	426.36	15	1	1	NA	1	0	2	10
MGAT5B	1	8	1	3	129.69	259.38	15	1	1	-1.66666666666667	1	-0.138888888888889	4	9
MGEA5	0	6	0	3	286.44	572.88	15	1	1	NA	1	0	3	6
MGLL	1	2	0	1	85.47	170.94	15	1	1	1	1	0.333333333333333	1	3
MGME1	4	7	0	0	99.99	199.98	15	1	1	NA	1	NA	0	11
MGST1	1	2	0	0	62.7	125.4	15	1	1	NA	1	NA	0	3
MGST2	1	0	1	0	42.57	85.14	15	1	1	NA	1	0	1	1
MGST3	1	3	0	1	50.16	100.32	15	1	1	1	1	0.25	1	4
MGTNIPA2L	1	3	0	2	79.86	159.72	15	1	1	1	1	0.25	2	4
MIA2	19	22	5	2	416.13	832.26	15	1	0.415800758700314	-1.89473684210526	1	-0.250871080139373	7	41
MIB1	0	17	0	3	275.88	551.76	15	1	1	NA	1	0	3	17
MIB2	4	13	0	5	322.74	645.48	15	1	0.535201640464798	1	1	0.235294117647059	5	17
MICAL1	5	6	2	2	83.49	166.98	15	1	1	-0.2	1	-0.0454545454545455	4	11
MICAL2	29	29	8	6	688.71	1377.42	15	1	0.768318364665911	-0.333333333333333	1	-0.0714285714285714	14	58
MICALL1	0	4	0	1	108.24	216.48	15	1	1	NA	1	0	1	4
MICALL2	10	11	3	1	249.15	498.3	15	1	0.59304347826087	-2.3	1	-0.273809523809524	4	21
MICU1	1	4	0	1	105.27	210.54	15	1	1	1	1	0.2	1	5
MICU2	2	2	0	0	112.53	225.06	15	1	1	NA	1	NA	0	4
MICU3	1	5	0	0	122.76	245.52	15	1	1	NA	1	NA	0	6
MID1	0	2	0	1	116.82	233.64	15	1	1	NA	1	0	1	2
MID2	1	3	1	2	157.74	315.48	15	1	1	-0.5	1	-0.0833333333333333	3	4
MIEF1	0	4	0	2	98.34	196.68	15	1	1	NA	1	0	2	4
MIEF2	4	7	1	4	78.87	157.74	15	1	1	0.5625	1	0.163636363636364	5	11
MIER1	0	7	0	0	129.03	258.06	15	1	1	NA	1	NA	0	7
MIER2	1	10	0	0	199.98	399.96	15	1	1	NA	1	NA	0	11
MIF	0	2	0	2	14.19	28.38	15	1	1	NA	1	0	2	2
MIF4GD	0	5	0	0	75.9	151.8	15	1	1	NA	1	NA	0	5
MIGA1	1	5	0	0	184.8	369.6	15	1	1	NA	1	NA	0	6
MIGA2	1	10	1	4	144.21	288.42	15	1	1	-1.5	1	-0.109090909090909	5	11
MILR1	9	1	0	0	88.11	176.22	15	1	1	NA	1	NA	0	10
MINA	2	5	0	2	111.21	222.42	15	1	1	1	1	0.285714285714286	2	7
MINDY4B	2	7	1	1	150.48	300.96	15	1	0.490909090909091	-2.5	1	-0.277777777777778	2	9
MINPP1	3	2	0	0	89.43	178.86	15	1	1	NA	1	NA	0	5
MIOS	0	6	0	1	114.51	229.02	15	1	1	NA	1	0	1	6
MIPEP	4	5	0	1	179.19	358.38	15	1	1	1	1	0.444444444444444	1	9
MIPOL1	4	4	0	0	149.49	298.98	15	1	1	NA	1	NA	0	8
MIS12	1	4	0	1	32.01	64.02	15	1	1	1	1	0.2	1	5
MIS18A	1	1	1	0	23.76	47.52	15	1	1	-Inf	1	-0.5	1	2
MIS18BP1	30	16	4	2	266.97	533.94	15	1	1	-0.0666666666666667	1	-0.0144927536231884	6	46
MISP	10	13	3	5	213.18	426.36	15	1	1	0.22	1	0.0597826086956522	8	23
MITD1	3	3	1	1	53.79	107.58	15	1	1	0	1	0	2	6
MITF	4	2	1	0	141.24	282.48	15	1	1	-Inf	1	-0.333333333333333	1	6
MKI67	64	27	12	3	543.84	1087.68	15	1	0.548121386133957	-0.6875	1	-0.0967032967032967	15	91
MKKS	4	8	1	2	151.14	302.28	15	1	1	0	1	0	3	12
MKL1	0	5	0	0	232.65	465.3	15	1	1	NA	1	NA	0	5
MKL2	14	9	0	1	289.41	578.82	15	1	0.416666666666667	1	1	0.608695652173913	1	23
MKLN1	1	5	1	1	251.13	502.26	15	1	0.464285714285714	-4	1	-0.333333333333333	2	6
MKNK1	1	7	0	2	135.63	271.26	15	1	1	1	1	0.125	2	8
MKNK2	0	4	0	0	23.43	46.86	15	1	1	NA	1	NA	0	4
MKRN1	0	2	0	0	137.94	275.88	15	1	1	NA	1	NA	0	2
MKRN2	9	18	1	2	232.65	465.3	15	1	1	0	1	0	3	27
MKS1	6	8	1	0	136.29	272.58	15	1	0.466666666666667	-Inf	1	-0.571428571428571	1	14
MKX	1	4	0	2	59.07	118.14	15	1	1	1	1	0.2	2	5
MLC1	1	3	0	0	104.94	209.88	15	1	1	NA	1	NA	0	4
MLF1	4	6	0	2	75.57	151.14	15	1	0.515151515151515	1	1	0.4	2	10
MLF2	0	7	0	2	54.45	108.9	15	1	1	NA	1	0	2	7
MLH1	13	15	6	10	248.82	497.64	15	1	0.752969122193262	0.307692307692308	1	0.0892857142857143	16	28
MLH3	35	23	9	4	398.31	796.62	15	1	0.753755155525575	-0.478571428571429	1	-0.0888594164456233	13	58
MLIP	20	9	3	1	210.21	420.42	15	1	1	-0.35	1	-0.0603448275862069	4	29
MLLT10	1	11	0	5	274.23	548.46	15	1	1	1	1	0.0833333333333333	5	12
MLLT3	2	4	0	0	149.82	299.64	15	1	1	NA	1	NA	0	6
MLLT6	1	10	1	3	182.16	364.32	15	1	0.476190476190476	-2.33333333333333	1	-0.159090909090909	4	11
MLN	3	3	0	0	35.31	70.62	15	1	1	NA	1	NA	0	6
MLNR	2	7	0	3	69.3	138.6	15	1	1	1	1	0.222222222222222	3	9
MLPH	7	13	1	1	160.71	321.42	15	1	1	-0.857142857142857	1	-0.15	2	20
MLX	0	3	0	1	20.46	40.92	15	1	1	NA	1	0	1	3
MLXIP	7	8	1	3	229.02	458.04	15	1	0.602683178534572	0.619047619047619	1	0.216666666666667	4	15
MLXIPL	5	15	1	0	214.17	428.34	15	1	0.285714285714286	-Inf	1	-0.75	1	20
MLYCD	0	3	0	0	83.16	166.32	15	1	1	NA	1	NA	0	3
MMAA	2	6	0	1	151.47	302.94	15	1	1	1	1	0.25	1	8
MMAB	0	4	0	3	37.95	75.9	15	1	1	NA	1	0	3	4
MMACHC	0	5	0	2	80.52	161.04	15	1	1	NA	1	0	2	5
MMADHC	1	5	0	0	81.18	162.36	15	1	1	NA	1	NA	0	6
MMD	0	4	0	2	72.27	144.54	15	1	1	NA	1	0	2	4
MMD2	0	1	0	1	43.23	86.46	15	1	1	NA	1	0	1	1
MME	1	8	0	1	226.71	453.42	15	1	1	1	1	0.111111111111111	1	9
MMEL1	0	7	0	1	244.2	488.4	15	1	1	NA	1	0	1	7
MMP1	2	6	0	0	135.63	271.26	15	1	1	NA	1	NA	0	8
MMP10	5	6	0	0	199.65	399.3	15	1	1	NA	1	NA	0	11
MMP11	2	7	0	3	122.43	244.86	15	1	1	1	1	0.222222222222222	3	9
MMP13	0	6	0	2	107.25	214.5	15	1	1	NA	1	0	2	6
MMP15	0	4	0	1	92.07	184.14	15	1	1	NA	1	0	1	4
MMP16	3	2	1	0	124.74	249.48	15	1	1	-Inf	1	-0.4	1	5
MMP17	4	11	0	2	159.06	318.12	15	1	1	1	1	0.266666666666667	2	15
MMP2	1	7	0	1	195.36	390.72	15	1	1	1	1	0.125	1	8
MMP23B	3	3	1	0	101.31	202.62	15	1	1	-Inf	1	-0.5	1	6
MMP24	2	7	2	2	131.01	262.02	15	1	0.53006993006993	-2.5	1	-0.277777777777778	4	9
MMP27	12	8	3	2	139.59	279.18	15	1	1	0	1	0	5	20
MMP28	4	3	2	3	68.97	137.94	15	1	1	0.5	1	0.171428571428571	5	7
MMR1L1	48	39	5	4	830.28	1660.56	15	1	1	-0.015625	1	-0.00383141762452111	9	87
MMR1L2	16	17	3	2	449.13	898.26	15	1	1	-0.59375	1	-0.115151515151515	5	33
MMR1L4	15	22	3	4	453.75	907.5	15	1	1	-0.1	1	-0.0231660231660231	7	37
MMRN1	13	17	4	1	383.13	766.26	15	1	0.17741935483871	-4.23076923076923	1	-0.366666666666667	5	30
MMRN2	9	14	0	3	376.86	753.72	15	1	0.529230769230769	1	1	0.391304347826087	3	23
MMS19	0	6	0	2	164.67	329.34	15	1	1	NA	1	0	2	6
MMS22L	11	6	1	1	367.95	735.9	15	1	1	0.454545454545455	1	0.147058823529412	2	17
MN1	2	9	1	4	121.44	242.88	15	1	1	-0.125	1	-0.0181818181818182	5	11
MNAT1	2	5	0	0	79.2	158.4	15	1	1	NA	1	NA	0	7
MNR2	1	0	1	0	11.55	23.1	15	1	1	NA	1	0	1	1
MNS1	7	6	1	1	106.26	212.52	15	1	1	0.142857142857143	1	0.0384615384615384	2	13
MNT	0	8	0	2	119.46	238.92	15	1	1	NA	1	0	2	8
MOB1A	0	3	0	1	68.64	137.28	15	1	1	NA	1	0	1	3
MOB2	0	2	0	0	47.19	94.38	15	1	1	NA	1	NA	0	2
MOB3A	1	4	1	0	77.55	155.1	15	1	0.333333333333333	-Inf	1	-0.8	1	5
MOB3B	1	1	0	0	51.48	102.96	15	1	1	NA	1	NA	0	2
MOB3C	0	4	0	1	86.13	172.26	15	1	1	NA	1	0	1	4
MOCOS	6	5	1	1	134.31	268.62	15	1	1	0.166666666666667	1	0.0454545454545454	2	11
MOCS1	3	6	2	0	179.52	359.04	15	1	0.181818181818182	-Inf	1	-0.666666666666667	2	9
MOCS3	5	7	1	2	106.26	212.52	15	1	1	0.3	1	0.0833333333333334	3	12
MOGAT1	0	5	0	1	113.85	227.7	15	1	1	NA	1	0	1	5
MOK	2	5	0	0	126.06	252.12	15	1	1	NA	1	NA	0	7
MON2	1	19	0	2	522.06	1044.12	15	1	1	1	1	0.05	2	20
MORC2	9	17	2	1	321.75	643.5	15	1	0.539408866995074	-2.77777777777778	1	-0.32051282051282	3	26
MORC3	6	15	0	2	275.88	551.76	15	1	1	1	1	0.285714285714286	2	21
MORN3	5	5	2	2	84.15	168.3	15	1	1	0	1	0	4	10
MORN5	1	2	0	2	25.08	50.16	15	1	1	1	1	0.333333333333333	2	3
MOS	7	5	2	0	111.54	223.08	15	1	0.505494505494505	-Inf	1	-0.416666666666667	2	12
MOSPD2	1	6	0	0	176.88	353.76	15	1	1	NA	1	NA	0	7
MOV10L1	13	20	1	0	444.18	888.36	15	1	0.411764705882353	-Inf	1	-0.606060606060606	1	33
MOXD1	0	7	0	0	125.4	250.8	15	1	1	NA	1	NA	0	7
MPC1	1	3	0	0	34.32	68.64	15	1	1	NA	1	NA	0	4
MPC2	1	1	0	0	30.03	60.06	15	1	1	NA	1	NA	0	2
MPDZ	23	26	0	2	573.87	1147.74	15	1	0.494901960784314	1	1	0.469387755102041	2	49
MPHOSPH10	6	9	1	0	162.03	324.06	15	1	0.4375	-Inf	1	-0.6	1	15
MPHOSPH6	0	3	0	0	39.6	79.2	15	1	1	NA	1	NA	0	3
MPHOSPH8	4	10	0	1	169.95	339.9	15	1	1	1	1	0.285714285714286	1	14
MPHOSPH9	17	8	3	2	333.96	667.92	15	1	1	0.294117647058823	1	0.0800000000000001	5	25
MPI	1	0	1	0	16.17	32.34	15	1	1	NA	1	0	1	1
MPL	3	6	0	0	45.21	90.42	15	1	1	NA	1	NA	0	9
MPP1	2	6	2	3	116.49	232.98	15	1	1	-1	1	-0.15	5	8
MPP2	0	7	0	2	150.81	301.62	15	1	1	NA	1	0	2	7
MPP3	3	2	0	0	172.26	344.52	15	1	1	NA	1	NA	0	5
MPP4	3	11	1	1	195.36	390.72	15	1	0.45	-2.66666666666667	1	-0.285714285714286	2	14
MPP5	1	7	0	1	207.9	415.8	15	1	1	1	1	0.125	1	8
MPP7	1	3	1	0	218.46	436.92	15	1	0.4	-Inf	1	-0.75	1	4
MPPE1	4	7	3	0	158.73	317.46	15	1	0.192307692307692	-Inf	1	-0.636363636363636	3	11
MPPED2	0	3	0	1	88.11	176.22	15	1	1	NA	1	0	1	3
MPRIP	9	26	6	6	518.76	1037.52	15	1	0.157895605641779	-1.88888888888889	1	-0.242857142857143	12	35
MPST	1	7	0	2	67.65	135.3	15	1	1	1	1	0.125	2	8
MPZL2	1	3	0	0	62.7	125.4	15	1	1	NA	1	NA	0	4
MPZL3	4	4	0	1	80.85	161.7	15	1	1	1	1	0.5	1	8
MRAS	0	2	0	0	61.71	123.42	15	1	1	NA	1	NA	0	2
MRC1	12	18	4	4	473.22	946.44	15	1	0.698446074157649	-0.5	1	-0.1	8	30
MRC2	0	11	0	4	165.66	331.32	15	1	1	NA	1	0	4	11
MRE11	5	10	1	2	193.38	386.76	15	1	1	0	1	0	3	15
MREG	0	2	0	0	59.07	118.14	15	1	1	NA	1	NA	0	2
MRGBP	1	1	0	0	34.65	69.3	15	1	1	NA	1	NA	0	2
MRGPRH	3	5	0	1	91.74	183.48	15	1	1	1	1	0.375	1	8
MRM2	3	4	3	1	52.14	104.28	15	1	0.545454545454546	-3	1	-0.321428571428571	4	7
MRM3	5	6	2	1	69.63	139.26	15	1	1	-1.4	1	-0.212121212121212	3	11
MRNIP	11	4	1	2	90.42	180.84	15	1	0.245098039215686	0.818181818181818	1	0.4	3	15
MROH1L1	5	9	3	2	281.82	563.64	15	1	0.602683178534572	-1.7	1	-0.242857142857143	5	14
MRPL1	2	5	1	2	82.5	165	15	1	1	-0.25	1	-0.0476190476190476	3	7
MRPL10	3	0	1	0	13.2	26.4	15	1	1	NA	1	0	1	3
MRPL13	13	10	4	1	178.2	356.4	15	1	0.619454619454619	-2.07692307692308	1	-0.234782608695652	5	23
MRPL14	0	3	0	1	27.06	54.12	15	1	1	NA	1	0	1	3
MRPL15	0	5	0	0	85.47	170.94	15	1	1	NA	1	NA	0	5
MRPL18	3	1	2	1	45.21	90.42	15	1	1	0.333333333333333	1	0.0833333333333334	3	4
MRPL19	2	2	0	0	62.04	124.08	15	1	1	NA	1	NA	0	4
MRPL20	0	3	0	0	33.99	67.98	15	1	1	NA	1	NA	0	3
MRPL21	1	1	0	0	64.02	128.04	15	1	1	NA	1	NA	0	2
MRPL22	1	1	0	0	54.45	108.9	15	1	1	NA	1	NA	0	2
MRPL27	1	5	0	0	39.93	79.86	15	1	1	NA	1	NA	0	6
MRPL3	0	10	0	0	121.11	242.22	15	1	1	NA	1	NA	0	10
MRPL30	2	1	0	0	45.87	91.74	15	1	1	NA	1	NA	0	3
MRPL35	0	3	0	1	40.26	80.52	15	1	1	NA	1	0	1	3
MRPL37	5	12	0	2	101.97	203.94	15	1	1	1	1	0.294117647058824	2	17
MRPL38	1	6	0	0	79.53	159.06	15	1	1	NA	1	NA	0	7
MRPL39	9	4	2	0	90.42	180.84	15	1	1	-Inf	1	-0.307692307692308	2	13
MRPL40	2	3	2	1	55.44	110.88	15	1	1	-2	1	-0.266666666666667	3	5
MRPL42	0	2	0	0	32.01	64.02	15	1	1	NA	1	NA	0	2
MRPL44	5	5	0	2	39.27	78.54	15	1	0.46969696969697	1	1	0.5	2	10
MRPL46	4	5	1	0	43.23	86.46	15	1	1	-Inf	1	-0.555555555555556	1	9
MRPL47	1	7	0	0	76.23	152.46	15	1	1	NA	1	NA	0	8
MRPL48	2	4	1	0	57.75	115.5	15	1	0.428571428571428	-Inf	1	-0.666666666666667	1	6
MRPL50	0	2	0	0	32.34	64.68	15	1	1	NA	1	NA	0	2
MRPL54	1	1	0	0	24.09	48.18	15	1	1	NA	1	NA	0	2
MRPL55	1	1	1	1	17.49	34.98	15	1	1	0	1	0	2	2
MRPL57	2	0	0	0	26.73	53.46	15	1	1	NA	1	NA	0	2
MRPL58	0	4	0	1	35.64	71.28	15	1	1	NA	1	0	1	4
MRPP3	10	9	4	2	183.48	366.96	15	1	0.660869565217391	-0.8	1	-0.140350877192982	6	19
MRPS10	9	1	2	0	61.38	122.76	15	1	1	-Inf	1	-0.1	2	10
MRPS11	2	2	0	1	26.73	53.46	15	1	1	1	1	0.5	1	4
MRPS14	3	5	1	1	29.7	59.4	15	1	1	-0.666666666666667	1	-0.125	2	8
MRPS15	2	1	1	0	67.98	135.96	15	1	1	-Inf	1	-0.333333333333333	1	3
MRPS17	0	2	0	2	17.49	34.98	15	1	1	NA	1	0	2	2
MRPS18A	1	2	0	0	52.14	104.28	15	1	1	NA	1	NA	0	3
MRPS18C	0	2	0	0	30.69	61.38	15	1	1	NA	1	NA	0	2
MRPS22	3	4	1	0	86.46	172.92	15	1	1	-Inf	1	-0.571428571428571	1	7
MRPS23	1	1	1	0	26.07	52.14	15	1	1	-Inf	1	-0.5	1	2
MRPS27	2	2	0	0	81.51	163.02	15	1	1	NA	1	NA	0	4
MRPS30	2	9	0	0	202.95	405.9	15	1	1	NA	1	NA	0	11
MRPS31	5	4	2	1	112.86	225.72	15	1	1	-0.6	1	-0.111111111111111	3	9
MRPS35	3	5	1	0	70.29	140.58	15	1	0.444444444444444	-Inf	1	-0.625	1	8
MRPS36	4	2	1	1	43.23	86.46	15	1	1	0.5	1	0.166666666666667	2	6
MRPS5	3	2	0	1	98.01	196.02	15	1	1	1	1	0.6	1	5
MRPS6	0	2	0	0	38.94	77.88	15	1	1	NA	1	NA	0	2
MRPS7	2	2	1	1	69.3	138.6	15	1	1	0	1	0	2	4
MRPS9	5	5	0	3	121.44	242.88	15	1	0.230769230769231	1	1	0.5	3	10
MRRF	3	4	0	0	56.76	113.52	15	1	1	NA	1	NA	0	7
MRS2	0	2	0	0	120.12	240.24	15	1	1	NA	1	NA	0	2
MRTO4	0	5	0	0	48.51	97.02	15	1	1	NA	1	NA	0	5
MRVLDC3	5	4	0	1	104.61	209.22	15	1	1	1	1	0.555555555555556	1	9
MSANTD2	3	10	1	0	185.13	370.26	15	1	0.285714285714286	-Inf	1	-0.769230769230769	1	13
MSANTD4	1	8	0	1	89.76	179.52	15	1	1	1	1	0.111111111111111	1	9
MSGN1	2	1	1	0	48.18	96.36	15	1	1	-Inf	1	-0.333333333333333	1	3
MSH2	3	18	2	0	279.51	559.02	15	1	0.0395256916996047	-Inf	1	-0.857142857142857	2	21
MSH3	11	5	0	0	245.52	491.04	15	1	1	NA	1	NA	0	16
MSH4	7	4	1	2	287.76	575.52	15	1	0.538461538461539	0.714285714285714	1	0.303030303030303	3	11
MSH6	8	39	2	5	449.13	898.26	15	1	0.601409956015949	-0.95	1	-0.115501519756839	7	47
MSI2	2	2	0	0	37.62	75.24	15	1	1	NA	1	NA	0	4
MSL2	0	8	0	1	180.84	361.68	15	1	1	NA	1	0	1	8
MSL3	1	3	0	0	128.04	256.08	15	1	1	NA	1	NA	0	4
MSLN	10	9	2	0	234.63	469.26	15	1	0.485714285714286	-Inf	1	-0.473684210526316	2	19
MSLNL	4	9	1	2	99.66	199.32	15	1	1	-0.125	1	-0.0256410256410256	3	13
MSMB	1	2	0	0	19.14	38.28	15	1	1	NA	1	NA	0	3
MSMO1	0	4	0	0	88.11	176.22	15	1	1	NA	1	NA	0	4
MSRA	1	3	0	0	64.35	128.7	15	1	1	NA	1	NA	0	4
MST1	3	10	1	5	62.7	125.4	15	1	1	0.333333333333333	1	0.0641025641025641	6	13
MSTN	0	4	0	0	132.99	265.98	15	1	1	NA	1	NA	0	4
MSTO1	0	13	0	0	113.19	226.38	15	1	1	NA	1	NA	0	13
MSX1	0	2	0	0	18.48	36.96	15	1	1	NA	1	NA	0	2
MTA1	0	4	0	1	171.93	343.86	15	1	1	NA	1	0	1	4
MTA3	1	4	0	0	209.88	419.76	15	1	1	NA	1	NA	0	5
MTBP	8	15	3	3	242.88	485.76	15	1	0.645699128457749	-0.875	1	-0.152173913043478	6	23
MTCH1	4	7	0	2	97.68	195.36	15	1	1	1	1	0.363636363636364	2	11
MTCH2	0	1	0	1	30.03	60.06	15	1	1	NA	1	0	1	1
MTCL1	7	10	2	2	436.92	873.84	15	1	1	-0.428571428571429	1	-0.0882352941176471	4	17
MTDH	1	10	0	2	157.08	314.16	15	1	1	1	1	0.0909090909090909	2	11
MTERF2	9	9	3	0	137.61	275.22	15	1	0.228571428571428	-Inf	1	-0.5	3	18
MTERF3	4	6	1	1	128.37	256.74	15	1	1	-0.5	1	-0.1	2	10
MTERF4	3	3	2	0	44.22	88.44	15	1	0.464285714285714	-Inf	1	-0.5	2	6
MTF1	2	5	1	0	215.82	431.64	15	1	0.375	-Inf	1	-0.714285714285714	1	7
MTF2	2	4	2	0	248.82	497.64	15	1	0.428571428571429	-Inf	1	-0.666666666666667	2	6
MTFMT	2	7	1	1	83.82	167.64	15	1	0.490909090909091	-2.5	1	-0.277777777777778	2	9
MTFR1	3	2	1	0	97.02	194.04	15	1	1	-Inf	1	-0.4	1	5
MTFR1L	1	4	0	0	82.17	164.34	15	1	1	NA	1	NA	0	5
MTFR2	5	6	0	0	106.59	213.18	15	1	1	NA	1	NA	0	11
MTG1	0	3	0	0	51.15	102.3	15	1	1	NA	1	NA	0	3
MTG2	1	10	0	1	245.19	490.38	15	1	1	1	1	0.0909090909090909	1	11
MTHFD1	2	10	1	0	285.12	570.24	15	1	0.230769230769231	-Inf	1	-0.833333333333333	1	12
MTHFD1L	10	6	5	3	239.25	478.5	15	1	1	0	1	0	8	16
MTHFD2	2	5	0	0	108.57	217.14	15	1	1	NA	1	NA	0	7
MTHFD2L	1	5	0	2	72.93	145.86	15	1	1	1	1	0.166666666666667	2	6
MTHFR	1	11	0	3	225.72	451.44	15	1	1	1	1	0.0833333333333333	3	12
MTIF2	2	12	0	1	202.29	404.58	15	1	1	1	1	0.142857142857143	1	14
MTIF3	4	6	2	1	82.17	164.34	15	1	0.559440559440559	-2	1	-0.266666666666667	3	10
MTM1	0	11	0	1	172.59	345.18	15	1	1	NA	1	0	1	11
MTMR1	1	10	1	1	221.43	442.86	15	1	0.294871794871795	-9	1	-0.409090909090909	2	11
MTMR10	2	7	1	1	216.15	432.3	15	1	0.490909090909091	-2.5	1	-0.277777777777778	2	9
MTMR12	4	9	2	1	210.21	420.42	15	1	0.517857142857143	-3.5	1	-0.358974358974359	3	13
MTMR14	1	9	0	4	163.35	326.7	15	1	1	1	1	0.1	4	10
MTMR2	0	10	0	3	233.64	467.28	15	1	1	NA	1	0	3	10
MTMR3	5	14	2	4	353.43	706.86	15	1	1	-0.4	1	-0.0701754385964912	6	19
MTMR4	7	12	1	1	293.04	586.08	15	1	1	-0.714285714285714	1	-0.131578947368421	2	19
MTMR6	3	7	1	0	169.62	339.24	15	1	0.363636363636364	-Inf	1	-0.7	1	10
MTMR7	1	9	0	2	211.2	422.4	15	1	1	1	1	0.1	2	10
MTMR8	4	6	2	3	167.97	335.94	15	1	1	0	1	0	5	10
MTMR9	9	12	0	1	156.75	313.5	15	1	1	1	1	0.428571428571429	1	21
MTMR9LP	2	2	2	0	58.08	116.16	15	1	0.466666666666667	-Inf	1	-0.5	2	4
MTNR1A	1	5	1	0	107.58	215.16	15	1	0.285714285714286	-Inf	1	-0.833333333333333	1	6
MTNR1B	2	5	1	0	132.33	264.66	15	1	0.375	-Inf	1	-0.714285714285714	1	7
MTO1	7	11	1	1	198.33	396.66	15	1	1	-0.571428571428571	1	-0.111111111111111	2	18
MTOR	0	31	0	7	442.86	885.72	15	1	1	NA	1	0	7	31
MTPAP	3	6	0	1	163.02	326.04	15	1	1	1	1	0.333333333333333	1	9
MTR	4	12	1	2	373.56	747.12	15	1	1	-0.5	1	-0.0833333333333333	3	16
MTRF1	2	10	0	1	140.58	281.16	15	1	1	1	1	0.166666666666667	1	12
MTRF1L	1	1	0	0	78.87	157.74	15	1	1	NA	1	NA	0	2
MTRR	10	7	1	1	248.49	496.98	15	1	1	0.3	1	0.0882352941176471	2	17
MTSS1	3	15	1	3	202.29	404.58	15	1	1	-0.666666666666667	1	-0.0833333333333333	4	18
MTTP	3	9	0	0	263.01	526.02	15	1	1	NA	1	NA	0	12
MTUS1	23	9	2	1	326.04	652.08	15	1	1	0.217391304347826	1	0.0520833333333334	3	32
MTUS2	9	11	1	3	271.26	542.52	15	1	0.614624505928854	0.592592592592593	1	0.2	4	20
MTX2	4	3	0	0	71.94	143.88	15	1	1	NA	1	NA	0	7
MTX3	1	4	0	1	62.7	125.4	15	1	1	1	1	0.2	1	5
MUC13	13	5	1	1	101.97	203.94	15	1	0.521052631578947	0.615384615384615	1	0.222222222222222	2	18
MUC2	18	32	2	2	708.18	1416.36	15	1	0.621566414019244	-0.777777777777778	1	-0.14	4	50
MUC4	26	19	5	7	277.86	555.72	15	1	0.34902688916848	0.478021978021978	1	0.161111111111111	12	45
MUC4L	9	9	4	3	66.99	133.98	15	1	1	-0.333333333333333	1	-0.0714285714285714	7	18
MUC6	10	14	0	2	429	858	15	1	0.507692307692308	1	1	0.416666666666667	2	24
MUL1	0	2	0	0	17.16	34.32	15	1	1	NA	1	NA	0	2
MUM1	15	19	0	0	248.49	496.98	15	1	1	NA	1	NA	0	34
MURC	1	6	0	2	108.24	216.48	15	1	1	1	1	0.142857142857143	2	7
MUSK	4	17	2	2	198.99	397.98	15	1	0.23399209486166	-3.25	1	-0.30952380952381	4	21
MUSTN1	3	5	0	1	88.44	176.88	15	1	1	1	1	0.375	1	8
MUT	1	11	0	0	241.56	483.12	15	1	1	NA	1	NA	0	12
MUTYH	6	8	3	7	103.29	206.58	15	1	0.678456050612465	0.428571428571429	1	0.128571428571429	10	14
MVK	2	5	2	3	64.02	128.04	15	1	1	-0.666666666666667	1	-0.114285714285714	5	7
MVP	0	8	0	2	86.46	172.92	15	1	1	NA	1	0	2	8
MX1	16	7	0	1	181.17	362.34	15	1	0.333333333333333	1	1	0.695652173913043	1	23
MXD1	1	3	0	2	22.11	44.22	15	1	1	1	1	0.25	2	4
MXD3	1	1	0	0	13.53	27.06	15	1	1	NA	1	NA	0	2
MXD4	0	3	0	1	54.12	108.24	15	1	1	NA	1	0	1	3
MXI1	0	1	0	1	59.07	118.14	15	1	1	NA	1	0	1	1
MXRA5	40	40	2	4	1067.22	2134.44	15	1	0.676614956558259	0.5	1	0.166666666666667	6	80
MXRA7	0	1	0	1	33.66	67.32	15	1	1	NA	1	0	1	1
MXRA8	1	6	0	2	119.79	239.58	15	1	1	1	1	0.142857142857143	2	7
MYBBP1A	18	13	2	5	416.79	833.58	15	1	0.222358722358722	0.711111111111111	1	0.294930875576037	7	31
MYBL1	0	9	0	2	244.86	489.72	15	1	1	NA	1	0	2	9
MYBL2	1	7	1	4	190.74	381.48	15	1	1	-0.75	1	-0.075	5	8
MYBPC1	0	16	0	2	369.93	739.86	15	1	1	NA	1	0	2	16
MYBPC3	6	9	0	1	384.78	769.56	15	1	1	1	1	0.4	1	15
MYBPH	2	7	1	2	89.76	179.52	15	1	1	-0.75	1	-0.111111111111111	3	9
MYCBP2	3	48	0	6	1395.9	2791.8	15	1	1	1	1	0.0588235294117647	6	51
MYCBPAP	20	16	4	4	311.19	622.38	15	1	1	0.2	1	0.0555555555555556	8	36
MYCL	0	9	0	0	45.54	91.08	15	1	1	NA	1	NA	0	9
MYCT1	3	0	1	0	61.05	122.1	15	1	1	NA	1	0	1	3
MYD88	0	6	0	2	61.05	122.1	15	1	1	NA	1	0	2	6
MYH10	1	27	1	4	595.32	1190.64	15	1	0.284090909090909	-5.75	1	-0.164285714285714	5	28
MYH13	27	26	2	2	609.51	1219.02	15	1	1	0.0370370370370371	1	0.00943396226415094	4	53
MYH15	1	25	0	4	624.03	1248.06	15	1	1	1	1	0.0384615384615385	4	26
MYH1E	2	14	1	7	330	660	15	1	1	0	1	0	8	16
MYH9	2	33	1	3	624.03	1248.06	15	1	0.28383849436481	-4.5	1	-0.192857142857143	4	35
MYL1	0	3	0	0	64.35	128.7	15	1	1	NA	1	NA	0	3
MYL12A	1	10	0	1	133.65	267.3	15	1	1	1	1	0.0909090909090909	1	11
MYL2	1	5	0	4	55.11	110.22	15	1	1	1	1	0.166666666666667	4	6
MYL3	0	3	0	0	75.57	151.14	15	1	1	NA	1	NA	0	3
MYL4	3	3	1	2	74.25	148.5	15	1	1	0.5	1	0.166666666666667	3	6
MYL9	0	4	0	0	41.91	83.82	15	1	1	NA	1	NA	0	4
MYLIP	1	11	1	5	161.37	322.74	15	1	1	-1.2	1	-0.0833333333333333	6	12
MYLK	8	17	0	3	551.43	1102.86	15	1	0.536019536019536	1	1	0.32	3	25
MYLK3	6	7	0	0	265.32	530.64	15	1	1	NA	1	NA	0	13
MYLKSML	2	7	0	0	66.33	132.66	15	1	1	NA	1	NA	0	9
MYNN	1	8	1	0	150.48	300.96	15	1	0.2	-Inf	1	-0.888888888888889	1	9
MYO10L	3	18	1	2	661.32	1322.64	15	1	0.436758893280632	-2	1	-0.19047619047619	3	21
MYO15A	8	10	2	5	187.77	375.54	15	1	0.659246931558144	0.5	1	0.158730158730159	7	18
MYO15L	22	15	5	3	520.41	1040.82	15	1	1	-0.136363636363636	1	-0.0304054054054054	8	37
MYO16	17	20	2	2	562.32	1124.64	15	1	1	-0.176470588235294	1	-0.0405405405405405	4	37
MYO18A	2	10	2	5	154.77	309.54	15	1	0.602683178534572	-1	1	-0.119047619047619	7	12
MYO18B	12	23	3	6	481.14	962.28	15	1	1	0.0416666666666666	1	0.00952380952380955	9	35
MYO19	10	8	3	4	336.6	673.2	15	1	0.672768878718536	0.4	1	0.126984126984127	7	18
MYO1B	3	13	1	4	306.9	613.8	15	1	1	-0.0833333333333333	1	-0.0125	5	16
MYO1D	0	11	0	1	261.36	522.72	15	1	1	NA	1	0	1	11
MYO1E	1	17	1	3	374.55	749.1	15	1	0.337662337662338	-4.66666666666667	1	-0.194444444444444	4	18
MYO1G	1	2	0	2	28.38	56.76	15	1	1	1	1	0.333333333333333	2	3
MYO1H	4	27	2	8	327.36	654.72	15	1	0.622116685659689	-0.6875	1	-0.0709677419354839	10	31
MYO3A	17	22	4	4	628.98	1257.96	15	1	1	-0.294117647058824	1	-0.0641025641025641	8	39
MYO3AL	9	9	2	4	248.82	497.64	15	1	0.649395227198431	0.5	1	0.166666666666667	6	18
MYO3B	6	10	1	0	396.99	793.98	15	1	0.411764705882353	-Inf	1	-0.625	1	16
MYO5A	2	26	0	7	552.42	1104.84	15	1	1	1	1	0.0714285714285714	7	28
MYO5B	15	24	9	7	197.67	395.34	15	1	0.248789594630866	-1.05714285714286	1	-0.177884615384615	16	39
MYO5C	9	14	1	2	494.34	988.68	15	1	1	0.222222222222222	1	0.0579710144927537	3	23
MYO6	1	18	0	3	424.38	848.76	15	1	1	1	1	0.0526315789473684	3	19
MYO7A	4	29	0	1	710.82	1421.64	15	1	1	1	1	0.121212121212121	1	33
MYO7B	12	21	1	3	602.58	1205.16	15	1	1	0.416666666666667	1	0.113636363636364	4	33
MYO9B	9	40	3	12	683.1	1366.2	15	1	1	-0.111111111111111	1	-0.0163265306122449	15	49
MYOC	4	7	4	4	67.32	134.64	15	1	0.657696276891323	-0.75	1	-0.136363636363636	8	11
MYOCD	1	6	0	1	289.08	578.16	15	1	1	1	1	0.142857142857143	1	7
MYOD1	1	2	0	1	40.92	81.84	15	1	1	1	1	0.333333333333333	1	3
MYOF	10	22	1	2	680.13	1360.26	15	1	1	-0.1	1	-0.0208333333333333	3	32
MYOG	1	5	0	2	30.36	60.72	15	1	1	1	1	0.166666666666667	2	6
MYOM1	5	14	1	3	590.04	1180.08	15	1	1	0.0666666666666667	1	0.0131578947368421	4	19
MYOM2	2	20	0	0	473.22	946.44	15	1	1	NA	1	NA	0	22
MYOM3	19	15	1	1	407.88	815.76	15	1	1	0.210526315789474	1	0.0588235294117647	2	34
MYOT	2	10	1	1	176.55	353.1	15	1	0.395604395604396	-4	1	-0.333333333333333	2	12
MYOZ1	1	1	0	0	90.42	180.84	15	1	1	NA	1	NA	0	2
MYOZ2	0	6	0	0	84.81	169.62	15	1	1	NA	1	NA	0	6
MYOZ3	2	2	1	1	32.67	65.34	15	1	1	0	1	0	2	4
MYPN	8	18	2	4	483.12	966.24	15	1	1	-0.125	1	-0.0256410256410256	6	26
MYRFL	7	11	1	0	270.6	541.2	15	1	0.421052631578948	-Inf	1	-0.611111111111111	1	18
MYRIP	13	2	3	1	121.11	242.22	15	1	0.530443756449949	0.538461538461538	1	0.116666666666667	4	15
MYSM1	7	13	1	1	257.73	515.46	15	1	1	-0.857142857142857	1	-0.15	2	20
MYT1	5	12	1	5	238.26	476.52	15	1	1	0.52	1	0.127450980392157	6	17
MYT1L	0	4	0	0	297.66	595.32	15	1	1	NA	1	NA	0	4
MZB1	0	2	0	2	15.84	31.68	15	1	1	NA	1	0	2	2
N4BP1	7	13	0	2	249.48	498.96	15	1	1	1	1	0.35	2	20
N4BP2	20	16	5	3	524.04	1048.08	15	1	1	-0.333333333333333	1	-0.0694444444444444	8	36
N4BP2L1	1	2	0	0	45.87	91.74	15	1	1	NA	1	NA	0	3
N4BP2L2	27	12	7	1	360.03	720.06	15	1	0.413326980805466	-2.11111111111111	1	-0.182692307692308	8	39
N4BP3	1	4	1	2	40.59	81.18	15	1	1	-1	1	-0.133333333333333	3	5
N6AMT1	1	2	1	0	57.09	114.18	15	1	1	-Inf	1	-0.666666666666667	1	3
NAA25	2	10	0	1	330.66	661.32	15	1	1	1	1	0.166666666666667	1	12
NAA35	1	5	0	0	150.15	300.3	15	1	1	NA	1	NA	0	6
NAAA	3	3	0	0	83.16	166.32	15	1	1	NA	1	NA	0	6
NAALAD2	6	11	0	2	280.83	561.66	15	1	1	1	1	0.352941176470588	2	17
NAALADL2	7	11	1	1	256.74	513.48	15	1	1	-0.571428571428571	1	-0.111111111111111	2	18
NAB1	2	9	0	4	141.9	283.8	15	1	1	1	1	0.181818181818182	4	11
NABP1	0	3	0	2	42.9	85.8	15	1	1	NA	1	0	2	3
NACC2	0	11	0	4	143.88	287.76	15	1	1	NA	1	0	4	11
NADK	0	5	0	0	134.97	269.94	15	1	1	NA	1	NA	0	5
NADK2	0	3	0	1	95.7	191.4	15	1	1	NA	1	0	1	3
NADSYN1	3	8	3	2	207.24	414.48	15	1	0.299450549450549	-3	1	-0.327272727272727	5	11
NAE1	19	13	1	0	319.77	639.54	15	1	1	-Inf	1	-0.40625	1	32
NAGA	3	5	0	3	73.92	147.84	15	1	0.490909090909091	1	1	0.375	3	8
NAGLU	2	4	2	2	48.18	96.36	15	1	1	-1	1	-0.166666666666667	4	6
NAGPA	15	12	6	2	232.65	465.3	15	1	0.43073914569367	-1.4	1	-0.194444444444444	8	27
NAMPT	0	6	0	4	100.98	201.96	15	1	1	NA	1	0	4	6
NANOG	3	4	0	1	72.27	144.54	15	1	1	1	1	0.428571428571429	1	7
NANP	1	4	0	0	32.01	64.02	15	1	1	NA	1	NA	0	5
NANS	2	4	2	2	73.92	147.84	15	1	1	-1	1	-0.166666666666667	4	6
NAP1L1	1	5	0	2	132	264	15	1	1	1	1	0.166666666666667	2	6
NAPA-NAPB	0	10	0	3	79.53	159.06	15	1	1	NA	1	0	3	10
NAPEPLD	2	12	0	0	136.62	273.24	15	1	1	NA	1	NA	0	14
NAPG	2	7	0	1	107.91	215.82	15	1	1	1	1	0.222222222222222	1	9
NAPRT	2	13	1	5	91.74	183.48	15	1	1	-0.3	1	-0.0333333333333333	6	15
NARF	2	4	0	1	121.11	242.22	15	1	1	1	1	0.333333333333333	1	6
NARFL	3	9	1	1	118.14	236.28	15	1	0.505494505494505	-2	1	-0.25	2	12
NARS	19	24	0	3	310.86	621.72	15	1	0.256521739130435	1	1	0.441860465116279	3	43
NARS2	3	11	2	5	135.63	271.26	15	1	1	-0.466666666666667	1	-0.0714285714285714	7	14
NASP	4	4	0	1	158.73	317.46	15	1	1	1	1	0.5	1	8
NAT	4	2	1	0	85.14	170.28	15	1	1	-Inf	1	-0.333333333333333	1	6
NAT10	1	14	0	1	353.76	707.52	15	1	1	1	1	0.0666666666666667	1	15
NAT8L	2	2	0	1	36.63	73.26	15	1	1	1	1	0.5	1	4
NAT9	2	3	2	1	52.8	105.6	15	1	1	-2	1	-0.266666666666667	3	5
NATD1	0	1	0	1	9.9	19.8	15	1	1	NA	1	0	1	1
NAV1	2	18	1	8	237.93	475.86	15	1	1	-0.125	1	-0.0111111111111111	9	20
NAV2	9	34	2	2	733.59	1467.18	15	1	0.229417206290472	-2.77777777777778	1	-0.290697674418605	4	43
NAV3	9	31	1	2	611.16	1222.32	15	1	0.557896442751803	-0.722222222222222	1	-0.108333333333333	3	40
NBEA	7	18	3	3	645.81	1291.62	15	1	0.357833490202789	-1.57142857142857	1	-0.22	6	25
NBEAL1	12	25	0	0	932.25	1864.5	15	1	1	NA	1	NA	0	37
NBEAL2	4	8	3	5	182.49	364.98	15	1	1	-0.2	1	-0.0416666666666667	8	12
NBL1	0	2	0	0	38.28	76.56	15	1	1	NA	1	NA	0	2
NBR1	12	13	0	0	279.18	558.36	15	1	1	NA	1	NA	0	25
NCAM1	4	14	1	1	286.44	572.88	15	1	0.447368421052632	-2.5	1	-0.277777777777778	2	18
NCAN	1	5	1	1	69.63	139.26	15	1	0.464285714285714	-4	1	-0.333333333333333	2	6
NCAPD2	14	15	1	1	386.76	773.52	15	1	1	-0.0714285714285714	1	-0.0172413793103448	2	29
NCAPD3	33	24	2	8	451.44	902.88	15	1	0.0393057900698912	0.818181818181818	1	0.378947368421053	10	57
NCAPG	11	15	0	0	305.91	611.82	15	1	1	NA	1	NA	0	26
NCAPG2	9	9	3	2	324.72	649.44	15	1	1	-0.5	1	-0.1	5	18
NCAPH	10	6	1	0	191.73	383.46	15	1	1	-Inf	1	-0.375	1	16
NCBP1	0	4	0	0	179.52	359.04	15	1	1	NA	1	NA	0	4
NCBP2	0	2	0	0	29.04	58.08	15	1	1	NA	1	NA	0	2
NCBP3	1	6	0	0	132.99	265.98	15	1	1	NA	1	NA	0	7
NCDN	18	11	3	2	227.7	455.4	15	1	1	0.0833333333333334	1	0.0206896551724138	5	29
NCEH1	1	6	1	1	116.49	232.98	15	1	0.416666666666667	-5	1	-0.357142857142857	2	7
NCF1	2	2	0	1	90.09	180.18	15	1	1	1	1	0.5	1	4
NCF2	5	13	1	1	154.77	309.54	15	1	0.521052631578947	-1.6	1	-0.222222222222222	2	18
NCF4	2	9	1	1	132.66	265.32	15	1	0.423076923076923	-3.5	1	-0.318181818181818	2	11
NCK2	1	4	0	0	105.6	211.2	15	1	1	NA	1	NA	0	5
NCKAP1	0	13	0	3	336.6	673.2	15	1	1	NA	1	0	3	13
NCKIPSD	3	12	1	3	226.05	452.1	15	1	1	-0.333333333333333	1	-0.05	4	15
NCL	2	8	0	2	168.3	336.6	15	1	1	1	1	0.2	2	10
NCLN	1	7	0	0	154.44	308.88	15	1	1	NA	1	NA	0	8
NCOA1	3	7	0	2	152.13	304.26	15	1	1	1	1	0.3	2	10
NCOA2	1	9	0	0	486.42	972.84	15	1	1	NA	1	NA	0	10
NCOA3	8	23	3	1	430.98	861.96	15	1	0.0819327731092437	-7.625	1	-0.491935483870968	4	31
NCOA4	5	3	1	1	167.31	334.62	15	1	1	0.4	1	0.125	2	8
NCOA5	4	8	2	0	209.55	419.1	15	1	0.164835164835165	-Inf	1	-0.666666666666667	2	12
NCOA6	17	14	2	0	627.99	1255.98	15	1	0.496212121212121	-Inf	1	-0.451612903225806	2	31
NCOA7	3	8	0	1	304.26	608.52	15	1	1	1	1	0.272727272727273	1	11
NCOR1	2	21	0	3	777.48	1554.96	15	1	1	1	1	0.0869565217391304	3	23
NCOR2	2	20	2	6	502.92	1005.84	15	1	0.283524904214559	-2.33333333333333	1	-0.159090909090909	8	22
NCSTN	3	9	0	2	185.46	370.92	15	1	1	1	1	0.25	2	12
NDC1	4	10	0	3	192.06	384.12	15	1	0.541176470588235	1	1	0.285714285714286	3	14
NDC80	0	14	0	1	224.4	448.8	15	1	1	NA	1	0	1	14
NDE1	1	6	0	0	129.36	258.72	15	1	1	NA	1	NA	0	7
NDFIP1	1	3	0	0	44.22	88.44	15	1	1	NA	1	NA	0	4
NDNF	4	13	1	0	219.45	438.9	15	1	0.277777777777778	-Inf	1	-0.764705882352941	1	17
NDRG1	0	4	0	0	132	264	15	1	1	NA	1	NA	0	4
NDST1	0	10	0	4	176.22	352.44	15	1	1	NA	1	0	4	10
NDST2	2	14	0	4	306.57	613.14	15	1	1	1	1	0.125	4	16
NDST4	2	14	1	2	267.96	535.92	15	1	0.422084623323013	-2.5	1	-0.208333333333333	3	16
NDUFA10	6	9	2	1	104.94	209.88	15	1	0.558823529411765	-2	1	-0.266666666666667	3	15
NDUFA7	1	3	0	1	25.08	50.16	15	1	1	1	1	0.25	1	4
NDUFA9	1	3	0	0	97.02	194.04	15	1	1	NA	1	NA	0	4
NDUFAB1	0	1	0	1	22.77	45.54	15	1	1	NA	1	0	1	1
NDUFAF1	2	8	1	0	71.28	142.56	15	1	0.272727272727273	-Inf	1	-0.8	1	10
NDUFAF2	2	2	0	0	22.11	44.22	15	1	1	NA	1	NA	0	4
NDUFAF3	0	2	0	0	5.61	11.22	15	1	1	NA	1	NA	0	2
NDUFAF4	2	1	0	1	32.67	65.34	15	1	1	1	1	0.666666666666667	1	3
NDUFAF6	4	7	1	1	91.74	183.48	15	1	1	-0.75	1	-0.136363636363636	2	11
NDUFB10	1	2	0	2	31.68	63.36	15	1	1	1	1	0.333333333333333	2	3
NDUFB3	3	0	2	0	40.26	80.52	15	1	1	NA	1	0	2	3
NDUFB5	1	1	0	0	38.28	76.56	15	1	1	NA	1	NA	0	2
NDUFB6	3	1	0	0	16.17	32.34	15	1	1	NA	1	NA	0	4
NDUFB8	3	4	1	0	28.05	56.1	15	1	1	-Inf	1	-0.571428571428571	1	7
NDUFB9	0	2	0	1	38.28	76.56	15	1	1	NA	1	0	1	2
NDUFC2	1	2	0	0	24.42	48.84	15	1	1	NA	1	NA	0	3
NDUFS1	2	6	1	0	177.21	354.42	15	1	0.333333333333333	-Inf	1	-0.75	1	8
NDUFS3	0	4	0	0	65.01	130.02	15	1	1	NA	1	NA	0	4
NDUFS6	0	1	0	1	27.06	54.12	15	1	1	NA	1	0	1	1
NDUFV2	0	3	0	2	53.13	106.26	15	1	1	NA	1	0	2	3
NDUFV3	1	2	0	0	18.81	37.62	15	1	1	NA	1	NA	0	3
NEBL	4	0	0	0	37.95	75.9	15	1	1	NA	1	NA	0	4
NEBL1	15	79	7	16	1824.57	3649.14	15	1	0.137394225749252	-1.30416666666667	1	-0.14477335800185	23	94
NECAB2	2	6	1	2	64.35	128.7	15	1	1	-0.5	1	-0.0833333333333333	3	8
NECAB3	0	1	0	1	59.73	119.46	15	1	1	NA	1	0	1	1
NECAP1	0	5	0	1	99	198	15	1	1	NA	1	0	1	5
NECAP2	4	8	0	2	44.55	89.1	15	1	1	1	1	0.333333333333333	2	12
NECTIN1	0	5	0	2	77.22	154.44	15	1	1	NA	1	0	2	5
NECTIN3	6	7	1	1	216.15	432.3	15	1	1	-0.166666666666667	1	-0.0384615384615384	2	13
NEDD1	10	11	1	2	194.37	388.74	15	1	1	0.45	1	0.142857142857143	3	21
NEDD4	12	14	1	2	447.81	895.62	15	1	1	0.416666666666667	1	0.128205128205128	3	26
NEDD9	9	13	0	1	309.21	618.42	15	1	1	1	1	0.409090909090909	1	22
NEFL	0	6	0	1	102.63	205.26	15	1	1	NA	1	0	1	6
NEFM	1	10	0	2	98.34	196.68	15	1	1	1	1	0.0909090909090909	2	11
NEGR1	3	5	1	1	70.62	141.24	15	1	1	-0.666666666666667	1	-0.125	2	8
NEIL1	2	6	0	2	33.99	67.98	15	1	1	1	1	0.25	2	8
NEIL2	3	7	1	0	66.99	133.98	15	1	0.363636363636364	-Inf	1	-0.7	1	10
NEIL3	9	5	1	0	127.38	254.76	15	1	1	-Inf	1	-0.357142857142857	1	14
NEK1	11	7	1	1	408.87	817.74	15	1	1	0.363636363636364	1	0.111111111111111	2	18
NEK10	11	16	1	3	396.33	792.66	15	1	1	0.515151515151515	1	0.157407407407407	4	27
NEK11	7	8	1	1	179.19	358.38	15	1	1	-0.142857142857143	1	-0.0333333333333333	2	15
NEK2	4	9	2	1	99	198	15	1	0.517857142857143	-3.5	1	-0.358974358974359	3	13
NEK3	9	8	3	1	171.27	342.54	15	1	0.603007518796992	-1.66666666666667	1	-0.220588235294118	4	17
NEK4	11	7	3	1	250.47	500.94	15	1	1	-0.909090909090909	1	-0.138888888888889	4	18
NEK5	21	6	3	1	265.32	530.64	15	1	1	0.142857142857143	1	0.0277777777777778	4	27
NEK6	0	3	0	1	94.71	189.42	15	1	1	NA	1	0	1	3
NEK7	0	1	0	1	77.22	154.44	15	1	1	NA	1	0	1	1
NEK8	3	12	2	3	154.44	308.88	15	1	0.559791021671827	-1.66666666666667	1	-0.2	5	15
NEK9	2	11	1	4	235.95	471.9	15	1	1	-0.375	1	-0.0461538461538462	5	13
NELFA	2	4	0	0	137.94	275.88	15	1	1	NA	1	NA	0	6
NELFB	0	4	0	0	164.67	329.34	15	1	1	NA	1	NA	0	4
NELFCD	0	6	0	0	175.23	350.46	15	1	1	NA	1	NA	0	6
NELL1	2	7	0	0	104.28	208.56	15	1	1	NA	1	NA	0	9
NELL2	1	10	0	2	227.04	454.08	15	1	1	1	1	0.0909090909090909	2	11
NEMF	6	24	3	7	285.45	570.9	15	1	0.664967176577084	-0.714285714285714	1	-0.1	10	30
NEMP2	4	13	0	2	117.48	234.96	15	1	1	1	1	0.235294117647059	2	17
NENF	1	3	1	0	43.23	86.46	15	1	0.4	-Inf	1	-0.75	1	4
NEO1	4	28	1	5	474.54	949.08	15	1	1	-0.4	1	-0.0416666666666667	6	32
NEPRO	11	10	2	1	131.34	262.68	15	1	1	-0.818181818181818	1	-0.142857142857143	3	21
NETO1	2	2	1	0	119.79	239.58	15	1	1	-Inf	1	-0.5	1	4
NETO2	2	7	1	0	174.57	349.14	15	1	0.3	-Inf	1	-0.777777777777778	1	9
NEU2	8	2	0	0	89.76	179.52	15	1	1	NA	1	NA	0	10
NEU4	2	3	0	0	69.96	139.92	15	1	1	NA	1	NA	0	5
NEURL1B	1	6	1	3	109.56	219.12	15	1	1	-1	1	-0.107142857142857	4	7
NEURL2	0	2	0	0	13.53	27.06	15	1	1	NA	1	NA	0	2
NEUROD4	1	7	0	2	52.47	104.94	15	1	1	1	1	0.125	2	8
NEUROD6	0	3	0	1	57.09	114.18	15	1	1	NA	1	0	1	3
NEXN	0	4	0	0	166.98	333.96	15	1	1	NA	1	NA	0	4
NF1	2	9	0	0	502.92	1005.84	15	1	1	NA	1	NA	0	11
NF2	0	8	0	1	142.89	285.78	15	1	1	NA	1	0	1	8
NF2L	1	4	1	0	201.96	403.92	15	1	0.333333333333333	-Inf	1	-0.8	1	5
NFAM1	7	4	0	0	69.96	139.92	15	1	1	NA	1	NA	0	11
NFASC	2	18	0	7	337.59	675.18	15	1	1	1	1	0.1	7	20
NFAT5	8	23	2	6	503.91	1007.82	15	1	1	0.0416666666666666	1	0.00806451612903225	8	31
NFATC2	4	7	1	0	362.01	724.02	15	1	0.416666666666667	-Inf	1	-0.636363636363636	1	11
NFATC3	2	16	0	1	315.15	630.3	15	1	1	1	1	0.111111111111111	1	18
NFE2L2	6	7	3	0	185.79	371.58	15	1	0.2125	-Inf	1	-0.538461538461538	3	13
NFIL3	2	4	0	2	135.63	271.26	15	1	1	1	1	0.333333333333333	2	6
NFKB1	12	14	2	3	342.21	684.42	15	1	1	0.222222222222222	1	0.0615384615384615	5	26
NFKB2	0	6	0	2	113.19	226.38	15	1	1	NA	1	0	2	6
NFKBIA	0	4	0	1	85.47	170.94	15	1	1	NA	1	0	1	4
NFKBIE	1	2	0	1	35.31	70.62	15	1	1	1	1	0.333333333333333	1	3
NFKBIZ	1	11	1	1	178.86	357.72	15	1	0.274725274725275	-10	1	-0.416666666666667	2	12
NFRKB	2	21	0	7	368.61	737.22	15	1	1	1	1	0.0869565217391304	7	23
NFS1	0	13	0	2	129.36	258.72	15	1	1	NA	1	0	2	13
NFU1	2	2	0	1	70.62	141.24	15	1	1	1	1	0.5	1	4
NFXL1	4	16	0	3	292.71	585.42	15	1	1	1	1	0.2	3	20
NFYC	0	6	0	3	94.71	189.42	15	1	1	NA	1	0	3	6
NGB	0	3	0	0	26.07	52.14	15	1	1	NA	1	NA	0	3
NGEF	0	11	0	2	153.78	307.56	15	1	1	NA	1	0	2	11
NGF	3	5	0	0	74.58	149.16	15	1	1	NA	1	NA	0	8
NGFR	2	1	2	0	27.72	55.44	15	1	1	-Inf	1	-0.333333333333333	2	3
NGLY1	10	5	0	0	210.87	421.74	15	1	1	NA	1	NA	0	15
NHEJ1	1	1	0	0	29.7	59.4	15	1	1	NA	1	NA	0	2
NHLRC1	1	8	0	0	80.52	161.04	15	1	1	NA	1	NA	0	9
NHLRC2	5	7	0	2	165.33	330.66	15	1	0.505494505494505	1	1	0.416666666666667	2	12
NHLRC3	3	1	0	0	100.98	201.96	15	1	1	NA	1	NA	0	4
NHLRC4	5	8	1	3	102.96	205.92	15	1	1	0.466666666666667	1	0.134615384615385	4	13
NHS	10	26	3	7	372.9	745.8	15	1	1	-0.114285714285714	1	-0.0222222222222222	10	36
NHSL1	15	23	5	6	459.69	919.38	15	1	0.740458510675242	-0.277777777777778	1	-0.0598086124401914	11	38
NID1	15	20	2	4	458.7	917.4	15	1	1	0.333333333333333	1	0.0952380952380952	6	35
NID2	5	2	3	1	99	198	15	1	1	-0.2	1	-0.0357142857142857	4	7
NIF3L1	4	1	1	0	94.38	188.76	15	1	1	-Inf	1	-0.2	1	5
NIFK	6	7	1	2	45.21	90.42	15	1	1	0.416666666666667	1	0.128205128205128	3	13
NIM1KZ	3	6	0	1	113.52	227.04	15	1	1	1	1	0.333333333333333	1	9
NIN	21	46	4	10	577.83	1155.66	15	1	1	0.123809523809524	1	0.0277185501066098	14	67
NINJ1	0	2	0	1	43.23	86.46	15	1	1	NA	1	0	1	2
NINJ2	0	3	0	2	33.66	67.32	15	1	1	NA	1	0	2	3
NINL	13	8	4	2	141.57	283.14	15	1	1	-0.230769230769231	1	-0.0476190476190476	6	21
NIP7	0	3	0	1	19.47	38.94	15	1	1	NA	1	0	1	3
NIPA2	4	10	2	6	151.14	302.28	15	1	1	0.166666666666667	1	0.0357142857142857	8	14
NIPAL1	7	12	2	0	122.43	244.86	15	1	0.171428571428571	-Inf	1	-0.631578947368421	2	19
NIPAL2	5	4	1	1	98.34	196.68	15	1	1	0.2	1	0.0555555555555556	2	9
NIPAL4	3	9	1	0	118.8	237.6	15	1	0.307692307692308	-Inf	1	-0.75	1	12
NIPSNAP3L	1	3	0	1	57.42	114.84	15	1	1	1	1	0.25	1	4
NISCH	5	18	1	1	478.5	957	15	1	0.43	-2.6	1	-0.282608695652174	2	23
NIT2	2	7	1	2	96.69	193.38	15	1	1	-0.75	1	-0.111111111111111	3	9
NKAIN1	1	0	1	0	20.79	41.58	15	1	1	NA	1	0	1	1
NKAIN4	1	2	0	0	58.08	116.16	15	1	1	NA	1	NA	0	3
NKAP	3	7	1	0	89.43	178.86	15	1	0.363636363636364	-Inf	1	-0.7	1	10
NKD1	2	3	1	0	130.02	260.04	15	1	1	-Inf	1	-0.6	1	5
NKIRAS2	0	4	0	0	35.31	70.62	15	1	1	NA	1	NA	0	4
NKRF	5	9	0	3	201.96	403.92	15	1	0.514705882352941	1	1	0.357142857142857	3	14
NKTR	18	21	4	3	420.09	840.18	15	1	0.694271128757799	-0.555555555555556	1	-0.10989010989011	7	39
NKX2-5	0	5	0	0	56.43	112.86	15	1	1	NA	1	NA	0	5
NKX3-1	0	1	0	1	25.74	51.48	15	1	1	NA	1	0	1	1
NKX6-2	0	2	0	0	40.59	81.18	15	1	1	NA	1	NA	0	2
NKX6-3	0	3	0	0	45.54	91.08	15	1	1	NA	1	NA	0	3
NLGN4L	0	8	0	0	182.82	365.64	15	1	1	NA	1	NA	0	8
NLN	5	9	2	0	192.39	384.78	15	1	0.175	-Inf	1	-0.642857142857143	2	14
NLRC5	33	26	8	6	729.96	1459.92	15	1	1	-0.0505050505050506	1	-0.0121065375302664	14	59
NLRP1L	3	8	1	2	110.22	220.44	15	1	1	-0.333333333333333	1	-0.0606060606060606	3	11
NLRPL	14	13	3	2	227.7	455.4	15	1	1	-0.392857142857143	1	-0.0814814814814815	5	27
NLRX1	5	5	2	2	123.09	246.18	15	1	1	0	1	0	4	10
NMB	2	3	1	0	17.82	35.64	15	1	1	-Inf	1	-0.6	1	5
NMBR	1	4	0	0	147.84	295.68	15	1	1	NA	1	NA	0	5
NMD3	5	7	1	0	133.98	267.96	15	1	0.461538461538462	-Inf	1	-0.583333333333333	1	12
NME1	2	4	1	1	38.28	76.56	15	1	1	-1	1	-0.166666666666667	2	6
NME2	0	3	0	1	38.28	76.56	15	1	1	NA	1	0	1	3
NME5	1	1	0	0	49.17	98.34	15	1	1	NA	1	NA	0	2
NME6	1	2	0	0	46.2	92.4	15	1	1	NA	1	NA	0	3
NME7	2	4	1	0	108.57	217.14	15	1	0.428571428571428	-Inf	1	-0.666666666666667	1	6
NME8	7	6	0	0	144.87	289.74	15	1	1	NA	1	NA	0	13
NMI	3	5	1	1	93.72	187.44	15	1	1	-0.666666666666667	1	-0.125	2	8
NMNAT1	2	3	0	1	88.11	176.22	15	1	1	1	1	0.4	1	5
NMNAT2	0	6	0	1	74.91	149.82	15	1	1	NA	1	0	1	6
NMNAT3	4	8	1	0	99.66	199.32	15	1	0.384615384615385	-Inf	1	-0.666666666666667	1	12
NMRK2	5	2	0	0	48.84	97.68	15	1	1	NA	1	NA	0	7
NMT1	0	4	0	2	135.96	271.92	15	1	1	NA	1	0	2	4
NMT2	1	7	1	4	152.46	304.92	15	1	1	-0.75	1	-0.075	5	8
NMUR1	0	6	0	5	60.06	120.12	15	1	1	NA	1	0	5	6
NMUR2	0	10	0	2	111.21	222.42	15	1	1	NA	1	0	2	10
NNT	2	12	0	0	254.1	508.2	15	1	1	NA	1	NA	0	14
NOA1	7	5	1	1	108.9	217.8	15	1	1	0.285714285714286	1	0.0833333333333334	2	12
NOB1	4	6	1	3	65.67	131.34	15	1	1	0.5	1	0.15	4	10
NOBOX	24	7	3	0	190.41	380.82	15	1	1	-Inf	1	-0.225806451612903	3	31
NOC2L	11	13	4	3	210.54	421.08	15	1	0.685082190087752	-0.575757575757576	1	-0.113095238095238	7	24
NOC3L	11	14	2	3	404.58	809.16	15	1	1	0.151515151515151	1	0.04	5	25
NOC4L	3	10	0	4	147.18	294.36	15	1	0.541176470588235	1	1	0.230769230769231	4	13
NOCT	1	4	1	0	71.94	143.88	15	1	0.333333333333333	-Inf	1	-0.8	1	5
NOD1	3	14	0	4	321.75	643.5	15	1	1	1	1	0.176470588235294	4	17
NODAL	1	2	0	0	39.6	79.2	15	1	1	NA	1	NA	0	3
NOL11	7	10	0	2	204.6	409.2	15	1	0.508771929824561	1	1	0.411764705882353	2	17
NOL12	4	2	0	0	33.66	67.32	15	1	1	NA	1	NA	0	6
NOL4	3	3	0	1	143.55	287.1	15	1	1	1	1	0.5	1	6
NOL6	2	0	2	0	225.06	450.12	15	1	1	NA	1	0	2	2
NOL7	5	1	2	1	50.16	100.32	15	1	1	0.6	1	0.166666666666667	3	6
NOL8	29	26	5	7	375.21	750.42	15	1	0.538708257873724	0.359605911330049	1	0.110606060606061	12	55
NOL9	0	4	0	1	103.95	207.9	15	1	1	NA	1	0	1	4
NOLC1	3	10	1	2	211.2	422.4	15	1	1	-0.666666666666667	1	-0.102564102564103	3	13
NOM1	3	5	2	1	160.38	320.76	15	1	0.545454545454546	-2.33333333333333	1	-0.291666666666667	3	8
NOMO3	6	15	2	1	360.36	720.72	15	1	0.24901185770751	-4	1	-0.380952380952381	3	21
NONO	0	9	0	0	124.41	248.82	15	1	1	NA	1	NA	0	9
NOP14	6	12	0	1	270.93	541.86	15	1	1	1	1	0.333333333333333	1	18
NOP2	6	7	1	2	152.13	304.26	15	1	1	0.416666666666667	1	0.128205128205128	3	13
NOP56	0	1	0	1	30.03	60.06	15	1	1	NA	1	0	1	1
NOP58	2	7	2	1	182.16	364.32	15	1	0.236363636363636	-6	1	-0.444444444444444	3	9
NOS1	6	32	3	7	363.99	727.98	15	1	0.3697798250921	-1.28571428571429	1	-0.142105263157895	10	38
NOS2	5	19	1	4	377.52	755.04	15	1	1	0.05	1	0.00833333333333333	5	24
NOTCH1	3	22	3	13	386.43	772.86	15	1	0.662395682934836	-0.692307692307692	1	-0.0675	16	25
NOTCH2	9	32	3	7	743.16	1486.32	15	1	0.682214827716255	-0.523809523809524	1	-0.0804878048780488	10	41
NOTO	1	2	0	0	26.07	52.14	15	1	1	NA	1	NA	0	3
NOTUM	0	3	0	0	132.99	265.98	15	1	1	NA	1	NA	0	3
NOV	0	2	0	0	61.38	122.76	15	1	1	NA	1	NA	0	2
NOX1	2	9	0	0	109.56	219.12	15	1	1	NA	1	NA	0	11
NOX4	3	5	0	0	135.63	271.26	15	1	1	NA	1	NA	0	8
NOX5	3	1	1	1	52.47	104.94	15	1	1	0.666666666666667	1	0.25	2	4
NOXA1	4	4	0	0	135.3	270.6	15	1	1	NA	1	NA	0	8
NOXO1	4	9	0	2	95.37	190.74	15	1	1	1	1	0.307692307692308	2	13
NOXRED1-VIPAS39	5	10	1	3	243.21	486.42	15	1	1	0.333333333333333	1	0.0833333333333333	4	15
NPAS2	3	12	2	6	193.71	387.42	15	1	1	-0.333333333333333	1	-0.05	8	15
NPAS3	0	8	0	1	182.82	365.64	15	1	1	NA	1	0	1	8
NPAS4	3	1	2	0	40.26	80.52	15	1	1	-Inf	1	-0.25	2	4
NPAT	22	30	5	6	479.16	958.32	15	1	1	-0.136363636363636	1	-0.0314685314685315	11	52
NPBWR2	1	2	1	0	77.55	155.1	15	1	1	-Inf	1	-0.666666666666667	1	3
NPC1	9	22	1	5	487.41	974.82	15	1	1	0.511111111111111	1	0.123655913978495	6	31
NPC2	1	1	1	0	38.28	76.56	15	1	1	-Inf	1	-0.5	1	2
NPDC1	3	4	0	0	73.92	147.84	15	1	1	NA	1	NA	0	7
NPEPL1	1	5	0	0	139.26	278.52	15	1	1	NA	1	NA	0	6
NPEPPS	3	11	1	1	270.6	541.2	15	1	0.45	-2.66666666666667	1	-0.285714285714286	2	14
NPFFR2	5	6	1	1	152.46	304.92	15	1	1	-0.2	1	-0.0454545454545455	2	11
NPHP1	2	5	0	0	183.15	366.3	15	1	1	NA	1	NA	0	7
NPHP3	4	18	2	1	361.02	722.04	15	1	0.132608695652174	-8	1	-0.484848484848485	3	22
NPHP4	12	25	4	2	333.96	667.92	15	1	0.173998524388112	-3.16666666666667	1	-0.342342342342342	6	37
NPHS2	4	2	0	0	113.19	226.38	15	1	1	NA	1	NA	0	6
NPL	10	4	0	0	140.91	281.82	15	1	1	NA	1	NA	0	14
NPLOC4	0	4	0	2	141.57	283.14	15	1	1	NA	1	0	2	4
NPM1	3	1	1	1	71.94	143.88	15	1	1	0.666666666666667	1	0.25	2	4
NPM3	0	2	0	2	23.76	47.52	15	1	1	NA	1	0	2	2
NPNT	6	6	1	0	166.65	333.3	15	1	1	-Inf	1	-0.5	1	12
NPPA	2	1	0	0	72.27	144.54	15	1	1	NA	1	NA	0	3
NPR1	4	5	1	0	189.42	378.84	15	1	1	-Inf	1	-0.555555555555556	1	9
NPR2	1	5	0	4	63.03	126.06	15	1	1	1	1	0.166666666666667	4	6
NPRL2	1	1	0	0	43.56	87.12	15	1	1	NA	1	NA	0	2
NPSR1	2	5	0	0	89.76	179.52	15	1	1	NA	1	NA	0	7
NPTN	1	3	0	0	127.38	254.76	15	1	1	NA	1	NA	0	4
NPTX2	2	4	2	1	120.12	240.24	15	1	0.523809523809524	-3	1	-0.333333333333333	3	6
NPTXR	1	2	0	1	36.3	72.6	15	1	1	1	1	0.333333333333333	1	3
NPVF	2	2	0	0	71.61	143.22	15	1	1	NA	1	NA	0	4
NPY1R	0	5	0	1	151.14	302.28	15	1	1	NA	1	0	1	5
NPY2R	0	12	0	0	132.99	265.98	15	1	1	NA	1	NA	0	12
NPY4R	1	7	1	0	127.71	255.42	15	1	0.222222222222222	-Inf	1	-0.875	1	8
NPY5R	4	6	0	1	151.8	303.6	15	1	1	1	1	0.4	1	10
NPY7R	0	7	0	5	125.07	250.14	15	1	1	NA	1	0	5	7
NQO1	2	1	0	0	21.45	42.9	15	1	1	NA	1	NA	0	3
NR0B1	0	5	0	0	48.51	97.02	15	1	1	NA	1	NA	0	5
NR0B2	4	5	0	4	61.71	123.42	15	1	0.227972027972028	1	1	0.444444444444444	4	9
NR1D1	1	11	0	2	89.43	178.86	15	1	1	1	1	0.0833333333333333	2	12
NR1D2	1	7	0	0	151.14	302.28	15	1	1	NA	1	NA	0	8
NR1H4	1	3	0	1	200.64	401.28	15	1	1	1	1	0.25	1	4
NR2C2	4	12	1	3	194.04	388.08	15	1	1	0	1	0	4	16
NR2E1	1	5	1	1	92.4	184.8	15	1	0.464285714285714	-4	1	-0.333333333333333	2	6
NR2E3	1	4	0	0	23.43	46.86	15	1	1	NA	1	NA	0	5
NR3C1	0	7	0	1	134.97	269.94	15	1	1	NA	1	0	1	7
NR3C2	3	3	1	0	118.47	236.94	15	1	1	-Inf	1	-0.5	1	6
NR4A2	0	2	0	0	102.96	205.92	15	1	1	NA	1	NA	0	2
NR4A3	0	3	0	0	118.8	237.6	15	1	1	NA	1	NA	0	3
NR5A1	0	1	0	1	46.86	93.72	15	1	1	NA	1	0	1	1
NR5A2	0	6	0	0	170.28	340.56	15	1	1	NA	1	NA	0	6
NR6A1	1	1	0	1	105.93	211.86	15	1	1	1	1	0.5	1	2
NRAP	7	25	3	0	551.1	1102.2	15	1	0.0183346065699007	-Inf	1	-0.78125	3	32
NRBF2	2	6	1	1	129.69	259.38	15	1	1	-2	1	-0.25	2	8
NRBP1	0	3	0	1	178.86	357.72	15	1	1	NA	1	0	1	3
NRBP2	5	3	0	1	161.7	323.4	15	1	0.444444444444444	1	1	0.625	1	8
NRCAM	10	18	2	2	541.86	1083.72	15	1	0.619577308120134	-0.8	1	-0.142857142857143	4	28
NRDC	2	17	1	1	326.37	652.74	15	1	0.271428571428572	-7.5	1	-0.394736842105263	2	19
NRDE2	12	11	3	1	391.38	782.76	15	1	0.605128205128205	-1.75	1	-0.228260869565217	4	23
NRF1	2	7	0	2	90.42	180.84	15	1	1	1	1	0.222222222222222	2	9
NRG1	2	7	0	1	171.93	343.86	15	1	1	1	1	0.222222222222222	1	9
NRG2	1	3	0	1	101.97	203.94	15	1	1	1	1	0.25	1	4
NRG3	2	1	0	1	106.26	212.52	15	1	1	1	1	0.666666666666667	1	3
NRIP1	14	12	2	0	436.92	873.84	15	1	0.492063492063492	-Inf	1	-0.461538461538462	2	26
NRIP3	1	3	0	0	68.97	137.94	15	1	1	NA	1	NA	0	4
NRK	4	14	1	5	404.58	809.16	15	1	1	0.3	1	0.0555555555555556	6	18
NRN1L	1	0	1	0	13.2	26.4	15	1	1	NA	1	0	1	1
NRP1	4	15	0	1	314.82	629.64	15	1	1	1	1	0.210526315789474	1	19
NRP2	4	15	0	5	285.45	570.9	15	1	0.544042913608131	1	1	0.210526315789474	5	19
NRROS	6	10	2	2	231.33	462.66	15	1	1	-0.666666666666667	1	-0.125	4	16
NRSN1	9	7	0	0	131.67	263.34	15	1	1	NA	1	NA	0	16
NRSN2	1	0	1	0	3.96	7.92	15	1	1	NA	1	0	1	1
NRXN1	7	3	2	0	93.06	186.12	15	1	1	-Inf	1	-0.3	2	10
NRXN3	4	13	3	3	346.83	693.66	15	1	0.318493863116289	-2.25	1	-0.264705882352941	6	17
NSA2	0	4	0	0	68.64	137.28	15	1	1	NA	1	NA	0	4
NSD1	8	31	1	5	681.45	1362.9	15	1	1	0.225	1	0.0384615384615385	6	39
NSDHL	1	7	1	0	84.15	168.3	15	1	0.222222222222222	-Inf	1	-0.875	1	8
NSF	10	12	2	1	265.32	530.64	15	1	0.593043478260869	-1.4	1	-0.212121212121212	3	22
NSFL1C	0	5	0	2	70.95	141.9	15	1	1	NA	1	0	2	5
NSG1	1	1	0	0	61.05	122.1	15	1	1	NA	1	NA	0	2
NSL1	2	5	0	2	57.42	114.84	15	1	1	1	1	0.285714285714286	2	7
NSMAF	2	15	0	1	297.66	595.32	15	1	1	1	1	0.117647058823529	1	17
NSMCE1	2	0	0	0	74.58	149.16	15	1	1	NA	1	NA	0	2
NSMCE4A	4	3	1	0	101.31	202.62	15	1	1	-Inf	1	-0.428571428571429	1	7
NSMF	0	5	0	2	165.33	330.66	15	1	1	NA	1	0	2	5
NSRP1	1	3	1	1	93.39	186.78	15	1	1	-2	1	-0.25	2	4
NSUN2	3	8	1	0	184.47	368.94	15	1	0.333333333333333	-Inf	1	-0.727272727272727	1	11
NSUN3	4	9	1	0	123.09	246.18	15	1	0.357142857142857	-Inf	1	-0.692307692307692	1	13
NSUN4	3	7	2	4	94.38	188.76	15	1	1	-0.166666666666667	1	-0.0333333333333333	6	10
NSUN5	1	0	1	0	52.8	105.6	15	1	1	NA	1	0	1	1
NSUN6	5	2	1	0	113.52	227.04	15	1	1	-Inf	1	-0.285714285714286	1	7
NSUN7	14	9	2	0	205.92	411.84	15	1	0.52	-Inf	1	-0.391304347826087	2	23
NT5C1A	1	10	0	0	78.54	157.08	15	1	1	NA	1	NA	0	11
NT5C1B	0	7	0	0	87.78	175.56	15	1	1	NA	1	NA	0	7
NT5C2	0	6	0	1	163.02	326.04	15	1	1	NA	1	0	1	6
NT5C3A	0	4	0	0	104.94	209.88	15	1	1	NA	1	NA	0	4
NT5C3B	0	5	0	2	60.39	120.78	15	1	1	NA	1	0	2	5
NT5DC1	1	5	1	0	137.94	275.88	15	1	0.285714285714286	-Inf	1	-0.833333333333333	1	6
NT5DC2	0	7	0	1	129.36	258.72	15	1	1	NA	1	0	1	7
NT5DC3	0	7	0	1	144.87	289.74	15	1	1	NA	1	0	1	7
NT5M	0	2	0	0	32.34	64.68	15	1	1	NA	1	NA	0	2
NTAN1	1	3	1	0	97.68	195.36	15	1	0.4	-Inf	1	-0.75	1	4
NTF3	1	6	0	0	103.29	206.58	15	1	1	NA	1	NA	0	7
NTL	3	15	0	3	263.67	527.34	15	1	1	1	1	0.166666666666667	3	18
NTM	1	3	1	1	47.19	94.38	15	1	1	-2	1	-0.25	2	4
NTMT1	0	4	0	1	35.97	71.94	15	1	1	NA	1	0	1	4
NTN3	0	3	0	3	77.88	155.76	15	1	1	NA	1	0	3	3
NTN4	4	11	1	5	119.13	238.26	15	1	1	0.45	1	0.1	6	15
NTN4L	3	8	1	0	184.47	368.94	15	1	0.333333333333333	-Inf	1	-0.727272727272727	1	11
NTNG1	1	4	0	1	120.78	241.56	15	1	1	1	1	0.2	1	5
NTNG2	3	9	1	5	184.14	368.28	15	1	1	0.4	1	0.0833333333333333	6	12
NTPCR	1	3	1	0	45.54	91.08	15	1	0.4	-Inf	1	-0.75	1	4
NTRK2	0	4	0	0	57.42	114.84	15	1	1	NA	1	NA	0	4
NTRK3	1	5	0	0	348.81	697.62	15	1	1	NA	1	NA	0	6
NUAK1	2	7	0	2	211.2	422.4	15	1	1	1	1	0.222222222222222	2	9
NUAK2	1	4	1	1	51.81	103.62	15	1	1	-3	1	-0.3	2	5
NUB1	4	17	0	4	222.09	444.18	15	1	1	1	1	0.19047619047619	4	21
NUBP1	1	2	0	1	45.21	90.42	15	1	1	1	1	0.333333333333333	1	3
NUBPL	4	6	1	2	88.11	176.22	15	1	1	0.25	1	0.0666666666666667	3	10
NUCB2	0	2	0	0	132.66	265.32	15	1	1	NA	1	NA	0	2
NUDC	1	8	0	4	78.87	157.74	15	1	1	1	1	0.111111111111111	4	9
NUDCD1	8	7	3	1	154.77	309.54	15	1	0.602683178534572	-1.625	1	-0.216666666666667	4	15
NUDCD2	2	1	1	0	33.33	66.66	15	1	1	-Inf	1	-0.333333333333333	1	3
NUDCD3	1	2	1	1	28.05	56.1	15	1	1	-1	1	-0.166666666666667	2	3
NUDT1	3	2	0	1	44.22	88.44	15	1	1	1	1	0.6	1	5
NUDT12	1	7	0	2	88.44	176.88	15	1	1	1	1	0.125	2	8
NUDT13	3	9	0	2	130.02	260.04	15	1	1	1	1	0.25	2	12
NUDT14	2	1	0	0	59.73	119.46	15	1	1	NA	1	NA	0	3
NUDT19	2	3	0	0	45.21	90.42	15	1	1	NA	1	NA	0	5
NUDT2	0	2	0	0	38.94	77.88	15	1	1	NA	1	NA	0	2
NUDT21	0	3	0	0	51.81	103.62	15	1	1	NA	1	NA	0	3
NUDT3	0	1	0	1	36.3	72.6	15	1	1	NA	1	0	1	1
NUDT5	0	2	0	0	58.41	116.82	15	1	1	NA	1	NA	0	2
NUDT6	2	5	0	2	71.94	143.88	15	1	1	1	1	0.285714285714286	2	7
NUDT7	4	5	0	0	85.47	170.94	15	1	1	NA	1	NA	0	9
NUF2	0	7	0	1	112.86	225.72	15	1	1	NA	1	0	1	7
NUFIP1	11	12	2	1	168.3	336.6	15	1	1	-1.18181818181818	1	-0.188405797101449	3	23
NUFIP2	3	2	0	1	204.6	409.2	15	1	1	1	1	0.6	1	5
NUGGC	32	16	7	8	251.46	502.92	15	1	0.225033208728271	0.5625	1	0.2	15	48
NUMB	2	6	1	0	174.57	349.14	15	1	0.333333333333333	-Inf	1	-0.75	1	8
NUMBL	1	1	1	0	47.85	95.7	15	1	1	-Inf	1	-0.5	1	2
NUP107	8	19	2	4	263.34	526.68	15	1	1	-0.1875	1	-0.037037037037037	6	27
NUP133	3	14	1	3	356.07	712.14	15	1	1	-0.555555555555556	1	-0.0735294117647059	4	17
NUP153	17	10	3	2	277.2	554.4	15	1	1	0.117647058823529	1	0.0296296296296297	5	27
NUP155	3	9	0	0	310.2	620.4	15	1	1	NA	1	NA	0	12
NUP160	6	21	0	6	301.95	603.9	15	1	0.562663421117259	1	1	0.222222222222222	6	27
NUP188	4	24	2	5	547.14	1094.28	15	1	0.576160082801449	-1.4	1	-0.142857142857143	7	28
NUP205	3	25	1	2	637.56	1275.12	15	1	0.349276974416018	-3.16666666666667	1	-0.226190476190476	3	28
NUP210	13	26	5	7	588.06	1176.12	15	1	0.732380408463958	-0.428571428571429	1	-0.0833333333333334	12	39
NUP210L	30	36	5	8	565.62	1131.24	15	1	0.764326886245637	0.25	1	0.0699300699300699	13	66
NUP214	17	38	6	9	581.13	1162.26	15	1	0.54473419771971	-0.490196078431373	1	-0.0909090909090909	15	55
NUP37	2	1	0	0	91.41	182.82	15	1	1	NA	1	NA	0	3
NUP50	7	4	0	0	139.59	279.18	15	1	1	NA	1	NA	0	11
NUP54	1	12	0	1	190.08	380.16	15	1	1	1	1	0.0769230769230769	1	13
NUP58	0	5	0	1	151.8	303.6	15	1	1	NA	1	0	1	5
NUP62	3	8	1	2	133.32	266.64	15	1	1	-0.333333333333333	1	-0.0606060606060606	3	11
NUP85	4	15	0	2	215.16	430.32	15	1	1	1	1	0.210526315789474	2	19
NUP88	1	8	0	2	203.94	407.88	15	1	1	1	1	0.111111111111111	2	9
NUP93	4	9	0	0	234.63	469.26	15	1	1	NA	1	NA	0	13
NUP98	4	29	1	5	543.18	1086.36	15	1	1	-0.45	1	-0.0454545454545454	6	33
NUR2L	1	1	1	0	26.4	52.8	15	1	1	-Inf	1	-0.5	1	2
NUS1	0	2	0	1	50.16	100.32	15	1	1	NA	1	0	1	2
NUSAP1	6	7	0	0	128.7	257.4	15	1	1	NA	1	NA	0	13
NVL	9	7	0	1	289.41	578.82	15	1	0.470588235294118	1	1	0.5625	1	16
NWD2	12	35	7	5	648.12	1296.24	15	1	0.0416599920737568	-3.08333333333333	1	-0.328014184397163	12	47
NXF1	3	1	1	0	34.98	69.96	15	1	1	-Inf	1	-0.25	1	4
NXN	0	4	0	1	80.52	161.04	15	1	1	NA	1	0	1	4
NXPE3	2	7	1	0	190.08	380.16	15	1	0.3	-Inf	1	-0.777777777777778	1	9
NXPH1	1	3	0	1	108.9	217.8	15	1	1	1	1	0.25	1	4
NXPH2	0	5	0	1	75.57	151.14	15	1	1	NA	1	0	1	5
NXT2	0	4	0	0	44.55	89.1	15	1	1	NA	1	NA	0	4
NYAP2	0	12	0	3	241.23	482.46	15	1	1	NA	1	0	3	12
NYX	3	13	1	7	155.43	310.86	15	1	1	0.380952380952381	1	0.0625	8	16
OAF	0	5	0	0	43.89	87.78	15	1	1	NA	1	NA	0	5
OARD1	1	8	0	1	47.85	95.7	15	1	1	1	1	0.111111111111111	1	9
OAT	0	9	0	2	123.75	247.5	15	1	1	NA	1	0	2	9
OAZ2	0	3	0	1	60.06	120.12	15	1	1	NA	1	0	1	3
OBSCN	67	134	19	32	2641.98	5283.96	15	1	0.622000388241714	-0.1875	1	-0.0392156862745098	51	201
OBSL1	15	11	10	6	260.37	520.74	15	1	1	-0.222222222222222	1	-0.0480769230769231	16	26
OC3	1	3	0	0	33.66	67.32	15	1	1	NA	1	NA	0	4
OCA2	5	7	2	2	152.79	305.58	15	1	1	-0.4	1	-0.0833333333333333	4	12
OCIAD1	0	7	0	1	103.62	207.24	15	1	1	NA	1	0	1	7
OCLN	0	2	0	1	34.98	69.96	15	1	1	NA	1	0	1	2
OCM	2	0	1	0	41.58	83.16	15	1	1	NA	1	0	1	2
OCM2	1	1	0	0	54.12	108.24	15	1	1	NA	1	NA	0	2
OCRL	4	14	2	3	218.13	436.26	15	1	0.575618889120033	-1.33333333333333	1	-0.177777777777778	5	18
OCSTAMP	9	5	3	0	112.86	225.72	15	1	0.514705882352941	-Inf	1	-0.357142857142857	3	14
ODF2	7	11	1	1	253.11	506.22	15	1	1	-0.571428571428571	1	-0.111111111111111	2	18
ODF2L	7	6	0	0	173.58	347.16	15	1	1	NA	1	NA	0	13
OFCC1	9	10	0	2	152.13	304.26	15	1	0.485714285714286	1	1	0.473684210526316	2	19
OFD1	13	12	2	1	292.71	585.42	15	1	1	-0.846153846153846	1	-0.146666666666667	3	25
OGDH	0	4	0	3	128.04	256.08	15	1	1	NA	1	0	3	4
OGDHL	1	7	0	1	292.05	584.1	15	1	1	1	1	0.125	1	8
OGFOD1	1	7	0	4	140.58	281.16	15	1	1	1	1	0.125	4	8
OGFOD2	2	9	1	2	76.56	153.12	15	1	1	-1.25	1	-0.151515151515151	3	11
OGFOD3	4	1	0	1	117.48	234.96	15	1	0.333333333333333	1	1	0.8	1	5
OGFR	16	8	1	1	149.49	298.98	15	1	1	0.5	1	0.166666666666667	2	24
OGFRL1	3	3	1	0	116.16	232.32	15	1	1	-Inf	1	-0.5	1	6
OGG1	2	0	1	0	14.52	29.04	15	1	1	NA	1	0	1	2
OGN	0	3	0	0	66.66	133.32	15	1	1	NA	1	NA	0	3
OGT	1	18	1	2	335.94	671.88	15	1	0.25974025974026	-8	1	-0.280701754385965	3	19
OIP5	3	1	0	0	28.71	57.42	15	1	1	NA	1	NA	0	4
OIT3	1	8	0	1	174.24	348.48	15	1	1	1	1	0.111111111111111	1	9
OLA1	0	2	0	0	115.17	230.34	15	1	1	NA	1	NA	0	2
OLFM3	2	11	2	1	176.55	353.1	15	1	0.135714285714286	-10	1	-0.512820512820513	3	13
OLFM4	0	3	0	0	27.72	55.44	15	1	1	NA	1	NA	0	3
OLFML1	3	7	2	3	137.28	274.56	15	1	1	-0.555555555555556	1	-0.1	5	10
OLFML3	0	3	0	1	67.65	135.3	15	1	1	NA	1	0	1	3
OLFR1019L2	5	2	1	0	69.3	138.6	15	1	1	-Inf	1	-0.285714285714286	1	7
OLFR4	1	3	0	1	69.3	138.6	15	1	1	1	1	0.25	1	4
OLFR52I1L	8	10	2	2	164.01	328.02	15	1	1	-0.25	1	-0.0555555555555556	4	18
OMA1	7	5	3	0	156.75	313.5	15	1	0.505494505494505	-Inf	1	-0.416666666666667	3	12
OMD	4	9	1	0	193.38	386.76	15	1	0.357142857142857	-Inf	1	-0.692307692307692	1	13
OMG	2	8	0	2	168.3	336.6	15	1	1	1	1	0.2	2	10
ONECUT2	0	2	0	1	29.37	58.74	15	1	1	NA	1	0	1	2
OPA1	0	8	0	2	283.8	567.6	15	1	1	NA	1	0	2	8
OPHN1	1	10	1	4	191.73	383.46	15	1	1	-1.5	1	-0.109090909090909	5	11
OPN1MSW	0	6	0	3	84.81	169.62	15	1	1	NA	1	0	3	6
OPN3	1	5	0	2	119.13	238.26	15	1	1	1	1	0.166666666666667	2	6
OPN4	5	6	0	0	206.25	412.5	15	1	1	NA	1	NA	0	11
OPN4-1	2	5	0	0	152.46	304.92	15	1	1	NA	1	NA	0	7
OPN5	0	5	0	1	88.77	177.54	15	1	1	NA	1	0	1	5
OPN5L1	2	9	0	2	102.63	205.26	15	1	1	1	1	0.181818181818182	2	11
OPN5L2	1	8	0	1	135.63	271.26	15	1	1	1	1	0.111111111111111	1	9
OPNP	2	6	1	0	80.52	161.04	15	1	0.333333333333333	-Inf	1	-0.75	1	8
OPNVA	3	4	0	0	134.97	269.94	15	1	1	NA	1	NA	0	7
OPRD1	0	3	0	3	46.53	93.06	15	1	1	NA	1	0	3	3
OPRK1	0	3	0	0	111.21	222.42	15	1	1	NA	1	NA	0	3
OPRL1	0	5	0	1	91.74	183.48	15	1	1	NA	1	0	1	5
OPRM1	0	3	0	2	163.68	327.36	15	1	1	NA	1	0	2	3
OPTC	4	1	2	1	48.18	96.36	15	1	1	0.5	1	0.133333333333333	3	5
OPTN	2	9	0	0	143.88	287.76	15	1	1	NA	1	NA	0	11
OR10AC1	2	4	2	1	109.23	218.46	15	1	0.523809523809524	-3	1	-0.333333333333333	3	6
OR51M1L	5	7	3	2	96.36	192.72	15	1	0.619909502262444	-1.1	1	-0.183333333333333	5	12
OR52B2	3	6	2	4	62.04	124.08	15	1	1	0	1	0	6	9
OR5AS1	6	4	0	1	92.73	185.46	15	1	0.454545454545455	1	1	0.6	1	10
OR8D4	4	16	1	7	108.9	217.8	15	1	1	0.428571428571429	1	0.075	8	20
ORAI2	0	7	0	2	71.61	143.22	15	1	1	NA	1	0	2	7
ORC1	9	24	0	2	295.35	590.7	15	1	1	1	1	0.272727272727273	2	33
ORC2	5	8	1	0	155.1	310.2	15	1	0.428571428571428	-Inf	1	-0.615384615384615	1	13
ORC3	4	8	0	1	208.89	417.78	15	1	1	1	1	0.333333333333333	1	12
ORC4	6	10	0	0	151.8	303.6	15	1	1	NA	1	NA	0	16
ORC5	4	6	0	2	133.65	267.3	15	1	0.515151515151515	1	1	0.4	2	10
ORC6	4	2	1	0	74.91	149.82	15	1	1	-Inf	1	-0.333333333333333	1	6
ORMDL3	0	2	0	0	59.4	118.8	15	1	1	NA	1	NA	0	2
OSBP2	0	6	0	4	124.08	248.16	15	1	1	NA	1	0	4	6
OSBPL10	4	10	0	2	247.17	494.34	15	1	1	1	1	0.285714285714286	2	14
OSBPL11	2	11	1	2	260.7	521.4	15	1	0.489285714285714	-1.75	1	-0.179487179487179	3	13
OSBPL1A	18	21	5	3	433.95	867.9	15	1	0.461396797045655	-0.944444444444444	1	-0.163461538461538	8	39
OSBPL2	3	8	2	2	177.87	355.74	15	1	0.56043956043956	-1.66666666666667	1	-0.227272727272727	4	11
OSBPL3	2	8	2	0	223.41	446.82	15	1	0.0909090909090909	-Inf	1	-0.8	2	10
OSBPL5	0	14	0	3	245.19	490.38	15	1	1	NA	1	0	3	14
OSBPL6	3	6	0	1	308.22	616.44	15	1	1	1	1	0.333333333333333	1	9
OSBPL7	0	2	0	0	31.68	63.36	15	1	1	NA	1	NA	0	2
OSBPL8	2	10	0	2	301.29	602.58	15	1	1	1	1	0.166666666666667	2	12
OSBPL9	2	3	1	0	215.82	431.64	15	1	1	-Inf	1	-0.6	1	5
OSCP1	0	4	0	0	98.34	196.68	15	1	1	NA	1	NA	0	4
OSER1	5	5	0	0	106.92	213.84	15	1	1	NA	1	NA	0	10
OSGEPL1	3	10	1	0	136.29	272.58	15	1	0.285714285714286	-Inf	1	-0.769230769230769	1	13
OSGIN1	1	15	0	2	176.88	353.76	15	1	1	1	1	0.0625	2	16
OSMR	5	4	1	0	232.98	465.96	15	1	1	-Inf	1	-0.444444444444444	1	9
OSR1	1	2	0	0	100.65	201.3	15	1	1	NA	1	NA	0	3
OSTM1	0	2	0	0	69.63	139.26	15	1	1	NA	1	NA	0	2
OSTN	2	3	2	0	67.32	134.64	15	1	0.428571428571428	-Inf	1	-0.6	2	5
OTC	9	6	4	1	111.21	222.42	15	1	0.612616099071207	-1.66666666666667	1	-0.2	5	15
OTOA	7	12	1	2	442.86	885.72	15	1	1	0.142857142857143	1	0.0350877192982456	3	19
OTOF	10	33	4	13	482.46	964.92	15	1	1	-0.0153846153846153	1	-0.0027359781121751	17	43
OTOG	61	48	16	11	1093.95	2187.9	15	1	0.830300957390872	-0.144560357675112	1	-0.0329595650696568	27	109
OTOL1	1	7	0	4	62.37	124.74	15	1	1	1	1	0.125	4	8
OTOP1	4	7	2	0	188.1	376.2	15	1	0.192307692307692	-Inf	1	-0.636363636363636	2	11
OTOP2	2	11	1	5	149.49	298.98	15	1	1	-0.1	1	-0.0128205128205128	6	13
OTOP3	7	20	2	3	233.97	467.94	15	1	0.604247775305895	-0.904761904761905	1	-0.140740740740741	5	27
OTOR	1	1	0	0	45.54	91.08	15	1	1	NA	1	NA	0	2
OTOS	0	3	0	0	38.28	76.56	15	1	1	NA	1	NA	0	3
OTUD1	0	4	0	1	40.92	81.84	15	1	1	NA	1	0	1	4
OTUD3	9	8	5	2	121.44	242.88	15	1	0.652936689549962	-1.22222222222222	1	-0.184873949579832	7	17
OTUD4	7	10	1	2	301.95	603.9	15	1	1	0.285714285714286	1	0.0784313725490196	3	17
OTUD7A	6	7	1	3	272.58	545.16	15	1	0.602941176470588	0.611111111111111	1	0.211538461538462	4	13
OTUD7B	2	20	1	3	191.07	382.14	15	1	0.407692307692308	-2.33333333333333	1	-0.159090909090909	4	22
OTX2	0	2	0	1	25.41	50.82	15	1	1	NA	1	0	1	2
OVCH2	14	14	1	4	258.72	517.44	15	1	0.345674486803519	0.75	1	0.3	5	28
OVOL2	3	1	1	0	46.86	93.72	15	1	1	-Inf	1	-0.25	1	4
OVST	19	20	2	6	496.32	992.64	15	1	0.268993254557345	0.649122807017544	1	0.237179487179487	8	39
OVSTL	19	13	0	2	402.6	805.2	15	1	0.187165775401069	1	1	0.59375	2	32
OXCT1	0	6	0	0	114.51	229.02	15	1	1	NA	1	NA	0	6
OXGR1	6	8	2	0	125.73	251.46	15	1	0.466666666666667	-Inf	1	-0.571428571428571	2	14
OXGR1L	1	6	0	1	99.99	199.98	15	1	1	1	1	0.142857142857143	1	7
OXNAD1	2	6	1	2	91.74	183.48	15	1	1	-0.5	1	-0.0833333333333333	3	8
OXR1	5	8	1	1	236.28	472.56	15	1	1	-0.6	1	-0.115384615384615	2	13
OXSM	1	2	0	0	132.66	265.32	15	1	1	NA	1	NA	0	3
OXSR1	1	9	1	2	157.41	314.82	15	1	0.423076923076923	-3.5	1	-0.233333333333333	3	10
OXTR	1	2	0	1	77.55	155.1	15	1	1	1	1	0.333333333333333	1	3
P2RX1	0	5	0	1	85.47	170.94	15	1	1	NA	1	0	1	5
P2RX2	2	5	1	0	88.77	177.54	15	1	0.375	-Inf	1	-0.714285714285714	1	7
P2RX4	0	6	0	0	125.07	250.14	15	1	1	NA	1	NA	0	6
P2RX6	2	2	1	0	115.5	231	15	1	1	-Inf	1	-0.5	1	4
P2RX7	22	5	2	2	198	396	15	1	0.212013348164627	0.772727272727273	1	0.314814814814815	4	27
P2RY1	0	4	0	1	82.17	164.34	15	1	1	NA	1	0	1	4
P2RY10	2	4	0	1	153.12	306.24	15	1	1	1	1	0.333333333333333	1	6
P2RY13	8	7	1	0	129.69	259.38	15	1	1	-Inf	1	-0.466666666666667	1	15
P2RY14	0	14	0	2	132.33	264.66	15	1	1	NA	1	0	2	14
P2RY2	3	0	2	0	89.1	178.2	15	1	1	NA	1	0	2	3
P2RY6	0	3	0	1	29.7	59.4	15	1	1	NA	1	0	1	3
P2RY8	0	7	0	1	76.89	153.78	15	1	1	NA	1	0	1	7
P3H1	1	18	0	2	157.41	314.82	15	1	1	1	1	0.0526315789473684	2	19
P3H2	1	5	1	0	156.09	312.18	15	1	0.285714285714286	-Inf	1	-0.833333333333333	1	6
P3H3	5	11	3	4	265.65	531.3	15	1	0.657019787319962	-0.65	1	-0.116071428571429	7	16
P4HA1	3	4	1	0	183.81	367.62	15	1	1	-Inf	1	-0.571428571428571	1	7
P4HA2	1	8	0	1	161.37	322.74	15	1	1	1	1	0.111111111111111	1	9
P4HA3	2	0	1	0	39.93	79.86	15	1	1	NA	1	0	1	2
P4HB	1	3	1	0	137.94	275.88	15	1	0.4	-Inf	1	-0.75	1	4
P4HTM	2	6	0	1	88.11	176.22	15	1	1	1	1	0.25	1	8
PA2G4	0	2	0	0	60.06	120.12	15	1	1	NA	1	NA	0	2
PAAF1	0	5	0	1	33.33	66.66	15	1	1	NA	1	0	1	5
PABPC1	0	5	0	1	184.8	369.6	15	1	1	NA	1	0	1	5
PABPC1L	3	7	0	3	165.66	331.32	15	1	0.527972027972028	1	1	0.3	3	10
PABPC4	0	11	0	1	164.01	328.02	15	1	1	NA	1	0	1	11
PABPN1L	2	3	2	0	57.42	114.84	15	1	0.428571428571428	-Inf	1	-0.6	2	5
PACRGL	4	2	0	0	90.42	180.84	15	1	1	NA	1	NA	0	6
PACS2	0	7	0	1	234.63	469.26	15	1	1	NA	1	0	1	7
PACSIN1	1	2	0	2	45.21	90.42	15	1	1	1	1	0.333333333333333	2	3
PACSIN2	2	3	0	0	138.93	277.86	15	1	1	NA	1	NA	0	5
PACSIN3	2	2	0	0	140.91	281.82	15	1	1	NA	1	NA	0	4
PADI1	2	5	2	2	99	198	15	1	0.575757575757576	-1.5	1	-0.214285714285714	4	7
PADI2	5	6	4	2	68.97	137.94	15	1	0.619909502262443	-1.4	1	-0.212121212121212	6	11
PADIL	4	5	0	3	73.59	147.18	15	1	0.490909090909091	1	1	0.444444444444444	3	9
PAFAH1B2	0	4	0	0	34.32	68.64	15	1	1	NA	1	NA	0	4
PAFAH2	4	0	3	0	37.29	74.58	15	1	1	NA	1	0	3	4
PAH	1	10	1	1	125.4	250.8	15	1	0.294871794871795	-9	1	-0.409090909090909	2	11
PAICS	0	3	0	1	100.32	200.64	15	1	1	NA	1	0	1	3
PAIP1	2	9	0	0	90.75	181.5	15	1	1	NA	1	NA	0	11
PAIP2	0	5	0	2	50.82	101.64	15	1	1	NA	1	0	2	5
PAK1IP1	3	5	0	0	104.94	209.88	15	1	1	NA	1	NA	0	8
PAK2	0	7	0	4	178.53	357.06	15	1	1	NA	1	0	4	7
PAK3	1	5	1	1	174.57	349.14	15	1	0.464285714285714	-4	1	-0.333333333333333	2	6
PAK5	0	8	0	3	191.07	382.14	15	1	1	NA	1	0	3	8
PAK6	1	7	0	1	226.05	452.1	15	1	1	1	1	0.125	1	8
PALB2	35	26	5	4	422.73	845.46	15	1	1	0.0714285714285714	1	0.0182149362477231	9	61
PALLD	5	5	3	0	214.17	428.34	15	1	0.230769230769231	-Inf	1	-0.5	3	10
PALLDL	3	6	0	1	67.65	135.3	15	1	1	1	1	0.333333333333333	1	9
PALM	0	1	0	1	18.48	36.96	15	1	1	NA	1	0	1	1
PALMD	3	13	1	3	159.06	318.12	15	1	1	-0.444444444444444	1	-0.0625	4	16
PAM	7	8	3	0	233.97	467.94	15	1	0.215686274509804	-Inf	1	-0.533333333333333	3	15
PAN2	3	16	1	3	216.81	433.62	15	1	1	-0.777777777777778	1	-0.0921052631578947	4	19
PANK1	0	6	0	0	114.84	229.68	15	1	1	NA	1	NA	0	6
PANK4	0	10	0	4	214.17	428.34	15	1	1	NA	1	0	4	10
PANX1	1	6	0	2	144.54	289.08	15	1	1	1	1	0.142857142857143	2	7
PANX2	8	10	1	2	304.59	609.18	15	1	1	0.375	1	0.111111111111111	3	18
PANX3	3	7	0	0	86.79	173.58	15	1	1	NA	1	NA	0	10
PAOX	3	6	0	0	69.63	139.26	15	1	1	NA	1	NA	0	9
PAPD4	9	9	1	0	96.03	192.06	15	1	1	-Inf	1	-0.5	1	18
PAPD5	7	6	1	2	177.87	355.74	15	1	1	0.571428571428571	1	0.205128205128205	3	13
PAPD7	0	4	0	0	165.33	330.66	15	1	1	NA	1	NA	0	4
PAPLN	16	21	4	4	447.15	894.3	15	1	1	-0.3125	1	-0.0675675675675675	8	37
PAPOLA	1	4	0	0	222.75	445.5	15	1	1	NA	1	NA	0	5
PAPOLG	6	10	1	1	213.84	427.68	15	1	1	-0.666666666666667	1	-0.125	2	16
PAPPA	1	14	0	2	368.28	736.56	15	1	1	1	1	0.0666666666666667	2	15
PAPPA2	6	19	3	4	276.87	553.74	15	1	0.370178938136391	-1.375	1	-0.188571428571429	7	25
PAPSS1	6	8	1	0	200.97	401.94	15	1	0.466666666666667	-Inf	1	-0.571428571428571	1	14
PAPSS2	2	14	1	2	226.71	453.42	15	1	0.422084623323013	-2.5	1	-0.208333333333333	3	16
PAQR3	1	6	0	2	49.17	98.34	15	1	1	1	1	0.142857142857143	2	7
PAQR5	2	4	1	1	57.09	114.18	15	1	1	-1	1	-0.166666666666667	2	6
PAQR7	0	2	0	2	61.71	123.42	15	1	1	NA	1	0	2	2
PAQR8	1	4	1	1	82.17	164.34	15	1	1	-3	1	-0.3	2	5
PAQR9	0	4	0	0	44.22	88.44	15	1	1	NA	1	NA	0	4
PARD3	6	10	1	0	497.64	995.28	15	1	0.411764705882353	-Inf	1	-0.625	1	16
PARD3B	11	10	2	0	373.89	747.78	15	1	0.486166007905138	-Inf	1	-0.476190476190476	2	21
PARD6B	0	7	0	0	112.86	225.72	15	1	1	NA	1	NA	0	7
PARD6G	0	8	0	1	122.1	244.2	15	1	1	NA	1	0	1	8
PARG	9	18	2	5	314.49	628.98	15	1	1	0.2	1	0.0476190476190476	7	27
PARK7	1	5	1	0	53.46	106.92	15	1	0.285714285714286	-Inf	1	-0.833333333333333	1	6
PARL	3	5	1	1	83.82	167.64	15	1	1	-0.666666666666667	1	-0.125	2	8
PARM1	3	3	0	1	34.32	68.64	15	1	1	1	1	0.5	1	6
PARN	2	5	1	0	167.64	335.28	15	1	0.375	-Inf	1	-0.714285714285714	1	7
PARP12	12	6	0	1	146.19	292.38	15	1	0.368421052631579	1	1	0.666666666666667	1	18
PARP14	37	36	4	9	870.54	1741.08	15	1	0.235456558710109	0.567567567567568	1	0.199157007376185	13	73
PARP16	0	2	0	1	65.67	131.34	15	1	1	NA	1	0	1	2
PARP3	3	4	1	2	62.04	124.08	15	1	1	0.333333333333333	1	0.0952380952380952	3	7
PARP4	13	13	4	6	363.33	726.66	15	1	0.716924528937877	0.333333333333333	1	0.1	10	26
PARP6	0	7	0	2	102.3	204.6	15	1	1	NA	1	0	2	7
PARP8	6	4	1	0	169.29	338.58	15	1	1	-Inf	1	-0.4	1	10
PARP9	16	18	2	0	285.78	571.56	15	1	0.485714285714286	-Inf	1	-0.529411764705882	2	34
PARS2	4	9	1	0	119.79	239.58	15	1	0.357142857142857	-Inf	1	-0.692307692307692	1	13
PARVA	2	9	0	4	120.78	241.56	15	1	1	1	1	0.181818181818182	4	11
PARVG	3	5	0	1	87.78	175.56	15	1	1	1	1	0.375	1	8
PASD1	9	8	0	1	227.04	454.08	15	1	1	1	1	0.529411764705882	1	17
PASK	21	18	4	1	363.66	727.32	15	1	0.37017038548519	-2.42857142857143	1	-0.261538461538462	5	39
PATJ	17	27	2	5	650.43	1300.86	15	1	0.699026474604643	0.364705882352941	1	0.100649350649351	7	44
PATL2	2	10	1	1	156.75	313.5	15	1	0.395604395604396	-4	1	-0.333333333333333	2	12
PAWR	2	4	0	0	74.25	148.5	15	1	1	NA	1	NA	0	6
PAX2	1	2	1	0	51.15	102.3	15	1	1	-Inf	1	-0.666666666666667	1	3
PAX7	2	3	0	0	87.45	174.9	15	1	1	NA	1	NA	0	5
PAXBP1	3	6	2	0	231.99	463.98	15	1	0.181818181818182	-Inf	1	-0.666666666666667	2	9
PAXIP1	3	16	1	4	339.57	679.14	15	1	1	-0.333333333333333	1	-0.0421052631578948	5	19
PAXX	2	2	0	0	24.42	48.84	15	1	1	NA	1	NA	0	4
PBK	1	4	0	1	24.75	49.5	15	1	1	1	1	0.2	1	5
PBLD	3	5	1	0	69.3	138.6	15	1	0.444444444444444	-Inf	1	-0.625	1	8
PBX3	3	0	1	0	88.77	177.54	15	1	1	NA	1	0	1	3
PCASP1	8	6	2	0	231	462	15	1	0.5	-Inf	1	-0.428571428571429	2	14
PCASP3	4	13	1	2	238.26	476.52	15	1	1	-0.625	1	-0.0980392156862745	3	17
PCBD1	0	3	0	0	29.7	59.4	15	1	1	NA	1	NA	0	3
PCBP2	0	2	0	0	99.99	199.98	15	1	1	NA	1	NA	0	2
PCBP3	0	1	0	1	67.32	134.64	15	1	1	NA	1	0	1	1
PCCA	0	3	0	0	110.22	220.44	15	1	1	NA	1	NA	0	3
PCCB	1	5	0	1	145.53	291.06	15	1	1	1	1	0.166666666666667	1	6
PCDH1	6	13	2	5	232.98	465.96	15	1	1	0.133333333333333	1	0.0300751879699248	7	19
PCDH10	4	2	0	0	146.52	293.04	15	1	1	NA	1	NA	0	6
PCDH11X	8	12	6	1	364.98	729.96	15	1	0.0768115942028985	-8	1	-0.457142857142857	7	20
PCDH12	12	21	4	5	307.56	615.12	15	1	0.710851831972424	-0.4	1	-0.0808080808080808	9	33
PCDH15	5	15	0	4	167.97	335.94	15	1	0.544042913608131	1	1	0.25	4	20
PCDH17	0	21	0	1	241.23	482.46	15	1	1	NA	1	0	1	21
PCDH18	3	22	1	1	421.08	842.16	15	1	0.279202279202279	-6.33333333333333	1	-0.38	2	25
PCDH19	5	22	1	0	316.14	632.28	15	1	0.214285714285714	-Inf	1	-0.814814814814815	1	27
PCDH20	6	20	3	2	288.09	576.18	15	1	0.131256952169077	-4	1	-0.369230769230769	5	26
PCDH7	1	9	0	0	148.5	297	15	1	1	NA	1	NA	0	10
PCDH8	1	8	1	2	188.1	376.2	15	1	0.454545454545454	-3	1	-0.222222222222222	3	9
PCDH9	1	7	0	1	318.78	637.56	15	1	1	1	1	0.125	1	8
PCDHAC2	2	11	1	2	264	528	15	1	0.489285714285714	-1.75	1	-0.179487179487179	3	13
PCGF2	0	1	0	1	29.04	58.08	15	1	1	NA	1	0	1	1
PCGF5	0	6	0	0	88.11	176.22	15	1	1	NA	1	NA	0	6
PCID2	0	9	0	4	140.58	281.16	15	1	1	NA	1	0	4	9
PCIF1	0	8	0	2	201.63	403.26	15	1	1	NA	1	0	2	8
PCK1	0	9	0	1	202.95	405.9	15	1	1	NA	1	0	1	9
PCLO	28	55	1	7	1446.06	2892.12	15	1	0.428103651968144	0.719387755102041	1	0.212349397590361	8	83
PCM1	19	25	5	4	625.02	1250.04	15	1	0.715252556261365	-0.644736842105263	1	-0.123737373737374	9	44
PCMT1	0	3	0	0	81.51	163.02	15	1	1	NA	1	NA	0	3
PCMT1L	1	6	1	1	76.56	153.12	15	1	0.416666666666667	-5	1	-0.357142857142857	2	7
PCMTD1	0	3	0	1	114.18	228.36	15	1	1	NA	1	0	1	3
PCMTD2	2	2	1	0	119.79	239.58	15	1	1	-Inf	1	-0.5	1	4
PCNA	0	2	0	0	52.14	104.28	15	1	1	NA	1	NA	0	2
PCNP	0	2	0	1	62.7	125.4	15	1	1	NA	1	0	1	2
PCNT	25	18	2	0	590.37	1180.74	15	1	0.509090909090909	-Inf	1	-0.418604651162791	2	43
PCNX1	1	17	0	4	725.67	1451.34	15	1	1	1	1	0.0555555555555556	4	18
PCNX2	10	25	3	6	589.05	1178.1	15	1	1	-0.25	1	-0.0476190476190476	9	35
PCNX4	7	21	1	3	445.17	890.34	15	1	1	0	1	0	4	28
PCOLCE2	1	10	1	0	119.79	239.58	15	1	0.166666666666667	-Inf	1	-0.909090909090909	1	11
PCSK1	4	16	1	1	147.84	295.68	15	1	0.411255411255411	-3	1	-0.3	2	20
PCSK2	2	12	0	4	218.13	436.26	15	1	1	1	1	0.142857142857143	4	14
PCSK4	4	6	3	4	84.15	168.3	15	1	1	-0.125	1	-0.0285714285714285	7	10
PCSK5	2	3	0	0	92.73	185.46	15	1	1	NA	1	NA	0	5
PCSK6	2	10	0	4	122.76	245.52	15	1	1	1	1	0.166666666666667	4	12
PCSK7	2	4	0	2	112.53	225.06	15	1	1	1	1	0.333333333333333	2	6
PCSK9	10	17	2	6	114.51	229.02	15	1	0.685467512922855	0.433333333333333	1	0.12037037037037	8	27
PCTP	2	3	0	0	54.12	108.24	15	1	1	NA	1	NA	0	5
PCTPL	2	4	1	3	45.54	91.08	15	1	1	0.333333333333333	1	0.0833333333333333	4	6
PCYOX1	2	3	2	1	70.29	140.58	15	1	1	-2	1	-0.266666666666667	3	5
PCYOX1L	3	12	0	0	103.29	206.58	15	1	1	NA	1	NA	0	15
PCYT1A	5	13	1	4	202.29	404.58	15	1	1	0.35	1	0.0777777777777778	5	18
PCYT1B	0	4	0	1	95.37	190.74	15	1	1	NA	1	0	1	4
PCYT2	0	2	0	0	113.19	226.38	15	1	1	NA	1	NA	0	2
PDAP1	0	6	0	1	54.45	108.9	15	1	1	NA	1	0	1	6
PDC	1	2	1	0	64.02	128.04	15	1	1	-Inf	1	-0.666666666666667	1	3
PDCD1	1	8	0	1	71.61	143.22	15	1	1	1	1	0.111111111111111	1	9
PDCD11	29	26	4	1	552.09	1104.18	15	1	0.366575409886493	-2.58620689655172	1	-0.272727272727273	5	55
PDCD1LG2	1	3	0	0	61.38	122.76	15	1	1	NA	1	NA	0	4
PDCD2	2	5	0	0	67.65	135.3	15	1	1	NA	1	NA	0	7
PDCD2L	5	5	0	0	88.11	176.22	15	1	1	NA	1	NA	0	10
PDCD4	1	5	0	1	125.73	251.46	15	1	1	1	1	0.166666666666667	1	6
PDCD6	0	2	0	0	23.1	46.2	15	1	1	NA	1	NA	0	2
PDCD6IP	3	13	2	2	230.01	460.02	15	1	0.248710010319917	-3.33333333333333	1	-0.3125	4	16
PDCD7	2	4	1	0	54.12	108.24	15	1	0.428571428571428	-Inf	1	-0.666666666666667	1	6
PDCL	0	3	0	0	129.36	258.72	15	1	1	NA	1	NA	0	3
PDCL2	4	6	2	4	109.89	219.78	15	1	1	0.25	1	0.0666666666666667	6	10
PDCL3	1	5	1	1	85.14	170.28	15	1	0.464285714285714	-4	1	-0.333333333333333	2	6
PDDC1	0	3	0	0	63.03	126.06	15	1	1	NA	1	NA	0	3
PDE10A	0	8	0	1	224.07	448.14	15	1	1	NA	1	0	1	8
PDE11A	2	9	0	1	221.43	442.86	15	1	1	1	1	0.181818181818182	1	11
PDE12	1	10	0	0	112.86	225.72	15	1	1	NA	1	NA	0	11
PDE1A	5	4	2	0	206.91	413.82	15	1	0.490909090909091	-Inf	1	-0.444444444444444	2	9
PDE1C	5	4	1	0	157.41	314.82	15	1	1	-Inf	1	-0.444444444444444	1	9
PDE3A	7	14	0	0	300.3	600.6	15	1	1	NA	1	NA	0	21
PDE3B	5	11	0	3	178.86	357.72	15	1	0.530443756449948	1	1	0.3125	3	16
PDE4DIP	23	23	7	3	442.86	885.72	15	1	0.310236791333445	-1.33333333333333	1	-0.2	10	46
PDE5A	2	10	2	0	314.16	628.32	15	1	0.0659340659340659	-Inf	1	-0.833333333333333	2	12
PDE6B	0	18	0	3	231	462	15	1	1	NA	1	0	3	18
PDE6C	1	7	0	1	253.11	506.22	15	1	1	1	1	0.125	1	8
PDE6D	0	2	0	0	44.55	89.1	15	1	1	NA	1	NA	0	2
PDE7A	1	4	1	0	131.67	263.34	15	1	0.333333333333333	-Inf	1	-0.8	1	5
PDE7B	0	3	0	1	140.25	280.5	15	1	1	NA	1	0	1	3
PDE8A	0	8	0	0	276.21	552.42	15	1	1	NA	1	NA	0	8
PDE8B	6	9	2	1	202.29	404.58	15	1	0.558823529411765	-2	1	-0.266666666666667	3	15
PDE9A	0	6	0	1	182.82	365.64	15	1	1	NA	1	0	1	6
PDGFB	1	6	1	2	57.75	115.5	15	1	1	-2	1	-0.19047619047619	3	7
PDGFC	1	4	0	1	107.58	215.16	15	1	1	1	1	0.2	1	5
PDGFD	2	3	1	0	128.7	257.4	15	1	1	-Inf	1	-0.6	1	5
PDGFRA	2	20	0	2	340.23	680.46	15	1	1	1	1	0.0909090909090909	2	22
PDGFRB	6	25	4	8	322.08	644.16	15	1	0.426723825309124	-1.08333333333333	1	-0.139784946236559	12	31
PDGFRL	1	3	0	1	93.72	187.44	15	1	1	1	1	0.25	1	4
PDHA1	0	6	0	0	127.71	255.42	15	1	1	NA	1	NA	0	6
PDHB	1	5	0	1	74.58	149.16	15	1	1	1	1	0.166666666666667	1	6
PDHX	2	8	1	1	139.92	279.84	15	1	0.454545454545455	-3	1	-0.3	2	10
PDIA3	2	4	0	1	136.95	273.9	15	1	1	1	1	0.333333333333333	1	6
PDIA4	2	4	0	0	203.28	406.56	15	1	1	NA	1	NA	0	6
PDIA5	0	6	0	0	136.29	272.58	15	1	1	NA	1	NA	0	6
PDIK1L	0	2	0	0	106.92	213.84	15	1	1	NA	1	NA	0	2
PDK1	0	6	0	1	133.98	267.96	15	1	1	NA	1	0	1	6
PDK3	0	2	0	0	113.52	227.04	15	1	1	NA	1	NA	0	2
PDK4	0	2	0	1	132	264	15	1	1	NA	1	0	1	2
PDLIM1	0	11	0	1	98.34	196.68	15	1	1	NA	1	0	1	11
PDLIM3	0	3	0	1	88.11	176.22	15	1	1	NA	1	0	1	3
PDLIM4	3	7	1	2	106.59	213.18	15	1	1	-0.166666666666667	1	-0.0333333333333333	3	10
PDLIM5	8	6	3	1	196.68	393.36	15	1	1	-1.25	1	-0.178571428571429	4	14
PDLIM7	3	6	0	2	156.75	313.5	15	1	1	1	1	0.333333333333333	2	9
PDPK1	0	6	0	0	214.5	429	15	1	1	NA	1	NA	0	6
PDRG1	1	2	0	2	26.73	53.46	15	1	1	1	1	0.333333333333333	2	3
PDS5A	2	11	0	1	401.28	802.56	15	1	1	1	1	0.153846153846154	1	13
PDS5B	0	13	0	1	385.44	770.88	15	1	1	NA	1	0	1	13
PDSS1	0	3	0	1	92.4	184.8	15	1	1	NA	1	0	1	3
PDSS2	2	1	1	0	53.46	106.92	15	1	1	-Inf	1	-0.333333333333333	1	3
PDXDC1	4	7	0	0	259.38	518.76	15	1	1	NA	1	NA	0	11
PDXK	1	4	0	1	104.94	209.88	15	1	1	1	1	0.2	1	5
PDXP	0	1	0	1	22.44	44.88	15	1	1	NA	1	0	1	1
PDZD2	28	25	2	2	675.51	1351.02	15	1	1	0.107142857142857	1	0.0283018867924528	4	53
PDZD3	3	4	2	1	47.85	95.7	15	1	1	-1.66666666666667	1	-0.238095238095238	3	7
PDZD7	0	2	0	1	48.84	97.68	15	1	1	NA	1	0	1	2
PDZD8	9	14	1	1	355.08	710.16	15	1	1	-0.555555555555556	1	-0.108695652173913	2	23
PDZK1	5	7	0	1	129.69	259.38	15	1	1	1	1	0.416666666666667	1	12
PDZK1IP1	1	1	0	1	21.78	43.56	15	1	1	1	1	0.5	1	2
PDZRN3	2	13	1	5	297.66	595.32	15	1	1	-0.3	1	-0.0333333333333333	6	15
PEAK1	5	27	1	6	553.08	1106.16	15	1	1	0.1	1	0.0133928571428572	7	32
PEBP1	1	4	1	3	33.33	66.66	15	1	1	-0.333333333333333	1	-0.05	4	5
PEBP4	0	3	0	2	23.76	47.52	15	1	1	NA	1	0	2	3
PECAM1	9	11	2	2	272.91	545.82	15	1	1	-0.222222222222222	1	-0.05	4	20
PEF1	0	1	0	1	18.81	37.62	15	1	1	NA	1	0	1	1
PELI1	2	6	0	2	287.43	574.86	15	1	1	1	1	0.25	2	8
PELO	0	6	0	2	87.78	175.56	15	1	1	NA	1	0	2	6
PENK	0	5	0	1	79.2	158.4	15	1	1	NA	1	0	1	5
PEPD	3	3	0	0	148.17	296.34	15	1	1	NA	1	NA	0	6
PER2	1	23	1	2	415.8	831.6	15	1	0.213675213675214	-10.5	1	-0.291666666666667	3	24
PER3	18	12	0	0	313.83	627.66	15	1	1	NA	1	NA	0	30
PERM1	6	4	3	2	59.4	118.8	15	1	1	0	1	0	5	10
PERP1	1	2	0	1	33.33	66.66	15	1	1	1	1	0.333333333333333	1	3
PERP2	1	2	0	1	57.75	115.5	15	1	1	1	1	0.333333333333333	1	3
PEX1	10	14	2	0	390.06	780.12	15	1	0.203076923076923	-Inf	1	-0.583333333333333	2	24
PEX10	2	4	0	1	79.86	159.72	15	1	1	1	1	0.333333333333333	1	6
PEX11A	2	3	0	0	81.51	163.02	15	1	1	NA	1	NA	0	5
PEX11G	3	2	1	2	54.78	109.56	15	1	1	0.666666666666667	1	0.266666666666667	3	5
PEX12	3	8	1	4	74.25	148.5	15	1	1	0.333333333333333	1	0.0727272727272727	5	11
PEX13	1	6	0	0	100.32	200.64	15	1	1	NA	1	NA	0	7
PEX14	1	2	0	0	73.59	147.18	15	1	1	NA	1	NA	0	3
PEX16	5	1	2	0	81.18	162.36	15	1	1	-Inf	1	-0.166666666666667	2	6
PEX2	3	1	0	0	105.93	211.86	15	1	1	NA	1	NA	0	4
PEX26	3	2	1	0	59.07	118.14	15	1	1	-Inf	1	-0.4	1	5
PEX3	1	5	0	0	94.71	189.42	15	1	1	NA	1	NA	0	6
PEX5	2	4	1	2	183.15	366.3	15	1	1	0	1	0	3	6
PEX5L	1	4	1	1	186.78	373.56	15	1	1	-3	1	-0.3	2	5
PEX7	2	3	2	1	71.94	143.88	15	1	1	-2	1	-0.266666666666667	3	5
PFDN4	0	4	0	2	39.93	79.86	15	1	1	NA	1	0	2	4
PFDN5	2	2	0	0	21.78	43.56	15	1	1	NA	1	NA	0	4
PFKFB3	4	8	0	1	138.93	277.86	15	1	1	1	1	0.333333333333333	1	12
PFKFB4L	0	5	0	1	127.05	254.1	15	1	1	NA	1	0	1	5
PFKL	1	1	1	0	58.41	116.82	15	1	1	-Inf	1	-0.5	1	2
PFKP	1	5	0	0	251.13	502.26	15	1	1	NA	1	NA	0	6
PGA3	2	8	0	0	114.51	229.02	15	1	1	NA	1	NA	0	10
PGA5	3	4	0	1	45.21	90.42	15	1	1	1	1	0.428571428571429	1	7
PGAM1	1	1	0	0	25.41	50.82	15	1	1	NA	1	NA	0	2
PGAM5	0	7	0	1	86.79	173.58	15	1	1	NA	1	0	1	7
PGAP1	11	10	2	0	244.86	489.72	15	1	0.486166007905138	-Inf	1	-0.476190476190476	2	21
PGAP2	0	1	0	1	24.09	48.18	15	1	1	NA	1	0	1	1
PGBD5	1	2	0	0	123.75	247.5	15	1	1	NA	1	NA	0	3
PGC	3	11	2	3	84.81	169.62	15	1	0.569573443412453	-1.44444444444444	1	-0.185714285714286	5	14
PGD	0	3	0	0	124.41	248.82	15	1	1	NA	1	NA	0	3
PGF	0	1	0	1	18.15	36.3	15	1	1	NA	1	0	1	1
PGGHG	15	16	4	1	197.67	395.34	15	1	0.341991341991342	-3.26666666666667	1	-0.316129032258065	5	31
PGGT1B	2	4	0	0	161.04	322.08	15	1	1	NA	1	NA	0	6
PGK1	3	7	1	0	146.19	292.38	15	1	0.363636363636364	-Inf	1	-0.7	1	10
PGM1	0	14	0	4	190.74	381.48	15	1	1	NA	1	0	4	14
PGM2	1	9	1	3	180.51	361.02	15	1	0.505494505494505	-2	1	-0.15	4	10
PGM2L1	3	6	1	2	96.69	193.38	15	1	1	0	1	0	3	9
PGM3	7	12	0	1	160.38	320.76	15	1	1	1	1	0.368421052631579	1	19
PGM5	0	2	0	0	74.58	149.16	15	1	1	NA	1	NA	0	2
PGPEP1	0	5	0	1	48.84	97.68	15	1	1	NA	1	0	1	5
PGPEP1L	1	3	0	1	54.78	109.56	15	1	1	1	1	0.25	1	4
PGR	0	4	0	0	149.49	298.98	15	1	1	NA	1	NA	0	4
PGS1	2	8	1	1	160.71	321.42	15	1	0.454545454545455	-3	1	-0.3	2	10
PHACTR1	2	2	1	0	136.95	273.9	15	1	1	-Inf	1	-0.5	1	4
PHACTR2	6	7	2	3	178.2	356.4	15	1	1	0.222222222222222	1	0.0615384615384615	5	13
PHACTR3	3	4	0	1	229.02	458.04	15	1	1	1	1	0.428571428571429	1	7
PHACTR4	1	7	0	1	84.81	169.62	15	1	1	1	1	0.125	1	8
PHAX	0	3	0	3	60.72	121.44	15	1	1	NA	1	0	3	3
PHB	0	2	0	0	75.9	151.8	15	1	1	NA	1	NA	0	2
PHB2	0	2	0	1	49.83	99.66	15	1	1	NA	1	0	1	2
PHC1	4	8	0	1	209.55	419.1	15	1	1	1	1	0.333333333333333	1	12
PHC3	4	10	2	2	325.71	651.42	15	1	0.568627450980392	-1.5	1	-0.214285714285714	4	14
PHEX	4	4	2	0	182.82	365.64	15	1	0.466666666666667	-Inf	1	-0.5	2	8
PHF10	1	4	0	0	142.23	284.46	15	1	1	NA	1	NA	0	5
PHF12	3	6	2	2	295.68	591.36	15	1	1	-1	1	-0.166666666666667	4	9
PHF13	1	2	1	0	45.87	91.74	15	1	1	-Inf	1	-0.666666666666667	1	3
PHF14	0	6	0	0	154.44	308.88	15	1	1	NA	1	NA	0	6
PHF19	1	9	0	2	95.04	190.08	15	1	1	1	1	0.1	2	10
PHF2	0	7	0	3	269.28	538.56	15	1	1	NA	1	0	3	7
PHF20	4	6	2	1	277.86	555.72	15	1	0.559440559440559	-2	1	-0.266666666666667	3	10
PHF20L1	0	4	0	0	290.73	581.46	15	1	1	NA	1	NA	0	4
PHF21A	1	2	0	1	207.9	415.8	15	1	1	1	1	0.333333333333333	1	3
PHF3	8	19	3	3	590.37	1180.74	15	1	0.375208565072302	-1.375	1	-0.203703703703704	6	27
PHGDH	2	1	1	0	22.77	45.54	15	1	1	-Inf	1	-0.333333333333333	1	3
PHIP	2	18	1	2	517.77	1035.54	15	1	0.356295878035009	-3.5	1	-0.233333333333333	3	20
PHKA1	0	8	0	3	214.5	429	15	1	1	NA	1	0	3	8
PHKA2	0	29	0	5	377.85	755.7	15	1	1	NA	1	0	5	29
PHKB	5	9	1	3	333.96	667.92	15	1	1	0.4	1	0.107142857142857	4	14
PHKG1	1	7	1	0	101.31	202.62	15	1	0.222222222222222	-Inf	1	-0.875	1	8
PHLDA2	0	2	0	0	23.43	46.86	15	1	1	NA	1	NA	0	2
PHLDA3	1	1	1	1	11.55	23.1	15	1	1	0	1	0	2	2
PHLDB1	8	16	0	1	258.06	516.12	15	1	1	1	1	0.333333333333333	1	24
PHLDB2	2	16	0	1	420.75	841.5	15	1	1	1	1	0.111111111111111	1	18
PHLPP2	6	28	1	2	786.39	1572.78	15	1	0.477477477477477	-1.33333333333333	1	-0.156862745098039	3	34
PHOSPHO1	0	4	0	1	123.09	246.18	15	1	1	NA	1	0	1	4
PHOX2B	4	0	1	0	56.1	112.2	15	1	1	NA	1	0	1	4
PHPT1	1	1	0	0	5.61	11.22	15	1	1	NA	1	NA	0	2
PHTF1	4	6	0	1	216.48	432.96	15	1	1	1	1	0.4	1	10
PHTF2	3	13	0	1	232.32	464.64	15	1	1	1	1	0.1875	1	16
PHYH	1	4	0	1	88.11	176.22	15	1	1	1	1	0.2	1	5
PHYHD1	0	3	0	0	74.25	148.5	15	1	1	NA	1	NA	0	3
PHYHIPL	0	3	0	0	137.94	275.88	15	1	1	NA	1	NA	0	3
PHYKPL	6	8	1	0	127.71	255.42	15	1	0.466666666666667	-Inf	1	-0.571428571428571	1	14
PI15	2	4	0	0	115.17	230.34	15	1	1	NA	1	NA	0	6
PI16	6	7	1	0	176.88	353.76	15	1	1	-Inf	1	-0.538461538461538	1	13
PI4K2B	2	7	1	3	124.41	248.82	15	1	1	-0.166666666666667	1	-0.0277777777777778	4	9
PI4KA	1	19	0	4	395.67	791.34	15	1	1	1	1	0.05	4	20
PI4KB	2	15	0	3	243.54	487.08	15	1	1	1	1	0.117647058823529	3	17
PIANP	1	1	0	0	36.3	72.6	15	1	1	NA	1	NA	0	2
PIAS1	0	8	0	3	176.88	353.76	15	1	1	NA	1	0	3	8
PIAS2	2	7	0	1	151.8	303.6	15	1	1	1	1	0.222222222222222	1	9
PIBF1	1	7	0	1	190.41	380.82	15	1	1	1	1	0.125	1	8
PICALM	2	7	0	1	203.94	407.88	15	1	1	1	1	0.222222222222222	1	9
PICK1	2	6	1	0	109.56	219.12	15	1	0.333333333333333	-Inf	1	-0.75	1	8
PIEZO1	3	7	1	4	121.11	242.22	15	1	1	0.416666666666667	1	0.1	5	10
PIEZO2	5	27	0	1	782.1	1564.2	15	1	1	1	1	0.15625	1	32
PIF1	6	13	1	1	135.3	270.6	15	1	1	-1.16666666666667	1	-0.184210526315789	2	19
PIGA	4	6	2	0	72.27	144.54	15	1	0.454545454545454	-Inf	1	-0.6	2	10
PIGB	6	8	2	4	104.94	209.88	15	1	1	0.333333333333333	1	0.0952380952380952	6	14
PIGC	2	11	1	5	118.8	237.6	15	1	1	-0.1	1	-0.0128205128205128	6	13
PIGG	2	6	1	0	207.57	415.14	15	1	0.333333333333333	-Inf	1	-0.75	1	8
PIGK	2	9	0	0	113.52	227.04	15	1	1	NA	1	NA	0	11
PIGL	4	4	3	0	86.13	172.26	15	1	0.236363636363636	-Inf	1	-0.5	3	8
PIGM	5	5	1	1	64.35	128.7	15	1	1	0	1	0	2	10
PIGP	0	2	0	0	44.88	89.76	15	1	1	NA	1	NA	0	2
PIGQ	2	9	2	2	180.84	361.68	15	1	0.516483516483517	-3.5	1	-0.318181818181818	4	11
PIGR	32	27	5	2	363.99	727.98	15	1	0.453159380281274	-1.109375	1	-0.171912832929782	7	59
PIGS	2	7	2	1	77.22	154.44	15	1	0.236363636363636	-6	1	-0.444444444444444	3	9
PIGT	3	17	2	2	156.42	312.84	15	1	0.179277244494636	-4.66666666666667	1	-0.35	4	20
PIGU	3	6	0	0	115.83	231.66	15	1	1	NA	1	NA	0	9
PIGV	11	10	4	1	104.61	209.22	15	1	0.3561872909699	-2.63636363636364	1	-0.276190476190476	5	21
PIGW	6	6	1	0	114.51	229.02	15	1	1	-Inf	1	-0.5	1	12
PIGZ	4	9	0	0	139.26	278.52	15	1	1	NA	1	NA	0	13
PIH1D2	2	1	0	1	57.75	115.5	15	1	1	1	1	0.666666666666667	1	3
PIH1D3	0	2	0	0	61.71	123.42	15	1	1	NA	1	NA	0	2
PIK3AP1	5	9	1	0	264.99	529.98	15	1	0.4	-Inf	1	-0.642857142857143	1	14
PIK3C2A	5	26	2	2	607.53	1215.06	15	1	0.170989304812834	-4.2	1	-0.338709677419355	4	31
PIK3C2B	2	5	2	1	104.28	208.56	15	1	0.5	-4	1	-0.380952380952381	3	7
PIK3C2G	21	5	1	0	286.77	573.54	15	1	1	-Inf	1	-0.192307692307692	1	26
PIK3C3	1	5	0	1	199.65	399.3	15	1	1	1	1	0.166666666666667	1	6
PIK3CA	0	5	0	0	270.93	541.86	15	1	1	NA	1	NA	0	5
PIK3CB	2	12	1	1	320.1	640.2	15	1	0.35	-5	1	-0.357142857142857	2	14
PIK3CD	3	12	1	4	338.91	677.82	15	1	1	0	1	0	5	15
PIK3CG	1	22	1	2	363.33	726.66	15	1	0.221538461538462	-10	1	-0.289855072463768	3	23
PIK3R1	1	4	1	0	191.07	382.14	15	1	0.333333333333333	-Inf	1	-0.8	1	5
PIK3R2	1	2	0	0	85.8	171.6	15	1	1	NA	1	NA	0	3
PIK3R3	1	4	1	2	129.36	258.72	15	1	1	-1	1	-0.133333333333333	3	5
PIK3R4	2	15	1	1	407.55	815.1	15	1	0.298245614035088	-6.5	1	-0.382352941176471	2	17
PIK3R5	4	10	2	1	176.55	353.1	15	1	0.514705882352941	-4	1	-0.380952380952381	3	14
PIK3R6	6	12	1	5	205.59	411.18	15	1	0.628666527980029	0.6	1	0.166666666666667	6	18
PIKFYVE	9	30	2	1	671.88	1343.76	15	1	0.162891986062718	-5.66666666666667	1	-0.435897435897436	3	39
PIM3	0	2	0	0	37.29	74.58	15	1	1	NA	1	NA	0	2
PINX1	2	3	0	2	79.86	159.72	15	1	1	1	1	0.4	2	5
PIP4K2A	10	7	6	4	172.59	345.18	15	1	1	-0.05	1	-0.0117647058823529	10	17
PIP5K1A	1	16	0	1	208.56	417.12	15	1	1	1	1	0.0588235294117647	1	17
PIP5K1B	1	7	0	0	111.21	222.42	15	1	1	NA	1	NA	0	8
PIP5K1C	0	2	0	1	166.32	332.64	15	1	1	NA	1	0	1	2
PIRT	1	5	0	1	43.89	87.78	15	1	1	1	1	0.166666666666667	1	6
PISD	3	0	1	0	33.33	66.66	15	1	1	NA	1	0	1	3
PIT54	3	10	0	2	117.81	235.62	15	1	1	1	1	0.230769230769231	2	13
PITHD1	1	1	0	0	27.06	54.12	15	1	1	NA	1	NA	0	2
PITPNA	3	3	0	0	99	198	15	1	1	NA	1	NA	0	6
PITPNB	0	2	0	1	64.68	129.36	15	1	1	NA	1	0	1	2
PITPNC1	2	2	0	0	134.97	269.94	15	1	1	NA	1	NA	0	4
PITPNM2	3	13	3	0	361.02	722.04	15	1	0.020639834881321	-Inf	1	-0.8125	3	16
PITPNM3	1	11	0	0	306.9	613.8	15	1	1	NA	1	NA	0	12
PITRM1	5	8	0	0	314.16	628.32	15	1	1	NA	1	NA	0	13
PITX2	0	2	0	1	37.62	75.24	15	1	1	NA	1	0	1	2
PITX3	0	4	0	1	50.49	100.98	15	1	1	NA	1	0	1	4
PIWIL1	1	20	0	3	257.4	514.8	15	1	1	1	1	0.0476190476190476	3	21
PJA2	15	12	1	2	134.31	268.62	15	1	0.586206896551724	0.6	1	0.222222222222222	3	27
PKD1	33	59	10	21	1122.99	2245.98	15	1	0.828765968888505	0.148629148629149	1	0.0361150070126227	31	92
PKD1L2	11	25	3	2	822.36	1644.72	15	1	0.316951739929917	-2.40909090909091	1	-0.294444444444444	5	36
PKD2	5	14	1	1	221.43	442.86	15	1	0.5	-1.8	1	-0.236842105263158	2	19
PKD2L1	5	20	1	1	251.79	503.58	15	1	0.401709401709402	-3	1	-0.3	2	25
PKD2L2	8	7	0	0	201.3	402.6	15	1	1	NA	1	NA	0	15
PKDCCA	1	2	0	0	95.37	190.74	15	1	1	NA	1	NA	0	3
PKDCCB	0	11	0	1	84.81	169.62	15	1	1	NA	1	0	1	11
PKHD1	66	52	5	5	1191.3	2382.6	15	1	0.750610994489682	0.212121212121212	1	0.059322033898305	10	118
PKIG	0	1	0	1	11.55	23.1	15	1	1	NA	1	0	1	1
PKM	0	9	0	1	161.04	322.08	15	1	1	NA	1	0	1	9
PKN2	2	11	2	1	295.35	590.7	15	1	0.135714285714286	-10	1	-0.512820512820513	3	13
PKN3	5	17	2	1	309.21	618.42	15	1	0.179565217391304	-5.8	1	-0.439393939393939	3	22
PKNOX1	0	3	0	0	97.68	195.36	15	1	1	NA	1	NA	0	3
PKNOX2	1	2	0	0	83.16	166.32	15	1	1	NA	1	NA	0	3
PKP1	6	12	1	3	217.14	434.28	15	1	1	0.333333333333333	1	0.0833333333333333	4	18
PKP2	12	16	0	1	319.44	638.88	15	1	1	1	1	0.428571428571429	1	28
PKP3	1	5	0	1	105.93	211.86	15	1	1	1	1	0.166666666666667	1	6
PKP4	9	13	1	2	404.58	809.16	15	1	1	0.277777777777778	1	0.0757575757575758	3	22
PLA1A	6	7	1	1	154.44	308.88	15	1	1	-0.166666666666667	1	-0.0384615384615384	2	13
PLA2G10	1	1	0	0	39.6	79.2	15	1	1	NA	1	NA	0	2
PLA2G10L	3	5	1	3	39.93	79.86	15	1	1	0.444444444444444	1	0.125	4	8
PLA2G12B	1	3	0	0	43.89	87.78	15	1	1	NA	1	NA	0	4
PLA2G15	0	4	0	0	140.91	281.82	15	1	1	NA	1	NA	0	4
PLA2G2A	1	1	0	0	10.89	21.78	15	1	1	NA	1	NA	0	2
PLA2G2E	4	3	0	0	32.01	64.02	15	1	1	NA	1	NA	0	7
PLA2G2E-PLA2G5	1	1	0	0	15.84	31.68	15	1	1	NA	1	NA	0	2
PLA2G4A	1	6	1	1	195.36	390.72	15	1	0.416666666666667	-5	1	-0.357142857142857	2	7
PLA2G6	1	8	0	2	171.6	343.2	15	1	1	1	1	0.111111111111111	2	9
PLA2G7	2	3	0	1	78.54	157.08	15	1	1	1	1	0.4	1	5
PLA2R1	5	22	1	1	477.18	954.36	15	1	0.376847290640394	-3.4	1	-0.314814814814815	2	27
PLAA	8	15	3	0	201.63	403.26	15	1	0.0634615384615385	-Inf	1	-0.652173913043478	3	23
PLAC8L1	2	2	0	0	29.7	59.4	15	1	1	NA	1	NA	0	4
PLAC9	3	1	1	0	28.71	57.42	15	1	1	-Inf	1	-0.25	1	4
PLAGL1	0	5	0	0	199.65	399.3	15	1	1	NA	1	NA	0	5
PLAGL2	1	10	0	2	119.13	238.26	15	1	1	1	1	0.0909090909090909	2	11
PLAT	4	8	3	1	147.18	294.36	15	1	0.261538461538462	-5	1	-0.416666666666667	4	12
PLAU	14	15	2	0	163.68	327.36	15	1	0.483870967741935	-Inf	1	-0.517241379310345	2	29
PLBD1	1	10	0	2	154.44	308.88	15	1	1	1	1	0.0909090909090909	2	11
PLBD2	0	1	0	1	19.8	39.6	15	1	1	NA	1	0	1	1
PLCB1	2	13	0	1	354.09	708.18	15	1	1	1	1	0.133333333333333	1	15
PLCB2	7	8	4	2	366.63	733.26	15	1	0.635117204776647	-1.28571428571429	1	-0.2	6	15
PLCB4	1	13	0	5	406.89	813.78	15	1	1	1	1	0.0714285714285714	5	14
PLCD1	0	5	0	2	237.93	475.86	15	1	1	NA	1	0	2	5
PLCD3	0	5	0	1	85.14	170.28	15	1	1	NA	1	0	1	5
PLCD4	1	4	1	2	89.76	179.52	15	1	1	-1	1	-0.133333333333333	3	5
PLCE1	11	26	1	2	734.91	1469.82	15	1	1	-0.181818181818182	1	-0.036036036036036	3	37
PLCG1	2	12	0	2	260.04	520.08	15	1	1	1	1	0.142857142857143	2	14
PLCG2	4	17	1	3	382.8	765.6	15	1	1	-0.416666666666667	1	-0.0595238095238095	4	21
PLCH1	21	26	4	6	483.78	967.56	15	1	1	0.174603174603175	1	0.0468085106382978	10	47
PLCH2	11	21	3	5	504.9	1009.8	15	1	1	-0.145454545454546	1	-0.03125	8	32
PLCL1	4	22	1	4	304.92	609.84	15	1	1	-0.375	1	-0.0461538461538462	5	26
PLCL2	4	8	0	1	420.09	840.18	15	1	1	1	1	0.333333333333333	1	12
PLCXD1	3	4	1	0	124.41	248.82	15	1	1	-Inf	1	-0.571428571428571	1	7
PLCXD2	1	7	0	2	112.53	225.06	15	1	1	1	1	0.125	2	8
PLCZ1	6	5	0	1	144.87	289.74	15	1	1	1	1	0.545454545454545	1	11
PLD1	1	17	0	3	282.15	564.3	15	1	1	1	1	0.0555555555555556	3	18
PLD4	5	5	0	1	180.51	361.02	15	1	1	1	1	0.5	1	10
PLD6	0	5	0	2	43.23	86.46	15	1	1	NA	1	0	2	5
PLEK	2	3	0	0	106.59	213.18	15	1	1	NA	1	NA	0	5
PLEK2	2	4	0	1	134.31	268.62	15	1	1	1	1	0.333333333333333	1	6
PLEKHA1	2	3	0	1	145.86	291.72	15	1	1	1	1	0.4	1	5
PLEKHA2	1	2	1	1	92.73	185.46	15	1	1	-1	1	-0.166666666666667	2	3
PLEKHA3	4	4	0	0	91.41	182.82	15	1	1	NA	1	NA	0	8
PLEKHA5	4	12	0	0	353.43	706.86	15	1	1	NA	1	NA	0	16
PLEKHA6	1	11	0	5	127.05	254.1	15	1	1	1	1	0.0833333333333333	5	12
PLEKHA7	6	19	1	2	318.12	636.24	15	1	1	-0.583333333333333	1	-0.0933333333333333	3	25
PLEKHA8	3	6	1	1	169.29	338.58	15	1	1	-1	1	-0.166666666666667	2	9
PLEKHB2	1	3	0	0	47.52	95.04	15	1	1	NA	1	NA	0	4
PLEKHD1	2	9	1	2	176.88	353.76	15	1	1	-1.25	1	-0.151515151515151	3	11
PLEKHF1	1	1	0	1	96.03	192.06	15	1	1	1	1	0.5	1	2
PLEKHF2	2	7	0	3	73.59	147.18	15	1	1	1	1	0.222222222222222	3	9
PLEKHG1	10	24	2	0	550.11	1100.22	15	1	0.104761904761905	-Inf	1	-0.705882352941176	2	34
PLEKHG3	1	0	1	0	19.47	38.94	15	1	1	NA	1	0	1	1
PLEKHG4	17	28	4	10	495.99	991.98	15	1	0.750564477166461	0.341176470588235	1	0.0920634920634921	14	45
PLEKHG5	1	15	0	2	134.31	268.62	15	1	1	1	1	0.0625	2	16
PLEKHH1	19	21	4	3	529.32	1058.64	15	1	0.700775998358697	-0.473684210526316	1	-0.0964285714285714	7	40
PLEKHH3	2	3	2	0	48.84	97.68	15	1	0.428571428571428	-Inf	1	-0.6	2	5
PLEKHM1	9	21	4	2	226.05	452.1	15	1	0.160776407337128	-3.66666666666667	1	-0.366666666666667	6	30
PLEKHM2	5	11	3	6	265.65	531.3	15	1	1	-0.1	1	-0.0208333333333333	9	16
PLEKHM3	6	7	0	1	265.65	531.3	15	1	1	1	1	0.461538461538462	1	13
PLEKHN1	1	6	1	3	101.64	203.28	15	1	1	-1	1	-0.107142857142857	4	7
PLEKHO1	2	2	0	1	62.37	124.74	15	1	1	1	1	0.5	1	4
PLEKHO2	8	3	2	0	117.81	235.62	15	1	1	-Inf	1	-0.272727272727273	2	11
PLEKHS1	10	6	0	0	166.32	332.64	15	1	1	NA	1	NA	0	16
PLG	2	10	0	1	252.78	505.56	15	1	1	1	1	0.166666666666667	1	12
PLGL	10	9	2	0	229.68	459.36	15	1	0.485714285714286	-Inf	1	-0.473684210526316	2	19
PLIN1	2	6	0	3	53.13	106.26	15	1	1	1	1	0.25	3	8
PLIN3	11	14	3	4	224.73	449.46	15	1	1	0.0454545454545454	1	0.0114285714285715	7	25
PLIN3L	11	11	4	0	132.99	265.98	15	1	0.113377926421405	-Inf	1	-0.5	4	22
PLIN4	0	2	0	0	23.43	46.86	15	1	1	NA	1	NA	0	2
PLK1	0	11	0	1	179.85	359.7	15	1	1	NA	1	0	1	11
PLK2	1	3	0	0	126.72	253.44	15	1	1	NA	1	NA	0	4
PLK3	3	6	2	2	92.07	184.14	15	1	1	-1	1	-0.166666666666667	4	9
PLK4	6	11	1	1	345.84	691.68	15	1	1	-0.833333333333333	1	-0.147058823529412	2	17
PLOD1	2	12	1	2	254.1	508.2	15	1	0.464705882352941	-2	1	-0.19047619047619	3	14
PLPP1	0	6	0	0	59.07	118.14	15	1	1	NA	1	NA	0	6
PLPP2	1	1	0	0	32.34	64.68	15	1	1	NA	1	NA	0	2
PLPP5	4	5	2	1	69.63	139.26	15	1	1	-1.5	1	-0.222222222222222	3	9
PLPP7	1	2	0	1	54.45	108.9	15	1	1	1	1	0.333333333333333	1	3
PLPPR1	3	4	0	0	73.26	146.52	15	1	1	NA	1	NA	0	7
PLPPR3	1	1	0	1	32.34	64.68	15	1	1	1	1	0.5	1	2
PLPPR4	0	6	0	2	197.01	394.02	15	1	1	NA	1	0	2	6
PLPPR5	4	4	1	0	111.54	223.08	15	1	1	-Inf	1	-0.5	1	8
PLRG1	0	6	0	0	140.91	281.82	15	1	1	NA	1	NA	0	6
PLS1	2	10	0	1	218.13	436.26	15	1	1	1	1	0.166666666666667	1	12
PLS3	2	7	1	2	214.5	429	15	1	1	-0.75	1	-0.111111111111111	3	9
PLVAP	2	0	0	0	31.02	62.04	15	1	1	NA	1	NA	0	2
PLXDC1	1	3	0	3	41.91	83.82	15	1	1	1	1	0.25	3	4
PLXDC2	8	2	1	1	103.95	207.9	15	1	0.454545454545455	0.75	1	0.3	2	10
PLXNA1	4	34	2	14	509.85	1019.7	15	1	1	-0.214285714285714	1	-0.0197368421052632	16	38
PLXNA2	8	30	4	7	521.07	1042.14	15	1	0.426673142226189	-1.14285714285714	1	-0.15311004784689	11	38
PLXNA4	4	10	2	1	182.82	365.64	15	1	0.514705882352941	-4	1	-0.380952380952381	3	14
PLXNB1	4	32	1	7	662.64	1325.28	15	1	1	-0.142857142857143	1	-0.0138888888888889	8	36
PLXNB2	7	23	1	4	573.87	1147.74	15	1	1	0.178571428571429	1	0.0333333333333333	5	30
PLXNC1	13	13	3	2	468.93	937.86	15	1	1	-0.5	1	-0.1	5	26
PLXND1	1	10	0	1	229.68	459.36	15	1	1	1	1	0.0909090909090909	1	11
PM20D1	5	7	2	3	139.26	278.52	15	1	1	0.0666666666666667	1	0.0166666666666667	5	12
PM20D2	1	3	0	0	99.99	199.98	15	1	1	NA	1	NA	0	4
PMCH	7	2	1	0	87.12	174.24	15	1	1	-Inf	1	-0.222222222222222	1	9
PMEPA1	1	1	0	0	35.64	71.28	15	1	1	NA	1	NA	0	2
PMFBP1	8	4	0	0	102.3	204.6	15	1	1	NA	1	NA	0	12
PMLL	16	6	4	2	124.08	248.16	15	1	1	0.25	1	0.0606060606060607	6	22
PMM1	0	2	0	0	48.51	97.02	15	1	1	NA	1	NA	0	2
PMM2	0	6	0	3	57.09	114.18	15	1	1	NA	1	0	3	6
PMPCA	1	17	0	5	128.7	257.4	15	1	1	1	1	0.0555555555555556	5	18
PMPCB	3	10	1	1	145.86	291.72	15	1	0.476190476190476	-2.33333333333333	1	-0.269230769230769	2	13
PMS1	10	12	0	1	275.88	551.76	15	1	1	1	1	0.454545454545455	1	22
PMS2	8	10	0	0	233.31	466.62	15	1	1	NA	1	NA	0	18
PNAT10	1	9	1	0	117.48	234.96	15	1	0.181818181818182	-Inf	1	-0.9	1	10
PNAT3	1	8	1	1	114.84	229.68	15	1	0.345454545454545	-7	1	-0.388888888888889	2	9
PNISR	1	4	0	2	199.32	398.64	15	1	1	1	1	0.2	2	5
PNLDC1	12	7	3	1	181.83	363.66	15	1	1	-0.75	1	-0.118421052631579	4	19
PNLIP	6	5	1	0	137.61	275.22	15	1	1	-Inf	1	-0.454545454545455	1	11
PNLIPRP3	3	2	0	0	135.3	270.6	15	1	1	NA	1	NA	0	5
PNN	0	10	0	1	151.47	302.94	15	1	1	NA	1	0	1	10
PNOC	0	3	0	2	10.23	20.46	15	1	1	NA	1	0	2	3
PNPLA1	9	10	2	1	225.72	451.44	15	1	1	-1.22222222222222	1	-0.192982456140351	3	19
PNPLA2	1	12	0	3	154.11	308.22	15	1	1	1	1	0.0769230769230769	3	13
PNPLA3	4	4	0	0	118.14	236.28	15	1	1	NA	1	NA	0	8
PNPLA7	12	26	4	2	443.85	887.7	15	1	0.169287887382045	-3.33333333333333	1	-0.350877192982456	6	38
PNPLA8	11	9	0	0	260.37	520.74	15	1	1	NA	1	NA	0	20
PNPT1	4	7	1	1	223.08	446.16	15	1	1	-0.75	1	-0.136363636363636	2	11
POC1A	3	8	1	1	80.85	161.7	15	1	1	-1.66666666666667	1	-0.227272727272727	2	11
POC5	9	4	4	1	124.74	249.48	15	1	1	-0.777777777777778	1	-0.107692307692308	5	13
PODN	0	8	0	1	170.94	341.88	15	1	1	NA	1	0	1	8
PODXL	5	3	2	1	62.04	124.08	15	1	1	-0.2	1	-0.0416666666666666	3	8
PODXL2	6	11	1	3	197.34	394.68	15	1	1	0.388888888888889	1	0.102941176470588	4	17
POF1B	0	2	0	0	144.21	288.42	15	1	1	NA	1	NA	0	2
POFUT1	2	5	2	1	53.13	106.26	15	1	0.5	-4	1	-0.380952380952381	3	7
POFUT2	3	6	1	1	119.79	239.58	15	1	1	-1	1	-0.166666666666667	2	9
POGLUT1	1	7	1	4	108.9	217.8	15	1	1	-0.75	1	-0.075	5	8
POGZ	2	9	1	2	338.91	677.82	15	1	1	-1.25	1	-0.151515151515151	3	11
POLA1	10	17	3	5	436.26	872.52	15	1	1	-0.02	1	-0.00462962962962965	8	27
POLD3	5	10	1	0	122.1	244.2	15	1	0.375	-Inf	1	-0.666666666666667	1	15
POLDIP2	0	2	0	1	65.01	130.02	15	1	1	NA	1	0	1	2
POLDIP3	1	6	0	1	99.33	198.66	15	1	1	1	1	0.142857142857143	1	7
POLE	8	43	3	7	726.33	1452.66	15	1	0.366934044316016	-1.30357142857143	1	-0.143137254901961	10	51
POLE2	3	8	1	0	142.56	285.12	15	1	0.333333333333333	-Inf	1	-0.727272727272727	1	11
POLE3	0	2	0	0	35.97	71.94	15	1	1	NA	1	NA	0	2
POLG	4	9	3	4	215.82	431.64	15	1	0.651354489164087	-0.6875	1	-0.120879120879121	7	13
POLG2	2	1	2	0	71.28	142.56	15	1	1	-Inf	1	-0.333333333333333	2	3
POLH	7	5	2	2	153.12	306.24	15	1	1	0.285714285714286	1	0.0833333333333334	4	12
POLK	11	11	2	1	191.4	382.8	15	1	1	-1	1	-0.166666666666667	3	22
POLL	2	10	1	3	131.01	262.02	15	1	1	-0.666666666666667	1	-0.0833333333333333	4	12
POLN	11	5	0	1	247.83	495.66	15	1	0.352941176470588	1	1	0.6875	1	16
POLQ	2	7	1	1	142.56	285.12	15	1	0.490909090909091	-2.5	1	-0.277777777777778	2	9
POLR1A	5	27	0	5	500.94	1001.88	15	1	1	1	1	0.15625	5	32
POLR1B	5	29	2	7	361.02	722.04	15	1	0.624376452987971	-0.657142857142857	1	-0.0751633986928104	9	34
POLR1C	0	3	0	0	72.93	145.86	15	1	1	NA	1	NA	0	3
POLR1D	0	4	0	0	26.4	52.8	15	1	1	NA	1	NA	0	4
POLR1E	10	2	0	0	136.29	272.58	15	1	1	NA	1	NA	0	12
POLR2B	0	12	0	0	347.49	694.98	15	1	1	NA	1	NA	0	12
POLR2C	0	5	0	2	92.4	184.8	15	1	1	NA	1	0	2	5
POLR2D	0	4	0	2	36.63	73.26	15	1	1	NA	1	0	2	4
POLR2E	0	2	0	1	32.01	64.02	15	1	1	NA	1	0	1	2
POLR2F	0	1	0	1	25.41	50.82	15	1	1	NA	1	0	1	1
POLR2J	0	3	0	0	26.73	53.46	15	1	1	NA	1	NA	0	3
POLR3A	2	19	2	2	447.81	895.62	15	1	0.106324110671937	-8.5	1	-0.404761904761905	4	21
POLR3B	0	15	0	4	381.81	763.62	15	1	1	NA	1	0	4	15
POLR3D	1	4	1	4	16.5	33	15	1	1	0	1	0	5	5
POLR3E	1	10	0	0	215.16	430.32	15	1	1	NA	1	NA	0	11
POLR3G	1	1	0	0	40.92	81.84	15	1	1	NA	1	NA	0	2
POLR3H	1	3	0	2	81.18	162.36	15	1	1	1	1	0.25	2	4
POLRMT	10	10	1	3	285.12	570.24	15	1	0.596273291925466	0.666666666666667	1	0.25	4	20
POMGNT1	3	9	2	1	214.5	429	15	1	0.241758241758242	-5	1	-0.416666666666667	3	12
POMGNT2	1	4	0	3	178.86	357.72	15	1	1	1	1	0.2	3	5
POMK	2	3	1	0	111.21	222.42	15	1	1	-Inf	1	-0.6	1	5
POMP	1	1	0	0	44.88	89.76	15	1	1	NA	1	NA	0	2
POMT1	3	10	1	0	223.08	446.16	15	1	0.285714285714286	-Inf	1	-0.769230769230769	1	13
POMT2	3	10	1	1	162.36	324.72	15	1	0.476190476190476	-2.33333333333333	1	-0.269230769230769	2	13
PON2	1	5	1	0	94.05	188.1	15	1	0.285714285714286	-Inf	1	-0.833333333333333	1	6
POP1	5	11	0	3	289.08	578.16	15	1	0.530443756449948	1	1	0.3125	3	16
POP4	1	3	0	0	54.45	108.9	15	1	1	NA	1	NA	0	4
POPDC2	1	6	1	1	71.94	143.88	15	1	0.416666666666667	-5	1	-0.357142857142857	2	7
POPDC3	0	3	0	0	97.02	194.04	15	1	1	NA	1	NA	0	3
POR	4	4	2	0	135.3	270.6	15	1	0.466666666666667	-Inf	1	-0.5	2	8
POT1	8	19	0	1	222.09	444.18	15	1	1	1	1	0.296296296296296	1	27
POU1F1	1	2	1	0	104.61	209.22	15	1	1	-Inf	1	-0.666666666666667	1	3
POU2AF1	0	6	0	2	127.05	254.1	15	1	1	NA	1	0	2	6
POU2F1	2	0	0	0	216.15	432.3	15	1	1	NA	1	NA	0	2
POU2F3	1	7	1	2	153.45	306.9	15	1	0.490909090909091	-2.5	1	-0.208333333333333	3	8
POU3F2	3	0	0	0	26.73	53.46	15	1	1	NA	1	NA	0	3
POU4F3	0	1	0	1	53.13	106.26	15	1	1	NA	1	0	1	1
Pou5f3	1	5	0	0	74.91	149.82	15	1	1	NA	1	NA	0	6
POU6F2	0	3	0	0	115.17	230.34	15	1	1	NA	1	NA	0	3
PP2D1	18	9	2	0	225.06	450.12	15	1	1	-Inf	1	-0.333333333333333	2	27
PPA2	1	3	0	0	63.69	127.38	15	1	1	NA	1	NA	0	4
PPARA	2	2	0	1	142.56	285.12	15	1	1	1	1	0.5	1	4
PPARD	0	2	0	1	132.66	265.32	15	1	1	NA	1	0	1	2
PPARG	1	2	0	0	145.86	291.72	15	1	1	NA	1	NA	0	3
PPARGC1A	1	5	0	0	265.65	531.3	15	1	1	NA	1	NA	0	6
PPARGC1B	12	15	0	1	169.95	339.9	15	1	1	1	1	0.444444444444444	1	27
PPAT	0	4	0	1	169.95	339.9	15	1	1	NA	1	0	1	4
PPCDC	0	4	0	0	42.24	84.48	15	1	1	NA	1	NA	0	4
PPDPF	2	2	0	0	19.47	38.94	15	1	1	NA	1	NA	0	4
PPEF1	17	5	1	3	205.26	410.52	15	1	0.0721070234113713	0.901960784313726	1	0.522727272727273	4	22
PPEF2	3	10	2	2	224.73	449.46	15	1	0.53781512605042	-2.33333333333333	1	-0.269230769230769	4	13
PPFIA1	3	15	0	0	384.78	769.56	15	1	1	NA	1	NA	0	18
PPFIA2	6	19	0	1	410.52	821.04	15	1	1	1	1	0.24	1	25
PPFIA4	3	23	3	13	247.83	495.66	15	1	0.658011211284639	-0.769230769230769	1	-0.0721153846153846	16	26
PPFIBP1	4	10	1	0	317.13	634.26	15	1	0.333333333333333	-Inf	1	-0.714285714285714	1	14
PPFIBP2	4	14	4	2	278.19	556.38	15	1	0.128770542958186	-6	1	-0.444444444444444	6	18
PPIB	0	3	0	0	22.77	45.54	15	1	1	NA	1	NA	0	3
PPIC	0	2	0	0	59.4	118.8	15	1	1	NA	1	NA	0	2
PPID	1	1	0	0	120.12	240.24	15	1	1	NA	1	NA	0	2
PPIE	0	7	0	0	72.27	144.54	15	1	1	NA	1	NA	0	7
PPIF	1	2	0	0	55.11	110.22	15	1	1	NA	1	NA	0	3
PPIG	1	6	0	0	184.14	368.28	15	1	1	NA	1	NA	0	7
PPIL4	2	4	2	1	114.84	229.68	15	1	0.523809523809524	-3	1	-0.333333333333333	3	6
PPIL6	7	4	2	1	76.56	153.12	15	1	1	-0.142857142857143	1	-0.0303030303030303	3	11
PPIP5K1	7	14	0	1	441.54	883.08	15	1	1	1	1	0.333333333333333	1	21
PPIP5K2	1	11	0	3	278.19	556.38	15	1	1	1	1	0.0833333333333333	3	12
PPL	4	18	0	6	378.18	756.36	15	1	0.548717948717949	1	1	0.181818181818182	6	22
PPM1A	0	7	0	2	123.75	247.5	15	1	1	NA	1	0	2	7
PPM1D	4	4	0	1	165	330	15	1	1	1	1	0.5	1	8
PPM1E	4	6	1	0	233.97	467.94	15	1	0.454545454545455	-Inf	1	-0.6	1	10
PPM1F	0	5	0	1	114.84	229.68	15	1	1	NA	1	0	1	5
PPM1H	2	7	0	1	135.63	271.26	15	1	1	1	1	0.222222222222222	1	9
PPM1J	3	6	0	0	66.99	133.98	15	1	1	NA	1	NA	0	9
PPM1L	0	2	0	0	90.09	180.18	15	1	1	NA	1	NA	0	2
PPM1M	7	7	2	0	176.88	353.76	15	1	0.475	-Inf	1	-0.5	2	14
PPME1	0	5	0	0	58.08	116.16	15	1	1	NA	1	NA	0	5
PPP1CB	0	4	0	1	104.28	208.56	15	1	1	NA	1	0	1	4
PPP1CC	1	3	1	2	98.34	196.68	15	1	1	-0.5	1	-0.0833333333333333	3	4
PPP1R14D	0	2	0	0	43.56	87.12	15	1	1	NA	1	NA	0	2
PPP1R15B	2	1	1	0	38.28	76.56	15	1	1	-Inf	1	-0.333333333333333	1	3
PPP1R16B	2	4	0	0	174.57	349.14	15	1	1	NA	1	NA	0	6
PPP1R17	0	2	0	0	25.41	50.82	15	1	1	NA	1	NA	0	2
PPP1R2	0	4	0	1	53.46	106.92	15	1	1	NA	1	0	1	4
PPP1R21	0	7	0	1	223.08	446.16	15	1	1	NA	1	0	1	7
PPP1R26	19	26	9	9	365.97	731.94	15	1	0.588754776362552	-0.368421052631579	1	-0.0777777777777778	18	45
PPP1R36	11	2	2	0	138.27	276.54	15	1	1	-Inf	1	-0.153846153846154	2	13
PPP1R3A	16	10	2	1	429.33	858.66	15	1	1	-0.25	1	-0.0512820512820512	3	26
PPP1R3C	1	2	1	1	118.14	236.28	15	1	1	-1	1	-0.166666666666667	2	3
PPP1R3D	3	2	2	0	88.44	176.88	15	1	1	-Inf	1	-0.4	2	5
PPP1R42	7	3	0	0	96.69	193.38	15	1	1	NA	1	NA	0	10
PPP1R7	1	6	0	1	106.92	213.84	15	1	1	1	1	0.142857142857143	1	7
PPP1R8	7	6	1	0	167.97	335.94	15	1	1	-Inf	1	-0.461538461538462	1	13
PPP1R9A	2	4	2	2	250.47	500.94	15	1	1	-1	1	-0.166666666666667	4	6
PPP1R9B	7	17	1	3	402.27	804.54	15	1	1	0.19047619047619	1	0.0416666666666667	4	24
PPP2CB	1	5	0	2	110.88	221.76	15	1	1	1	1	0.166666666666667	2	6
PPP2R2B	0	11	0	1	143.55	287.1	15	1	1	NA	1	0	1	11
PPP2R2C	0	3	0	1	146.85	293.7	15	1	1	NA	1	0	1	3
PPP2R2D	3	3	0	0	150.81	301.62	15	1	1	NA	1	NA	0	6
PPP2R3A	10	8	1	0	390.06	780.12	15	1	1	-Inf	1	-0.444444444444444	1	18
PPP2R3B	4	5	1	0	208.23	416.46	15	1	1	-Inf	1	-0.555555555555556	1	9
PPP2R3C	0	7	0	1	149.16	298.32	15	1	1	NA	1	0	1	7
PPP2R5A	0	3	0	3	104.61	209.22	15	1	1	NA	1	0	3	3
PPP2R5C	0	2	0	1	152.46	304.92	15	1	1	NA	1	0	1	2
PPP2R5D	0	5	0	2	112.86	225.72	15	1	1	NA	1	0	2	5
PPP2R5E	0	1	0	1	158.4	316.8	15	1	1	NA	1	0	1	1
PPP3CB	0	3	0	0	132.99	265.98	15	1	1	NA	1	NA	0	3
PPP3CC	1	1	1	1	117.81	235.62	15	1	1	0	1	0	2	2
PPP4R1	5	9	0	0	300.3	600.6	15	1	1	NA	1	NA	0	14
PPP4R2	0	3	0	0	81.84	163.68	15	1	1	NA	1	NA	0	3
PPP4R3A	0	9	0	1	221.76	443.52	15	1	1	NA	1	0	1	9
PPP4R3B	1	6	0	0	234.63	469.26	15	1	1	NA	1	NA	0	7
PPP4R4	4	3	0	0	228.69	457.38	15	1	1	NA	1	NA	0	7
PPP6C	0	3	0	0	23.76	47.52	15	1	1	NA	1	NA	0	3
PPP6R3	0	9	0	1	268.29	536.58	15	1	1	NA	1	0	1	9
PPRC1	10	5	5	1	115.5	231	15	1	0.622678018575851	-1.5	1	-0.166666666666667	6	15
PPT1	1	4	0	0	56.43	112.86	15	1	1	NA	1	NA	0	5
PPTC7	0	2	0	0	82.83	165.66	15	1	1	NA	1	NA	0	2
PPWD1	0	4	0	0	129.36	258.72	15	1	1	NA	1	NA	0	4
PQLC1	0	2	0	0	57.75	115.5	15	1	1	NA	1	NA	0	2
PQLC2	4	5	0	0	72.6	145.2	15	1	1	NA	1	NA	0	9
PQLC2L	3	4	1	0	89.1	178.2	15	1	1	-Inf	1	-0.571428571428571	1	7
PRADC1	1	5	0	3	26.07	52.14	15	1	1	1	1	0.166666666666667	3	6
PRAM1	9	15	0	2	152.13	304.26	15	1	0.529230769230769	1	1	0.375	2	24
PRC1	0	6	0	0	109.23	218.46	15	1	1	NA	1	NA	0	6
PRCC	2	2	1	1	47.85	95.7	15	1	1	0	1	0	2	4
PRCP	7	10	5	3	190.74	381.48	15	1	0.410983981693364	-1.38095238095238	1	-0.213235294117647	8	17
PRDM1	0	13	0	3	305.91	611.82	15	1	1	NA	1	0	3	13
PRDM10	1	11	1	2	363.99	727.98	15	1	0.371428571428571	-4.5	1	-0.25	3	12
PRDM11	3	13	0	2	476.85	953.7	15	1	1	1	1	0.1875	2	16
PRDM12	0	3	0	1	59.4	118.8	15	1	1	NA	1	0	1	3
PRDM13	0	3	0	1	27.72	55.44	15	1	1	NA	1	0	1	3
PRDM14	0	4	0	2	80.19	160.38	15	1	1	NA	1	0	2	4
PRDM16	2	3	2	2	250.8	501.6	15	1	1	-0.5	1	-0.1	4	5
PRDM4	2	11	0	3	256.08	512.16	15	1	1	1	1	0.153846153846154	3	13
PRDM5	1	9	0	1	168.96	337.92	15	1	1	1	1	0.1	1	10
PRDM6	0	2	0	0	82.83	165.66	15	1	1	NA	1	NA	0	2
PRDX1	0	4	0	0	75.9	151.8	15	1	1	NA	1	NA	0	4
PRDX4	0	1	0	1	59.73	119.46	15	1	1	NA	1	0	1	1
PRDX6	2	1	0	0	29.37	58.74	15	1	1	NA	1	NA	0	3
PRELID3A	0	4	0	1	68.64	137.28	15	1	1	NA	1	0	1	4
PRELID3B	1	3	0	0	52.14	104.28	15	1	1	NA	1	NA	0	4
PRELP	0	3	0	0	46.2	92.4	15	1	1	NA	1	NA	0	3
PREP	4	15	2	0	245.52	491.04	15	1	0.0714285714285714	-Inf	1	-0.789473684210526	2	19
PREX1	8	25	1	5	565.95	1131.9	15	1	1	0.375	1	0.0757575757575758	6	33
PREX2	3	11	0	1	413.49	826.98	15	1	1	1	1	0.214285714285714	1	14
PRG4	14	14	5	3	292.38	584.76	15	1	0.695149492702329	-0.666666666666667	1	-0.125	8	28
PRICKLE2	4	16	0	3	197.01	394.02	15	1	1	1	1	0.2	3	20
PRICKLE4	2	3	2	1	30.69	61.38	15	1	1	-2	1	-0.266666666666667	3	5
PRIM1	2	2	1	0	32.01	64.02	15	1	1	-Inf	1	-0.5	1	4
PRIMA1	1	2	0	0	41.91	83.82	15	1	1	NA	1	NA	0	3
PRKAA1	1	1	1	0	127.05	254.1	15	1	1	-Inf	1	-0.5	1	2
PRKAA2	1	17	0	5	166.65	333.3	15	1	1	1	1	0.0555555555555556	5	18
PRKAB2	0	6	0	2	86.13	172.26	15	1	1	NA	1	0	2	6
PRKACB	0	3	0	1	116.49	232.98	15	1	1	NA	1	0	1	3
PRKAG3	1	1	1	0	12.21	24.42	15	1	1	-Inf	1	-0.5	1	2
PRKAR1A	0	3	0	1	85.8	171.6	15	1	1	NA	1	0	1	3
PRKAR1B	4	6	0	0	93.72	187.44	15	1	1	NA	1	NA	0	10
PRKAR2A	0	4	0	1	89.76	179.52	15	1	1	NA	1	0	1	4
PRKAR2B	2	2	0	0	92.4	184.8	15	1	1	NA	1	NA	0	4
PRKCA	0	6	0	1	180.18	360.36	15	1	1	NA	1	0	1	6
PRKCB	0	6	0	1	179.85	359.7	15	1	1	NA	1	0	1	6
PRKCD	0	10	0	1	202.29	404.58	15	1	1	NA	1	0	1	10
PRKCE	0	3	0	1	153.12	306.24	15	1	1	NA	1	0	1	3
PRKCH	1	10	0	1	227.37	454.74	15	1	1	1	1	0.0909090909090909	1	11
PRKCI	0	6	0	0	92.4	184.8	15	1	1	NA	1	NA	0	6
PRKCQ	3	10	1	1	217.14	434.28	15	1	0.476190476190476	-2.33333333333333	1	-0.269230769230769	2	13
PRKCZ	0	6	0	2	158.4	316.8	15	1	1	NA	1	0	2	6
PRKD1	1	2	0	0	138.6	277.2	15	1	1	NA	1	NA	0	3
PRKDC	29	57	8	4	1315.05	2630.1	15	1	0.0523534746009688	-2.93103448275862	1	-0.329457364341085	12	86
PRKG2	2	7	0	0	291.72	583.44	15	1	1	NA	1	NA	0	9
PRL	1	3	0	0	79.2	158.4	15	1	1	NA	1	NA	0	4
PRLHR	1	8	0	0	146.85	293.7	15	1	1	NA	1	NA	0	9
PRLHR2	0	4	0	0	70.62	141.24	15	1	1	NA	1	NA	0	4
PRLHRL	2	1	0	1	38.28	76.56	15	1	1	1	1	0.666666666666667	1	3
PRLL	2	2	0	0	61.05	122.1	15	1	1	NA	1	NA	0	4
PRLR	4	5	0	0	242.55	485.1	15	1	1	NA	1	NA	0	9
PRMT3	5	5	0	0	64.35	128.7	15	1	1	NA	1	NA	0	10
PRMT7	7	9	3	2	185.13	370.26	15	1	0.635117204776648	-0.928571428571429	1	-0.1625	5	16
PRMT8	0	3	0	3	50.49	100.98	15	1	1	NA	1	0	3	3
PRMT9	4	18	1	3	337.26	674.52	15	1	1	-0.5	1	-0.0681818181818182	4	22
PRNP	3	5	1	1	34.98	69.96	15	1	1	-0.666666666666667	1	-0.125	2	8
PROC	2	2	0	0	143.55	287.1	15	1	1	NA	1	NA	0	4
PROCA1	3	2	1	1	9.24	18.48	15	1	1	0.333333333333333	1	0.1	2	5
PROCR	2	0	0	0	13.2	26.4	15	1	1	NA	1	NA	0	2
PRODH	2	4	1	2	72.6	145.2	15	1	1	0	1	0	3	6
PROKR2	0	7	0	3	129.03	258.06	15	1	1	NA	1	0	3	7
PROM1	4	7	2	0	290.73	581.46	15	1	0.192307692307692	-Inf	1	-0.636363636363636	2	11
PROM1L	2	4	0	3	46.53	93.06	15	1	0.5	1	1	0.333333333333333	3	6
PROM2	0	7	0	1	223.41	446.82	15	1	1	NA	1	0	1	7
PRORSD1P	0	3	0	0	38.61	77.22	15	1	1	NA	1	NA	0	3
PROS1	2	7	0	2	184.47	368.94	15	1	1	1	1	0.222222222222222	2	9
PROSER1	1	7	0	2	171.93	343.86	15	1	1	1	1	0.125	2	8
PROSER2	8	7	2	1	125.4	250.8	15	1	1	-0.75	1	-0.133333333333333	3	15
PROX2	2	2	1	0	65.34	130.68	15	1	1	-Inf	1	-0.5	1	4
PROZ	3	7	1	0	132.66	265.32	15	1	0.363636363636364	-Inf	1	-0.7	1	10
PRPF18	0	3	0	0	76.23	152.46	15	1	1	NA	1	NA	0	3
PRPF19	0	9	0	1	53.79	107.58	15	1	1	NA	1	0	1	9
PRPF3	0	5	0	1	128.7	257.4	15	1	1	NA	1	0	1	5
PRPF38A	0	6	0	0	85.14	170.28	15	1	1	NA	1	NA	0	6
PRPF38B	0	3	0	1	111.21	222.42	15	1	1	NA	1	0	1	3
PRPF39	2	10	2	3	175.23	350.46	15	1	0.53781512605042	-2.33333333333333	1	-0.233333333333333	5	12
PRPF4	1	7	0	2	159.72	319.44	15	1	1	1	1	0.125	2	8
PRPF40A	1	11	1	3	267.96	535.92	15	1	0.45	-2.66666666666667	1	-0.166666666666667	4	12
PRPF4B	1	10	1	1	263.67	527.34	15	1	0.294871794871795	-9	1	-0.409090909090909	2	11
PRPF6	0	24	0	8	264.33	528.66	15	1	1	NA	1	0	8	24
PRPF8	1	45	1	10	769.23	1538.46	15	1	0.351503759398496	-3.5	1	-0.0691699604743083	11	46
PRPH2	0	2	0	1	86.46	172.92	15	1	1	NA	1	0	1	2
PRPS1-PRPS2	0	2	0	1	84.48	168.96	15	1	1	NA	1	0	1	2
PRPSAP1	1	8	1	1	96.69	193.38	15	1	0.345454545454545	-7	1	-0.388888888888889	2	9
PRPSAP2	0	8	0	0	109.23	218.46	15	1	1	NA	1	NA	0	8
PRR11	5	2	2	0	92.07	184.14	15	1	1	-Inf	1	-0.285714285714286	2	7
PRR15L	1	0	1	0	7.92	15.84	15	1	1	NA	1	0	1	1
PRR16	4	2	1	0	62.7	125.4	15	1	1	-Inf	1	-0.333333333333333	1	6
PRR29	9	4	2	1	96.36	192.72	15	1	1	0.111111111111111	1	0.0256410256410257	3	13
PRR33	5	10	1	1	102.96	205.92	15	1	1	-1	1	-0.166666666666667	2	15
PRR35	9	10	3	4	296.01	592.02	15	1	1	0.166666666666667	1	0.0451127819548872	7	19
PRR5	7	2	2	0	122.1	244.2	15	1	1	-Inf	1	-0.222222222222222	2	9
PRR5L	3	4	0	0	104.94	209.88	15	1	1	NA	1	NA	0	7
PRRC1	4	6	0	1	112.2	224.4	15	1	1	1	1	0.4	1	10
PRRC2B	9	30	4	3	673.53	1347.06	15	1	0.0866688039984547	-3.44444444444444	1	-0.340659340659341	7	39
PRRC2C	15	55	5	8	870.87	1741.74	15	1	0.286578486460967	-1.29166666666667	1	-0.17032967032967	13	70
PRRG3	1	1	0	0	53.46	106.92	15	1	1	NA	1	NA	0	2
PRRG4	6	2	0	0	80.85	161.7	15	1	1	NA	1	NA	0	8
PRRT3	3	3	1	1	11.22	22.44	15	1	1	0	1	0	2	6
PRRX1	0	2	0	0	71.28	142.56	15	1	1	NA	1	NA	0	2
PRRX2	3	1	0	1	32.01	64.02	15	1	0.4	1	1	0.75	1	4
PRSS23	0	5	0	0	122.43	244.86	15	1	1	NA	1	NA	0	5
PRSS55	3	7	0	1	127.71	255.42	15	1	1	1	1	0.3	1	10
PRSS56	7	1	3	1	53.79	107.58	15	1	1	0.571428571428571	1	0.125	4	8
PRTFDC1	0	2	0	0	76.56	153.12	15	1	1	NA	1	NA	0	2
PRTG	7	20	2	2	353.76	707.52	15	1	0.559510567296997	-1.85714285714286	1	-0.240740740740741	4	27
PRUNE1	2	6	0	2	95.7	191.4	15	1	1	1	1	0.25	2	8
PRUNE2	40	27	3	2	779.79	1559.58	15	1	1	-0.0125	1	-0.0029850746268657	5	67
PSAP	3	10	0	2	191.73	383.46	15	1	1	1	1	0.230769230769231	2	13
PSAT1	2	3	0	0	64.02	128.04	15	1	1	NA	1	NA	0	5
PSD	8	5	4	0	177.87	355.74	15	1	0.260504201680672	-Inf	1	-0.384615384615385	4	13
PSD2	4	13	2	3	284.46	568.92	15	1	0.585326953748006	-1.16666666666667	1	-0.164705882352941	5	17
PSD3	6	12	0	3	231.66	463.32	15	1	0.526315789473684	1	1	0.333333333333333	3	18
PSEN1	1	6	0	0	138.6	277.2	15	1	1	NA	1	NA	0	7
PSEN2	3	13	0	4	158.4	316.8	15	1	1	1	1	0.1875	4	16
PSIP1	6	5	0	1	129.69	259.38	15	1	1	1	1	0.545454545454545	1	11
PSKH1	1	12	0	2	110.55	221.1	15	1	1	1	1	0.0769230769230769	2	13
PSMA1	0	9	0	4	67.32	134.64	15	1	1	NA	1	0	4	9
PSMA3	0	6	0	1	79.53	159.06	15	1	1	NA	1	0	1	6
PSMA4	1	2	0	0	75.24	150.48	15	1	1	NA	1	NA	0	3
PSMA5	0	3	0	0	48.84	97.68	15	1	1	NA	1	NA	0	3
PSMA6	0	7	0	2	65.01	130.02	15	1	1	NA	1	0	2	7
PSMA7	0	4	0	0	65.34	130.68	15	1	1	NA	1	NA	0	4
PSMB1	1	4	0	2	70.95	141.9	15	1	1	1	1	0.2	2	5
PSMB3	0	3	0	0	61.05	122.1	15	1	1	NA	1	NA	0	3
PSMB4	0	2	0	0	44.22	88.44	15	1	1	NA	1	NA	0	2
PSMB7	0	4	0	1	37.62	75.24	15	1	1	NA	1	0	1	4
PSMC1	0	9	0	3	142.23	284.46	15	1	1	NA	1	0	3	9
PSMC2	0	11	0	1	130.02	260.04	15	1	1	NA	1	0	1	11
PSMC3	0	2	0	0	103.62	207.24	15	1	1	NA	1	NA	0	2
PSMC5	0	9	0	2	82.83	165.66	15	1	1	NA	1	0	2	9
PSMC6	0	7	0	2	98.34	196.68	15	1	1	NA	1	0	2	7
PSMD1	1	7	0	0	213.51	427.02	15	1	1	NA	1	NA	0	8
PSMD10	0	3	0	0	29.04	58.08	15	1	1	NA	1	NA	0	3
PSMD11	0	6	0	1	118.8	237.6	15	1	1	NA	1	0	1	6
PSMD12	2	5	1	1	121.44	242.88	15	1	1	-1.5	1	-0.214285714285714	2	7
PSMD13	1	4	1	0	71.28	142.56	15	1	0.333333333333333	-Inf	1	-0.8	1	5
PSMD2	0	4	0	0	87.78	175.56	15	1	1	NA	1	NA	0	4
PSMD3	20	14	5	3	186.12	372.24	15	1	1	-0.166666666666667	1	-0.0367647058823529	8	34
PSMD5	0	6	0	1	114.84	229.68	15	1	1	NA	1	0	1	6
PSMD6	0	10	0	1	110.88	221.76	15	1	1	NA	1	0	1	10
PSMD7	1	2	0	0	108.57	217.14	15	1	1	NA	1	NA	0	3
PSMD9	0	2	0	0	35.31	70.62	15	1	1	NA	1	NA	0	2
PSME3	0	3	0	1	71.61	143.22	15	1	1	NA	1	0	1	3
PSME4	2	19	1	2	527.01	1054.02	15	1	0.342885375494071	-3.75	1	-0.238095238095238	3	21
PSMF1	2	1	0	0	38.28	76.56	15	1	1	NA	1	NA	0	3
PSMG1	1	2	0	1	50.82	101.64	15	1	1	1	1	0.333333333333333	1	3
PSMG2	4	5	1	1	84.48	168.96	15	1	1	-0.25	1	-0.0555555555555556	2	9
PSMG3	2	2	0	1	47.52	95.04	15	1	1	1	1	0.5	1	4
PSPC1	0	4	0	0	137.94	275.88	15	1	1	NA	1	NA	0	4
PSPH	0	3	0	1	82.17	164.34	15	1	1	NA	1	0	1	3
PSTK	2	2	2	1	45.21	90.42	15	1	1	-1	1	-0.166666666666667	3	4
PSTPIP1	4	5	2	0	114.51	229.02	15	1	0.454545454545455	-Inf	1	-0.555555555555556	2	9
PSTPIP2	1	3	0	0	71.94	143.88	15	1	1	NA	1	NA	0	4
PTAFR	3	6	0	0	147.51	295.02	15	1	1	NA	1	NA	0	9
PTBP1	0	3	0	0	199.65	399.3	15	1	1	NA	1	NA	0	3
PTBP2	0	13	0	5	183.48	366.96	15	1	1	NA	1	0	5	13
PTBP3	7	8	1	0	181.5	363	15	1	1	-Inf	1	-0.533333333333333	1	15
PTCD2	8	5	1	0	99	198	15	1	1	-Inf	1	-0.384615384615385	1	13
PTCD3	13	7	5	0	174.9	349.8	15	1	0.274308300395257	-Inf	1	-0.35	5	20
PTCH1	4	12	1	2	314.16	628.32	15	1	1	-0.5	1	-0.0833333333333333	3	16
PTCH2	1	6	0	1	88.11	176.22	15	1	1	1	1	0.142857142857143	1	7
PTCHD1	0	2	0	0	238.92	477.84	15	1	1	NA	1	NA	0	2
PTCHD3-PTCHD3L	19	12	4	0	255.42	510.84	15	1	0.275210084033613	-Inf	1	-0.387096774193548	4	31
PTDSS1	1	5	0	0	143.88	287.76	15	1	1	NA	1	NA	0	6
PTDSS2	0	4	0	1	141.9	283.8	15	1	1	NA	1	0	1	4
PTER	0	4	0	0	109.23	218.46	15	1	1	NA	1	NA	0	4
PTGDS	1	2	0	0	21.78	43.56	15	1	1	NA	1	NA	0	3
PTGER2	1	1	0	0	29.37	58.74	15	1	1	NA	1	NA	0	2
PTGER3	1	3	0	2	56.43	112.86	15	1	1	1	1	0.25	2	4
PTGER4	0	7	0	0	103.62	207.24	15	1	1	NA	1	NA	0	7
PTGES	1	1	0	1	27.39	54.78	15	1	1	1	1	0.5	1	2
PTGES2	1	3	0	1	92.07	184.14	15	1	1	1	1	0.25	1	4
PTGFRN	4	16	3	1	297	594	15	1	0.0592885375494071	-11	1	-0.55	4	20
PTGR1	0	2	0	0	55.77	111.54	15	1	1	NA	1	NA	0	2
PTGR2	4	4	4	0	128.04	256.08	15	1	0.208080808080808	-Inf	1	-0.5	4	8
PTGS1	2	6	0	3	92.07	184.14	15	1	1	1	1	0.25	3	8
PTGS2	3	8	0	0	218.79	437.58	15	1	1	NA	1	NA	0	11
PTH	4	3	0	1	33.99	67.98	15	1	1	1	1	0.571428571428571	1	7
PTH1R	1	3	0	2	196.35	392.7	15	1	1	1	1	0.25	2	4
PTHLH	2	4	0	0	61.71	123.42	15	1	1	NA	1	NA	0	6
PTHRL	3	6	1	3	79.86	159.72	15	1	1	0.333333333333333	1	0.0833333333333333	4	9
PTN	0	3	0	0	52.47	104.94	15	1	1	NA	1	NA	0	3
PTP4A1	1	1	1	0	47.85	95.7	15	1	1	-Inf	1	-0.5	1	2
PTP4A2	0	4	0	1	51.48	102.96	15	1	1	NA	1	0	1	4
PTP4A3	0	2	0	1	31.02	62.04	15	1	1	NA	1	0	1	2
PTPA	0	5	0	1	86.13	172.26	15	1	1	NA	1	0	1	5
PTPDC1	5	8	1	2	234.3	468.6	15	1	1	0.2	1	0.0512820512820513	3	13
PTPMT1	2	1	0	0	39.93	79.86	15	1	1	NA	1	NA	0	3
PTPN1	0	6	0	1	158.07	316.14	15	1	1	NA	1	0	1	6
PTPN11	0	10	0	2	207.24	414.48	15	1	1	NA	1	0	2	10
PTPN12	12	10	4	1	291.72	583.44	15	1	0.618481357611792	-2.33333333333333	1	-0.254545454545455	5	22
PTPN13	15	35	5	4	802.23	1604.46	15	1	0.249438353184369	-1.91666666666667	1	-0.255555555555556	9	50
PTPN14	3	7	2	0	207.24	414.48	15	1	0.151515151515152	-Inf	1	-0.7	2	10
PTPN2	1	6	1	2	128.7	257.4	15	1	1	-2	1	-0.19047619047619	3	7
PTPN21	3	24	1	5	435.6	871.2	15	1	1	-0.6	1	-0.0555555555555556	6	27
PTPN22	10	13	2	0	381.48	762.96	15	1	0.22	-Inf	1	-0.565217391304348	2	23
PTPN23	2	15	0	7	90.75	181.5	15	1	1	1	1	0.117647058823529	7	17
PTPN4	1	3	1	0	273.9	547.8	15	1	0.4	-Inf	1	-0.75	1	4
PTPN5	3	6	0	1	193.05	386.1	15	1	1	1	1	0.333333333333333	1	9
PTPN6	0	10	0	1	141.24	282.48	15	1	1	NA	1	0	1	10
PTPN7	0	2	0	1	36.63	73.26	15	1	1	NA	1	0	1	2
PTPN9	1	1	0	0	51.48	102.96	15	1	1	NA	1	NA	0	2
PTPRB	6	25	1	2	701.58	1403.16	15	1	0.511196524064171	-1.08333333333333	1	-0.139784946236559	3	31
PTPRC	5	12	0	1	300.3	600.6	15	1	1	1	1	0.294117647058824	1	17
PTPRD	6	11	0	0	259.05	518.1	15	1	1	NA	1	NA	0	17
PTPRE	1	6	0	2	227.7	455.4	15	1	1	1	1	0.142857142857143	2	7
PTPRF	5	24	0	7	585.75	1171.5	15	1	0.55899064171123	1	1	0.172413793103448	7	29
PTPRG	0	5	0	2	339.9	679.8	15	1	1	NA	1	0	2	5
PTPRJ	11	12	4	5	199.98	399.96	15	1	1	0.127272727272727	1	0.033816425120773	9	23
PTPRM	0	4	0	0	128.04	256.08	15	1	1	NA	1	NA	0	4
PTPRN2	3	4	0	1	114.84	229.68	15	1	1	1	1	0.428571428571429	1	7
PTPRO	5	7	2	3	378.51	757.02	15	1	1	0.0666666666666667	1	0.0166666666666667	5	12
PTPRQ	66	69	14	8	1851.63	3703.26	15	1	0.252184715960713	-0.829545454545455	1	-0.147474747474747	22	135
PTPRR	6	5	2	0	197.67	395.34	15	1	0.487179487179487	-Inf	1	-0.454545454545455	2	11
PTPRS	2	11	1	3	414.15	828.3	15	1	1	-0.833333333333333	1	-0.0961538461538461	4	13
PTPRT	8	7	4	1	362.34	724.68	15	1	0.602683178534572	-2.5	1	-0.266666666666667	5	15
PTPRU	13	14	7	5	262.02	524.04	15	1	0.731094147111945	-0.507692307692308	1	-0.101851851851852	12	27
PTPRVP	18	40	7	14	595.98	1191.96	15	1	1	-0.111111111111111	1	-0.0229885057471264	21	58
PTPRZ1	14	16	2	1	658.02	1316.04	15	1	0.601173020527859	-1.28571428571429	1	-0.2	3	30
PTRF	2	8	1	1	98.67	197.34	15	1	0.454545454545455	-3	1	-0.3	2	10
PTRH2	0	1	0	1	9.24	18.48	15	1	1	NA	1	0	1	1
PTRHD1	2	2	0	0	12.87	25.74	15	1	1	NA	1	NA	0	4
PTS	0	3	0	0	43.56	87.12	15	1	1	NA	1	NA	0	3
PTTG1	9	2	0	0	49.5	99	15	1	1	NA	1	NA	0	11
PTTG1IP	2	0	0	0	64.02	128.04	15	1	1	NA	1	NA	0	2
PTX3	4	10	0	3	115.17	230.34	15	1	0.541176470588235	1	1	0.285714285714286	3	14
PUDP	3	2	0	0	72.27	144.54	15	1	1	NA	1	NA	0	5
PUF60	1	7	1	1	185.13	370.26	15	1	0.377777777777778	-6	1	-0.375	2	8
PUM1	0	14	0	2	309.54	619.08	15	1	1	NA	1	0	2	14
PUM2	0	5	0	1	367.29	734.58	15	1	1	NA	1	0	1	5
PUM3	5	6	1	0	158.07	316.14	15	1	1	-Inf	1	-0.545454545454545	1	11
PURG	0	2	0	0	56.43	112.86	15	1	1	NA	1	NA	0	2
PUS1	23	14	6	4	327.03	654.06	15	1	1	0.0869565217391305	1	0.0216216216216216	10	37
PUS10	0	11	0	3	182.49	364.98	15	1	1	NA	1	0	3	11
PUS3	3	7	0	0	110.55	221.1	15	1	1	NA	1	NA	0	10
PUS7L	3	4	0	2	133.65	267.3	15	1	0.5	1	1	0.428571428571429	2	7
PUSL1	6	11	1	1	209.55	419.1	15	1	1	-0.833333333333333	1	-0.147058823529412	2	17
PWP1	3	7	0	1	118.47	236.94	15	1	1	1	1	0.3	1	10
PWP2	6	11	3	1	258.39	516.78	15	1	0.27218045112782	-4.5	1	-0.397058823529412	4	17
PWWP2A	1	1	0	0	167.97	335.94	15	1	1	NA	1	NA	0	2
PWWP2B	14	18	4	4	296.01	592.02	15	1	1	-0.285714285714286	1	-0.0625	8	32
PXDC1	0	4	0	2	55.44	110.88	15	1	1	NA	1	0	2	4
PXDN	4	14	1	2	513.15	1026.3	15	1	1	-0.75	1	-0.111111111111111	3	18
PXDNL	6	29	0	5	389.07	778.14	15	1	1	1	1	0.171428571428571	5	35
PXK	2	2	0	0	172.92	345.84	15	1	1	NA	1	NA	0	4
PXMP4	2	4	0	2	52.8	105.6	15	1	1	1	1	0.333333333333333	2	6
PXYLP1	4	9	3	5	192.39	384.78	15	1	1	-0.35	1	-0.0673076923076923	8	13
PYCR1	0	2	0	0	66	132	15	1	1	NA	1	NA	0	2
PYCRL	0	1	0	1	7.59	15.18	15	1	1	NA	1	0	1	1
PYGB	1	10	1	6	192.06	384.12	15	1	1	-0.666666666666667	1	-0.0519480519480519	7	11
PYGL	0	5	0	4	121.11	242.22	15	1	1	NA	1	0	4	5
PYGO1	3	2	0	1	152.79	305.58	15	1	1	1	1	0.6	1	5
PYROXD1	5	1	0	0	131.67	263.34	15	1	1	NA	1	NA	0	6
QDPR	1	2	1	0	58.08	116.16	15	1	1	-Inf	1	-0.666666666666667	1	3
QRFPR	1	4	1	0	129.69	259.38	15	1	0.333333333333333	-Inf	1	-0.8	1	5
QRICH1	1	7	0	1	247.17	494.34	15	1	1	1	1	0.125	1	8
QRICH2	0	2	0	0	14.85	29.7	15	1	1	NA	1	NA	0	2
QRSL1	4	11	0	0	140.25	280.5	15	1	1	NA	1	NA	0	15
QSER1	6	12	3	1	253.11	506.22	15	1	0.264251537935748	-5	1	-0.416666666666667	4	18
QSOX1	2	4	1	2	56.76	113.52	15	1	1	0	1	0	3	6
QSOX2	6	5	2	1	195.03	390.06	15	1	1	-0.666666666666667	1	-0.121212121212121	3	11
QTRT2	3	4	0	0	103.62	207.24	15	1	1	NA	1	NA	0	7
R3HCC1	13	7	6	2	126.39	252.78	15	1	1	-0.615384615384615	1	-0.1	8	20
R3HCC1L	6	7	3	3	73.92	147.84	15	1	1	-0.166666666666667	1	-0.0384615384615384	6	13
R3HDM1	5	8	2	1	323.07	646.14	15	1	0.55	-2.2	1	-0.282051282051282	3	13
R3HDM2	5	8	1	1	270.6	541.2	15	1	1	-0.6	1	-0.115384615384615	2	13
R3HDML	2	3	1	2	32.34	64.68	15	1	1	0.25	1	0.0666666666666667	3	5
RAB10	0	3	0	0	48.51	97.02	15	1	1	NA	1	NA	0	3
RAB11A	0	4	0	0	75.24	150.48	15	1	1	NA	1	NA	0	4
RAB11B	0	6	0	1	66	132	15	1	1	NA	1	0	1	6
RAB11FIP1	20	18	6	1	401.28	802.56	15	1	0.210823493012943	-4.4	1	-0.330827067669173	7	38
RAB11FIP2	2	3	0	0	163.35	326.7	15	1	1	NA	1	NA	0	5
RAB11FIP4	3	10	0	1	181.5	363	15	1	1	1	1	0.230769230769231	1	13
RAB11FIP5	8	12	2	4	104.28	208.56	15	1	1	0.25	1	0.0666666666666667	6	20
RAB12	0	1	0	1	53.79	107.58	15	1	1	NA	1	0	1	1
RAB17	1	4	0	1	36.63	73.26	15	1	1	1	1	0.2	1	5
RAB18	0	5	0	1	64.68	129.36	15	1	1	NA	1	0	1	5
RAB18L	4	5	1	0	37.62	75.24	15	1	1	-Inf	1	-0.555555555555556	1	9
RAB19	1	3	1	2	51.48	102.96	15	1	1	-0.5	1	-0.0833333333333333	3	4
RAB20	1	1	1	0	62.37	124.74	15	1	1	-Inf	1	-0.5	1	2
RAB21	1	1	1	1	65.01	130.02	15	1	1	0	1	0	2	2
RAB22A	1	0	1	0	57.42	114.84	15	1	1	NA	1	0	1	1
RAB24	0	2	0	2	2.97	5.94	15	1	1	NA	1	0	2	2
RAB26	0	4	0	2	36.63	73.26	15	1	1	NA	1	0	2	4
RAB27A	1	4	1	1	39.27	78.54	15	1	1	-3	1	-0.3	2	5
RAB28	0	3	0	1	60.39	120.78	15	1	1	NA	1	0	1	3
RAB31	0	3	0	0	54.78	109.56	15	1	1	NA	1	NA	0	3
RAB32	0	3	0	0	68.31	136.62	15	1	1	NA	1	NA	0	3
RAB37	0	2	0	1	8.91	17.82	15	1	1	NA	1	0	1	2
RAB38	1	2	0	0	60.06	120.12	15	1	1	NA	1	NA	0	3
RAB3B	1	2	0	0	91.74	183.48	15	1	1	NA	1	NA	0	3
RAB3GAP1	3	10	1	0	256.08	512.16	15	1	0.285714285714286	-Inf	1	-0.769230769230769	1	13
RAB3GAP2	2	13	0	1	401.61	803.22	15	1	1	1	1	0.133333333333333	1	15
RAB3IL1	3	9	1	0	115.5	231	15	1	0.307692307692308	-Inf	1	-0.75	1	12
RAB3IP	1	3	0	0	154.44	308.88	15	1	1	NA	1	NA	0	4
RAB40B	0	6	0	2	66.33	132.66	15	1	1	NA	1	0	2	6
RAB40C	0	5	0	2	75.9	151.8	15	1	1	NA	1	0	2	5
RAB41	0	4	0	0	106.59	213.18	15	1	1	NA	1	NA	0	4
RAB41-RAB6A	0	3	0	0	48.18	96.36	15	1	1	NA	1	NA	0	3
RAB42	0	1	0	1	11.88	23.76	15	1	1	NA	1	0	1	1
RAB44	42	19	6	4	485.1	970.2	15	1	0.717595104566228	0.321428571428571	1	0.0885245901639344	10	61
RAB4A	0	2	0	2	36.63	73.26	15	1	1	NA	1	0	2	2
RAB5C	0	2	0	1	47.19	94.38	15	1	1	NA	1	0	1	2
RAB7B	0	3	0	2	47.85	95.7	15	1	1	NA	1	0	2	3
RAB9A	1	5	0	0	95.7	191.4	15	1	1	NA	1	NA	0	6
RAB9B	2	3	0	2	64.02	128.04	15	1	1	1	1	0.4	2	5
RABEP1	4	9	1	0	257.73	515.46	15	1	0.357142857142857	-Inf	1	-0.692307692307692	1	13
RABEPK	3	8	0	2	53.79	107.58	15	1	1	1	1	0.272727272727273	2	11
RABGAP1	1	4	0	0	190.41	380.82	15	1	1	NA	1	NA	0	5
RABGAP1L	4	4	0	2	236.28	472.56	15	1	0.466666666666667	1	1	0.5	2	8
RABGGTB	0	2	0	0	108.9	217.8	15	1	1	NA	1	NA	0	2
RABL2L	2	2	1	1	57.75	115.5	15	1	1	0	1	0	2	4
RABL6	5	12	1	2	230.34	460.68	15	1	1	-0.2	1	-0.0392156862745098	3	17
RAC2	0	3	0	2	48.18	96.36	15	1	1	NA	1	0	2	3
RAC3	0	3	0	0	135.3	270.6	15	1	1	NA	1	NA	0	3
RACGAP1	1	14	0	2	163.68	327.36	15	1	1	1	1	0.0666666666666667	2	15
RACGAP1L	1	2	1	0	35.97	71.94	15	1	1	-Inf	1	-0.666666666666667	1	3
RACK1	0	2	0	2	26.73	53.46	15	1	1	NA	1	0	2	2
RAD1	1	2	0	0	50.82	101.64	15	1	1	NA	1	NA	0	3
RAD17	5	5	0	0	113.52	227.04	15	1	1	NA	1	NA	0	10
RAD18	12	4	0	1	149.82	299.64	15	1	0.294117647058824	1	1	0.75	1	16
RAD21	0	14	0	3	216.81	433.62	15	1	1	NA	1	0	3	14
RAD21L1	15	7	2	1	129.69	259.38	15	1	1	0.0666666666666667	1	0.0151515151515151	3	22
RAD23B	0	3	0	1	78.87	157.74	15	1	1	NA	1	0	1	3
RAD50	9	23	1	2	371.58	743.16	15	1	1	-0.277777777777778	1	-0.0520833333333333	3	32
RAD51	0	1	0	1	72.93	145.86	15	1	1	NA	1	0	1	1
RAD51AP2	8	3	1	0	110.55	221.1	15	1	1	-Inf	1	-0.272727272727273	1	11
RAD51B	2	4	0	1	73.92	147.84	15	1	1	1	1	0.333333333333333	1	6
RAD51C	1	5	0	1	95.7	191.4	15	1	1	1	1	0.166666666666667	1	6
RAD51D	5	3	1	0	81.51	163.02	15	1	1	-Inf	1	-0.375	1	8
RAD52	4	3	1	0	128.04	256.08	15	1	1	-Inf	1	-0.428571428571429	1	7
RAD54L	4	13	2	3	201.63	403.26	15	1	0.585326953748006	-1.16666666666667	1	-0.164705882352941	5	17
RAD9B	5	9	1	2	89.76	179.52	15	1	1	0.1	1	0.0238095238095238	3	14
RADIL	0	3	0	1	76.89	153.78	15	1	1	NA	1	0	1	3
RAE1	0	5	0	1	98.01	196.02	15	1	1	NA	1	0	1	5
RAF1	1	2	0	1	188.43	376.86	15	1	1	1	1	0.333333333333333	1	3
RAG1	15	20	3	5	438.9	877.8	15	1	1	0.2	1	0.0535714285714285	8	35
RAG2	3	7	1	0	159.72	319.44	15	1	0.363636363636364	-Inf	1	-0.7	1	10
RAI14	4	5	1	0	215.16	430.32	15	1	1	-Inf	1	-0.555555555555556	1	9
RAI2	1	6	0	5	60.72	121.44	15	1	1	1	1	0.142857142857143	5	7
RALA	0	3	0	0	57.75	115.5	15	1	1	NA	1	NA	0	3
RALB	0	1	0	1	69.3	138.6	15	1	1	NA	1	0	1	1
RALBP1	1	9	0	2	192.06	384.12	15	1	1	1	1	0.1	2	10
RALGAPA1	8	22	3	2	890.34	1780.68	15	1	0.297031715912171	-3.125	1	-0.333333333333333	5	30
RALGAPA2	9	24	1	5	541.2	1082.4	15	1	1	0.466666666666667	1	0.106060606060606	6	33
RALGAPB	2	19	2	3	500.28	1000.56	15	1	0.154849498327759	-5.33333333333333	1	-0.304761904761905	5	21
RALGDS	2	18	1	7	213.84	427.68	15	1	1	-0.285714285714286	1	-0.025	8	20
RALGPS1	4	8	0	1	117.81	235.62	15	1	1	1	1	0.333333333333333	1	12
RALYL	3	4	0	0	91.74	183.48	15	1	1	NA	1	NA	0	7
RAMP1	2	3	1	0	33.66	67.32	15	1	1	-Inf	1	-0.6	1	5
RAMP3	0	3	0	0	47.52	95.04	15	1	1	NA	1	NA	0	3
RAN	0	2	0	1	69.63	139.26	15	1	1	NA	1	0	1	2
RANBP1	0	2	0	1	68.97	137.94	15	1	1	NA	1	0	1	2
RANBP10	0	8	0	3	152.13	304.26	15	1	1	NA	1	0	3	8
RANBP17	3	3	0	0	127.05	254.1	15	1	1	NA	1	NA	0	6
RANBP3	0	6	0	0	155.43	310.86	15	1	1	NA	1	NA	0	6
RANBP3L	12	10	3	0	171.6	343.2	15	1	0.25	-Inf	1	-0.454545454545455	3	22
RANBP9	0	9	0	1	157.74	315.48	15	1	1	NA	1	0	1	9
RAP1GDS1L	5	4	1	1	182.16	364.32	15	1	1	0.2	1	0.0555555555555556	2	9
RAP2B	0	2	0	2	31.02	62.04	15	1	1	NA	1	0	2	2
RAPGEF1	1	8	0	2	266.97	533.94	15	1	1	1	1	0.111111111111111	2	9
RAPGEF2	3	15	0	2	542.85	1085.7	15	1	1	1	1	0.166666666666667	2	18
RAPGEF5	1	9	0	0	205.92	411.84	15	1	1	NA	1	NA	0	10
RAPGEF6	0	21	0	4	572.88	1145.76	15	1	1	NA	1	0	4	21
RAPSN	1	3	0	1	164.67	329.34	15	1	1	1	1	0.25	1	4
RARA-RARB	1	7	0	0	129.03	258.06	15	1	1	NA	1	NA	0	8
RARRES1	6	3	1	1	65.67	131.34	15	1	1	0.5	1	0.166666666666667	2	9
RARS	0	13	0	4	201.63	403.26	15	1	1	NA	1	0	4	13
RARS2	9	7	4	1	170.28	340.56	15	1	0.606467148262814	-2.11111111111111	1	-0.2375	5	16
RASA1	6	12	6	7	170.61	341.22	15	1	0.709769447073698	-0.714285714285714	1	-0.128205128205128	13	18
RASA3	3	12	1	2	267.3	534.6	15	1	1	-1	1	-0.133333333333333	3	15
RASA4	6	4	1	0	104.94	209.88	15	1	1	-Inf	1	-0.4	1	10
RASAL1	3	2	1	2	37.29	74.58	15	1	1	0.666666666666667	1	0.266666666666667	3	5
RASAL2	0	16	0	2	323.07	646.14	15	1	1	NA	1	0	2	16
RASD2	0	3	0	1	80.52	161.04	15	1	1	NA	1	0	1	3
RASEF	4	10	0	0	165.99	331.98	15	1	1	NA	1	NA	0	14
RASGEF1A	2	4	0	0	136.62	273.24	15	1	1	NA	1	NA	0	6
RASGEF1B	1	11	0	1	136.95	273.9	15	1	1	1	1	0.0833333333333333	1	12
RASGEF1C	3	7	2	1	302.28	604.56	15	1	0.510489510489511	-3.66666666666667	1	-0.366666666666667	3	10
RASGRP1	3	9	1	0	237.27	474.54	15	1	0.307692307692308	-Inf	1	-0.75	1	12
RASGRP3	0	10	0	2	218.46	436.92	15	1	1	NA	1	0	2	10
RASL10A	0	2	0	1	37.95	75.9	15	1	1	NA	1	0	1	2
RASL11A	0	2	0	2	38.61	77.22	15	1	1	NA	1	0	2	2
RASL11B	0	3	0	0	70.95	141.9	15	1	1	NA	1	NA	0	3
RASL12	2	1	0	0	31.02	62.04	15	1	1	NA	1	NA	0	3
RASSF10	0	2	0	0	19.47	38.94	15	1	1	NA	1	NA	0	2
RASSF2	2	2	0	0	61.71	123.42	15	1	1	NA	1	NA	0	4
RASSF3	1	6	0	2	78.21	156.42	15	1	1	1	1	0.142857142857143	2	7
RASSF5	1	5	0	0	82.5	165	15	1	1	NA	1	NA	0	6
RASSF6	1	6	0	2	120.45	240.9	15	1	1	1	1	0.142857142857143	2	7
RASSF9	2	8	0	0	126.72	253.44	15	1	1	NA	1	NA	0	10
RAVER2	6	9	2	2	169.29	338.58	15	1	1	-0.5	1	-0.1	4	15
RAX	1	6	0	0	32.67	65.34	15	1	1	NA	1	NA	0	7
RB1	3	12	0	2	167.97	335.94	15	1	1	1	1	0.2	2	15
RBBP4	2	6	2	1	150.48	300.96	15	1	0.490909090909091	-5	1	-0.416666666666667	3	8
RBBP5	8	16	1	2	240.9	481.8	15	1	1	0	1	0	3	24
RBBP6	1	8	0	0	355.41	710.82	15	1	1	NA	1	NA	0	9
RBBP7	1	8	1	2	128.37	256.74	15	1	0.454545454545454	-3	1	-0.222222222222222	3	9
RBBP8NL	10	11	1	3	162.03	324.06	15	1	0.604347826086957	0.633333333333333	1	0.226190476190476	4	21
RBFA	4	1	0	0	61.05	122.1	15	1	1	NA	1	NA	0	5
RBFOX2	1	3	0	1	106.59	213.18	15	1	1	1	1	0.25	1	4
RBKS	1	0	1	0	122.76	245.52	15	1	1	NA	1	0	1	1
RBL1	7	4	2	0	312.84	625.68	15	1	1	-Inf	1	-0.363636363636364	2	11
RBL2	4	15	2	0	321.42	642.84	15	1	0.0714285714285714	-Inf	1	-0.789473684210526	2	19
RBM11	3	3	0	0	70.62	141.24	15	1	1	NA	1	NA	0	6
RBM12	0	6	0	0	188.43	376.86	15	1	1	NA	1	NA	0	6
RBM15	1	6	0	1	125.73	251.46	15	1	1	1	1	0.142857142857143	1	7
RBM17	1	4	1	2	118.47	236.94	15	1	1	-1	1	-0.133333333333333	3	5
RBM19	9	15	1	2	239.25	478.5	15	1	1	0.166666666666667	1	0.0416666666666667	3	24
RBM20	9	6	1	3	293.37	586.74	15	1	0.303405572755418	0.777777777777778	1	0.35	4	15
RBM22	0	8	0	3	105.93	211.86	15	1	1	NA	1	0	3	8
RBM24	0	2	0	1	31.68	63.36	15	1	1	NA	1	0	1	2
RBM25	0	9	0	1	215.82	431.64	15	1	1	NA	1	0	1	9
RBM27	3	18	1	2	329.34	658.68	15	1	0.436758893280632	-2	1	-0.19047619047619	3	21
RBM33	4	12	0	2	351.78	703.56	15	1	1	1	1	0.25	2	16
RBM34	11	6	3	1	93.39	186.78	15	1	1	-0.636363636363636	1	-0.102941176470588	4	17
RBM38	0	5	0	1	24.75	49.5	15	1	1	NA	1	0	1	5
RBM41	2	6	1	2	93.06	186.12	15	1	1	-0.5	1	-0.0833333333333333	3	8
RBM43	0	2	0	0	80.52	161.04	15	1	1	NA	1	NA	0	2
RBM44	21	8	5	1	319.11	638.22	15	1	1	-0.904761904761905	1	-0.109195402298851	6	29
RBM45	1	4	1	0	109.89	219.78	15	1	0.333333333333333	-Inf	1	-0.8	1	5
RBM46	0	5	0	0	145.2	290.4	15	1	1	NA	1	NA	0	5
RBM47	2	11	2	3	169.95	339.9	15	1	0.532679738562091	-2.66666666666667	1	-0.246153846153846	5	13
RBM48	8	4	2	0	95.37	190.74	15	1	1	-Inf	1	-0.333333333333333	2	12
RBM5	0	12	0	1	218.79	437.58	15	1	1	NA	1	0	1	12
RBM7	2	4	1	0	74.25	148.5	15	1	0.428571428571428	-Inf	1	-0.666666666666667	1	6
RBMX	0	4	0	0	113.19	226.38	15	1	1	NA	1	NA	0	4
RBMX2	1	1	1	0	80.85	161.7	15	1	1	-Inf	1	-0.5	1	2
RBP	1	4	0	1	87.45	174.9	15	1	1	1	1	0.2	1	5
RBP1	1	3	1	0	43.56	87.12	15	1	0.4	-Inf	1	-0.75	1	4
RBP2	2	1	0	0	49.83	99.66	15	1	1	NA	1	NA	0	3
RBP3	10	15	3	0	426.69	853.38	15	1	0.0873015873015873	-Inf	1	-0.6	3	25
RBP4	1	2	0	0	52.8	105.6	15	1	1	NA	1	NA	0	3
RBP4A	1	2	0	1	84.15	168.3	15	1	1	1	1	0.333333333333333	1	3
RBPJ	1	2	0	0	158.07	316.14	15	1	1	NA	1	NA	0	3
RBPJL	22	15	4	3	186.78	373.56	15	1	1	0.0909090909090909	1	0.0231660231660232	7	37
RBPMS	0	1	0	1	10.56	21.12	15	1	1	NA	1	0	1	1
RBSN	5	13	1	0	256.41	512.82	15	1	0.315789473684211	-Inf	1	-0.722222222222222	1	18
RC3H1	1	10	0	4	325.71	651.42	15	1	1	1	1	0.0909090909090909	4	11
RC3H2	0	4	0	1	317.79	635.58	15	1	1	NA	1	0	1	4
RCAN2	0	3	0	0	73.59	147.18	15	1	1	NA	1	NA	0	3
RCBTB1	4	12	4	2	202.95	405.9	15	1	0.136504362510554	-5	1	-0.416666666666667	6	16
RCBTB2	0	11	0	2	173.25	346.5	15	1	1	NA	1	0	2	11
RCC1	2	4	2	2	44.22	88.44	15	1	1	-1	1	-0.166666666666667	4	6
RCC1L	3	9	1	2	93.06	186.12	15	1	1	-0.5	1	-0.0833333333333333	3	12
RCC2	0	2	0	2	31.68	63.36	15	1	1	NA	1	0	2	2
RCCD1	4	0	1	0	27.39	54.78	15	1	1	NA	1	0	1	4
RCL1	1	3	0	1	71.28	142.56	15	1	1	1	1	0.25	1	4
RCN1L	0	3	0	2	76.23	152.46	15	1	1	NA	1	0	2	3
RCN2	1	3	0	0	86.46	172.92	15	1	1	NA	1	NA	0	4
RCOR1	0	3	0	1	94.05	188.1	15	1	1	NA	1	0	1	3
RCSD1	7	5	1	0	104.28	208.56	15	1	1	-Inf	1	-0.416666666666667	1	12
RD3	1	3	0	0	61.38	122.76	15	1	1	NA	1	NA	0	4
RD3L	0	5	0	0	60.06	120.12	15	1	1	NA	1	NA	0	5
RDH10	0	3	0	0	79.53	159.06	15	1	1	NA	1	NA	0	3
RDH12	2	2	1	0	107.25	214.5	15	1	1	-Inf	1	-0.5	1	4
RDH16	2	3	1	0	31.02	62.04	15	1	1	-Inf	1	-0.6	1	5
RDH7L	2	4	0	0	94.71	189.42	15	1	1	NA	1	NA	0	6
RDH8	17	12	4	1	371.25	742.5	15	1	0.627177850612386	-1.82352941176471	1	-0.213793103448276	5	29
RDM1	4	2	0	1	74.58	149.16	15	1	0.428571428571429	1	1	0.666666666666667	1	6
RDX	0	7	0	2	185.79	371.58	15	1	1	NA	1	0	2	7
REC114	2	2	0	0	59.4	118.8	15	1	1	NA	1	NA	0	4
RECK	1	8	0	1	231.66	463.32	15	1	1	1	1	0.111111111111111	1	9
RECQL	5	11	0	0	155.76	311.52	15	1	1	NA	1	NA	0	16
RECQL5	8	10	0	3	316.8	633.6	15	1	0.257142857142857	1	1	0.444444444444444	3	18
REEP1-REEP4	6	2	1	2	69.96	139.92	15	1	0.490909090909091	0.833333333333333	1	0.416666666666667	3	8
REEP2	4	4	0	1	78.87	157.74	15	1	1	1	1	0.5	1	8
REEP3	4	1	2	0	75.24	150.48	15	1	1	-Inf	1	-0.2	2	5
REEP5	0	2	0	0	30.36	60.72	15	1	1	NA	1	NA	0	2
REG4	0	1	0	1	12.87	25.74	15	1	1	NA	1	0	1	1
REL	4	12	0	3	173.25	346.5	15	1	1	1	1	0.25	3	16
RELL1	4	5	1	1	108.57	217.14	15	1	1	-0.25	1	-0.0555555555555556	2	9
RELN	11	51	3	5	1084.38	2168.76	15	1	0.192618429591175	-1.78181818181818	1	-0.19758064516129	8	62
REN	0	2	0	1	60.72	121.44	15	1	1	NA	1	0	1	2
REPS1	12	7	1	1	308.55	617.1	15	1	1	0.416666666666667	1	0.131578947368421	2	19
RER1	0	1	0	1	46.2	92.4	15	1	1	NA	1	0	1	1
RERE	4	14	1	3	316.8	633.6	15	1	1	-0.166666666666667	1	-0.0277777777777778	4	18
RERG	4	1	0	0	56.76	113.52	15	1	1	NA	1	NA	0	5
REST	4	10	0	1	173.25	346.5	15	1	1	1	1	0.285714285714286	1	14
RET	0	12	0	2	349.47	698.94	15	1	1	NA	1	0	2	12
REV1	6	11	0	1	354.75	709.5	15	1	1	1	1	0.352941176470588	1	17
REV3L	35	35	8	6	1203.18	2406.36	15	1	0.771732445945702	-0.333333333333333	1	-0.0714285714285714	14	70
REXO1	3	3	0	0	268.62	537.24	15	1	1	NA	1	NA	0	6
REXO4	5	4	2	0	92.73	185.46	15	1	0.490909090909091	-Inf	1	-0.444444444444444	2	9
REXO5	10	10	0	1	236.61	473.22	15	1	1	1	1	0.5	1	20
RFC1	7	23	2	4	369.6	739.2	15	1	0.626977623894133	-0.642857142857143	1	-0.1	6	30
RFC2	1	6	0	3	94.71	189.42	15	1	1	1	1	0.142857142857143	3	7
RFC3	2	8	0	0	106.26	212.52	15	1	1	NA	1	NA	0	10
RFC4	0	6	0	0	83.16	166.32	15	1	1	NA	1	NA	0	6
RFFL	6	5	1	2	111.87	223.74	15	1	1	0.583333333333333	1	0.212121212121212	3	11
RFLNA	0	3	0	0	32.34	64.68	15	1	1	NA	1	NA	0	3
RFT1	4	5	2	0	137.28	274.56	15	1	0.454545454545455	-Inf	1	-0.555555555555556	2	9
RFTN1	3	0	0	0	135.63	271.26	15	1	1	NA	1	NA	0	3
RFTN2	2	7	1	0	220.11	440.22	15	1	0.3	-Inf	1	-0.777777777777778	1	9
RFX3	6	4	2	0	210.87	421.74	15	1	0.515151515151515	-Inf	1	-0.4	2	10
RFX4	1	6	0	0	239.58	479.16	15	1	1	NA	1	NA	0	7
RFX6	4	9	0	0	250.8	501.6	15	1	1	NA	1	NA	0	13
RFX7	11	31	0	1	459.03	918.06	15	1	1	1	1	0.261904761904762	1	42
RFX8	5	4	1	0	156.75	313.5	15	1	1	-Inf	1	-0.444444444444444	1	9
RFXANK	1	2	1	1	56.76	113.52	15	1	1	-1	1	-0.166666666666667	2	3
RFXAP	0	2	0	1	15.18	30.36	15	1	1	NA	1	0	1	2
RGCCL	2	1	0	0	33	66	15	1	1	NA	1	NA	0	3
RGI3L1	3	7	2	3	103.62	207.24	15	1	1	-0.555555555555556	1	-0.1	5	10
RGL1	3	6	0	3	308.55	617.1	15	1	0.509090909090909	1	1	0.333333333333333	3	9
RGMA	0	7	0	1	68.31	136.62	15	1	1	NA	1	0	1	7
RGMB	2	10	0	0	102.96	205.92	15	1	1	NA	1	NA	0	12
RGN	0	5	0	0	71.94	143.88	15	1	1	NA	1	NA	0	5
RGNL	3	2	2	1	98.67	197.34	15	1	1	-0.333333333333333	1	-0.0666666666666667	3	5
RGP1	0	6	0	2	61.71	123.42	15	1	1	NA	1	0	2	6
RGR	2	1	0	0	89.76	179.52	15	1	1	NA	1	NA	0	3
RGS1	1	2	1	1	81.18	162.36	15	1	1	-1	1	-0.166666666666667	2	3
RGS10	0	4	0	1	54.78	109.56	15	1	1	NA	1	0	1	4
RGS12	5	23	1	1	540.87	1081.74	15	1	0.36551724137931	-3.6	1	-0.321428571428571	2	28
RGS14	3	2	2	1	70.95	141.9	15	1	1	-0.333333333333333	1	-0.0666666666666667	3	5
RGS16	1	4	0	1	55.77	111.54	15	1	1	1	1	0.2	1	5
RGS2	0	2	0	0	47.52	95.04	15	1	1	NA	1	NA	0	2
RGS20	0	2	0	0	76.89	153.78	15	1	1	NA	1	NA	0	2
RGS21	1	1	1	0	37.62	75.24	15	1	1	-Inf	1	-0.5	1	2
RGS22	16	9	7	0	403.92	807.84	15	1	0.149189091868458	-Inf	1	-0.36	7	25
RGS3	6	10	2	3	191.73	383.46	15	1	1	-0.111111111111111	1	-0.025	5	16
RGS4	0	3	0	2	48.18	96.36	15	1	1	NA	1	0	2	3
RGS5	0	3	0	1	35.31	70.62	15	1	1	NA	1	0	1	3
RGS6	4	7	1	2	159.06	318.12	15	1	1	0.125	1	0.0303030303030303	3	11
RGS7BP	3	4	0	0	79.2	158.4	15	1	1	NA	1	NA	0	7
RGS9	7	6	1	1	141.9	283.8	15	1	1	0.142857142857143	1	0.0384615384615384	2	13
RGS9BP	2	4	0	0	45.54	91.08	15	1	1	NA	1	NA	0	6
RGSL1	21	14	3	7	294.36	588.72	15	1	0.151335549520461	0.714285714285714	1	0.3	10	35
RHAG	0	4	0	0	137.61	275.22	15	1	1	NA	1	NA	0	4
RHBDD1	4	7	3	0	89.1	178.2	15	1	0.192307692307692	-Inf	1	-0.636363636363636	3	11
RHBDD2	5	6	0	2	36.3	72.6	15	1	0.487179487179487	1	1	0.454545454545455	2	11
RHBDF2	1	2	0	1	84.15	168.3	15	1	1	1	1	0.333333333333333	1	3
RHBDL3	0	3	0	2	112.2	224.4	15	1	1	NA	1	0	2	3
RHCG	1	6	1	1	102.96	205.92	15	1	0.416666666666667	-5	1	-0.357142857142857	2	7
RHNO1	6	6	1	2	45.21	90.42	15	1	1	0.5	1	0.166666666666667	3	12
RHO	0	3	0	1	80.52	161.04	15	1	1	NA	1	0	1	3
RHOBTB1	0	7	0	0	230.34	460.68	15	1	1	NA	1	NA	0	7
RHOBTB2	1	2	0	1	91.41	182.82	15	1	1	1	1	0.333333333333333	1	3
RHOD	2	4	0	0	29.7	59.4	15	1	1	NA	1	NA	0	6
RHOF	2	5	1	0	67.98	135.96	15	1	0.375	-Inf	1	-0.714285714285714	1	7
RHOGL	0	3	0	0	36.3	72.6	15	1	1	NA	1	NA	0	3
RHOH	0	3	0	1	62.37	124.74	15	1	1	NA	1	0	1	3
RHOJ	3	3	0	0	83.16	166.32	15	1	1	NA	1	NA	0	6
RHOT1	1	6	0	1	190.08	380.16	15	1	1	1	1	0.142857142857143	1	7
RHOU	0	2	0	1	55.11	110.22	15	1	1	NA	1	0	1	2
RHPN1	3	9	1	2	115.83	231.66	15	1	1	-0.5	1	-0.0833333333333333	3	12
RHPN2	2	8	1	1	178.86	357.72	15	1	0.454545454545455	-3	1	-0.3	2	10
RIBC2	8	5	1	0	118.8	237.6	15	1	1	-Inf	1	-0.384615384615385	1	13
RIC1	5	8	0	2	411.84	823.68	15	1	0.523809523809524	1	1	0.384615384615385	2	13
RIC3	9	4	1	0	86.46	172.92	15	1	1	-Inf	1	-0.307692307692308	1	13
RIC8A	2	10	0	2	144.54	289.08	15	1	1	1	1	0.166666666666667	2	12
RICTOR	2	10	1	0	473.88	947.76	15	1	0.230769230769231	-Inf	1	-0.833333333333333	1	12
RIDA	0	2	0	0	29.7	59.4	15	1	1	NA	1	NA	0	2
RIF1	29	30	3	4	536.25	1072.5	15	1	1	0.224137931034483	1	0.062953995157385	7	59
RILP	1	3	0	2	89.1	178.2	15	1	1	1	1	0.25	2	4
RILPL1	0	2	0	0	95.7	191.4	15	1	1	NA	1	NA	0	2
RIMBP2	6	24	2	3	483.12	966.24	15	1	0.567510288572907	-1.66666666666667	1	-0.2	5	30
RIMKLB	0	3	0	1	124.74	249.48	15	1	1	NA	1	0	1	3
RIMS1	2	1	1	0	222.75	445.5	15	1	1	-Inf	1	-0.333333333333333	1	3
RIMS2	4	9	1	2	485.43	970.86	15	1	1	-0.125	1	-0.0256410256410256	3	13
RIMS4	2	4	2	0	92.4	184.8	15	1	0.428571428571429	-Inf	1	-0.666666666666667	2	6
RIN2	10	9	0	1	260.7	521.4	15	1	1	1	1	0.526315789473684	1	19
RIN3	7	6	2	1	283.14	566.28	15	1	1	-0.714285714285714	1	-0.128205128205128	3	13
RINT1	3	13	1	1	340.23	680.46	15	1	0.405228758169935	-3.33333333333333	1	-0.3125	2	16
RIOK1	10	3	3	2	180.18	360.36	15	1	0.582749766573296	0.55	1	0.169230769230769	5	13
RIOK2	3	6	1	2	130.68	261.36	15	1	1	0	1	0	3	9
RIOK3	2	6	0	3	135.96	271.92	15	1	1	1	1	0.25	3	8
RIPK1	8	16	2	2	236.61	473.22	15	1	0.601465201465202	-1	1	-0.166666666666667	4	24
RIPK3	11	10	2	0	154.11	308.22	15	1	0.486166007905138	-Inf	1	-0.476190476190476	2	21
RIPK4	2	12	1	2	313.17	626.34	15	1	0.464705882352941	-2	1	-0.19047619047619	3	14
RIT1	0	2	0	0	73.92	147.84	15	1	1	NA	1	NA	0	2
RLBP1	2	6	2	2	64.68	129.36	15	1	0.547474747474747	-2	1	-0.25	4	8
RLF	29	30	3	2	775.5	1551	15	1	1	-0.551724137931034	1	-0.108474576271186	5	59
RLTPR	6	8	4	2	174.57	349.14	15	1	0.628482972136223	-1.66666666666667	1	-0.238095238095238	6	14
RMDN1	1	1	0	0	77.22	154.44	15	1	1	NA	1	NA	0	2
RMDN2	3	4	2	2	143.88	287.76	15	1	1	-0.333333333333333	1	-0.0714285714285715	4	7
RMDN3	1	7	1	2	104.28	208.56	15	1	0.490909090909091	-2.5	1	-0.208333333333333	3	8
RMI1	16	16	2	0	194.04	388.08	15	1	0.486631016042781	-Inf	1	-0.5	2	32
RMI2	0	1	0	1	9.57	19.14	15	1	1	NA	1	0	1	1
RMND1	8	5	0	0	152.46	304.92	15	1	1	NA	1	NA	0	13
RMND5A	0	4	0	0	149.49	298.98	15	1	1	NA	1	NA	0	4
RNASEH1	3	3	0	0	53.46	106.92	15	1	1	NA	1	NA	0	6
RNASEH2B	2	5	2	0	85.47	170.94	15	1	0.166666666666667	-Inf	1	-0.714285714285714	2	7
RNASEL	20	13	4	4	280.17	560.34	15	1	0.697506531909613	0.35	1	0.106060606060606	8	33
RND2	1	0	1	0	28.38	56.76	15	1	1	NA	1	0	1	1
RNF103	3	12	0	0	209.88	419.76	15	1	1	NA	1	NA	0	15
RNF111	2	10	0	1	280.83	561.66	15	1	1	1	1	0.166666666666667	1	12
RNF113A	1	6	1	1	71.28	142.56	15	1	0.416666666666667	-5	1	-0.357142857142857	2	7
RNF114	0	4	0	0	37.29	74.58	15	1	1	NA	1	NA	0	4
RNF121	0	7	0	3	80.19	160.38	15	1	1	NA	1	0	3	7
RNF126	2	7	0	2	86.46	172.92	15	1	1	1	1	0.222222222222222	2	9
RNF128	0	2	0	1	67.98	135.96	15	1	1	NA	1	0	1	2
RNF13	1	3	0	0	109.23	218.46	15	1	1	NA	1	NA	0	4
RNF130	0	6	0	1	141.24	282.48	15	1	1	NA	1	0	1	6
RNF139	6	14	1	3	188.1	376.2	15	1	1	0.222222222222222	1	0.05	4	20
RNF14	1	5	0	1	114.51	229.02	15	1	1	1	1	0.166666666666667	1	6
RNF141	1	5	0	1	76.89	153.78	15	1	1	1	1	0.166666666666667	1	6
RNF144A	6	3	1	1	125.73	251.46	15	1	1	0.5	1	0.166666666666667	2	9
RNF144B	6	4	1	0	88.77	177.54	15	1	1	-Inf	1	-0.4	1	10
RNF145	4	9	1	3	207.57	415.14	15	1	1	0.25	1	0.0576923076923077	4	13
RNF149	0	4	0	1	84.15	168.3	15	1	1	NA	1	0	1	4
RNF150	0	2	0	2	83.49	166.98	15	1	1	NA	1	0	2	2
RNF151	0	7	0	2	87.12	174.24	15	1	1	NA	1	0	2	7
RNF152	0	3	0	2	32.67	65.34	15	1	1	NA	1	0	2	3
RNF157	1	1	1	1	30.03	60.06	15	1	1	0	1	0	2	2
RNF165	2	3	1	1	101.64	203.28	15	1	1	-0.5	1	-0.1	2	5
RNF168	6	8	1	0	173.58	347.16	15	1	0.466666666666667	-Inf	1	-0.571428571428571	1	14
RNF169	8	11	2	5	141.24	282.48	15	1	0.66798418972332	0.45	1	0.135338345864662	7	19
RNF17	21	31	2	4	542.85	1085.7	15	1	1	0.261904761904762	1	0.0705128205128205	6	52
RNF180	2	0	0	0	31.02	62.04	15	1	1	NA	1	NA	0	2
RNF186	5	10	0	0	125.73	251.46	15	1	1	NA	1	NA	0	15
RNF19A	5	24	3	1	309.54	619.08	15	1	0.0359237536656892	-13.4	1	-0.577586206896552	4	29
RNF19B	1	13	0	3	140.91	281.82	15	1	1	1	1	0.0714285714285714	3	14
RNF2	3	4	1	1	153.78	307.56	15	1	1	-0.333333333333333	1	-0.0714285714285715	2	7
RNF20	3	17	3	3	205.92	411.84	15	1	0.11193589019676	-4.66666666666667	1	-0.35	6	20
RNF207	5	9	0	2	73.92	147.84	15	1	1	1	1	0.357142857142857	2	14
RNF213	93	63	12	12	1756.59	3513.18	15	1	0.383539367637603	0.32258064516129	1	0.0961538461538461	24	156
RNF214	0	9	0	1	101.97	203.94	15	1	1	NA	1	0	1	9
RNF216	13	17	5	5	263.34	526.68	15	1	0.730651867748642	-0.307692307692308	1	-0.0666666666666667	10	30
RNF217	0	2	0	0	99.33	198.66	15	1	1	NA	1	NA	0	2
RNF219	6	13	2	0	264.33	528.66	15	1	0.133333333333333	-Inf	1	-0.684210526315789	2	19
RNF220	1	2	1	1	118.14	236.28	15	1	1	-1	1	-0.166666666666667	2	3
RNF222	2	4	0	1	58.08	116.16	15	1	1	1	1	0.333333333333333	1	6
RNF223	6	3	2	1	60.72	121.44	15	1	1	0	1	0	3	9
RNF25	4	5	0	0	46.86	93.72	15	1	1	NA	1	NA	0	9
RNF26	0	2	0	0	42.57	85.14	15	1	1	NA	1	NA	0	2
RNF32	3	4	1	2	124.41	248.82	15	1	1	0.333333333333333	1	0.0952380952380952	3	7
RNF34	1	7	0	0	105.27	210.54	15	1	1	NA	1	NA	0	8
RNF38	3	7	1	1	100.65	201.3	15	1	1	-1.33333333333333	1	-0.2	2	10
RNF4	1	2	0	0	53.13	106.26	15	1	1	NA	1	NA	0	3
RNF43	7	5	2	2	206.91	413.82	15	1	1	0.285714285714286	1	0.0833333333333334	4	12
RNF6	9	14	0	3	259.38	518.76	15	1	0.529230769230769	1	1	0.391304347826087	3	23
RNF8	1	8	1	1	111.54	223.08	15	1	0.345454545454545	-7	1	-0.388888888888889	2	9
RNFT1	1	3	0	0	133.98	267.96	15	1	1	NA	1	NA	0	4
RNFT2	2	11	0	4	194.37	388.74	15	1	1	1	1	0.153846153846154	4	13
RNGTT	1	6	0	1	178.53	357.06	15	1	1	1	1	0.142857142857143	1	7
RNH1	1	6	0	1	126.72	253.44	15	1	1	1	1	0.142857142857143	1	7
RNLS	1	4	0	0	79.2	158.4	15	1	1	NA	1	NA	0	5
RNMT	1	3	0	0	85.8	171.6	15	1	1	NA	1	NA	0	4
RNPC3	1	5	0	1	109.89	219.78	15	1	1	1	1	0.166666666666667	1	6
RNPEP	0	7	0	3	70.29	140.58	15	1	1	NA	1	0	3	7
RNPEPL1	0	6	0	2	152.13	304.26	15	1	1	NA	1	0	2	6
RNPS1	4	11	0	3	107.91	215.82	15	1	1	1	1	0.266666666666667	3	15
ROBO2	2	7	0	1	238.26	476.52	15	1	1	1	1	0.222222222222222	1	9
ROBO3	2	4	1	0	59.73	119.46	15	1	0.428571428571428	-Inf	1	-0.666666666666667	1	6
ROBO4	13	11	3	0	168.63	337.26	15	1	0.247863247863248	-Inf	1	-0.458333333333333	3	24
ROCK1	6	8	1	2	389.07	778.14	15	1	1	0.333333333333333	1	0.0952380952380952	3	14
ROM1	4	4	1	1	152.79	305.58	15	1	1	0	1	0	2	8
ROPN1L	5	8	1	1	77.88	155.76	15	1	1	-0.6	1	-0.115384615384615	2	13
ROR1	0	22	0	1	352.11	704.22	15	1	1	NA	1	0	1	22
ROR2	1	8	0	0	228.69	457.38	15	1	1	NA	1	NA	0	9
RORA	1	1	0	0	134.31	268.62	15	1	1	NA	1	NA	0	2
ROS1	24	38	2	3	752.07	1504.14	15	1	1	-0.0555555555555556	1	-0.0129032258064516	5	62
RP1L1	30	23	5	5	552.09	1104.18	15	1	0.73996272070601	0.233333333333333	1	0.0660377358490566	10	53
RP2	2	2	2	0	106.26	212.52	15	1	0.466666666666667	-Inf	1	-0.5	2	4
RP9	1	4	0	0	46.2	92.4	15	1	1	NA	1	NA	0	5
RPA1	3	12	0	0	189.75	379.5	15	1	1	NA	1	NA	0	15
RPA2	0	6	0	1	81.18	162.36	15	1	1	NA	1	0	1	6
RPAIN	1	5	0	1	39.93	79.86	15	1	1	1	1	0.166666666666667	1	6
RPAP1	11	19	2	5	417.12	834.24	15	1	1	0.309090909090909	1	0.0809523809523809	7	30
RPAP2	2	10	0	1	201.63	403.26	15	1	1	1	1	0.166666666666667	1	12
RPAP3	2	8	1	1	165.99	331.98	15	1	0.454545454545455	-3	1	-0.3	2	10
RPE	0	2	0	0	49.17	98.34	15	1	1	NA	1	NA	0	2
RPE65	3	12	3	4	161.04	322.08	15	1	0.334083872783563	-2	1	-0.228571428571429	7	15
RPESL	0	7	0	0	68.97	137.94	15	1	1	NA	1	NA	0	7
RPF1	1	4	0	0	102.63	205.26	15	1	1	NA	1	NA	0	5
RPF2	1	4	0	1	96.69	193.38	15	1	1	1	1	0.2	1	5
RPGRIP1L	22	14	4	5	430.32	860.64	15	1	0.460532568870629	0.490909090909091	1	0.166666666666667	9	36
RPH3A	1	5	0	3	91.08	182.16	15	1	1	1	1	0.166666666666667	3	6
RPH3AL	4	5	1	1	85.47	170.94	15	1	1	-0.25	1	-0.0555555555555556	2	9
RPIA	0	3	0	0	77.55	155.1	15	1	1	NA	1	NA	0	3
RPL10A	0	1	0	1	29.04	58.08	15	1	1	NA	1	0	1	1
RPL11	0	5	0	0	53.46	106.92	15	1	1	NA	1	NA	0	5
RPL12	0	2	0	2	44.55	89.1	15	1	1	NA	1	0	2	2
RPL14	2	1	0	0	35.97	71.94	15	1	1	NA	1	NA	0	3
RPL15	0	2	0	0	60.06	120.12	15	1	1	NA	1	NA	0	2
RPL18A	0	3	0	0	28.71	57.42	15	1	1	NA	1	NA	0	3
RPL19	0	2	0	0	27.72	55.44	15	1	1	NA	1	NA	0	2
RPL23	0	2	0	0	15.51	31.02	15	1	1	NA	1	NA	0	2
RPL23A	0	7	0	0	29.04	58.08	15	1	1	NA	1	NA	0	7
RPL24	0	1	0	1	36.3	72.6	15	1	1	NA	1	0	1	1
RPL3	1	8	1	1	142.89	285.78	15	1	0.345454545454545	-7	1	-0.388888888888889	2	9
RPL30	0	3	0	2	21.12	42.24	15	1	1	NA	1	0	2	3
RPL34	0	4	0	0	47.19	94.38	15	1	1	NA	1	NA	0	4
RPL37	2	0	0	0	12.87	25.74	15	1	1	NA	1	NA	0	2
RPL3L	1	5	1	1	105.93	211.86	15	1	0.464285714285714	-4	1	-0.333333333333333	2	6
RPL4	1	3	0	0	103.95	207.9	15	1	1	NA	1	NA	0	4
RPL5	1	5	0	1	89.76	179.52	15	1	1	1	1	0.166666666666667	1	6
RPL6	1	6	0	2	75.57	151.14	15	1	1	1	1	0.142857142857143	2	7
RPL7	0	4	0	2	70.95	141.9	15	1	1	NA	1	0	2	4
RPL7A	0	3	0	0	76.89	153.78	15	1	1	NA	1	NA	0	3
RPL7L1	3	1	0	0	49.5	99	15	1	1	NA	1	NA	0	4
RPL8	0	3	0	0	84.48	168.96	15	1	1	NA	1	NA	0	3
RPL9	1	4	0	0	68.64	137.28	15	1	1	NA	1	NA	0	5
RPLP2	0	3	0	0	32.01	64.02	15	1	1	NA	1	NA	0	3
RPN2	3	11	1	3	178.86	357.72	15	1	1	-0.222222222222222	1	-0.0357142857142857	4	14
RPP25L	1	3	0	0	59.4	118.8	15	1	1	NA	1	NA	0	4
RPP30	4	7	1	2	81.84	163.68	15	1	1	0.125	1	0.0303030303030303	3	11
RPRD1A	8	4	0	0	110.88	221.76	15	1	1	NA	1	NA	0	12
RPRD1B	0	4	0	2	57.09	114.18	15	1	1	NA	1	0	2	4
RPRD2	5	28	0	2	249.15	498.3	15	1	1	1	1	0.151515151515152	2	33
RPRML	1	2	1	2	23.1	46.2	15	1	1	0	1	0	3	3
RPS10	0	2	0	1	21.12	42.24	15	1	1	NA	1	0	1	2
RPS11	0	2	0	0	51.15	102.3	15	1	1	NA	1	NA	0	2
RPS12	0	2	0	1	36.96	73.92	15	1	1	NA	1	0	1	2
RPS14	0	2	0	1	33.99	67.98	15	1	1	NA	1	0	1	2
RPS16	0	2	0	2	35.64	71.28	15	1	1	NA	1	0	2	2
RPS19BP1	3	1	1	0	21.45	42.9	15	1	1	-Inf	1	-0.25	1	4
RPS2	0	9	0	3	69.63	139.26	15	1	1	NA	1	0	3	9
RPS20	1	6	1	1	48.51	97.02	15	1	0.416666666666667	-5	1	-0.357142857142857	2	7
RPS23	0	2	0	0	14.19	28.38	15	1	1	NA	1	NA	0	2
RPS25	0	2	0	0	25.41	50.82	15	1	1	NA	1	NA	0	2
RPS27A	0	3	0	0	50.82	101.64	15	1	1	NA	1	NA	0	3
RPS3	0	3	0	0	79.53	159.06	15	1	1	NA	1	NA	0	3
RPS3A	0	6	0	1	82.83	165.66	15	1	1	NA	1	0	1	6
RPS4X	0	1	0	1	36.63	73.26	15	1	1	NA	1	0	1	1
RPS6KA1L	0	12	0	3	282.81	565.62	15	1	1	NA	1	0	3	12
RPS6KA2	1	7	0	1	218.13	436.26	15	1	1	1	1	0.125	1	8
RPS6KA3	0	5	0	0	194.7	389.4	15	1	1	NA	1	NA	0	5
RPS6KA5	0	4	0	0	202.95	405.9	15	1	1	NA	1	NA	0	4
RPS6KB1	1	3	0	0	188.76	377.52	15	1	1	NA	1	NA	0	4
RPS6KC1	5	9	0	2	305.91	611.82	15	1	1	1	1	0.357142857142857	2	14
RPS6KL1	5	5	2	3	79.2	158.4	15	1	1	0.333333333333333	1	0.1	5	10
RPS7	0	3	0	0	45.54	91.08	15	1	1	NA	1	NA	0	3
RPS8	0	6	0	0	51.15	102.3	15	1	1	NA	1	NA	0	6
RPSA	0	6	0	0	73.59	147.18	15	1	1	NA	1	NA	0	6
RPUSD1	2	3	1	2	67.65	135.3	15	1	1	0.25	1	0.0666666666666667	3	5
RRAGA	0	3	0	1	99.66	199.32	15	1	1	NA	1	0	1	3
RRAGD	1	4	0	0	134.31	268.62	15	1	1	NA	1	NA	0	5
RRAS2	0	1	0	1	61.05	122.1	15	1	1	NA	1	0	1	1
RRBP1	3	3	1	1	222.42	444.84	15	1	1	0	1	0	2	6
RREB1	7	16	0	3	480.15	960.3	15	1	0.539615384615385	1	1	0.304347826086957	3	23
RRM1	2	20	1	9	229.68	459.36	15	1	1	-0.111111111111111	1	-0.00909090909090909	10	22
RRM2B	0	7	0	2	107.25	214.5	15	1	1	NA	1	0	2	7
RRN3	1	5	0	0	183.15	366.3	15	1	1	NA	1	NA	0	6
RRP12	8	16	3	5	198.33	396.66	15	1	1	-0.2	1	-0.0416666666666667	8	24
RRP15	3	1	0	0	61.05	122.1	15	1	1	NA	1	NA	0	4
RRP1B	17	17	3	5	228.69	457.38	15	1	0.699727870459578	0.4	1	0.125	8	34
RRP36	4	2	1	0	58.41	116.82	15	1	1	-Inf	1	-0.333333333333333	1	6
RRP7A	6	4	2	1	69.3	138.6	15	1	1	-0.333333333333333	1	-0.0666666666666667	3	10
RRP8	2	6	1	1	66.33	132.66	15	1	1	-2	1	-0.25	2	8
RS1	3	3	0	0	58.08	116.16	15	1	1	NA	1	NA	0	6
RSAD2	3	4	0	0	96.03	192.06	15	1	1	NA	1	NA	0	7
RSF1	12	19	5	5	424.71	849.42	15	1	0.714263982556665	-0.583333333333333	1	-0.112903225806452	10	31
RSL1D1	4	2	1	1	134.64	269.28	15	1	1	0.5	1	0.166666666666667	2	6
RSL24D1	2	0	0	0	41.25	82.5	15	1	1	NA	1	NA	0	2
RSPH1	7	10	1	6	96.03	192.06	15	1	0.352148487159929	0.761904761904762	1	0.26890756302521	7	17
RSPH10B	14	16	2	0	288.42	576.84	15	1	0.483870967741935	-Inf	1	-0.533333333333333	2	30
RSPH3	2	2	0	0	114.18	228.36	15	1	1	NA	1	NA	0	4
RSPH9	3	3	1	1	62.37	124.74	15	1	1	0	1	0	2	6
RSPO3	1	1	1	0	54.12	108.24	15	1	1	-Inf	1	-0.5	1	2
RSPRY1	2	5	2	0	163.68	327.36	15	1	0.166666666666667	-Inf	1	-0.714285714285714	2	7
RSRC1	2	0	1	0	33.33	66.66	15	1	1	NA	1	0	1	2
RSRC2	0	7	0	1	78.54	157.08	15	1	1	NA	1	0	1	7
RSU1	6	4	4	0	90.75	181.5	15	1	0.250749250749251	-Inf	1	-0.4	4	10
RTCA	0	4	0	0	125.73	251.46	15	1	1	NA	1	NA	0	4
RTCB	0	7	0	1	139.92	279.84	15	1	1	NA	1	0	1	7
RTEL1	16	17	2	3	460.02	920.04	15	1	1	0.291666666666667	1	0.0848484848484848	5	33
RTF1	1	12	0	1	191.4	382.8	15	1	1	1	1	0.0769230769230769	1	13
RTFDC1	2	4	1	0	49.17	98.34	15	1	0.428571428571428	-Inf	1	-0.666666666666667	1	6
RTKN2	16	13	1	1	204.93	409.86	15	1	1	0.1875	1	0.0517241379310345	2	29
RTN1	2	14	1	1	218.46	436.92	15	1	0.313725490196078	-6	1	-0.375	2	16
RTN4IP1	3	5	0	2	105.93	211.86	15	1	1	1	1	0.375	2	8
RTN4R	1	4	1	1	126.72	253.44	15	1	1	-3	1	-0.3	2	5
RTN4RL1	0	5	0	1	102.3	204.6	15	1	1	NA	1	0	1	5
RTP2	7	5	0	2	38.94	77.88	15	1	0.461538461538462	1	1	0.583333333333333	2	12
RUBCN	3	22	2	4	270.6	541.2	15	1	0.240602433038473	-2.66666666666667	1	-0.213333333333333	6	25
RUBCNL	10	13	2	2	280.5	561	15	1	1	-0.3	1	-0.0652173913043478	4	23
RUFY1	2	8	1	1	194.04	388.08	15	1	0.454545454545455	-3	1	-0.3	2	10
RUFY4	1	2	1	0	25.08	50.16	15	1	1	-Inf	1	-0.666666666666667	1	3
RUNDC1	1	4	0	1	118.47	236.94	15	1	1	1	1	0.2	1	5
RUNDC3B	0	4	0	1	125.4	250.8	15	1	1	NA	1	0	1	4
RUNX1	5	4	0	1	93.72	187.44	15	1	1	1	1	0.555555555555556	1	9
RUNX2	1	7	1	0	145.53	291.06	15	1	0.222222222222222	-Inf	1	-0.875	1	8
RUSC1	15	15	3	1	266.31	532.62	15	1	0.604105571847507	-2	1	-0.25	4	30
RUSC2	6	24	0	3	352.77	705.54	15	1	1	1	1	0.2	3	30
RUVBL1	0	5	0	0	130.35	260.7	15	1	1	NA	1	NA	0	5
RWDD1	0	2	0	0	42.9	85.8	15	1	1	NA	1	NA	0	2
RWDD3	4	3	1	0	75.57	151.14	15	1	1	-Inf	1	-0.428571428571429	1	7
RXFP1	4	9	1	0	188.1	376.2	15	1	0.357142857142857	-Inf	1	-0.692307692307692	1	13
RXFP3	2	1	0	0	105.93	211.86	15	1	1	NA	1	NA	0	3
RXRA	0	8	0	6	108.24	216.48	15	1	1	NA	1	0	6	8
RXRG	4	5	3	5	110.88	221.76	15	1	1	0.25	1	0.0694444444444444	8	9
RYBP	2	1	0	2	72.6	145.2	15	1	0.4	1	1	0.666666666666667	2	3
RYK	0	5	0	0	163.02	326.04	15	1	1	NA	1	NA	0	5
RYR2	11	48	1	2	1424.61	2849.22	15	1	0.481755684822845	-1.18181818181818	1	-0.146892655367232	3	59
RYR3	7	50	0	1	1456.29	2912.58	15	1	1	1	1	0.12280701754386	1	57
S100A9	6	3	0	1	42.9	85.8	15	1	0.4	1	1	0.666666666666667	1	9
S100B	0	3	0	2	24.42	48.84	15	1	1	NA	1	0	2	3
S100Z	1	1	1	0	26.4	52.8	15	1	1	-Inf	1	-0.5	1	2
S1PR1	0	13	0	2	136.95	273.9	15	1	1	NA	1	0	2	13
S1PR3	1	5	0	0	120.45	240.9	15	1	1	NA	1	NA	0	6
S1PR4	1	7	0	0	142.56	285.12	15	1	1	NA	1	NA	0	8
SAAL1	0	6	0	0	132.66	265.32	15	1	1	NA	1	NA	0	6
SACM1L	0	9	0	1	175.56	351.12	15	1	1	NA	1	0	1	9
SACS	10	73	1	7	1537.47	3074.94	15	1	1	-0.0428571428571429	1	-0.00451807228915663	8	83
SAFB	5	5	1	0	194.7	389.4	15	1	1	-Inf	1	-0.5	1	10
SAFB2	5	3	1	0	32.67	65.34	15	1	1	-Inf	1	-0.375	1	8
SAG	1	6	0	0	124.41	248.82	15	1	1	NA	1	NA	0	7
SALL1	4	15	1	1	459.36	918.72	15	1	0.428571428571428	-2.75	1	-0.289473684210526	2	19
SALL3	3	16	0	1	508.53	1017.06	15	1	1	1	1	0.157894736842105	1	19
SALL4	3	16	2	2	358.05	716.1	15	1	0.193675889328063	-4.33333333333333	1	-0.342105263157895	4	19
SAMD11	2	5	0	2	113.52	227.04	15	1	1	1	1	0.285714285714286	2	7
SAMD13	1	2	0	0	50.16	100.32	15	1	1	NA	1	NA	0	3
SAMD15	3	1	0	0	42.24	84.48	15	1	1	NA	1	NA	0	4
SAMD3	5	4	0	0	134.97	269.94	15	1	1	NA	1	NA	0	9
SAMD4A	1	3	1	0	149.49	298.98	15	1	0.4	-Inf	1	-0.75	1	4
SAMD7	3	5	1	0	167.97	335.94	15	1	0.444444444444444	-Inf	1	-0.625	1	8
SAMD8	4	8	2	2	139.92	279.84	15	1	0.604395604395604	-1	1	-0.166666666666667	4	12
SAMD9L	30	22	1	2	579.48	1158.96	15	1	0.574614065180103	0.633333333333333	1	0.243589743589744	3	52
SAMHD1	1	3	0	1	143.88	287.76	15	1	1	1	1	0.25	1	4
SAMM50	0	3	0	0	113.19	226.38	15	1	1	NA	1	NA	0	3
SAP130	0	21	0	2	290.73	581.46	15	1	1	NA	1	0	2	21
SAPCD2	1	7	0	0	67.32	134.64	15	1	1	NA	1	NA	0	8
SARAF	6	1	0	1	43.56	87.12	15	1	0.25	1	1	0.857142857142857	1	7
SARDH-VAV2	5	18	4	8	330.99	661.98	15	1	0.685467512922855	-0.8	1	-0.115942028985507	12	23
SARM1	1	14	0	7	123.75	247.5	15	1	1	1	1	0.0666666666666667	7	15
SART3	2	19	2	4	235.29	470.58	15	1	0.204273504273504	-3.75	1	-0.238095238095238	6	21
SASH1	11	28	3	2	534.27	1068.54	15	1	0.306515237456814	-2.81818181818182	1	-0.317948717948718	5	39
SASH3	1	1	1	1	23.76	47.52	15	1	1	0	1	0	2	2
SASS6	3	3	0	0	186.45	372.9	15	1	1	NA	1	NA	0	6
SATB1	0	6	0	0	206.58	413.16	15	1	1	NA	1	NA	0	6
SATB2	1	4	0	0	273.24	546.48	15	1	1	NA	1	NA	0	5
SAV1	0	5	0	1	131.34	262.68	15	1	1	NA	1	0	1	5
SAXO2	3	6	0	1	143.88	287.76	15	1	1	1	1	0.333333333333333	1	9
SBDS	0	2	0	0	51.81	103.62	15	1	1	NA	1	NA	0	2
SBK2	1	2	0	1	67.32	134.64	15	1	1	1	1	0.333333333333333	1	3
SBK3	1	1	0	0	36.63	73.26	15	1	1	NA	1	NA	0	2
SBNO1	0	19	0	2	402.6	805.2	15	1	1	NA	1	0	2	19
SBNO2	5	10	1	3	429.33	858.66	15	1	1	0.333333333333333	1	0.0833333333333333	4	15
SBSPONL	1	1	0	0	9.9	19.8	15	1	1	NA	1	NA	0	2
SC5D	2	1	0	1	38.94	77.88	15	1	1	1	1	0.666666666666667	1	3
SCAF11	17	18	6	4	386.43	772.86	15	1	0.722238010950433	-0.588235294117647	1	-0.114285714285714	10	35
SCAF4	0	15	0	1	256.74	513.48	15	1	1	NA	1	0	1	15
SCAF8	5	16	1	0	462	924	15	1	0.272727272727273	-Inf	1	-0.761904761904762	1	21
SCAI	1	3	0	0	203.61	407.22	15	1	1	NA	1	NA	0	4
SCAMP1	1	2	0	0	84.48	168.96	15	1	1	NA	1	NA	0	3
SCAMP2	0	2	0	0	31.02	62.04	15	1	1	NA	1	NA	0	2
SCAMP3	0	5	0	1	66.33	132.66	15	1	1	NA	1	0	1	5
SCAMP4	0	4	0	1	66	132	15	1	1	NA	1	0	1	4
SCAP	5	22	4	4	340.89	681.78	15	1	0.161533356390387	-3.4	1	-0.314814814814815	8	27
SCAPER	9	11	0	1	591.03	1182.06	15	1	1	1	1	0.45	1	20
SCARA5	1	1	0	0	48.51	97.02	15	1	1	NA	1	NA	0	2
SCARB1	0	10	0	1	146.19	292.38	15	1	1	NA	1	0	1	10
SCARB2	1	4	1	0	131.67	263.34	15	1	0.333333333333333	-Inf	1	-0.8	1	5
SCARF1	3	7	1	5	74.25	148.5	15	1	1	0.533333333333333	1	0.133333333333333	6	10
SCARF2	0	8	0	2	141.9	283.8	15	1	1	NA	1	0	2	8
SCD	2	3	2	1	92.4	184.8	15	1	1	-2	1	-0.266666666666667	3	5
SCD5	0	8	0	1	66	132	15	1	1	NA	1	0	1	8
SCEL	6	4	1	0	98.01	196.02	15	1	1	-Inf	1	-0.4	1	10
SCFD1	1	10	0	0	171.27	342.54	15	1	1	NA	1	NA	0	11
SCFD2	8	3	4	1	120.12	240.24	15	1	1	-0.5	1	-0.0727272727272728	5	11
SCFN	16	5	2	1	85.14	170.28	15	1	1	0.375	1	0.0952380952380952	3	21
SCG2	8	7	3	1	184.8	369.6	15	1	0.602683178534572	-1.625	1	-0.216666666666667	4	15
SCG3	4	5	2	2	91.41	182.82	15	1	1	-0.25	1	-0.0555555555555556	4	9
SCG5	3	5	0	0	67.98	135.96	15	1	1	NA	1	NA	0	8
SCHIP1	0	9	0	1	78.87	157.74	15	1	1	NA	1	0	1	9
SCIN	2	8	0	0	237.27	474.54	15	1	1	NA	1	NA	0	10
SCLT1	7	10	1	2	196.35	392.7	15	1	1	0.285714285714286	1	0.0784313725490196	3	17
SCLY	9	14	3	3	94.71	189.42	15	1	0.669319186560566	-0.555555555555556	1	-0.108695652173913	6	23
SCMH1	0	2	0	1	219.12	438.24	15	1	1	NA	1	0	1	2
SCML2	3	9	1	0	241.23	482.46	15	1	0.307692307692308	-Inf	1	-0.75	1	12
SCML4	7	3	2	1	132.33	264.66	15	1	1	0.142857142857143	1	0.0333333333333333	3	10
SCN11A	15	21	0	2	507.54	1015.08	15	1	0.509246088193457	1	1	0.416666666666667	2	36
SCN1A	7	18	1	1	575.19	1150.38	15	1	0.512820512820513	-1.57142857142857	1	-0.22	2	25
SCN2A	0	10	0	1	579.48	1158.96	15	1	1	NA	1	0	1	10
SCN2B	0	1	0	1	24.42	48.84	15	1	1	NA	1	0	1	1
SCN3A	4	19	1	0	561.66	1123.32	15	1	0.208333333333333	-Inf	1	-0.826086956521739	1	23
SCN3B	0	3	0	0	66	132	15	1	1	NA	1	NA	0	3
SCN4A	3	38	0	4	473.88	947.76	15	1	1	1	1	0.0731707317073171	4	41
SCN5A	4	18	2	0	671.22	1342.44	15	1	0.0543478260869565	-Inf	1	-0.818181818181818	2	22
SCN8A	3	13	1	4	614.79	1229.58	15	1	1	-0.0833333333333333	1	-0.0125	5	16
SCN9A	6	24	0	4	632.28	1264.56	15	1	1	1	1	0.2	4	30
SCNM1	1	1	0	1	17.49	34.98	15	1	1	1	1	0.5	1	2
SCNN1A	3	12	2	3	188.43	376.86	15	1	0.559791021671827	-1.66666666666667	1	-0.2	5	15
SCNN1B	3	11	1	5	191.73	383.46	15	1	1	0.266666666666667	1	0.0476190476190476	6	14
SCNN1D	3	12	1	5	206.58	413.16	15	1	1	0.2	1	0.0333333333333334	6	15
SCNN1G	2	8	1	2	138.27	276.54	15	1	1	-1	1	-0.133333333333333	3	10
SCO1	1	1	0	0	32.34	64.68	15	1	1	NA	1	NA	0	2
SCP2	4	7	0	0	134.31	268.62	15	1	1	NA	1	NA	0	11
SCPEP1	0	7	0	1	153.45	306.9	15	1	1	NA	1	0	1	7
SCRG1	2	1	0	0	41.25	82.5	15	1	1	NA	1	NA	0	3
SCRN1	1	10	1	0	184.8	369.6	15	1	0.166666666666667	-Inf	1	-0.909090909090909	1	11
SCRN2	3	1	2	1	29.04	58.08	15	1	1	0.333333333333333	1	0.0833333333333334	3	4
SCRN3	2	4	0	0	110.55	221.1	15	1	1	NA	1	NA	0	6
SCT	12	11	0	1	231.33	462.66	15	1	1	1	1	0.521739130434783	1	23
SCTR	4	6	0	1	121.11	242.22	15	1	1	1	1	0.4	1	10
SCUBE1	0	2	0	0	111.54	223.08	15	1	1	NA	1	NA	0	2
SCUBE2	2	9	2	3	303.27	606.54	15	1	0.546703296703297	-2	1	-0.218181818181818	5	11
SCUBE3	0	2	0	2	62.04	124.08	15	1	1	NA	1	0	2	2
SCX	1	1	1	1	16.17	32.34	15	1	1	0	1	0	2	2
SCYL2	4	9	0	1	321.42	642.84	15	1	1	1	1	0.307692307692308	1	13
SCYL3	12	14	5	5	231	462	15	1	1	-0.166666666666667	1	-0.0384615384615384	10	26
SDAD1	4	7	0	0	182.16	364.32	15	1	1	NA	1	NA	0	11
SDC1	2	5	1	0	126.39	252.78	15	1	0.375	-Inf	1	-0.714285714285714	1	7
SDC2	2	0	1	0	53.46	106.92	15	1	1	NA	1	0	1	2
SDC3	1	9	0	6	54.78	109.56	15	1	1	1	1	0.1	6	10
SDC4	2	3	0	0	55.44	110.88	15	1	1	NA	1	NA	0	5
SDCBP	1	6	0	0	91.74	183.48	15	1	1	NA	1	NA	0	7
SDCCAG3	1	5	1	0	36.63	73.26	15	1	0.285714285714286	-Inf	1	-0.833333333333333	1	6
SDCCAG8	5	8	0	1	217.14	434.28	15	1	1	1	1	0.384615384615385	1	13
SDF4	0	2	0	1	133.32	266.64	15	1	1	NA	1	0	1	2
SDHA	1	9	0	1	181.5	363	15	1	1	1	1	0.1	1	10
SDHAF3	2	1	1	0	19.14	38.28	15	1	1	-Inf	1	-0.333333333333333	1	3
SDHAF4	1	1	0	0	32.67	65.34	15	1	1	NA	1	NA	0	2
SDK1	6	33	2	7	622.38	1244.76	15	1	0.633155420575999	-0.571428571428571	1	-0.0683760683760684	9	39
SDK2	1	6	0	3	120.78	241.56	15	1	1	1	1	0.142857142857143	3	7
SDPR	3	5	1	3	66.66	133.32	15	1	1	0.444444444444444	1	0.125	4	8
SDR16C5	1	11	0	3	101.64	203.28	15	1	1	1	1	0.0833333333333333	3	12
SDR42E1	3	5	1	2	131.01	262.02	15	1	1	0.166666666666667	1	0.0416666666666667	3	8
SDR42E2	8	6	0	0	159.06	318.12	15	1	1	NA	1	NA	0	14
SDR42E2L	2	4	1	0	145.86	291.72	15	1	0.428571428571428	-Inf	1	-0.666666666666667	1	6
SEC13	0	9	0	2	102.63	205.26	15	1	1	NA	1	0	2	9
SEC14L1	3	4	0	1	205.92	411.84	15	1	1	1	1	0.428571428571429	1	7
SEC14L5	1	8	0	2	195.69	391.38	15	1	1	1	1	0.111111111111111	2	9
SEC16A	31	33	8	6	765.6	1531.2	15	1	0.768910511239322	-0.419354838709677	1	-0.0870535714285714	14	64
SEC16B	6	7	1	1	167.31	334.62	15	1	1	-0.166666666666667	1	-0.0384615384615384	2	13
SEC22A	0	2	0	1	88.44	176.88	15	1	1	NA	1	0	1	2
SEC22B	0	7	0	2	47.19	94.38	15	1	1	NA	1	0	2	7
SEC22C	7	7	2	0	102.96	205.92	15	1	0.475	-Inf	1	-0.5	2	14
SEC23A	1	11	0	0	272.91	545.82	15	1	1	NA	1	NA	0	12
SEC23B	2	16	2	3	251.13	502.26	15	1	0.193675889328063	-4.33333333333333	1	-0.288888888888889	5	18
SEC23IP	8	12	3	1	234.3	468.6	15	1	0.300207039337474	-3.5	1	-0.35	4	20
SEC24A	3	13	1	3	325.05	650.1	15	1	1	-0.444444444444444	1	-0.0625	4	16
SEC24B	10	7	1	0	181.83	363.66	15	1	1	-Inf	1	-0.411764705882353	1	17
SEC24C	2	17	0	1	332.97	665.94	15	1	1	1	1	0.105263157894737	1	19
SEC24D	3	1	0	0	23.43	46.86	15	1	1	NA	1	NA	0	4
SEC31A	1	14	0	4	258.39	516.78	15	1	1	1	1	0.0666666666666667	4	15
SEC31B	7	15	3	1	310.2	620.4	15	1	0.264214046822742	-5.42857142857143	1	-0.431818181818182	4	22
SEC61A1-SEC61A2	3	7	1	0	163.35	326.7	15	1	0.363636363636364	-Inf	1	-0.7	1	10
SEC61A2	0	8	0	0	182.16	364.32	15	1	1	NA	1	NA	0	8
SEC61G	0	2	0	0	15.84	31.68	15	1	1	NA	1	NA	0	2
SEC62	0	2	0	1	85.47	170.94	15	1	1	NA	1	0	1	2
SEC63	3	9	0	0	232.65	465.3	15	1	1	NA	1	NA	0	12
SECISBP2	11	5	0	1	151.47	302.94	15	1	0.352941176470588	1	1	0.6875	1	16
SEH1L	0	6	0	1	117.48	234.96	15	1	1	NA	1	0	1	6
SEL1L	2	13	0	1	243.87	487.74	15	1	1	1	1	0.133333333333333	1	15
SEL1L3	13	13	0	1	401.61	803.22	15	1	1	1	1	0.5	1	26
SELE	11	9	2	3	85.8	171.6	15	1	0.64472049689441	0.454545454545455	1	0.15	5	20
SELENBP1	4	6	0	0	103.62	207.24	15	1	1	NA	1	NA	0	10
SELENBP1L3	2	8	1	0	117.15	234.3	15	1	0.272727272727273	-Inf	1	-0.8	1	10
SELENOF	2	3	0	0	46.2	92.4	15	1	1	NA	1	NA	0	5
SELENOI	7	6	3	3	103.95	207.9	15	1	1	0.142857142857143	1	0.0384615384615384	6	13
SELENON	5	7	1	0	133.98	267.96	15	1	0.461538461538462	-Inf	1	-0.583333333333333	1	12
SELENOO	5	7	1	2	131.67	263.34	15	1	1	0.3	1	0.0833333333333334	3	12
SELENOP1	4	1	0	0	65.67	131.34	15	1	1	NA	1	NA	0	5
SELENOS	2	4	0	0	43.56	87.12	15	1	1	NA	1	NA	0	6
SELENOT	0	2	0	0	47.85	95.7	15	1	1	NA	1	NA	0	2
SELENOU	0	3	0	0	71.61	143.22	15	1	1	NA	1	NA	0	3
SEMA3C	1	8	0	1	254.1	508.2	15	1	1	1	1	0.111111111111111	1	9
SEMA3D	3	7	1	0	219.45	438.9	15	1	0.363636363636364	-Inf	1	-0.7	1	10
SEMA3F	0	1	0	1	70.95	141.9	15	1	1	NA	1	0	1	1
SEMA3G	3	9	0	3	111.21	222.42	15	1	1	1	1	0.25	3	12
SEMA4B	1	8	1	5	71.94	143.88	15	1	1	-0.6	1	-0.0555555555555556	6	9
SEMA4D	7	11	3	2	203.94	407.88	15	1	0.617522066034652	-1.35714285714286	1	-0.211111111111111	5	18
SEMA5B	0	10	0	1	358.71	717.42	15	1	1	NA	1	0	1	10
SEMA6A	2	13	0	1	210.54	421.08	15	1	1	1	1	0.133333333333333	1	15
SEMA6C	1	3	0	1	24.42	48.84	15	1	1	1	1	0.25	1	4
SEMA6D	0	12	0	4	311.19	622.38	15	1	1	NA	1	0	4	12
SEMA7A	2	7	1	1	121.44	242.88	15	1	0.490909090909091	-2.5	1	-0.277777777777778	2	9
SENP1	3	7	1	3	147.51	295.02	15	1	1	0.222222222222222	1	0.05	4	10
SENP2	11	8	1	1	163.68	327.36	15	1	1	0.272727272727273	1	0.0789473684210527	2	19
SENP5	4	5	0	2	189.75	379.5	15	1	0.490909090909091	1	1	0.444444444444444	2	9
SENP6	5	9	0	2	329.34	658.68	15	1	1	1	1	0.357142857142857	2	14
SENP7	12	13	1	0	324.39	648.78	15	1	1	-Inf	1	-0.52	1	25
SENP8	1	3	0	0	43.56	87.12	15	1	1	NA	1	NA	0	4
SEPHS1	0	5	0	0	139.59	279.18	15	1	1	NA	1	NA	0	5
SEPSECS	6	7	2	2	155.43	310.86	15	1	1	-0.166666666666667	1	-0.0384615384615384	4	13
SEPT10	6	6	0	1	126.39	252.78	15	1	1	1	1	0.5	1	12
SEPT11	4	11	0	1	186.78	373.56	15	1	1	1	1	0.266666666666667	1	15
SEPT2	0	3	0	1	99.33	198.66	15	1	1	NA	1	0	1	3
SEPT2L	0	2	0	0	89.1	178.2	15	1	1	NA	1	NA	0	2
SEPT3	1	3	1	1	112.53	225.06	15	1	1	-2	1	-0.25	2	4
SEPT4	0	4	0	0	53.13	106.26	15	1	1	NA	1	NA	0	4
SEPT5	1	5	1	1	106.59	213.18	15	1	0.464285714285714	-4	1	-0.333333333333333	2	6
SEPT7	5	2	1	0	114.18	228.36	15	1	1	-Inf	1	-0.285714285714286	1	7
SEPT9	1	2	1	2	46.53	93.06	15	1	1	0	1	0	3	3
SERAC1	5	11	0	0	196.02	392.04	15	1	1	NA	1	NA	0	16
SERHL2	5	4	1	2	73.92	147.84	15	1	1	0.6	1	0.222222222222222	3	9
SERINC1	0	13	0	3	165	330	15	1	1	NA	1	0	3	13
SERINC2	2	2	1	2	53.46	106.92	15	1	1	0.5	1	0.166666666666667	3	4
SERINC3	1	10	0	0	116.49	232.98	15	1	1	NA	1	NA	0	11
SERINC4	2	4	0	1	70.95	141.9	15	1	1	1	1	0.333333333333333	1	6
SERINC5	0	6	0	2	101.31	202.62	15	1	1	NA	1	0	2	6
SERPINA10	4	3	0	0	143.55	287.1	15	1	1	NA	1	NA	0	7
SERPINA3/4L	0	3	0	0	132	264	15	1	1	NA	1	NA	0	3
SERPINC1	3	7	0	0	95.37	190.74	15	1	1	NA	1	NA	0	10
SERPIND1	4	10	1	0	189.42	378.84	15	1	0.333333333333333	-Inf	1	-0.714285714285714	1	14
SERPINE2	0	5	0	0	147.18	294.36	15	1	1	NA	1	NA	0	5
SERPINE3	7	6	0	1	119.46	238.92	15	1	1	1	1	0.538461538461538	1	13
SERPINF1	3	9	2	4	135.63	271.26	15	1	1	-0.5	1	-0.0833333333333333	6	12
SERPINF2	10	10	3	4	167.31	334.62	15	1	1	0.25	1	0.0714285714285715	7	20
SERPING1	3	3	3	0	25.41	50.82	15	1	0.464285714285714	-Inf	1	-0.5	3	6
SERPINH1	1	3	1	0	91.74	183.48	15	1	0.4	-Inf	1	-0.75	1	4
SERPINI1	1	6	0	3	130.02	260.04	15	1	1	1	1	0.142857142857143	3	7
SERTAD2	1	3	0	2	101.97	203.94	15	1	1	1	1	0.25	2	4
SERTAD4	2	3	0	0	98.34	196.68	15	1	1	NA	1	NA	0	5
SERTM2	0	1	0	1	39.27	78.54	15	1	1	NA	1	0	1	1
SESN1	0	10	0	1	158.73	317.46	15	1	1	NA	1	0	1	10
SESN2	0	1	0	1	63.69	127.38	15	1	1	NA	1	0	1	1
SESN3	0	4	0	0	115.83	231.66	15	1	1	NA	1	NA	0	4
SESTD1	2	9	0	0	232.65	465.3	15	1	1	NA	1	NA	0	11
SETBP1	9	7	2	0	314.49	628.98	15	1	0.496732026143791	-Inf	1	-0.4375	2	16
SETD1B	10	28	4	8	437.91	875.82	15	1	0.717724444761604	-0.4	1	-0.0701754385964912	12	38
SETD2	8	26	2	5	465.96	931.92	15	1	1	-0.3	1	-0.0504201680672269	7	34
SETD3	5	4	0	1	254.43	508.86	15	1	1	1	1	0.555555555555556	1	9
SETD4	9	10	4	1	157.74	315.48	15	1	0.32712215320911	-3.44444444444444	1	-0.326315789473684	5	19
SETD5	1	16	0	4	438.57	877.14	15	1	1	1	1	0.0588235294117647	4	17
SETD7	0	7	0	1	85.47	170.94	15	1	1	NA	1	0	1	7
SETD9	3	2	0	0	50.82	101.64	15	1	1	NA	1	NA	0	5
SETDB1	5	22	0	0	372.24	744.48	15	1	1	NA	1	NA	0	27
SETDB2	20	15	2	3	291.06	582.12	15	1	0.641919247182405	0.5	1	0.171428571428571	5	35
SETMAR	6	8	1	1	99.66	199.32	15	1	1	-0.333333333333333	1	-0.0714285714285715	2	14
SETX	67	35	11	6	778.14	1556.28	15	1	1	0.0422885572139303	1	0.00980392156862742	17	102
SEZ6L	0	5	0	1	95.04	190.08	15	1	1	NA	1	0	1	5
SF3A2	0	4	0	0	66.99	133.98	15	1	1	NA	1	NA	0	4
SF3A3	0	6	0	0	126.39	252.78	15	1	1	NA	1	NA	0	6
SF3B1	0	13	0	5	418.11	836.22	15	1	1	NA	1	0	5	13
SF3B4	0	2	0	0	15.18	30.36	15	1	1	NA	1	NA	0	2
SF3B6	0	5	0	2	38.94	77.88	15	1	1	NA	1	0	2	5
SFMBT1	3	22	1	3	311.85	623.7	15	1	0.467390846701192	-1.44444444444444	1	-0.13	4	25
SFMBT2	5	9	0	1	298.65	597.3	15	1	1	1	1	0.357142857142857	1	14
SFPQ	0	5	0	0	93.72	187.44	15	1	1	NA	1	NA	0	5
SFR1	3	6	1	0	53.79	107.58	15	1	0.4	-Inf	1	-0.666666666666667	1	9
SFRP1	0	12	0	2	95.04	190.08	15	1	1	NA	1	0	2	12
SFRP2	1	1	0	0	45.54	91.08	15	1	1	NA	1	NA	0	2
SFRP4	5	8	1	0	70.29	140.58	15	1	0.428571428571428	-Inf	1	-0.615384615384615	1	13
SFSWAP	2	8	1	0	252.45	504.9	15	1	0.272727272727273	-Inf	1	-0.8	1	10
SFT2D1	2	0	0	0	40.59	81.18	15	1	1	NA	1	NA	0	2
SFTPA1	2	2	1	0	64.02	128.04	15	1	1	-Inf	1	-0.5	1	4
SFTPA2	4	3	0	0	59.73	119.46	15	1	1	NA	1	NA	0	7
SFXN1	0	2	0	0	99	198	15	1	1	NA	1	NA	0	2
SFXN3	1	2	0	0	15.84	31.68	15	1	1	NA	1	NA	0	3
SFXN4	5	5	1	1	82.17	164.34	15	1	1	0	1	0	2	10
SGCA	0	1	0	1	12.21	24.42	15	1	1	NA	1	0	1	1
SGCB	0	5	0	1	103.95	207.9	15	1	1	NA	1	0	1	5
SGCD	5	4	1	0	97.02	194.04	15	1	1	-Inf	1	-0.444444444444444	1	9
SGCE	4	9	1	2	143.88	287.76	15	1	1	-0.125	1	-0.0256410256410256	3	13
SGCG	2	6	0	0	95.37	190.74	15	1	1	NA	1	NA	0	8
SGCZ	1	3	0	0	49.5	99	15	1	1	NA	1	NA	0	4
SGK1	0	7	0	1	136.62	273.24	15	1	1	NA	1	0	1	7
SGK2	2	9	1	3	122.43	244.86	15	1	1	-0.5	1	-0.0681818181818182	4	11
SGK3	1	4	1	1	155.76	311.52	15	1	1	-3	1	-0.3	2	5
SGMS1	5	7	0	1	193.71	387.42	15	1	1	1	1	0.416666666666667	1	12
SGMS2	0	4	0	0	93.06	186.12	15	1	1	NA	1	NA	0	4
SGO1	14	5	2	3	190.74	381.48	15	1	0.288537549407114	0.761904761904762	1	0.336842105263158	5	19
SGO2	18	7	4	2	275.22	550.44	15	1	1	0.222222222222222	1	0.0533333333333333	6	25
SGPL1	3	10	1	2	160.71	321.42	15	1	1	-0.666666666666667	1	-0.102564102564103	3	13
SGPP2	3	5	3	1	89.43	178.86	15	1	0.545454545454546	-4	1	-0.375	4	8
SGSH	4	3	2	2	61.71	123.42	15	1	1	0.25	1	0.0714285714285714	4	7
SGSM1	8	24	5	9	356.73	713.46	15	1	0.49335547008324	-0.666666666666667	1	-0.107142857142857	14	32
SGSM2	1	15	1	3	352.77	705.54	15	1	0.368421052631579	-4	1	-0.1875	4	16
SGSM3	1	14	1	5	215.49	430.98	15	1	0.5	-1.8	1	-0.1	6	15
SGTA	0	2	0	0	66.33	132.66	15	1	1	NA	1	NA	0	2
SGTB	0	2	0	0	83.82	167.64	15	1	1	NA	1	NA	0	2
SH2B2	1	10	1	6	85.8	171.6	15	1	1	-0.666666666666667	1	-0.0519480519480519	7	11
SH2B3	1	2	0	1	46.86	93.72	15	1	1	1	1	0.333333333333333	1	3
SH2D1A	2	1	0	0	22.11	44.22	15	1	1	NA	1	NA	0	3
SH2D1B	1	5	0	0	38.94	77.88	15	1	1	NA	1	NA	0	6
SH2D2A	0	1	0	1	3.3	6.6	15	1	1	NA	1	0	1	1
SH2D4A	2	11	0	0	176.22	352.44	15	1	1	NA	1	NA	0	13
SH2D4B	3	3	1	0	133.98	267.96	15	1	1	-Inf	1	-0.5	1	6
SH2D5	1	4	1	0	29.37	58.74	15	1	0.333333333333333	-Inf	1	-0.8	1	5
SH3BGRL2	0	1	0	1	29.7	59.4	15	1	1	NA	1	0	1	1
SH3BP1	3	4	1	2	104.61	209.22	15	1	1	0.333333333333333	1	0.0952380952380952	3	7
SH3BP2	1	6	0	1	170.61	341.22	15	1	1	1	1	0.142857142857143	1	7
SH3BP4	4	15	0	2	267.3	534.6	15	1	1	1	1	0.210526315789474	2	19
SH3BP5	0	5	0	1	112.2	224.4	15	1	1	NA	1	0	1	5
SH3D19	9	5	3	1	300.96	601.92	15	1	1	-0.666666666666667	1	-0.107142857142857	4	14
SH3GL1	0	6	0	1	96.69	193.38	15	1	1	NA	1	0	1	6
SH3GL2	0	2	0	1	97.35	194.7	15	1	1	NA	1	0	1	2
SH3GL3	1	3	0	0	103.29	206.58	15	1	1	NA	1	NA	0	4
SH3GLB1	0	5	0	0	114.51	229.02	15	1	1	NA	1	NA	0	5
SH3KBP1	0	5	0	0	217.47	434.94	15	1	1	NA	1	NA	0	5
SH3PXD2A	3	18	1	3	331.65	663.3	15	1	0.526877470355731	-1	1	-0.107142857142857	4	21
SH3PXD2B	1	12	1	1	191.4	382.8	15	1	0.257142857142857	-11	1	-0.423076923076923	2	13
SH3RF1	5	8	1	1	269.61	539.22	15	1	1	-0.6	1	-0.115384615384615	2	13
SH3RF2	2	5	0	3	117.15	234.3	15	1	1	1	1	0.285714285714286	3	7
SH3RF3	6	16	3	4	223.41	446.82	15	1	0.642394187521624	-1	1	-0.155844155844156	7	22
SH3TC1	14	17	0	1	481.14	962.28	15	1	1	1	1	0.451612903225806	1	31
SH3TC2	13	21	5	3	309.21	618.42	15	1	0.25619016864203	-1.69230769230769	1	-0.242647058823529	8	34
SHANK2	4	14	1	1	378.18	756.36	15	1	0.447368421052632	-2.5	1	-0.277777777777778	2	18
SHB	7	3	2	0	117.48	234.96	15	1	1	-Inf	1	-0.3	2	10
SHC1	0	3	0	0	44.22	88.44	15	1	1	NA	1	NA	0	3
SHC2	1	3	0	0	26.07	52.14	15	1	1	NA	1	NA	0	4
SHC4	12	18	1	1	229.02	458.04	15	1	1	-0.5	1	-0.1	2	30
SHCBP1	8	11	3	2	208.56	417.12	15	1	0.629917184265011	-1.0625	1	-0.178947368421053	5	19
SHF	1	3	0	1	46.53	93.06	15	1	1	1	1	0.25	1	4
SHISA2	0	2	0	1	33	66	15	1	1	NA	1	0	1	2
SHISA3	3	4	1	3	64.35	128.7	15	1	1	0.555555555555556	1	0.178571428571429	4	7
SHISA5	1	1	0	0	28.71	57.42	15	1	1	NA	1	NA	0	2
SHISA6	2	4	0	0	94.05	188.1	15	1	1	NA	1	NA	0	6
SHISA8	0	4	0	2	35.31	70.62	15	1	1	NA	1	0	2	4
SHISA9	0	2	0	0	48.51	97.02	15	1	1	NA	1	NA	0	2
SHMT1	2	6	2	3	78.54	157.08	15	1	1	-1	1	-0.15	5	8
SHOC2	0	4	0	1	167.64	335.28	15	1	1	NA	1	0	1	4
SHPK	4	8	0	2	172.59	345.18	15	1	1	1	1	0.333333333333333	2	12
SHPRH	9	23	1	4	481.47	962.94	15	1	1	0.361111111111111	1	0.08125	5	32
SHQ1	10	8	5	1	174.57	349.14	15	1	0.350946536301227	-3	1	-0.277777777777778	6	18
SHROOM1	37	40	15	10	390.06	780.12	15	1	0.360436301017633	-0.621621621621622	1	-0.119480519480519	25	77
SHROOM2	12	18	3	3	594	1188	15	1	0.677365447645334	-0.5	1	-0.1	6	30
SHROOM3	25	34	3	8	468.93	937.86	15	1	0.506462722438235	0.49	1	0.151001540832049	11	59
SHTN1	5	5	1	0	211.2	422.4	15	1	1	-Inf	1	-0.5	1	10
SI	18	10	0	1	297	594	15	1	0.379310344827586	1	1	0.642857142857143	1	28
SIAH3	2	4	1	1	35.97	71.94	15	1	1	-1	1	-0.166666666666667	2	6
SIDT1	2	11	1	3	226.05	452.1	15	1	1	-0.833333333333333	1	-0.0961538461538461	4	13
SIDT2	2	2	0	2	75.24	150.48	15	1	0.466666666666667	1	1	0.5	2	4
SIGIRR	0	5	0	1	88.11	176.22	15	1	1	NA	1	0	1	5
SIGLEC1	12	7	6	4	126.72	253.44	15	1	1	0.125	1	0.031578947368421	10	19
SIGLEC15	1	1	0	0	86.13	172.26	15	1	1	NA	1	NA	0	2
SIGMAR1	0	1	0	1	26.4	52.8	15	1	1	NA	1	0	1	1
SIIL	6	24	0	6	305.91	611.82	15	1	0.561022942901501	1	1	0.2	6	30
SIK1	2	15	1	2	234.63	469.26	15	1	0.403508771929824	-2.75	1	-0.215686274509804	3	17
SIK2	2	12	2	3	236.28	472.56	15	1	0.27218782249742	-3	1	-0.257142857142857	5	14
SIK3	3	11	1	4	324.06	648.12	15	1	1	0.0833333333333334	1	0.0142857142857143	5	14
SIL1	2	3	1	0	107.58	215.16	15	1	1	-Inf	1	-0.6	1	5
SIM1	3	9	1	1	195.03	390.06	15	1	0.505494505494505	-2	1	-0.25	2	12
SIM2	2	10	0	2	249.81	499.62	15	1	1	1	1	0.166666666666667	2	12
SIMC1	8	12	3	2	188.43	376.86	15	1	0.623188405797101	-1.25	1	-0.2	5	20
SIN3A	2	10	1	2	286.44	572.88	15	1	0.516483516483516	-1.5	1	-0.166666666666667	3	12
SINHCAF	3	1	0	0	92.07	184.14	15	1	1	NA	1	NA	0	4
SIPA1L1	3	28	2	8	629.31	1258.62	15	1	0.580129650732988	-1.33333333333333	1	-0.103225806451613	10	31
SIPA1L2	1	24	0	2	535.59	1071.18	15	1	1	1	1	0.04	2	25
SIRPA-TPPNR1L	13	5	6	2	80.85	161.7	15	1	1	-0.153846153846154	1	-0.0277777777777778	8	18
SIRT1	4	11	2	2	227.7	455.4	15	1	0.557275541795666	-1.75	1	-0.233333333333333	4	15
SIRT3	0	4	0	0	99	198	15	1	1	NA	1	NA	0	4
SIRT4	1	5	0	0	93.39	186.78	15	1	1	NA	1	NA	0	6
SIRT5	2	2	1	0	96.03	192.06	15	1	1	-Inf	1	-0.5	1	4
SIRT6	2	2	0	1	42.57	85.14	15	1	1	1	1	0.5	1	4
SIRT7	0	7	0	0	65.67	131.34	15	1	1	NA	1	NA	0	7
SIVA1	2	2	0	1	26.4	52.8	15	1	1	1	1	0.5	1	4
SIX2	0	3	0	1	32.01	64.02	15	1	1	NA	1	0	1	3
SKA2	3	1	2	0	57.09	114.18	15	1	1	-Inf	1	-0.25	2	4
SKA3	8	6	0	1	90.75	181.5	15	1	0.466666666666667	1	1	0.571428571428571	1	14
SKAP1	1	2	0	0	67.32	134.64	15	1	1	NA	1	NA	0	3
SKAP2	1	1	0	0	103.95	207.9	15	1	1	NA	1	NA	0	2
SKI	3	0	2	0	61.71	123.42	15	1	1	NA	1	0	2	3
SKIL	3	15	1	6	249.48	498.96	15	1	1	0.166666666666667	1	0.0238095238095238	7	18
SKIV2L2	1	12	0	1	232.32	464.64	15	1	1	1	1	0.0769230769230769	1	13
SKOR2	4	2	0	0	36.63	73.26	15	1	1	NA	1	NA	0	6
SKP1	0	5	0	0	62.7	125.4	15	1	1	NA	1	NA	0	5
SKP2	2	2	1	0	99.99	199.98	15	1	1	-Inf	1	-0.5	1	4
SLA	0	3	0	2	94.38	188.76	15	1	1	NA	1	0	2	3
SLAIN1	2	4	0	0	164.67	329.34	15	1	1	NA	1	NA	0	6
SLAIN2	1	4	1	0	125.07	250.14	15	1	0.333333333333333	-Inf	1	-0.8	1	5
SLAINL	6	9	2	2	210.87	421.74	15	1	1	-0.5	1	-0.1	4	15
SLBP	0	3	0	0	81.84	163.68	15	1	1	NA	1	NA	0	3
SLC10A1	8	5	2	1	113.85	227.7	15	1	1	-0.25	1	-0.0512820512820512	3	13
SLC10A2	2	5	0	0	139.26	278.52	15	1	1	NA	1	NA	0	7
SLC10A4	1	4	0	2	63.03	126.06	15	1	1	1	1	0.2	2	5
SLC10A7	3	5	1	1	125.07	250.14	15	1	1	-0.666666666666667	1	-0.125	2	8
SLC11A1-SLC11A2	1	2	0	1	65.01	130.02	15	1	1	1	1	0.333333333333333	1	3
SLC12A1	5	12	0	0	354.09	708.18	15	1	1	NA	1	NA	0	17
SLC12A3	5	10	3	3	162.69	325.38	15	1	0.631062951496388	-1	1	-0.166666666666667	6	15
SLC12A4	0	6	0	2	289.74	579.48	15	1	1	NA	1	0	2	6
SLC12A5	0	20	0	4	278.85	557.7	15	1	1	NA	1	0	4	20
SLC12A7	1	8	0	0	277.86	555.72	15	1	1	NA	1	NA	0	9
SLC12A8	7	11	3	0	218.79	437.58	15	1	0.0902255639097746	-Inf	1	-0.611111111111111	3	18
SLC12A9	3	22	2	12	170.94	341.88	15	1	1	-0.222222222222222	1	-0.0228571428571429	14	25
SLC13A1	2	6	0	1	185.46	370.92	15	1	1	1	1	0.25	1	8
SLC13A2	1	12	0	2	196.35	392.7	15	1	1	1	1	0.0769230769230769	2	13
SLC13A3	0	9	0	2	151.8	303.6	15	1	1	NA	1	0	2	9
SLC13A4	8	9	1	2	172.59	345.18	15	1	1	0.4375	1	0.137254901960784	3	17
SLC14A2Z	3	4	1	2	115.5	231	15	1	1	0.333333333333333	1	0.0952380952380952	3	7
SLC15A1	8	11	0	3	196.35	392.7	15	1	0.272727272727273	1	1	0.421052631578947	3	19
SLC15A2	8	8	3	0	241.23	482.46	15	1	0.228070175438596	-Inf	1	-0.5	3	16
SLC15A4	2	7	1	0	150.81	301.62	15	1	0.3	-Inf	1	-0.777777777777778	1	9
SLC15A5	5	6	0	1	211.53	423.06	15	1	1	1	1	0.454545454545455	1	11
SLC16A1	2	13	0	0	128.37	256.74	15	1	1	NA	1	NA	0	15
SLC16A12	3	4	0	0	153.45	306.9	15	1	1	NA	1	NA	0	7
SLC16A14	2	5	1	0	131.67	263.34	15	1	0.375	-Inf	1	-0.714285714285714	1	7
SLC16A3	2	2	1	0	157.08	314.16	15	1	1	-Inf	1	-0.5	1	4
SLC16A4	6	4	2	1	127.05	254.1	15	1	1	-0.333333333333333	1	-0.0666666666666667	3	10
SLC16A5	2	12	0	1	176.22	352.44	15	1	1	1	1	0.142857142857143	1	14
SLC16A6	3	5	0	0	176.22	352.44	15	1	1	NA	1	NA	0	8
SLC16A7	0	3	0	1	205.26	410.52	15	1	1	NA	1	0	1	3
SLC16A8	4	12	2	5	156.75	313.5	15	1	1	-0.2	1	-0.0357142857142857	7	16
SLC16A9	4	4	0	0	193.71	387.42	15	1	1	NA	1	NA	0	8
SLC17A5	2	5	2	0	148.5	297	15	1	0.166666666666667	-Inf	1	-0.714285714285714	2	7
SLC17A6	0	5	0	0	151.47	302.94	15	1	1	NA	1	NA	0	5
SLC17A8	1	6	0	0	224.73	449.46	15	1	1	NA	1	NA	0	7
SLC17A9	2	5	1	1	103.95	207.9	15	1	1	-1.5	1	-0.214285714285714	2	7
SLC18A1	2	6	0	1	91.08	182.16	15	1	1	1	1	0.25	1	8
SLC18A2	0	5	0	1	145.53	291.06	15	1	1	NA	1	0	1	5
SLC18A3	0	8	0	1	62.7	125.4	15	1	1	NA	1	0	1	8
SLC18B1	1	2	0	0	121.11	242.22	15	1	1	NA	1	NA	0	3
SLC19A1	1	5	0	2	44.55	89.1	15	1	1	1	1	0.166666666666667	2	6
SLC19A2	4	8	2	0	141.24	282.48	15	1	0.164835164835165	-Inf	1	-0.666666666666667	2	12
SLC19A3	3	9	1	1	121.44	242.88	15	1	0.505494505494505	-2	1	-0.25	2	12
SLC1A1	1	2	0	0	138.27	276.54	15	1	1	NA	1	NA	0	3
SLC1A2	0	8	0	2	191.73	383.46	15	1	1	NA	1	0	2	8
SLC1A3	1	2	0	0	128.7	257.4	15	1	1	NA	1	NA	0	3
SLC1A4	2	7	0	0	125.73	251.46	15	1	1	NA	1	NA	0	9
SLC1A6	0	3	0	1	186.78	373.56	15	1	1	NA	1	0	1	3
SLC1A7	1	10	0	1	201.96	403.92	15	1	1	1	1	0.0909090909090909	1	11
SLC20A2	2	9	0	2	235.29	470.58	15	1	1	1	1	0.181818181818182	2	11
SLC22A15	1	9	1	2	189.75	379.5	15	1	0.423076923076923	-3.5	1	-0.233333333333333	3	10
SLC22A15L	3	6	1	0	117.48	234.96	15	1	0.4	-Inf	1	-0.666666666666667	1	9
SLC22A16	6	9	0	2	180.84	361.68	15	1	0.514705882352941	1	1	0.4	2	15
SLC22A18	3	5	0	3	128.37	256.74	15	1	0.490909090909091	1	1	0.375	3	8
SLC22A2	4	5	1	0	166.98	333.96	15	1	1	-Inf	1	-0.555555555555556	1	9
SLC22A23	2	12	1	4	147.18	294.36	15	1	1	-0.5	1	-0.0571428571428572	5	14
SLC22A3	4	8	2	0	172.26	344.52	15	1	0.164835164835165	-Inf	1	-0.666666666666667	2	12
SLC22A4	1	6	0	3	107.91	215.82	15	1	1	1	1	0.142857142857143	3	7
SLC22A5	8	11	5	0	165	330	15	1	0.0411490683229814	-Inf	1	-0.578947368421053	5	19
SLC22A7	8	11	2	1	177.54	355.08	15	1	0.571428571428572	-1.75	1	-0.245614035087719	3	19
SLC23A1	1	6	0	4	54.12	108.24	15	1	1	1	1	0.142857142857143	4	7
SLC23A2	0	3	0	0	157.74	315.48	15	1	1	NA	1	NA	0	3
SLC23A3	1	3	0	2	37.29	74.58	15	1	1	1	1	0.25	2	4
SLC24A1	6	4	2	2	260.04	520.08	15	1	1	0.333333333333333	1	0.1	4	10
SLC24A3	2	5	0	0	190.41	380.82	15	1	1	NA	1	NA	0	7
SLC24A5	5	6	2	0	133.65	267.3	15	1	0.461538461538462	-Inf	1	-0.545454545454545	2	11
SLC25A1	0	7	0	1	36.63	73.26	15	1	1	NA	1	0	1	7
SLC25A10	0	7	0	1	63.69	127.38	15	1	1	NA	1	0	1	7
SLC25A13	5	10	1	2	260.37	520.74	15	1	1	0	1	0	3	15
SLC25A14	0	4	0	0	55.11	110.22	15	1	1	NA	1	NA	0	4
SLC25A15	2	9	1	4	99.33	198.66	15	1	1	-0.125	1	-0.0181818181818182	5	11
SLC25A16	1	3	1	0	100.65	201.3	15	1	0.4	-Inf	1	-0.75	1	4
SLC25A17	1	4	0	3	105.93	211.86	15	1	1	1	1	0.2	3	5
SLC25A19	1	3	0	0	97.02	194.04	15	1	1	NA	1	NA	0	4
SLC25A20	1	5	1	0	94.38	188.76	15	1	0.285714285714286	-Inf	1	-0.833333333333333	1	6
SLC25A21	2	2	0	0	82.83	165.66	15	1	1	NA	1	NA	0	4
SLC25A24	1	7	0	2	121.44	242.88	15	1	1	1	1	0.125	2	8
SLC25A26	2	4	1	1	61.71	123.42	15	1	1	-1	1	-0.166666666666667	2	6
SLC25A29	1	4	0	0	99.66	199.32	15	1	1	NA	1	NA	0	5
SLC25A3	0	5	0	1	127.71	255.42	15	1	1	NA	1	0	1	5
SLC25A30	2	8	0	0	87.12	174.24	15	1	1	NA	1	NA	0	10
SLC25A32	2	4	2	1	81.51	163.02	15	1	0.523809523809524	-3	1	-0.333333333333333	3	6
SLC25A33	0	5	0	1	96.03	192.06	15	1	1	NA	1	0	1	5
SLC25A34	1	0	1	0	8.25	16.5	15	1	1	NA	1	0	1	1
SLC25A36	0	4	0	0	87.78	175.56	15	1	1	NA	1	NA	0	4
SLC25A37	0	4	0	1	50.82	101.64	15	1	1	NA	1	0	1	4
SLC25A38	2	3	0	0	66.99	133.98	15	1	1	NA	1	NA	0	5
SLC25A40	5	4	0	0	91.41	182.82	15	1	1	NA	1	NA	0	9
SLC25A42	0	6	0	2	122.43	244.86	15	1	1	NA	1	0	2	6
SLC25A46	1	1	1	0	44.88	89.76	15	1	1	-Inf	1	-0.5	1	2
SLC25A47	0	8	0	0	108.57	217.14	15	1	1	NA	1	NA	0	8
SLC25A48	1	9	0	3	87.78	175.56	15	1	1	1	1	0.1	3	10
SLC25A6	0	6	0	1	104.28	208.56	15	1	1	NA	1	0	1	6
SLC26A1	3	10	0	1	178.53	357.06	15	1	1	1	1	0.230769230769231	1	13
SLC26A3	12	11	1	1	262.68	525.36	15	1	1	0.0833333333333334	1	0.0217391304347826	2	23
SLC26A4	6	9	2	0	265.98	531.96	15	1	0.205882352941176	-Inf	1	-0.6	2	15
SLC26A5	10	9	3	0	229.68	459.36	15	1	0.24025974025974	-Inf	1	-0.473684210526316	3	19
SLC26A8	12	27	3	3	259.38	518.76	15	1	0.384275253957614	-1.25	1	-0.192307692307692	6	39
SLC26A9	5	12	1	2	226.05	452.1	15	1	1	-0.2	1	-0.0392156862745098	3	17
SLC27A6	4	2	0	0	148.5	297	15	1	1	NA	1	NA	0	6
SLC28A2	7	7	0	1	162.69	325.38	15	1	1	1	1	0.5	1	14
SLC28A3	5	3	0	0	171.6	343.2	15	1	1	NA	1	NA	0	8
SLC29A1	1	4	0	1	115.5	231	15	1	1	1	1	0.2	1	5
SLC29A3	1	1	1	1	54.12	108.24	15	1	1	0	1	0	2	2
SLC29A4	1	7	0	3	59.07	118.14	15	1	1	1	1	0.125	3	8
SLC2A1	2	7	0	1	132.33	264.66	15	1	1	1	1	0.222222222222222	1	9
SLC2A10	7	6	2	2	155.76	311.52	15	1	1	0.142857142857143	1	0.0384615384615384	4	13
SLC2A11	3	10	1	2	136.62	273.24	15	1	1	-0.666666666666667	1	-0.102564102564103	3	13
SLC2A11L1	3	11	0	1	150.48	300.96	15	1	1	1	1	0.214285714285714	1	14
SLC2A11L2	5	3	0	1	131.67	263.34	15	1	0.444444444444444	1	1	0.625	1	8
SLC2A11L3	1	6	0	1	175.56	351.12	15	1	1	1	1	0.142857142857143	1	7
SLC2A11L4	1	6	0	1	143.55	287.1	15	1	1	1	1	0.142857142857143	1	7
SLC2A12	2	8	0	1	189.75	379.5	15	1	1	1	1	0.2	1	10
SLC2A13	2	4	0	1	129.36	258.72	15	1	1	1	1	0.333333333333333	1	6
SLC2A14	2	10	0	1	142.23	284.46	15	1	1	1	1	0.166666666666667	1	12
SLC2A2	4	7	0	0	97.35	194.7	15	1	1	NA	1	NA	0	11
SLC2A5	1	12	0	2	160.38	320.76	15	1	1	1	1	0.0769230769230769	2	13
SLC2A6	0	7	0	3	108.24	216.48	15	1	1	NA	1	0	3	7
SLC2A8	5	6	0	0	162.03	324.06	15	1	1	NA	1	NA	0	11
SLC2A9	4	11	0	0	182.49	364.98	15	1	1	NA	1	NA	0	15
SLC2A9L	7	9	2	3	73.59	147.18	15	1	1	0.142857142857143	1	0.0375	5	16
SLC30A10	2	2	0	1	74.91	149.82	15	1	1	1	1	0.5	1	4
SLC30A5	2	4	0	2	90.75	181.5	15	1	1	1	1	0.333333333333333	2	6
SLC30A7	1	11	1	2	108.9	217.8	15	1	0.371428571428571	-4.5	1	-0.25	3	12
SLC30A8	3	3	0	2	64.35	128.7	15	1	0.464285714285714	1	1	0.5	2	6
SLC30A9	4	6	2	2	162.69	325.38	15	1	1	-0.5	1	-0.1	4	10
SLC31A1	2	1	1	0	68.97	137.94	15	1	1	-Inf	1	-0.333333333333333	1	3
SLC31A2	5	0	2	0	16.83	33.66	15	1	1	NA	1	0	2	5
SLC32A1	1	9	0	5	111.54	223.08	15	1	1	1	1	0.1	5	10
SLC33A1	2	8	0	2	117.15	234.3	15	1	1	1	1	0.2	2	10
SLC34A1	3	9	1	5	72.6	145.2	15	1	1	0.4	1	0.0833333333333333	6	12
SLC34A2	2	5	0	1	213.18	426.36	15	1	1	1	1	0.285714285714286	1	7
SLC35A1	3	7	0	1	109.89	219.78	15	1	1	1	1	0.3	1	10
SLC35A3	2	1	2	0	105.93	211.86	15	1	1	-Inf	1	-0.333333333333333	2	3
SLC35A4	3	2	1	0	83.82	167.64	15	1	1	-Inf	1	-0.4	1	5
SLC35A5	3	5	0	1	116.82	233.64	15	1	1	1	1	0.375	1	8
SLC35B1	0	2	0	1	66.33	132.66	15	1	1	NA	1	0	1	2
SLC35B2	2	7	1	2	84.15	168.3	15	1	1	-0.75	1	-0.111111111111111	3	9
SLC35B3	2	3	1	0	107.91	215.82	15	1	1	-Inf	1	-0.6	1	5
SLC35C1	3	4	0	1	62.37	124.74	15	1	1	1	1	0.428571428571429	1	7
SLC35D1	1	3	0	1	39.27	78.54	15	1	1	1	1	0.25	1	4
SLC35D3	4	0	3	0	83.16	166.32	15	1	1	NA	1	0	3	4
SLC35E1	0	3	0	0	81.18	162.36	15	1	1	NA	1	NA	0	3
SLC35E3	0	3	0	1	33.33	66.66	15	1	1	NA	1	0	1	3
SLC35F2	1	8	0	1	115.17	230.34	15	1	1	1	1	0.111111111111111	1	9
SLC35F3	1	3	0	1	76.23	152.46	15	1	1	1	1	0.25	1	4
SLC35F4	1	6	0	0	126.72	253.44	15	1	1	NA	1	NA	0	7
SLC35F5	0	7	0	1	156.09	312.18	15	1	1	NA	1	0	1	7
SLC35G1	1	4	0	0	98.67	197.34	15	1	1	NA	1	NA	0	5
SLC35G2	2	7	0	3	114.51	229.02	15	1	1	1	1	0.222222222222222	3	9
SLC36A1	2	4	2	4	97.68	195.36	15	1	1	0	1	0	6	6
SLC36A4	3	4	1	1	170.28	340.56	15	1	1	-0.333333333333333	1	-0.0714285714285715	2	7
SLC37A1	1	11	0	0	159.06	318.12	15	1	1	NA	1	NA	0	12
SLC37A2	2	13	0	0	113.85	227.7	15	1	1	NA	1	NA	0	15
SLC37A3	0	6	0	2	124.74	249.48	15	1	1	NA	1	0	2	6
SLC37A4	1	6	0	1	112.53	225.06	15	1	1	1	1	0.142857142857143	1	7
SLC38A1	0	4	0	0	158.07	316.14	15	1	1	NA	1	NA	0	4
SLC38A10	11	15	2	6	260.7	521.4	15	1	0.443766494361927	0.545454545454545	1	0.173076923076923	8	26
SLC38A11	5	4	2	0	143.55	287.1	15	1	0.490909090909091	-Inf	1	-0.444444444444444	2	9
SLC38A2	3	9	1	0	155.43	310.86	15	1	0.307692307692308	-Inf	1	-0.75	1	12
SLC38A4	1	6	0	0	156.42	312.84	15	1	1	NA	1	NA	0	7
SLC38A6	0	6	0	0	104.28	208.56	15	1	1	NA	1	NA	0	6
SLC38A8	1	9	1	6	53.46	106.92	15	1	1	-0.5	1	-0.0428571428571428	7	10
SLC38A9	3	3	1	1	102.96	205.92	15	1	1	0	1	0	2	6
SLC39A10	5	14	0	2	272.25	544.5	15	1	1	1	1	0.263157894736842	2	19
SLC39A11	1	8	1	2	66.33	132.66	15	1	0.454545454545454	-3	1	-0.222222222222222	3	9
SLC39A12	4	8	0	1	152.46	304.92	15	1	1	1	1	0.333333333333333	1	12
SLC39A13	2	6	1	0	148.5	297	15	1	0.333333333333333	-Inf	1	-0.75	1	8
SLC39A14	2	0	0	0	31.02	62.04	15	1	1	NA	1	NA	0	2
SLC39A3	1	2	1	1	48.84	97.68	15	1	1	-1	1	-0.166666666666667	2	3
SLC39A6	5	13	1	2	290.07	580.14	15	1	1	-0.3	1	-0.0555555555555555	3	18
SLC39A8	3	6	1	0	115.17	230.34	15	1	0.4	-Inf	1	-0.666666666666667	1	9
SLC39A9	0	1	0	1	87.45	174.9	15	1	1	NA	1	0	1	1
SLC40A1	2	9	1	1	212.85	425.7	15	1	0.423076923076923	-3.5	1	-0.318181818181818	2	11
SLC41A2	2	5	0	2	174.24	348.48	15	1	1	1	1	0.285714285714286	2	7
SLC41A3	1	3	0	0	127.38	254.76	15	1	1	NA	1	NA	0	4
SLC43A2	3	11	1	4	192.72	385.44	15	1	1	0.0833333333333334	1	0.0142857142857143	5	14
SLC44A3	8	6	3	2	185.46	370.92	15	1	1	-0.125	1	-0.0285714285714286	5	14
SLC44A5	3	5	0	1	267.63	535.26	15	1	1	1	1	0.375	1	8
SLC45A1	2	5	0	0	177.87	355.74	15	1	1	NA	1	NA	0	7
SLC45A2	2	5	0	0	105.27	210.54	15	1	1	NA	1	NA	0	7
SLC45A3	3	7	1	3	106.59	213.18	15	1	1	0.222222222222222	1	0.05	4	10
SLC45A4	0	16	0	3	256.74	513.48	15	1	1	NA	1	0	3	16
SLC46A1	4	9	0	3	90.75	181.5	15	1	0.528571428571428	1	1	0.307692307692308	3	13
SLC46A2	5	10	0	1	84.15	168.3	15	1	1	1	1	0.333333333333333	1	15
SLC46A3	3	6	0	1	110.55	221.1	15	1	1	1	1	0.333333333333333	1	9
SLC47A1	6	14	2	2	145.86	291.72	15	1	0.578392621870883	-1.33333333333333	1	-0.2	4	20
SLC47A2	4	7	2	2	114.51	229.02	15	1	1	-0.75	1	-0.136363636363636	4	11
SLC48A1	0	1	0	1	14.52	29.04	15	1	1	NA	1	0	1	1
SLC4A1	2	3	1	3	25.74	51.48	15	1	1	0.5	1	0.15	4	5
SLC4A10	2	6	1	2	328.02	656.04	15	1	1	-0.5	1	-0.0833333333333333	3	8
SLC4A11	1	10	1	3	179.19	358.38	15	1	0.476190476190476	-2.33333333333333	1	-0.159090909090909	4	11
SLC4A1AP	1	12	0	1	165.99	331.98	15	1	1	1	1	0.0769230769230769	1	13
SLC4A2	1	4	1	3	111.87	223.74	15	1	1	-0.333333333333333	1	-0.05	4	5
SLC4A3	0	22	0	4	330.33	660.66	15	1	1	NA	1	0	4	22
SLC4A4	1	11	0	2	350.46	700.92	15	1	1	1	1	0.0833333333333333	2	12
SLC4A5	8	19	0	1	381.15	762.3	15	1	1	1	1	0.296296296296296	1	27
SLC4A7	0	7	1	1	289.74	579.48	15	1	0.222222222222222	-Inf	1	-0.5	2	7
SLC4A8	9	16	2	6	347.16	694.32	15	1	0.687045435098828	0.407407407407407	1	0.11	8	25
SLC4A9	10	11	2	4	273.24	546.48	15	1	0.661835748792271	0.45	1	0.142857142857143	6	21
SLC51A	1	3	1	1	45.87	91.74	15	1	1	-2	1	-0.25	2	4
SLC51AL	1	5	0	0	100.32	200.64	15	1	1	NA	1	NA	0	6
SLC51B	7	2	1	1	74.91	149.82	15	1	0.490909090909091	0.714285714285714	1	0.277777777777778	2	9
SLC52A3	4	1	1	0	46.86	93.72	15	1	1	-Inf	1	-0.2	1	5
SLC5A10	3	3	1	3	44.55	89.1	15	1	0.571428571428572	0.666666666666667	1	0.25	4	6
SLC5A11	13	16	2	5	296.67	593.34	15	1	0.673780619285838	0.507692307692308	1	0.16256157635468	7	29
SLC5A3	0	8	0	2	240.9	481.8	15	1	1	NA	1	0	2	8
SLC5A7	0	4	0	1	162.69	325.38	15	1	1	NA	1	0	1	4
SLC5A8	0	10	0	3	184.8	369.6	15	1	1	NA	1	0	3	10
SLC5A9	3	13	2	2	217.47	434.94	15	1	0.248710010319917	-3.33333333333333	1	-0.3125	4	16
SLC6A1	0	5	0	1	173.91	347.82	15	1	1	NA	1	0	1	5
SLC6A11	0	8	0	0	195.36	390.72	15	1	1	NA	1	NA	0	8
SLC6A12	2	8	1	1	153.12	306.24	15	1	0.454545454545455	-3	1	-0.3	2	10
SLC6A13	3	9	1	2	153.45	306.9	15	1	1	-0.5	1	-0.0833333333333333	3	12
SLC6A14	1	6	0	1	181.5	363	15	1	1	1	1	0.142857142857143	1	7
SLC6A15	0	5	0	0	236.94	473.88	15	1	1	NA	1	NA	0	5
SLC6A17	0	8	0	1	172.59	345.18	15	1	1	NA	1	0	1	8
SLC6A19	6	14	2	1	302.28	604.56	15	1	0.268774703557312	-3.66666666666667	1	-0.366666666666667	3	20
SLC6A2	0	6	0	2	205.26	410.52	15	1	1	NA	1	0	2	6
SLC6A20	3	16	1	5	169.62	339.24	15	1	1	-0.0666666666666667	1	-0.0087719298245614	6	19
SLC6A4	3	11	1	3	228.03	456.06	15	1	1	-0.222222222222222	1	-0.0357142857142857	4	14
SLC6A5	3	9	0	0	204.27	408.54	15	1	1	NA	1	NA	0	12
SLC6A6	1	4	0	2	183.15	366.3	15	1	1	1	1	0.2	2	5
SLC6A7	0	5	0	3	155.76	311.52	15	1	1	NA	1	0	3	5
SLC6A9	2	2	1	0	44.55	89.1	15	1	1	-Inf	1	-0.5	1	4
SLC7A1	0	15	0	6	211.86	423.72	15	1	1	NA	1	0	6	15
SLC7A10	0	3	0	1	149.49	298.98	15	1	1	NA	1	0	1	3
SLC7A11	1	9	0	4	232.32	464.64	15	1	1	1	1	0.1	4	10
SLC7A13	4	13	1	0	176.22	352.44	15	1	0.277777777777778	-Inf	1	-0.764705882352941	1	17
SLC7A14	2	27	0	8	267.63	535.26	15	1	1	1	1	0.0689655172413793	8	29
SLC7A2	4	8	1	0	170.28	340.56	15	1	0.384615384615385	-Inf	1	-0.666666666666667	1	12
SLC7A3	0	8	0	3	136.95	273.9	15	1	1	NA	1	0	3	8
SLC7A5	2	4	0	1	135.3	270.6	15	1	1	1	1	0.333333333333333	1	6
SLC7A6	0	3	0	0	161.37	322.74	15	1	1	NA	1	NA	0	3
SLC7A6OS	5	7	2	0	107.91	215.82	15	1	0.461538461538462	-Inf	1	-0.583333333333333	2	12
SLC7A9	2	4	0	1	155.43	310.86	15	1	1	1	1	0.333333333333333	1	6
SLC8A3	4	12	4	8	96.36	192.72	15	1	0.690821256038647	-0.5	1	-0.0833333333333333	12	16
SLC8B1	0	2	0	1	34.65	69.3	15	1	1	NA	1	0	1	2
SLC9A1	1	8	0	3	121.11	242.22	15	1	1	1	1	0.111111111111111	3	9
SLC9A3	6	5	0	0	200.31	400.62	15	1	1	NA	1	NA	0	11
SLC9A3R1	0	2	0	1	18.81	37.62	15	1	1	NA	1	0	1	2
SLC9A3R2	1	1	1	1	59.4	118.8	15	1	1	0	1	0	2	2
SLC9A6	0	8	0	2	102.96	205.92	15	1	1	NA	1	0	2	8
SLC9A7	1	7	0	2	208.56	417.12	15	1	1	1	1	0.125	2	8
SLC9A8	0	6	0	1	182.82	365.64	15	1	1	NA	1	0	1	6
SLC9A9	5	2	0	0	134.31	268.62	15	1	1	NA	1	NA	0	7
SLC9B2	5	7	1	2	147.84	295.68	15	1	1	0.3	1	0.0833333333333334	3	12
SLCO1A2	5	1	0	0	45.87	91.74	15	1	1	NA	1	NA	0	6
SLCO1B1	2	8	0	1	224.07	448.14	15	1	1	1	1	0.2	1	10
SLCO1B3	5	3	1	0	195.03	390.06	15	1	1	-Inf	1	-0.375	1	8
SLCO1C1	6	6	0	0	120.78	241.56	15	1	1	NA	1	NA	0	12
SLCO2A1	1	8	0	1	164.01	328.02	15	1	1	1	1	0.111111111111111	1	9
SLCO2B1	4	10	2	5	202.29	404.58	15	1	1	0	1	0	7	14
SLCO3A1	1	6	1	0	139.26	278.52	15	1	0.25	-Inf	1	-0.857142857142857	1	7
SLCO4A1	4	12	2	2	191.73	383.46	15	1	0.54922600619195	-2	1	-0.25	4	16
SLCO4C1	2	4	0	0	108.57	217.14	15	1	1	NA	1	NA	0	6
SLCO5A1	2	8	1	0	230.01	460.02	15	1	0.272727272727273	-Inf	1	-0.8	1	10
SLF1	14	9	2	1	240.24	480.48	15	1	1	-0.285714285714286	1	-0.0579710144927535	3	23
SLF2	22	17	3	5	421.74	843.48	15	1	0.445537305447275	0.536363636363636	1	0.189102564102564	8	39
SLIT1	7	5	3	3	174.57	349.14	15	1	1	0.285714285714286	1	0.0833333333333334	6	12
SLIT3	6	19	2	5	385.11	770.22	15	1	1	-0.266666666666667	1	-0.0457142857142857	7	25
SLITRK2	2	14	0	2	223.08	446.16	15	1	1	1	1	0.125	2	16
SLITRK4	3	8	2	0	287.76	575.52	15	1	0.128205128205128	-Inf	1	-0.727272727272727	2	11
SLK	9	16	0	3	335.28	670.56	15	1	0.53021978021978	1	1	0.36	3	25
SLMAP	2	3	0	0	199.65	399.3	15	1	1	NA	1	NA	0	5
SLTM	2	8	0	1	320.1	640.2	15	1	1	1	1	0.2	1	10
SLX4IP	11	5	1	1	147.18	294.36	15	1	1	0.545454545454545	1	0.1875	2	16
SMAD1	0	10	0	1	144.87	289.74	15	1	1	NA	1	0	1	10
SMAD2W-SMAD2Z	2	3	1	0	105.93	211.86	15	1	1	-Inf	1	-0.6	1	5
SMAD3	0	9	0	4	123.75	247.5	15	1	1	NA	1	0	4	9
SMAD5	0	3	0	1	165.66	331.32	15	1	1	NA	1	0	1	3
SMAD6	1	1	1	1	51.81	103.62	15	1	1	0	1	0	2	2
SMAD9	0	2	0	0	137.94	275.88	15	1	1	NA	1	NA	0	2
SMAP1	2	9	1	1	151.8	303.6	15	1	0.423076923076923	-3.5	1	-0.318181818181818	2	11
SMAP2	3	7	2	1	129.36	258.72	15	1	0.510489510489511	-3.66666666666667	1	-0.366666666666667	3	10
SMARCA1	1	11	0	1	250.14	500.28	15	1	1	1	1	0.0833333333333333	1	12
SMARCA2-SMARCA4	2	14	0	1	367.62	735.24	15	1	1	1	1	0.125	1	16
SMARCAD1	18	16	0	1	265.65	531.3	15	1	0.485714285714286	1	1	0.529411764705882	1	34
SMARCAL1	8	10	2	1	299.64	599.28	15	1	0.586466165413534	-1.5	1	-0.222222222222222	3	18
SMARCB1	1	2	1	2	131.01	262.02	15	1	1	0	1	0	3	3
SMARCC1	0	19	0	3	302.94	605.88	15	1	1	NA	1	0	3	19
SMARCD1	0	4	0	0	100.65	201.3	15	1	1	NA	1	NA	0	4
SMARCD2	0	7	0	0	83.16	166.32	15	1	1	NA	1	NA	0	7
SMARCE1	0	6	0	1	135.63	271.26	15	1	1	NA	1	0	1	6
SMC1B	13	8	0	0	213.84	427.68	15	1	1	NA	1	NA	0	21
SMC2	16	9	0	0	236.61	473.22	15	1	1	NA	1	NA	0	25
SMC3	2	7	0	2	312.84	625.68	15	1	1	1	1	0.222222222222222	2	9
SMC4	14	17	1	1	385.77	771.54	15	1	1	-0.214285714285714	1	-0.0483870967741936	2	31
SMC5	9	9	2	0	262.02	524.04	15	1	0.478947368421053	-Inf	1	-0.5	2	18
SMC6	4	10	2	1	307.23	614.46	15	1	0.514705882352941	-4	1	-0.380952380952381	3	14
SMCHD1	19	17	2	1	545.16	1090.32	15	1	1	-0.789473684210526	1	-0.138888888888889	3	36
SMCO3	1	3	0	0	75.24	150.48	15	1	1	NA	1	NA	0	4
SMCR8	12	16	4	5	167.31	334.62	15	1	1	-0.0666666666666667	1	-0.0158730158730159	9	28
SMG1	4	49	2	0	1148.73	2297.46	15	1	0.0101010101010101	-Inf	1	-0.924528301886792	2	53
SMG5	5	18	1	4	269.28	538.56	15	1	1	0.1	1	0.0173913043478261	5	23
SMG6	2	16	1	4	219.78	439.56	15	1	0.539243365330322	-1	1	-0.0888888888888889	5	18
SMG7	0	7	0	0	320.1	640.2	15	1	1	NA	1	NA	0	7
SMG8	2	18	1	5	206.25	412.5	15	1	1	-0.8	1	-0.0666666666666667	6	20
SMIM19	0	1	0	1	7.26	14.52	15	1	1	NA	1	0	1	1
SMIM28	4	1	1	0	40.59	81.18	15	1	1	-Inf	1	-0.2	1	5
SMIM8	0	1	0	1	29.37	58.74	15	1	1	NA	1	0	1	1
SMIM9	3	1	0	1	26.73	53.46	15	1	0.4	1	1	0.75	1	4
SMN	1	4	1	0	56.43	112.86	15	1	0.333333333333333	-Inf	1	-0.8	1	5
SMNDC1	0	5	0	2	65.67	131.34	15	1	1	NA	1	0	2	5
SMOC1	11	14	1	3	196.68	393.36	15	1	0.622079070354932	0.575757575757576	1	0.19	4	25
SMOC2	0	4	0	0	66.99	133.98	15	1	1	NA	1	NA	0	4
SMOX	0	3	0	1	174.9	349.8	15	1	1	NA	1	0	1	3
SMPD1	4	6	2	0	69.96	139.92	15	1	0.454545454545454	-Inf	1	-0.6	2	10
SMPD3	3	13	1	2	344.52	689.04	15	1	0.530443756449948	-1.16666666666667	1	-0.145833333333333	3	16
SMPDL3A	1	3	0	0	105.27	210.54	15	1	1	NA	1	NA	0	4
SMPDL3B	4	8	1	0	125.07	250.14	15	1	0.384615384615385	-Inf	1	-0.666666666666667	1	12
SMPX	1	3	0	0	27.39	54.78	15	1	1	NA	1	NA	0	4
SMS	1	1	0	0	77.22	154.44	15	1	1	NA	1	NA	0	2
SMTN	5	8	2	3	214.83	429.66	15	1	1	-0.0666666666666667	1	-0.0153846153846154	5	13
SMTNL2	7	7	1	0	165.33	330.66	15	1	1	-Inf	1	-0.5	1	14
SMU1	1	3	0	0	103.62	207.24	15	1	1	NA	1	NA	0	4
SMURF1	1	5	1	1	219.78	439.56	15	1	0.464285714285714	-4	1	-0.333333333333333	2	6
SMURF2	0	3	0	0	156.75	313.5	15	1	1	NA	1	NA	0	3
SMYD1	1	8	1	1	155.1	310.2	15	1	0.345454545454545	-7	1	-0.388888888888889	2	9
SMYD2	2	2	1	0	65.01	130.02	15	1	1	-Inf	1	-0.5	1	4
SMYD3	2	2	0	1	122.1	244.2	15	1	1	1	1	0.5	1	4
SMYD4	10	11	2	4	205.59	411.18	15	1	0.661835748792271	0.45	1	0.142857142857143	6	21
SMYD5	2	6	2	2	112.86	225.72	15	1	0.547474747474747	-2	1	-0.25	4	8
SNAI2	0	2	0	0	89.43	178.86	15	1	1	NA	1	NA	0	2
SNAP23	0	2	0	0	44.88	89.76	15	1	1	NA	1	NA	0	2
SNAP29	0	2	0	0	57.09	114.18	15	1	1	NA	1	NA	0	2
SNAP47	2	9	2	2	160.05	320.1	15	1	0.516483516483517	-3.5	1	-0.318181818181818	4	11
SNAPC1	4	3	1	1	56.43	112.86	15	1	1	0.25	1	0.0714285714285714	2	7
SNAPC3	2	2	0	0	78.21	156.42	15	1	1	NA	1	NA	0	4
SNAPC4	21	23	4	4	385.77	771.54	15	1	1	-0.0952380952380953	1	-0.0227272727272727	8	44
SNCAIP	4	2	2	0	196.02	392.04	15	1	1	-Inf	1	-0.333333333333333	2	6
SNCG	0	4	0	0	49.17	98.34	15	1	1	NA	1	NA	0	4
SNED1	2	11	1	7	261.36	522.72	15	1	1	0.214285714285714	1	0.0288461538461539	8	13
SNF8	0	3	0	1	67.98	135.96	15	1	1	NA	1	0	1	3
SNIP1	1	7	0	1	81.18	162.36	15	1	1	1	1	0.125	1	8
SNN	1	1	0	0	20.79	41.58	15	1	1	NA	1	NA	0	2
SNPH	1	4	0	4	50.49	100.98	15	1	1	1	1	0.2	4	5
SNRK	0	8	0	1	282.81	565.62	15	1	1	NA	1	0	1	8
SNRNP200	0	20	0	7	330.99	661.98	15	1	1	NA	1	0	7	20
SNRNP27	0	1	0	1	13.86	27.72	15	1	1	NA	1	0	1	1
SNRNP35	4	3	1	0	62.37	124.74	15	1	1	-Inf	1	-0.428571428571429	1	7
SNRNP40	0	7	0	2	89.76	179.52	15	1	1	NA	1	0	2	7
SNRNP48	0	3	0	0	105.27	210.54	15	1	1	NA	1	NA	0	3
SNRPD1	0	2	0	0	37.29	74.58	15	1	1	NA	1	NA	0	2
SNRPE	0	4	0	2	27.72	55.44	15	1	1	NA	1	0	2	4
SNRPL	0	2	0	0	63.36	126.72	15	1	1	NA	1	NA	0	2
SNTA1	0	4	0	3	49.17	98.34	15	1	1	NA	1	0	3	4
SNTB1	1	10	0	0	121.11	242.22	15	1	1	NA	1	NA	0	11
SNTG1	0	2	0	1	26.4	52.8	15	1	1	NA	1	0	1	2
SNTN	0	2	0	1	45.54	91.08	15	1	1	NA	1	0	1	2
SNUPN	3	4	2	2	60.06	120.12	15	1	1	-0.333333333333333	1	-0.0714285714285715	4	7
SNW1	0	3	0	1	182.49	364.98	15	1	1	NA	1	0	1	3
SNX1	2	5	1	1	141.9	283.8	15	1	1	-1.5	1	-0.214285714285714	2	7
SNX10	1	3	0	2	57.42	114.84	15	1	1	1	1	0.25	2	4
SNX11	0	6	0	1	71.61	143.22	15	1	1	NA	1	0	1	6
SNX12	0	3	0	0	30.03	60.06	15	1	1	NA	1	NA	0	3
SNX13	5	6	2	2	239.58	479.16	15	1	1	-0.2	1	-0.0454545454545455	4	11
SNX19	5	14	3	2	173.58	347.16	15	1	0.288537549407114	-3.2	1	-0.336842105263158	5	19
SNX2	0	4	0	0	80.85	161.7	15	1	1	NA	1	NA	0	4
SNX20	0	6	0	0	90.75	181.5	15	1	1	NA	1	NA	0	6
SNX21	1	1	1	0	25.74	51.48	15	1	1	-Inf	1	-0.5	1	2
SNX22	0	4	0	1	20.46	40.92	15	1	1	NA	1	0	1	4
SNX24	1	1	0	0	54.78	109.56	15	1	1	NA	1	NA	0	2
SNX27	0	8	0	1	104.61	209.22	15	1	1	NA	1	0	1	8
SNX29	6	14	0	1	259.05	518.1	15	1	1	1	1	0.3	1	20
SNX3	0	2	0	1	38.94	77.88	15	1	1	NA	1	0	1	2
SNX30	1	6	0	0	99.33	198.66	15	1	1	NA	1	NA	0	7
SNX33	0	1	0	1	80.85	161.7	15	1	1	NA	1	0	1	1
SNX4	0	5	0	1	113.85	227.7	15	1	1	NA	1	0	1	5
SNX5	2	3	0	0	131.34	262.68	15	1	1	NA	1	NA	0	5
SNX6	0	3	0	1	106.92	213.84	15	1	1	NA	1	0	1	3
SNX7	0	4	0	0	123.42	246.84	15	1	1	NA	1	NA	0	4
SNX8	2	6	2	1	155.43	310.86	15	1	0.490909090909091	-5	1	-0.416666666666667	3	8
SNX9	2	9	0	1	184.14	368.28	15	1	1	1	1	0.181818181818182	1	11
SOAT1	3	12	0	3	199.32	398.64	15	1	1	1	1	0.2	3	15
SOBP	0	5	0	3	156.09	312.18	15	1	1	NA	1	0	3	5
SOCS1	1	4	0	0	57.42	114.84	15	1	1	NA	1	NA	0	5
SOCS2	1	4	1	1	33.33	66.66	15	1	1	-3	1	-0.3	2	5
SOCS4	2	15	2	3	175.56	351.12	15	1	0.209842788790157	-4	1	-0.282352941176471	5	17
SOCS5	2	14	0	4	229.68	459.36	15	1	1	1	1	0.125	4	16
SOD1	1	3	1	2	43.89	87.78	15	1	1	-0.5	1	-0.0833333333333333	3	4
SOD2	1	2	1	1	61.71	123.42	15	1	1	-1	1	-0.166666666666667	2	3
SOHYE2L	7	17	3	2	249.48	498.96	15	1	0.306429202980927	-2.64285714285714	1	-0.308333333333333	5	24
SON	73	70	7	7	1264.23	2528.46	15	1	1	0.041095890410959	1	0.0104895104895105	14	143
SORBS1	6	24	0	6	551.43	1102.86	15	1	0.561022942901501	1	1	0.2	6	30
SORBS2	20	24	3	5	532.95	1065.9	15	1	1	0.28	1	0.0795454545454545	8	44
SORCS1	6	18	3	1	293.7	587.4	15	1	0.0841025641025641	-8	1	-0.5	4	24
SORCS3	6	17	3	0	345.51	691.02	15	1	0.0323076923076923	-Inf	1	-0.739130434782609	3	23
SORD	2	9	2	1	148.5	297	15	1	0.175824175824176	-8	1	-0.484848484848485	3	11
SORL1	5	32	4	10	542.52	1085.04	15	1	0.236231740636362	-1.56	1	-0.150579150579151	14	37
SOS1	18	24	18	15	368.94	737.88	15	1	0.357791928083598	-0.6	1	-0.116883116883117	33	42
SOS2	2	21	2	4	383.79	767.58	15	1	0.179781903919835	-4.25	1	-0.246376811594203	6	23
SOST	0	3	0	1	72.27	144.54	15	1	1	NA	1	0	1	3
SOT3A1L	2	4	0	0	119.46	238.92	15	1	1	NA	1	NA	0	6
SOUL	0	3	0	0	60.39	120.78	15	1	1	NA	1	NA	0	3
SOWAHA	2	3	0	1	67.32	134.64	15	1	1	1	1	0.4	1	5
SOWAHB	3	2	2	0	25.08	50.16	15	1	1	-Inf	1	-0.4	2	5
SOWAHD	0	6	0	0	53.79	107.58	15	1	1	NA	1	NA	0	6
SOX10	2	3	2	0	69.3	138.6	15	1	0.428571428571428	-Inf	1	-0.6	2	5
SOX11	0	3	0	0	55.11	110.22	15	1	1	NA	1	NA	0	3
SOX13	0	4	0	3	48.84	97.68	15	1	1	NA	1	0	3	4
SOX18	0	2	0	2	87.45	174.9	15	1	1	NA	1	0	2	2
SOX3	0	2	0	1	58.74	117.48	15	1	1	NA	1	0	1	2
SOX30	6	4	0	0	140.58	281.16	15	1	1	NA	1	NA	0	10
SOX5	1	5	0	0	97.02	194.04	15	1	1	NA	1	NA	0	6
SOX6	3	3	1	0	252.12	504.24	15	1	1	-Inf	1	-0.5	1	6
SOX7	0	5	0	3	31.02	62.04	15	1	1	NA	1	0	3	5
SOX8	0	4	0	1	40.92	81.84	15	1	1	NA	1	0	1	4
SP2	4	3	2	0	81.51	163.02	15	1	0.5	-Inf	1	-0.428571428571429	2	7
SP3	3	2	1	0	201.63	403.26	15	1	1	-Inf	1	-0.4	1	5
SP4	6	11	1	0	274.23	548.46	15	1	0.388888888888889	-Inf	1	-0.647058823529412	1	17
SP8	0	2	0	1	26.73	53.46	15	1	1	NA	1	0	1	2
SPACA1	7	4	0	1	95.37	190.74	15	1	0.416666666666667	1	1	0.636363636363636	1	11
SPACA9	0	4	0	1	48.18	96.36	15	1	1	NA	1	0	1	4
SPAG1	18	13	8	0	250.8	501.6	15	1	0.0352039345847395	-Inf	1	-0.419354838709677	8	31
SPAG16	3	7	1	1	87.12	174.24	15	1	1	-1.33333333333333	1	-0.2	2	10
SPAG17	34	16	3	2	634.59	1269.18	15	1	1	0.294117647058823	1	0.0800000000000001	5	50
SPAG5	7	5	1	2	69.63	139.26	15	1	0.569230769230769	0.642857142857143	1	0.25	3	12
SPAG6	0	4	0	3	125.73	251.46	15	1	1	NA	1	0	3	4
SPAG8	0	1	0	1	6.93	13.86	15	1	1	NA	1	0	1	1
SPAG9	3	16	2	5	410.19	820.38	15	1	0.587534204925509	-1.13333333333333	1	-0.12781954887218	7	19
SPAM1	5	7	1	0	191.73	383.46	15	1	0.461538461538462	-Inf	1	-0.583333333333333	1	12
SPARC	1	2	0	0	49.5	99	15	1	1	NA	1	NA	0	3
SPARCL1	13	7	6	2	187.44	374.88	15	1	1	-0.615384615384615	1	-0.1	8	20
SPATA1	9	7	2	1	165.66	331.32	15	1	1	-0.555555555555556	1	-0.104166666666667	3	16
SPATA13	4	7	1	2	293.7	587.4	15	1	1	0.125	1	0.0303030303030303	3	11
SPATA16	15	7	2	0	201.3	402.6	15	1	1	-Inf	1	-0.318181818181818	2	22
SPATA17	3	5	0	0	84.81	169.62	15	1	1	NA	1	NA	0	8
SPATA18	1	4	1	0	141.57	283.14	15	1	0.333333333333333	-Inf	1	-0.8	1	5
SPATA2	0	9	0	0	189.42	378.84	15	1	1	NA	1	NA	0	9
SPATA20	3	9	2	2	115.17	230.34	15	1	0.546703296703297	-2	1	-0.25	4	12
SPATA22	4	5	0	0	74.91	149.82	15	1	1	NA	1	NA	0	9
SPATA4	5	0	1	0	56.76	113.52	15	1	1	NA	1	0	1	5
SPATA5	6	9	2	2	208.23	416.46	15	1	1	-0.5	1	-0.1	4	15
SPATA6	11	3	0	0	147.51	295.02	15	1	1	NA	1	NA	0	14
SPATA7	11	3	1	0	190.41	380.82	15	1	1	-Inf	1	-0.214285714285714	1	14
SPATS2	4	2	2	1	71.28	142.56	15	1	1	0	1	0	3	6
SPATS2L	4	11	0	2	177.21	354.42	15	1	1	1	1	0.266666666666667	2	15
SPC25	3	1	0	0	57.09	114.18	15	1	1	NA	1	NA	0	4
SPCS1	0	2	0	0	27.72	55.44	15	1	1	NA	1	NA	0	2
SPCS2	6	5	1	2	72.93	145.86	15	1	1	0.583333333333333	1	0.212121212121212	3	11
SPDEF	0	4	0	4	25.74	51.48	15	1	1	NA	1	0	4	4
SPDL1	4	10	1	1	198.33	396.66	15	1	1	-1.5	1	-0.214285714285714	2	14
SPDYA	1	4	0	0	82.83	165.66	15	1	1	NA	1	NA	0	5
SPECC1	5	16	2	3	303.27	606.54	15	1	0.587534204925509	-1.13333333333333	1	-0.161904761904762	5	21
SPEF2	27	22	4	1	592.35	1184.7	15	1	0.380001960468109	-2.25925925925926	1	-0.248979591836735	5	49
SPEG	4	15	2	8	233.31	466.62	15	1	1	0.0625	1	0.0105263157894737	10	19
SPEN	7	44	3	11	797.28	1594.56	15	1	0.438379550473713	-0.714285714285714	1	-0.0770308123249299	14	51
SPERT	5	6	1	3	119.79	239.58	15	1	0.604395604395604	0.6	1	0.204545454545455	4	11
SPG11	25	28	8	3	646.14	1292.28	15	1	0.186444856236173	-1.98666666666667	1	-0.25557461406518	11	53
SPG20	3	12	1	2	120.78	241.56	15	1	1	-1	1	-0.133333333333333	3	15
SPG21	1	5	1	2	84.15	168.3	15	1	1	-1.5	1	-0.166666666666667	3	6
SPG7	5	13	2	5	243.87	487.74	15	1	1	-0.04	1	-0.00793650793650791	7	18
SPHK1	0	3	0	2	24.09	48.18	15	1	1	NA	1	0	2	3
SPHKAP	23	27	2	6	649.44	1298.88	15	1	0.445162618970306	0.608695652173913	1	0.21	8	50
SPI1	0	2	0	0	87.45	174.9	15	1	1	NA	1	NA	0	2
SPIA1	13	11	0	0	230.01	460.02	15	1	1	NA	1	NA	0	24
SPIA3	11	5	3	0	146.52	293.04	15	1	0.530443756449948	-Inf	1	-0.3125	3	16
SPIA4	8	7	4	0	188.76	377.52	15	1	0.245098039215686	-Inf	1	-0.466666666666667	4	15
SPIA5	12	11	1	1	195.03	390.06	15	1	1	0.0833333333333334	1	0.0217391304347826	2	23
SPIA9	3	0	2	0	132	264	15	1	1	NA	1	0	2	3
SPIC	1	3	0	0	80.19	160.38	15	1	1	NA	1	NA	0	4
SPICE1	13	10	3	1	250.47	500.94	15	1	0.623931623931624	-1.30769230769231	1	-0.184782608695652	4	23
SPIK5	13	9	0	0	156.09	312.18	15	1	1	NA	1	NA	0	22
SPIK7	0	2	0	0	66.99	133.98	15	1	1	NA	1	NA	0	2
SPIN1W-SPIN1Z	1	0	1	0	62.04	124.08	15	1	1	NA	1	0	1	1
SPINT1	0	5	0	0	171.27	342.54	15	1	1	NA	1	NA	0	5
SPINT4	1	2	0	0	25.74	51.48	15	1	1	NA	1	NA	0	3
SPIRE1	2	6	1	2	182.82	365.64	15	1	1	-0.5	1	-0.0833333333333333	3	8
SPIRE1L	16	9	6	2	182.82	365.64	15	1	0.687045435098828	-0.6875	1	-0.11	8	25
SPIRE2	3	4	1	2	62.37	124.74	15	1	1	0.333333333333333	1	0.0952380952380952	3	7
SPNS3	7	5	2	1	173.58	347.16	15	1	1	-0.428571428571429	1	-0.0833333333333333	3	12
SPO11	3	3	0	0	105.93	211.86	15	1	1	NA	1	NA	0	6
SPOCK1	0	2	0	0	76.56	153.12	15	1	1	NA	1	NA	0	2
SPOCK3	2	2	0	0	73.59	147.18	15	1	1	NA	1	NA	0	4
SPON1	0	4	0	0	165.33	330.66	15	1	1	NA	1	NA	0	4
SPON2	1	2	1	0	54.78	109.56	15	1	1	-Inf	1	-0.666666666666667	1	3
SPOP	0	5	0	0	119.13	238.26	15	1	1	NA	1	NA	0	5
SPOPL	1	0	1	0	119.13	238.26	15	1	1	NA	1	0	1	1
SPP1	7	7	3	1	89.1	178.2	15	1	0.588235294117647	-2	1	-0.25	4	14
SPP2	3	2	0	1	46.53	93.06	15	1	1	1	1	0.6	1	5
SPPL2B	0	6	0	1	151.8	303.6	15	1	1	NA	1	0	1	6
SPR	1	6	1	1	47.19	94.38	15	1	0.416666666666667	-5	1	-0.357142857142857	2	7
SPRED1	1	4	0	1	101.97	203.94	15	1	1	1	1	0.2	1	5
SPRED2	1	2	1	1	148.17	296.34	15	1	1	-1	1	-0.166666666666667	2	3
SPRN	2	2	0	0	19.8	39.6	15	1	1	NA	1	NA	0	4
SPRTN	7	7	0	2	140.58	281.16	15	1	0.475	1	1	0.5	2	14
SPRY1	0	2	0	0	85.14	170.28	15	1	1	NA	1	NA	0	2
SPRY2	1	2	0	0	78.21	156.42	15	1	1	NA	1	NA	0	3
SPRY4	0	1	0	1	50.82	101.64	15	1	1	NA	1	0	1	1
SPRYD7	1	3	1	0	48.51	97.02	15	1	0.4	-Inf	1	-0.75	1	4
SPSB1	1	4	0	2	81.51	163.02	15	1	1	1	1	0.2	2	5
SPSB4	3	4	0	0	107.58	215.16	15	1	1	NA	1	NA	0	7
SPTAN1	3	41	2	6	816.75	1633.5	15	1	0.164274940745529	-3.55555555555556	1	-0.181818181818182	8	44
SPTB	5	18	4	11	235.62	471.24	15	1	1	-0.309090909090909	1	-0.0492753623188406	15	23
SPTBB4L	10	16	3	8	223.41	446.82	15	1	0.710565343294519	0.4	1	0.111888111888112	11	26
SPTBN1	1	29	0	3	740.19	1480.38	15	1	1	1	1	0.0333333333333333	3	30
SPTLC1	2	1	0	0	115.5	231	15	1	1	NA	1	NA	0	3
SPTLC2	1	8	0	0	192.39	384.78	15	1	1	NA	1	NA	0	9
SPTLC3	0	2	0	0	166.32	332.64	15	1	1	NA	1	NA	0	2
SPTSSB	0	2	0	1	22.77	45.54	15	1	1	NA	1	0	1	2
SPTY2D1	2	7	0	1	147.18	294.36	15	1	1	1	1	0.222222222222222	1	9
SPX	2	1	0	0	33.33	66.66	15	1	1	NA	1	NA	0	3
SQLE	1	10	0	1	168.63	337.26	15	1	1	1	1	0.0909090909090909	1	11
SQSTM1	4	13	3	1	123.09	246.18	15	1	0.087719298245614	-8.75	1	-0.514705882352941	4	17
SRA1	6	1	3	0	54.12	108.24	15	1	1	-Inf	1	-0.142857142857143	3	7
SRBD1	10	17	2	5	435.27	870.54	15	1	1	0.32	1	0.0846560846560847	7	27
SRCIN1	0	3	0	2	66.99	133.98	15	1	1	NA	1	0	2	3
SRCRB4D	0	4	0	4	31.68	63.36	15	1	1	NA	1	0	4	4
SRD5A3	4	6	2	3	107.58	215.16	15	1	1	0	1	0	5	10
SREBF2	4	15	3	3	266.31	532.62	15	1	0.298498023715415	-2.75	1	-0.289473684210526	6	19
SREK1	1	3	1	0	92.73	185.46	15	1	0.4	-Inf	1	-0.75	1	4
SRFBP1	3	4	0	1	85.47	170.94	15	1	1	1	1	0.428571428571429	1	7
SRGAP1	4	15	0	3	339.24	678.48	15	1	1	1	1	0.210526315789474	3	19
SRGAP3	1	11	0	3	297.66	595.32	15	1	1	1	1	0.0833333333333333	3	12
SRGN	0	2	0	0	21.78	43.56	15	1	1	NA	1	NA	0	2
SRI	1	2	0	0	62.37	124.74	15	1	1	NA	1	NA	0	3
SRP19	0	2	0	0	26.4	52.8	15	1	1	NA	1	NA	0	2
SRP54	0	6	0	1	170.61	341.22	15	1	1	NA	1	0	1	6
SRP68	2	14	0	2	172.92	345.84	15	1	1	1	1	0.125	2	16
SRP72	0	3	0	0	48.51	97.02	15	1	1	NA	1	NA	0	3
SRP9	0	2	0	1	22.77	45.54	15	1	1	NA	1	0	1	2
SRPK1	8	9	0	0	202.29	404.58	15	1	1	NA	1	NA	0	17
SRPRB	2	2	0	0	40.92	81.84	15	1	1	NA	1	NA	0	4
SRPX	1	10	1	2	146.52	293.04	15	1	0.395604395604396	-4	1	-0.242424242424242	3	11
SRPX2	1	8	0	1	106.92	213.84	15	1	1	1	1	0.111111111111111	1	9
SRRD	1	4	0	0	32.67	65.34	15	1	1	NA	1	NA	0	5
SRRL	2	11	1	0	183.15	366.3	15	1	0.214285714285714	-Inf	1	-0.846153846153846	1	13
SRRM3	6	12	4	5	105.6	211.2	15	1	0.683128770542958	-0.6	1	-0.111111111111111	9	18
SRRM4	3	5	0	1	95.7	191.4	15	1	1	1	1	0.375	1	8
SRSF10	0	2	0	0	63.69	127.38	15	1	1	NA	1	NA	0	2
SRSF11	1	6	0	0	120.78	241.56	15	1	1	NA	1	NA	0	7
SRSF2	0	2	0	0	34.65	69.3	15	1	1	NA	1	NA	0	2
SRSF3	3	5	1	0	104.61	209.22	15	1	0.444444444444444	-Inf	1	-0.625	1	8
SRSF4	3	2	1	0	107.58	215.16	15	1	1	-Inf	1	-0.4	1	5
SRSF5A	0	3	0	0	72.6	145.2	15	1	1	NA	1	NA	0	3
SS18	0	2	0	0	114.84	229.68	15	1	1	NA	1	NA	0	2
SS2	0	2	0	0	22.77	45.54	15	1	1	NA	1	NA	0	2
SSBP1	0	3	0	0	33.33	66.66	15	1	1	NA	1	NA	0	3
SSFA2	13	20	3	2	389.07	778.14	15	1	0.631829972387248	-1.30769230769231	1	-0.206060606060606	5	33
SSH1	1	21	1	6	255.42	510.84	15	1	0.431034482758621	-2.5	1	-0.0974025974025974	7	22
SSH2	9	15	1	3	342.21	684.42	15	1	1	0.444444444444444	1	0.125	4	24
SSNA1	2	5	1	3	35.97	71.94	15	1	1	0.166666666666667	1	0.0357142857142857	4	7
SSPO	5	5	5	3	93.39	186.78	15	1	0.664061428767311	-0.666666666666667	1	-0.125	8	10
SSR1	0	2	0	0	66.99	133.98	15	1	1	NA	1	NA	0	2
SSR2	0	2	0	0	46.86	93.72	15	1	1	NA	1	NA	0	2
SSTR1	0	5	0	1	95.7	191.4	15	1	1	NA	1	0	1	5
SSTR2	1	6	0	1	102.96	205.92	15	1	1	1	1	0.142857142857143	1	7
SSTR3	3	8	2	2	128.7	257.4	15	1	0.56043956043956	-1.66666666666667	1	-0.227272727272727	4	11
SSTR4	1	4	0	1	56.43	112.86	15	1	1	1	1	0.2	1	5
SSTR5	0	5	0	0	129.36	258.72	15	1	1	NA	1	NA	0	5
SSU72	2	5	0	2	82.83	165.66	15	1	1	1	1	0.285714285714286	2	7
SSX2IP	6	2	1	0	143.22	286.44	15	1	1	-Inf	1	-0.25	1	8
ST13	2	4	0	1	90.09	180.18	15	1	1	1	1	0.333333333333333	1	6
ST14	7	18	1	2	274.89	549.78	15	1	1	-0.285714285714286	1	-0.0533333333333333	3	25
ST18	4	10	1	0	314.49	628.98	15	1	0.333333333333333	-Inf	1	-0.714285714285714	1	14
ST3GAL1	2	8	1	0	105.93	211.86	15	1	0.272727272727273	-Inf	1	-0.8	1	10
ST3GAL2L	1	3	1	2	76.56	153.12	15	1	1	-0.5	1	-0.0833333333333333	3	4
ST3GAL3	6	2	1	1	172.92	345.84	15	1	1	0.666666666666667	1	0.25	2	8
ST3GAL5	4	7	2	0	138.93	277.86	15	1	0.192307692307692	-Inf	1	-0.636363636363636	2	11
ST3GAL6	1	1	0	0	101.64	203.28	15	1	1	NA	1	NA	0	2
ST5	5	21	1	3	370.92	741.84	15	1	1	-0.4	1	-0.0576923076923077	4	26
ST6GAL1	3	8	0	0	141.24	282.48	15	1	1	NA	1	NA	0	11
ST6GAL2	3	8	2	1	178.2	356.4	15	1	0.505494505494505	-4.33333333333333	1	-0.393939393939394	3	11
ST6GALNAC1	15	9	5	0	180.51	361.02	15	1	0.152835670077049	-Inf	1	-0.375	5	24
ST6GALNAC2	1	5	0	2	28.38	56.76	15	1	1	1	1	0.166666666666667	2	6
ST6GALNAC2L	1	4	1	2	19.8	39.6	15	1	1	-1	1	-0.133333333333333	3	5
ST6GALNAC5	2	3	0	1	102.63	205.26	15	1	1	1	1	0.4	1	5
ST7	3	6	0	2	178.53	357.06	15	1	1	1	1	0.333333333333333	2	9
ST7L	1	2	0	0	123.09	246.18	15	1	1	NA	1	NA	0	3
ST8SIA2	0	2	0	0	96.36	192.72	15	1	1	NA	1	NA	0	2
ST8SIA3W-ST8SIA3Z	0	3	0	0	38.28	76.56	15	1	1	NA	1	NA	0	3
ST8SIA5	0	5	0	0	94.71	189.42	15	1	1	NA	1	NA	0	5
ST8SIA6	0	4	0	0	152.13	304.26	15	1	1	NA	1	NA	0	4
STAB1	30	48	5	11	834.9	1669.8	15	1	0.777785980126543	0.272727272727273	1	0.0721153846153846	16	78
STAB2	29	48	5	8	790.35	1580.7	15	1	1	-0.0344827586206897	1	-0.007992007992008	13	77
STAC	3	2	0	0	101.31	202.62	15	1	1	NA	1	NA	0	5
STAG1	0	9	0	0	323.07	646.14	15	1	1	NA	1	NA	0	9
STAG2	1	11	0	2	355.41	710.82	15	1	1	1	1	0.0833333333333333	2	12
STAGL	13	14	0	1	396.33	792.66	15	1	1	1	1	0.481481481481481	1	27
STAM	1	6	0	2	152.79	305.58	15	1	1	1	1	0.142857142857143	2	7
STAM2	5	8	1	1	130.68	261.36	15	1	1	-0.6	1	-0.115384615384615	2	13
STAMBP	4	7	0	0	146.52	293.04	15	1	1	NA	1	NA	0	11
STAMBPL1	1	5	0	1	131.34	262.68	15	1	1	1	1	0.166666666666667	1	6
STAP1	3	7	1	0	109.89	219.78	15	1	0.363636363636364	-Inf	1	-0.7	1	10
STARD13	4	11	2	4	343.53	687.06	15	1	1	-0.375	1	-0.0666666666666667	6	15
STARD3	0	6	0	1	77.22	154.44	15	1	1	NA	1	0	1	6
STARD3NL	1	1	0	0	82.5	165	15	1	1	NA	1	NA	0	2
STARD4	1	2	0	0	45.54	91.08	15	1	1	NA	1	NA	0	3
STARD5	1	2	0	0	40.92	81.84	15	1	1	NA	1	NA	0	3
STARD9	105	59	21	9	1826.22	3652.44	15	1	0.677862279284995	-0.311111111111111	1	-0.0597560975609756	30	164
STAT1	0	23	0	0	413.49	826.98	15	1	1	NA	1	NA	0	23
STAU2	5	7	0	0	190.74	381.48	15	1	1	NA	1	NA	0	12
STBD1	6	11	3	4	67.32	134.64	15	1	1	-0.375	1	-0.0756302521008403	7	17
STC1	3	3	1	3	89.76	179.52	15	1	0.571428571428572	0.666666666666667	1	0.25	4	6
STEAP1	5	5	0	0	126.39	252.78	15	1	1	NA	1	NA	0	10
STEAP3	1	7	0	1	142.23	284.46	15	1	1	1	1	0.125	1	8
STEAP4	6	8	1	1	186.12	372.24	15	1	1	-0.333333333333333	1	-0.0714285714285715	2	14
STIL	24	26	2	6	367.29	734.58	15	1	0.276163216612526	0.638888888888889	1	0.23	8	50
STIM1	1	10	1	3	175.89	351.78	15	1	0.476190476190476	-2.33333333333333	1	-0.159090909090909	4	11
STIM2	2	4	1	2	266.64	533.28	15	1	1	0	1	0	3	6
STK10	1	9	0	2	221.76	443.52	15	1	1	1	1	0.1	2	10
STK11	1	6	0	2	104.28	208.56	15	1	1	1	1	0.142857142857143	2	7
STK11IP	12	19	2	4	331.32	662.64	15	1	1	0.208333333333333	1	0.0537634408602151	6	31
STK17A	3	0	2	0	23.1	46.2	15	1	1	NA	1	0	2	3
STK17B	0	4	0	1	84.81	169.62	15	1	1	NA	1	0	1	4
STK24	1	7	0	2	115.5	231	15	1	1	1	1	0.125	2	8
STK25	0	7	0	1	175.23	350.46	15	1	1	NA	1	0	1	7
STK26	0	2	0	0	112.2	224.4	15	1	1	NA	1	NA	0	2
STK31	14	16	2	2	307.89	615.78	15	1	1	-0.142857142857143	1	-0.0333333333333333	4	30
STK32A	5	5	1	1	95.37	190.74	15	1	1	0	1	0	2	10
STK32C	4	6	1	0	129.69	259.38	15	1	0.454545454545455	-Inf	1	-0.6	1	10
STK35	1	4	0	1	50.16	100.32	15	1	1	1	1	0.2	1	5
STK36	22	19	4	3	266.97	533.94	15	1	1	-0.151515151515152	1	-0.0348432055749128	7	41
STK38	0	5	0	0	118.8	237.6	15	1	1	NA	1	NA	0	5
STK38L	1	5	0	0	126.39	252.78	15	1	1	NA	1	NA	0	6
STK39	0	6	0	0	130.68	261.36	15	1	1	NA	1	NA	0	6
STK4	1	7	0	2	148.5	297	15	1	1	1	1	0.125	2	8
STK40	0	4	0	0	120.78	241.56	15	1	1	NA	1	NA	0	4
STKLD1	9	8	1	1	171.27	342.54	15	1	1	0.111111111111111	1	0.0294117647058824	2	17
STMND1	9	1	2	0	73.26	146.52	15	1	1	-Inf	1	-0.1	2	10
STN1	5	6	1	1	115.83	231.66	15	1	1	-0.2	1	-0.0454545454545455	2	11
STOML1	0	4	0	1	59.4	118.8	15	1	1	NA	1	0	1	4
STOML3	1	8	1	1	99.33	198.66	15	1	0.345454545454545	-7	1	-0.388888888888889	2	9
STON1	3	1	0	0	47.85	95.7	15	1	1	NA	1	NA	0	4
STON2	4	18	1	3	339.57	679.14	15	1	1	-0.5	1	-0.0681818181818182	4	22
STOX1	27	12	8	2	268.95	537.9	15	1	0.702144300478966	-0.777777777777778	1	-0.107692307692308	10	39
STRA6	3	6	1	1	71.61	143.22	15	1	1	-1	1	-0.166666666666667	2	9
STRA8	2	4	0	1	111.21	222.42	15	1	1	1	1	0.333333333333333	1	6
STRAP	0	2	0	0	93.39	186.78	15	1	1	NA	1	NA	0	2
STRIP1	0	6	0	2	159.06	318.12	15	1	1	NA	1	0	2	6
STRIP2	2	14	1	5	217.14	434.28	15	1	1	-0.4	1	-0.0416666666666667	6	16
STRN	0	7	0	2	224.73	449.46	15	1	1	NA	1	0	2	7
STRN3	3	11	0	0	235.62	471.24	15	1	1	NA	1	NA	0	14
STS	2	4	1	0	133.32	266.64	15	1	0.428571428571428	-Inf	1	-0.666666666666667	1	6
STT3B	0	8	0	1	232.65	465.3	15	1	1	NA	1	0	1	8
STX11	3	3	2	2	89.76	179.52	15	1	1	0	1	0	4	6
STX17	3	5	1	1	97.68	195.36	15	1	1	-0.666666666666667	1	-0.125	2	8
STX18	4	0	0	0	93.39	186.78	15	1	1	NA	1	NA	0	4
STX19	3	1	1	1	86.13	172.26	15	1	1	0.666666666666667	1	0.25	2	4
STX1A	0	6	0	2	53.46	106.92	15	1	1	NA	1	0	2	6
STX2	3	8	1	1	142.89	285.78	15	1	1	-1.66666666666667	1	-0.227272727272727	2	11
STX6	2	2	2	1	66.66	133.32	15	1	1	-1	1	-0.166666666666667	3	4
STX8	2	3	0	0	70.62	141.24	15	1	1	NA	1	NA	0	5
STXBP1	0	2	0	1	59.07	118.14	15	1	1	NA	1	0	1	2
STXBP3	2	7	0	1	169.95	339.9	15	1	1	1	1	0.222222222222222	1	9
STXBP4	2	6	0	0	166.32	332.64	15	1	1	NA	1	NA	0	8
STXBP6	2	1	0	0	50.82	101.64	15	1	1	NA	1	NA	0	3
STYK1	4	8	1	2	126.72	253.44	15	1	1	0	1	0	3	12
STYX	0	3	0	2	57.42	114.84	15	1	1	NA	1	0	2	3
STYXL1	5	2	2	0	84.15	168.3	15	1	1	-Inf	1	-0.285714285714286	2	7
SUCLG1	1	3	0	0	102.3	204.6	15	1	1	NA	1	NA	0	4
SUCLG2	2	3	0	0	145.86	291.72	15	1	1	NA	1	NA	0	5
SUCNR1	7	3	1	0	77.22	154.44	15	1	1	-Inf	1	-0.3	1	10
SUCO	10	18	0	3	401.28	802.56	15	1	0.532814238042269	1	1	0.357142857142857	3	28
SUFU	2	5	1	0	124.41	248.82	15	1	0.375	-Inf	1	-0.714285714285714	1	7
SUGCT	0	1	0	1	55.44	110.88	15	1	1	NA	1	0	1	1
SUGP1	0	10	0	3	156.42	312.84	15	1	1	NA	1	0	3	10
SUGP2	5	22	1	4	309.21	618.42	15	1	1	-0.1	1	-0.0148148148148148	5	27
SUGT1	5	1	2	0	87.45	174.9	15	1	1	-Inf	1	-0.166666666666667	2	6
SULF2	0	13	0	2	321.42	642.84	15	1	1	NA	1	0	2	13
SULT	3	5	2	1	110.22	220.44	15	1	0.545454545454546	-2.33333333333333	1	-0.291666666666667	3	8
SULT1B-SULT1B1	3	4	1	0	41.25	82.5	15	1	1	-Inf	1	-0.571428571428571	1	7
SULT1C3	1	3	0	0	103.62	207.24	15	1	1	NA	1	NA	0	4
SULT1E1	3	2	0	0	55.44	110.88	15	1	1	NA	1	NA	0	5
SULT2B1L1	0	2	0	0	22.44	44.88	15	1	1	NA	1	NA	0	2
SULT4A1	2	3	0	0	84.48	168.96	15	1	1	NA	1	NA	0	5
SULT6B1L	3	5	0	0	119.13	238.26	15	1	1	NA	1	NA	0	8
SUMF1	4	2	1	0	83.49	166.98	15	1	1	-Inf	1	-0.333333333333333	1	6
SUMF2	3	6	2	2	80.85	161.7	15	1	1	-1	1	-0.166666666666667	4	9
SUMO3	1	1	0	0	10.89	21.78	15	1	1	NA	1	NA	0	2
SUN1	9	14	3	0	309.21	618.42	15	1	0.0846153846153846	-Inf	1	-0.608695652173913	3	23
SUN2	3	4	1	2	44.88	89.76	15	1	1	0.333333333333333	1	0.0952380952380952	3	7
SUPT20H	0	4	0	0	210.21	420.42	15	1	1	NA	1	NA	0	4
SUPT3H	3	4	0	0	102.63	205.26	15	1	1	NA	1	NA	0	7
SUPT6H	0	21	0	6	459.03	918.06	15	1	1	NA	1	0	6	21
SUPT7L	1	8	1	4	89.1	178.2	15	1	1	-1	1	-0.0888888888888889	5	9
SUPV3L1	8	13	4	4	204.6	409.2	15	1	0.682825254039647	-0.625	1	-0.119047619047619	8	21
SURF1	3	5	0	0	69.96	139.92	15	1	1	NA	1	NA	0	8
SURF2	3	2	1	0	59.73	119.46	15	1	1	-Inf	1	-0.4	1	5
SURF6	3	2	1	1	60.72	121.44	15	1	1	0.333333333333333	1	0.1	2	5
SUSD1	6	7	1	1	169.29	338.58	15	1	1	-0.166666666666667	1	-0.0384615384615384	2	13
SUSD2	6	15	0	0	377.19	754.38	15	1	1	NA	1	NA	0	21
SUSD3	2	4	0	0	72.6	145.2	15	1	1	NA	1	NA	0	6
SUSD4	6	11	1	0	125.07	250.14	15	1	0.388888888888889	-Inf	1	-0.647058823529412	1	17
SUSD5	8	7	0	0	147.84	295.68	15	1	1	NA	1	NA	0	15
SUSD6	1	5	0	0	107.25	214.5	15	1	1	NA	1	NA	0	6
SUV39H2	4	3	0	0	131.01	262.02	15	1	1	NA	1	NA	0	7
SUZ12	0	4	0	1	196.02	392.04	15	1	1	NA	1	0	1	4
SV2B	4	18	3	6	301.95	603.9	15	1	0.384105416274493	-1.25	1	-0.151515151515151	9	22
SV2C	1	5	1	1	106.26	212.52	15	1	0.464285714285714	-4	1	-0.333333333333333	2	6
SVEP1	25	55	6	7	946.11	1892.22	15	1	0.346550845805372	-0.885714285714286	1	-0.149038461538462	13	80
SVIL	5	23	1	4	513.81	1027.62	15	1	1	-0.15	1	-0.0214285714285714	5	28
SVIP	2	1	0	0	27.06	54.12	15	1	1	NA	1	NA	0	3
SVOP	2	5	2	1	179.19	358.38	15	1	0.5	-4	1	-0.380952380952381	3	7
SVOPL	7	12	2	2	155.1	310.2	15	1	1	-0.714285714285714	1	-0.131578947368421	4	19
SWAP70	1	11	0	0	182.49	364.98	15	1	1	NA	1	NA	0	12
SWT1	9	6	0	1	222.42	444.84	15	1	0.4375	1	1	0.6	1	15
SYAP1	0	3	0	1	56.43	112.86	15	1	1	NA	1	0	1	3
SYCP2	15	20	1	2	334.29	668.58	15	1	1	0.333333333333333	1	0.0952380952380952	3	35
SYCP2L	28	12	5	1	242.22	484.44	15	1	0.659248246389729	-1.14285714285714	1	-0.133333333333333	6	40
SYDE2	8	17	1	0	301.95	603.9	15	1	0.346153846153846	-Inf	1	-0.68	1	25
SYK	0	7	0	1	157.08	314.16	15	1	1	NA	1	0	1	7
SYN2	2	5	1	1	135.63	271.26	15	1	1	-1.5	1	-0.214285714285714	2	7
SYN3	2	4	2	0	207.24	414.48	15	1	0.428571428571429	-Inf	1	-0.666666666666667	2	6
SYNC	6	13	1	1	99.99	199.98	15	1	1	-1.16666666666667	1	-0.184210526315789	2	19
SYNDIG1L	2	3	1	1	45.87	91.74	15	1	1	-0.5	1	-0.1	2	5
SYNE1	68	64	9	5	1902.45	3804.9	15	1	0.410972956049982	-0.694117647058824	1	-0.127705627705628	14	132
SYNE2	60	66	9	7	2208.03	4416.06	15	1	0.600163106797916	-0.414285714285714	1	-0.0863095238095238	16	126
SYNE3	4	7	1	4	277.86	555.72	15	1	1	0.5625	1	0.163636363636364	5	11
SYNGR1	0	2	0	1	41.91	83.82	15	1	1	NA	1	0	1	2
SYNGR3	0	6	0	4	56.1	112.2	15	1	1	NA	1	0	4	6
SYNJ1	10	17	2	3	443.85	887.7	15	1	1	-0.133333333333333	1	-0.0296296296296297	5	27
SYNJ2	8	21	3	4	456.72	913.44	15	1	0.649944655281467	-0.96875	1	-0.152709359605911	7	29
SYNJ2BP	3	4	0	1	112.86	225.72	15	1	1	1	1	0.428571428571429	1	7
SYNM	9	21	1	2	419.76	839.52	15	1	1	-0.166666666666667	1	-0.0333333333333333	3	30
SYNPO	3	3	2	1	40.92	81.84	15	1	1	-1	1	-0.166666666666667	3	6
SYNPO2	9	22	1	4	404.25	808.5	15	1	1	0.388888888888889	1	0.0903225806451613	5	31
SYNPO2L	2	11	1	6	192.72	385.44	15	1	1	0.0833333333333334	1	0.010989010989011	7	13
SYNPR	2	2	1	0	89.1	178.2	15	1	1	-Inf	1	-0.5	1	4
SYNRG	11	32	3	4	541.53	1083.06	15	1	0.383533765032377	-1.18181818181818	1	-0.172757475083056	7	43
SYPL1	3	2	2	0	65.01	130.02	15	1	1	-Inf	1	-0.4	2	5
SYS1	0	3	0	1	32.34	64.68	15	1	1	NA	1	0	1	3
SYT1	0	5	0	1	133.32	266.64	15	1	1	NA	1	0	1	5
SYT10	3	6	0	1	182.49	364.98	15	1	1	1	1	0.333333333333333	1	9
SYT11	0	4	0	1	93.72	187.44	15	1	1	NA	1	0	1	4
SYT12	3	3	2	2	58.41	116.82	15	1	1	0	1	0	4	6
SYT13	3	3	1	1	103.29	206.58	15	1	1	0	1	0	2	6
SYT14	6	4	1	1	224.4	448.8	15	1	1	0.333333333333333	1	0.1	2	10
SYT16	5	6	0	0	194.37	388.74	15	1	1	NA	1	NA	0	11
SYT17	0	4	0	0	143.88	287.76	15	1	1	NA	1	NA	0	4
SYT2	1	5	1	3	93.72	187.44	15	1	1	-0.666666666666667	1	-0.0833333333333333	4	6
SYT4	3	4	0	0	102.3	204.6	15	1	1	NA	1	NA	0	7
SYT6	2	3	0	0	168.63	337.26	15	1	1	NA	1	NA	0	5
SYT8	7	2	5	0	90.09	180.18	15	1	0.505494505494505	-Inf	1	-0.222222222222222	5	9
SYT9	3	5	0	0	200.64	401.28	15	1	1	NA	1	NA	0	8
SYTL1	1	0	1	0	2.64	5.28	15	1	1	NA	1	0	1	1
SYTL2	44	37	5	5	611.16	1222.32	15	1	1	0.159090909090909	1	0.0432098765432098	10	81
SYTL2L	11	9	2	3	293.04	586.08	15	1	0.64472049689441	0.454545454545455	1	0.15	5	20
SYTL3	6	8	0	1	187.44	374.88	15	1	1	1	1	0.428571428571429	1	14
SYTL4	0	9	0	2	187.44	374.88	15	1	1	NA	1	0	2	9
SYTL5	5	6	2	1	246.18	492.36	15	1	1	-1.4	1	-0.212121212121212	3	11
SZRD1	0	3	0	0	39.27	78.54	15	1	1	NA	1	NA	0	3
SZT2	14	53	2	9	962.28	1924.56	15	1	1	0.158730158730159	1	0.0271370420624152	11	67
T	0	5	0	0	68.64	137.28	15	1	1	NA	1	NA	0	5
TA3	31	17	4	1	445.5	891	15	1	0.651047066141406	-1.19354838709677	1	-0.154166666666667	5	48
TAB1	1	7	0	0	132.33	264.66	15	1	1	NA	1	NA	0	8
TAB2	6	8	1	1	216.48	432.96	15	1	1	-0.333333333333333	1	-0.0714285714285715	2	14
TAB3	0	5	0	1	192.72	385.44	15	1	1	NA	1	0	1	5
TACC1	3	6	1	0	114.84	229.68	15	1	0.4	-Inf	1	-0.666666666666667	1	9
TACC2	68	54	11	16	881.1	1762.2	15	1	0.201798904368	0.454044117647059	1	0.14996964177292	27	122
TACC3	14	14	0	2	253.44	506.88	15	1	0.485057471264368	1	1	0.5	2	28
TACR1	1	2	0	0	84.48	168.96	15	1	1	NA	1	NA	0	3
TACR3	4	7	2	0	112.2	224.4	15	1	0.192307692307692	-Inf	1	-0.636363636363636	2	11
TADA1	2	4	2	1	110.55	221.1	15	1	0.523809523809524	-3	1	-0.333333333333333	3	6
TADA2A	1	6	0	1	137.28	274.56	15	1	1	1	1	0.142857142857143	1	7
TADA2B	0	2	0	0	89.43	178.86	15	1	1	NA	1	NA	0	2
TADA3	0	2	0	1	38.28	76.56	15	1	1	NA	1	0	1	2
TAF10	0	2	0	0	33.33	66.66	15	1	1	NA	1	NA	0	2
TAF11	0	2	0	1	41.25	82.5	15	1	1	NA	1	0	1	2
TAF12	0	2	0	0	14.19	28.38	15	1	1	NA	1	NA	0	2
TAF15	3	5	0	1	138.93	277.86	15	1	1	1	1	0.375	1	8
TAF1A	10	2	0	0	54.45	108.9	15	1	1	NA	1	NA	0	12
TAF1B	6	5	1	0	166.98	333.96	15	1	1	-Inf	1	-0.454545454545455	1	11
TAF1D	8	5	2	2	119.79	239.58	15	1	1	0.375	1	0.115384615384615	4	13
TAF2	3	15	1	2	506.22	1012.44	15	1	0.488721804511278	-1.5	1	-0.166666666666667	3	18
TAF3	2	7	0	1	232.32	464.64	15	1	1	1	1	0.222222222222222	1	9
TAF4	0	9	0	1	268.95	537.9	15	1	1	NA	1	0	1	9
TAF4B	6	9	1	2	206.25	412.5	15	1	1	0.25	1	0.0666666666666667	3	15
TAF5	0	8	0	0	163.35	326.7	15	1	1	NA	1	NA	0	8
TAF5L	0	10	0	2	178.2	356.4	15	1	1	NA	1	0	2	10
TAF6-TAF6L	0	1	0	1	38.28	76.56	15	1	1	NA	1	0	1	1
TAF8	1	7	1	2	91.74	183.48	15	1	0.490909090909091	-2.5	1	-0.208333333333333	3	8
TAF9	1	6	0	0	47.19	94.38	15	1	1	NA	1	NA	0	7
TAGAP	3	5	0	1	179.19	358.38	15	1	1	1	1	0.375	1	8
TAGLN3	0	2	0	0	56.76	113.52	15	1	1	NA	1	NA	0	2
TAL1	0	2	0	0	33.33	66.66	15	1	1	NA	1	NA	0	2
TALDO1	2	6	1	1	123.09	246.18	15	1	1	-2	1	-0.25	2	8
TAMM41	1	5	0	1	96.69	193.38	15	1	1	1	1	0.166666666666667	1	6
TANC1	20	21	1	2	632.61	1265.22	15	1	1	0.475	1	0.154471544715447	3	41
TANC2	10	21	2	11	553.41	1106.82	15	1	0.459182045726231	0.618181818181818	1	0.168734491315136	13	31
TANK	3	4	1	1	148.5	297	15	1	1	-0.333333333333333	1	-0.0714285714285715	2	7
TAOK1	1	5	1	0	332.97	665.94	15	1	0.285714285714286	-Inf	1	-0.833333333333333	1	6
TAOK3	0	7	0	2	216.48	432.96	15	1	1	NA	1	0	2	7
TAP1	0	1	0	1	2.31	4.62	15	1	1	NA	1	0	1	1
TAP2	5	8	0	2	92.73	185.46	15	1	0.523809523809524	1	1	0.384615384615385	2	13
TAPBPL	10	3	2	1	101.97	203.94	15	1	1	0.4	1	0.102564102564103	3	13
TAPT1	0	6	0	1	167.64	335.28	15	1	1	NA	1	0	1	6
TARBP1	16	23	1	2	417.45	834.9	15	1	1	0.28125	1	0.0769230769230769	3	39
TARP	12	4	1	2	36.96	73.92	15	1	0.2218782249742	0.833333333333333	1	0.416666666666667	3	16
TARS	0	10	0	0	170.28	340.56	15	1	1	NA	1	NA	0	10
TARSL2	3	8	1	0	181.17	362.34	15	1	0.333333333333333	-Inf	1	-0.727272727272727	1	11
TAS1R1	5	15	0	0	237.27	474.54	15	1	1	NA	1	NA	0	20
TAS1R3	12	16	4	1	252.12	504.24	15	1	0.174840732126605	-4.33333333333333	1	-0.371428571428571	5	28
TAT	0	10	0	1	177.54	355.08	15	1	1	NA	1	0	1	10
TATDN1	2	3	1	2	69.63	139.26	15	1	1	0.25	1	0.0666666666666667	3	5
TATDN3	1	2	1	1	51.48	102.96	15	1	1	-1	1	-0.166666666666667	2	3
TAX1BP3	0	3	0	0	46.2	92.4	15	1	1	NA	1	NA	0	3
TBC1D13	0	8	0	1	140.58	281.16	15	1	1	NA	1	0	1	8
TBC1D14	1	7	0	1	233.97	467.94	15	1	1	1	1	0.125	1	8
TBC1D15	3	11	1	2	196.68	393.36	15	1	1	-0.833333333333333	1	-0.119047619047619	3	14
TBC1D16	1	11	1	2	210.21	420.42	15	1	0.371428571428571	-4.5	1	-0.25	3	12
TBC1D19	0	6	0	0	153.45	306.9	15	1	1	NA	1	NA	0	6
TBC1D2	5	11	1	2	247.5	495	15	1	1	-0.1	1	-0.0208333333333333	3	16
TBC1D22A	5	7	1	0	139.59	279.18	15	1	0.461538461538462	-Inf	1	-0.583333333333333	1	12
TBC1D22B	0	6	0	4	117.48	234.96	15	1	1	NA	1	0	4	6
TBC1D23	6	27	1	2	532.95	1065.9	15	1	0.488235294117647	-1.25	1	-0.151515151515151	3	33
TBC1D24	1	5	1	2	216.48	432.96	15	1	1	-1.5	1	-0.166666666666667	3	6
TBC1D24L	5	8	0	3	149.49	298.98	15	1	0.508928571428571	1	1	0.384615384615385	3	13
TBC1D2B	2	7	0	3	281.16	562.32	15	1	1	1	1	0.222222222222222	3	9
TBC1D30	5	20	0	2	280.17	560.34	15	1	1	1	1	0.2	2	25
TBC1D31	12	8	1	1	359.37	718.74	15	1	1	0.333333333333333	1	0.1	2	20
TBC1D32	11	12	2	1	323.07	646.14	15	1	1	-1.18181818181818	1	-0.188405797101449	3	23
TBC1D4	2	11	1	0	345.84	691.68	15	1	0.214285714285714	-Inf	1	-0.846153846153846	1	13
TBC1D7	1	4	0	0	58.74	117.48	15	1	1	NA	1	NA	0	5
TBC1D8	7	22	2	4	387.09	774.18	15	1	0.635267010029818	-0.571428571428571	1	-0.0919540229885057	6	29
TBC1D8B	4	13	2	0	333.96	667.92	15	1	0.087719298245614	-Inf	1	-0.764705882352941	2	17
TBC1D9	5	12	1	2	396.99	793.98	15	1	1	-0.2	1	-0.0392156862745098	3	17
TBC1D9B	1	15	0	1	386.1	772.2	15	1	1	1	1	0.0625	1	16
TBCC	0	2	0	1	35.97	71.94	15	1	1	NA	1	0	1	2
TBCCD1	3	4	2	0	136.62	273.24	15	1	0.444444444444445	-Inf	1	-0.571428571428571	2	7
TBCE	4	5	0	0	170.61	341.22	15	1	1	NA	1	NA	0	9
TBCEL	0	3	0	1	110.55	221.1	15	1	1	NA	1	0	1	3
TBCK	1	5	0	0	179.52	359.04	15	1	1	NA	1	NA	0	6
TBK1	4	11	4	1	211.53	423.06	15	1	0.108875128998968	-10	1	-0.533333333333333	5	15
TBL1X	0	5	0	1	159.72	319.44	15	1	1	NA	1	0	1	5
TBL1XR1	0	3	0	1	178.2	356.4	15	1	1	NA	1	0	1	3
TBL3	8	25	3	7	257.73	515.46	15	1	0.698275697531118	-0.339285714285714	1	-0.0575757575757576	10	33
TBP	0	3	0	0	93.72	187.44	15	1	1	NA	1	NA	0	3
TBPL2	5	10	2	3	96.03	192.06	15	1	1	-0.333333333333333	1	-0.0666666666666667	5	15
TBRG4	0	5	0	2	38.28	76.56	15	1	1	NA	1	0	2	5
TBX1	1	1	1	0	33.33	66.66	15	1	1	-Inf	1	-0.5	1	2
TBX19	4	3	3	0	103.29	206.58	15	1	0.475	-Inf	1	-0.428571428571429	3	7
TBX22	0	2	0	1	69.63	139.26	15	1	1	NA	1	0	1	2
TBX4	0	8	0	2	147.51	295.02	15	1	1	NA	1	0	2	8
TBX5	1	8	1	2	94.38	188.76	15	1	0.454545454545454	-3	1	-0.222222222222222	3	9
TBXA2R	0	4	0	1	41.25	82.5	15	1	1	NA	1	0	1	4
TBXAS1	4	3	0	0	77.88	155.76	15	1	1	NA	1	NA	0	7
TC2N	5	6	0	1	177.87	355.74	15	1	1	1	1	0.454545454545455	1	11
TCAIM	1	2	1	0	117.15	234.3	15	1	1	-Inf	1	-0.666666666666667	1	3
TCEA1	0	2	0	0	89.76	179.52	15	1	1	NA	1	NA	0	2
TCEA2	3	7	1	1	75.24	150.48	15	1	1	-1.33333333333333	1	-0.2	2	10
TCEA3	0	1	0	1	3.96	7.92	15	1	1	NA	1	0	1	1
TCEANC	9	3	1	0	117.81	235.62	15	1	1	-Inf	1	-0.25	1	12
TCEANC2	1	2	1	0	46.53	93.06	15	1	1	-Inf	1	-0.666666666666667	1	3
TCEB3	3	0	0	0	13.53	27.06	15	1	1	NA	1	NA	0	3
TCERG1	0	6	0	1	283.47	566.94	15	1	1	NA	1	0	1	6
TCERG1L	8	10	1	1	194.04	388.08	15	1	1	-0.25	1	-0.0555555555555556	2	18
TCF12	2	7	1	2	166.98	333.96	15	1	1	-0.75	1	-0.111111111111111	3	9
TCF20	6	41	3	7	573.54	1147.08	15	1	0.184419256970224	-1.92857142857143	1	-0.172340425531915	10	47
TCF24	2	4	1	2	31.35	62.7	15	1	1	0	1	0	3	6
TCF25	3	12	2	4	177.54	355.08	15	1	0.597523219814242	-1	1	-0.133333333333333	6	15
TCF7	0	3	0	1	54.78	109.56	15	1	1	NA	1	0	1	3
TCF7L2	0	2	0	2	84.81	169.62	15	1	1	NA	1	0	2	2
TCFL5	5	3	0	1	165.66	331.32	15	1	0.444444444444444	1	1	0.625	1	8
TCHP	8	3	5	1	73.92	147.84	15	1	1	-0.875	1	-0.106060606060606	6	11
TCIRG1	1	1	1	0	26.4	52.8	15	1	1	-Inf	1	-0.5	1	2
TCP1	1	9	1	2	176.55	353.1	15	1	0.423076923076923	-3.5	1	-0.233333333333333	3	10
TCP11	6	9	5	1	119.79	239.58	15	1	0.148606811145511	-6.5	1	-0.433333333333333	6	15
TCP11L1	4	9	2	3	194.37	388.74	15	1	1	-0.5	1	-0.0923076923076923	5	13
TCP11L2	4	4	1	0	122.43	244.86	15	1	1	-Inf	1	-0.5	1	8
TCTE1	13	7	3	2	147.51	295.02	15	1	1	0.192307692307692	1	0.05	5	20
TCTEX1D4	2	1	0	0	40.26	80.52	15	1	1	NA	1	NA	0	3
TCTN1	8	6	2	0	175.89	351.78	15	1	0.5	-Inf	1	-0.428571428571429	2	14
TCTN2	2	11	0	2	170.94	341.88	15	1	1	1	1	0.153846153846154	2	13
TCTN3	7	10	2	0	190.08	380.16	15	1	0.210526315789474	-Inf	1	-0.588235294117647	2	17
TDG	3	3	1	0	104.28	208.56	15	1	1	-Inf	1	-0.5	1	6
TDH	3	7	0	0	108.57	217.14	15	1	1	NA	1	NA	0	10
TDO2	0	8	0	0	147.51	295.02	15	1	1	NA	1	NA	0	8
TDP1	8	15	4	5	216.15	432.3	15	1	0.695986994096004	-0.5	1	-0.0966183574879227	9	23
TDP2	1	6	0	0	110.22	220.44	15	1	1	NA	1	NA	0	7
TDRD1	13	15	5	1	305.91	611.82	15	1	0.180149661239761	-4.76923076923077	1	-0.369047619047619	6	28
TDRD12	28	13	2	0	461.34	922.68	15	1	1	-Inf	1	-0.317073170731707	2	41
TDRD3	8	9	2	0	290.4	580.8	15	1	0.473684210526316	-Inf	1	-0.529411764705882	2	17
TDRD5	16	18	2	2	231.99	463.98	15	1	1	-0.125	1	-0.0294117647058824	4	34
TDRD6	54	64	7	3	709.17	1418.34	15	1	0.191560565083902	-1.76543209876543	1	-0.242372881355932	10	118
TDRD7	12	17	1	6	259.05	518.1	15	1	0.382205355260384	0.763888888888889	1	0.270935960591133	7	29
TDRD9	15	11	1	1	442.53	885.06	15	1	1	0.266666666666667	1	0.0769230769230769	2	26
TEAD1	13	8	2	1	203.28	406.56	15	1	1	-0.230769230769231	1	-0.0476190476190476	3	21
TEAD4	6	7	1	0	174.24	348.48	15	1	1	-Inf	1	-0.538461538461538	1	13
TEC	2	10	0	1	180.18	360.36	15	1	1	1	1	0.166666666666667	1	12
TECPR1	7	14	2	1	346.5	693	15	1	0.533102766798419	-3	1	-0.333333333333333	3	21
TECPR2	5	13	1	0	506.22	1012.44	15	1	0.315789473684211	-Inf	1	-0.722222222222222	1	18
TECRL	2	4	0	0	109.56	219.12	15	1	1	NA	1	NA	0	6
TECTA	8	47	5	21	470.25	940.5	15	1	0.746770289757067	-0.398809523809524	1	-0.0468531468531469	26	55
TECTB	2	5	1	0	105.93	211.86	15	1	0.375	-Inf	1	-0.714285714285714	1	7
TEF	1	2	1	1	116.16	232.32	15	1	1	-1	1	-0.166666666666667	2	3
TEK	2	12	0	0	301.29	602.58	15	1	1	NA	1	NA	0	14
TEKT1	3	5	1	0	181.17	362.34	15	1	0.444444444444444	-Inf	1	-0.625	1	8
TEKT2	2	6	1	1	138.27	276.54	15	1	1	-2	1	-0.25	2	8
TEKT3	2	6	0	4	123.75	247.5	15	1	0.515151515151515	1	1	0.25	4	8
TEKT4	2	4	1	1	118.14	236.28	15	1	1	-1	1	-0.166666666666667	2	6
TEKT5	1	6	1	0	111.54	223.08	15	1	0.25	-Inf	1	-0.857142857142857	1	7
TELO2	7	14	4	4	191.07	382.14	15	1	0.432745165878599	-1	1	-0.166666666666667	8	21
TEN1	6	7	1	2	55.77	111.54	15	1	1	0.416666666666667	1	0.128205128205128	3	13
TENM1	6	33	0	5	759.66	1519.32	15	1	1	1	1	0.153846153846154	5	39
TENM2	2	30	1	8	762.96	1525.92	15	1	0.534709193245778	-0.875	1	-0.0486111111111111	9	32
TENM3	0	32	0	5	826.65	1653.3	15	1	1	NA	1	0	5	32
TENM4	3	58	3	11	1025.97	2051.94	15	1	0.0747782511432907	-4.27272727272727	1	-0.165105386416862	14	61
TERAL2-VCP	0	8	0	5	193.38	386.76	15	1	1	NA	1	0	5	8
TERB2	2	8	0	1	86.79	173.58	15	1	1	1	1	0.2	1	10
TERF1	10	3	0	1	71.61	143.22	15	1	0.285714285714286	1	1	0.769230769230769	1	13
TERF2	2	11	0	3	103.95	207.9	15	1	1	1	1	0.153846153846154	3	13
TERF2IP	7	4	2	1	64.68	129.36	15	1	1	-0.142857142857143	1	-0.0303030303030303	3	11
TERT	20	20	3	1	349.8	699.6	15	1	0.608621667612025	-2	1	-0.25	4	40
TES	0	2	0	1	126.39	252.78	15	1	1	NA	1	0	1	2
TESC	0	1	0	1	22.77	45.54	15	1	1	NA	1	0	1	1
TESK1	4	2	1	0	36.63	73.26	15	1	1	-Inf	1	-0.333333333333333	1	6
TESK2	6	4	0	0	229.68	459.36	15	1	1	NA	1	NA	0	10
TESMIN	5	5	2	0	158.73	317.46	15	1	0.46969696969697	-Inf	1	-0.5	2	10
TESPA1	0	1	0	1	7.26	14.52	15	1	1	NA	1	0	1	1
TET1	15	25	1	2	665.94	1331.88	15	1	1	0.166666666666667	1	0.0416666666666667	3	40
TET2	17	25	3	4	566.94	1133.88	15	1	1	-0.102941176470588	1	-0.0238095238095238	7	42
TET3	6	18	0	1	276.54	553.08	15	1	1	1	1	0.25	1	24
TEX10	2	14	1	2	273.9	547.8	15	1	0.422084623323013	-2.5	1	-0.208333333333333	3	16
TEX11	5	6	2	2	245.85	491.7	15	1	1	-0.2	1	-0.0454545454545455	4	11
TEX14	32	16	6	3	479.82	959.64	15	1	1	0	1	0	9	48
TEX2	7	17	2	5	398.97	797.94	15	1	1	0.0285714285714286	1	0.00595238095238099	7	24
TEX264	1	6	0	2	66.99	133.98	15	1	1	1	1	0.142857142857143	2	7
TEX2L	11	20	7	5	156.09	312.18	15	1	0.301377777435335	-1.54545454545455	1	-0.228494623655914	12	31
TEX30	0	3	0	0	62.37	124.74	15	1	1	NA	1	NA	0	3
TEX33	7	4	0	2	115.83	231.66	15	1	0.192307692307692	1	1	0.636363636363636	2	11
TEX36	2	2	1	0	61.38	122.76	15	1	1	-Inf	1	-0.5	1	4
TEX9	7	3	1	0	99.99	199.98	15	1	1	-Inf	1	-0.3	1	10
TF	3	8	1	2	247.83	495.66	15	1	1	-0.333333333333333	1	-0.0606060606060606	3	11
TFAM	2	2	0	1	55.77	111.54	15	1	1	1	1	0.5	1	4
TFAP2B	0	2	0	0	91.74	183.48	15	1	1	NA	1	NA	0	2
TFAP2C	0	3	0	1	65.34	130.68	15	1	1	NA	1	0	1	3
TFAP2D	0	2	0	0	61.05	122.1	15	1	1	NA	1	NA	0	2
TFAP2E	0	4	0	0	62.7	125.4	15	1	1	NA	1	NA	0	4
TFB1M	1	5	0	1	127.38	254.76	15	1	1	1	1	0.166666666666667	1	6
TFCP2L1	0	4	0	1	158.4	316.8	15	1	1	NA	1	0	1	4
TFDP1	0	7	0	0	134.97	269.94	15	1	1	NA	1	NA	0	7
TFDP2	3	6	2	0	182.49	364.98	15	1	0.181818181818182	-Inf	1	-0.666666666666667	2	9
TFEB	0	1	0	1	53.13	106.26	15	1	1	NA	1	0	1	1
TFEC	6	1	1	0	115.17	230.34	15	1	1	-Inf	1	-0.142857142857143	1	7
TFF2	1	2	0	0	46.86	93.72	15	1	1	NA	1	NA	0	3
TFG	0	3	0	0	84.81	169.62	15	1	1	NA	1	NA	0	3
TFIP11	2	11	0	0	196.35	392.7	15	1	1	NA	1	NA	0	13
TFPI	4	6	0	3	99.99	199.98	15	1	0.496503496503497	1	1	0.4	3	10
TFRC	5	15	0	4	246.51	493.02	15	1	0.544042913608131	1	1	0.25	4	20
TGDS	4	5	0	1	106.92	213.84	15	1	1	1	1	0.444444444444444	1	9
TGFA	1	0	1	0	5.61	11.22	15	1	1	NA	1	0	1	1
TGFB2	0	3	0	0	121.11	242.22	15	1	1	NA	1	NA	0	3
TGFB3	0	8	0	1	100.65	201.3	15	1	1	NA	1	0	1	8
TGFBI	0	16	0	3	224.07	448.14	15	1	1	NA	1	0	3	16
TGFBR1	1	6	1	1	148.5	297	15	1	0.416666666666667	-5	1	-0.357142857142857	2	7
TGFBR2	0	10	0	5	208.89	417.78	15	1	1	NA	1	0	5	10
TGFBR3	7	11	1	1	272.58	545.16	15	1	1	-0.571428571428571	1	-0.111111111111111	2	18
TGFBRAP1	3	13	1	3	329.34	658.68	15	1	1	-0.444444444444444	1	-0.0625	4	16
TGIF1	2	8	0	1	111.54	223.08	15	1	1	1	1	0.2	1	10
TGM2	4	8	1	5	82.17	164.34	15	1	0.61484593837535	0.6	1	0.166666666666667	6	12
TGM4	4	8	0	1	192.72	385.44	15	1	1	1	1	0.333333333333333	1	12
TGS1	10	12	3	1	282.48	564.96	15	1	0.59304347826087	-2.6	1	-0.295454545454545	4	22
TH	1	6	1	2	143.55	287.1	15	1	1	-2	1	-0.19047619047619	3	7
THAP12	3	11	1	6	251.13	502.26	15	1	1	0.388888888888889	1	0.0714285714285714	7	14
THAP4	3	7	1	2	153.78	307.56	15	1	1	-0.166666666666667	1	-0.0333333333333333	3	10
THAP5	6	6	1	1	133.65	267.3	15	1	1	0	1	0	2	12
THBD	4	4	0	1	49.17	98.34	15	1	1	1	1	0.5	1	8
THBS2	1	22	0	1	472.23	944.46	15	1	1	1	1	0.0434782608695652	1	23
THBS4	5	7	2	0	262.35	524.7	15	1	0.461538461538462	-Inf	1	-0.583333333333333	2	12
THEMIS	6	9	1	1	254.76	509.52	15	1	1	-0.5	1	-0.1	2	15
THEMIS2	5	3	0	0	85.47	170.94	15	1	1	NA	1	NA	0	8
THG1L	3	8	2	1	77.22	154.44	15	1	0.505494505494505	-4.33333333333333	1	-0.393939393939394	3	11
THL	3	7	0	0	97.68	195.36	15	1	1	NA	1	NA	0	10
THNSL2	2	8	1	0	157.08	314.16	15	1	0.272727272727273	-Inf	1	-0.8	1	10
THOC1	1	10	0	1	190.41	380.82	15	1	1	1	1	0.0909090909090909	1	11
THOC2	2	12	0	0	388.41	776.82	15	1	1	NA	1	NA	0	14
THOC3	0	1	0	1	66.99	133.98	15	1	1	NA	1	0	1	1
THOC5	0	4	0	1	59.73	119.46	15	1	1	NA	1	0	1	4
THOC7	0	2	0	0	50.49	100.98	15	1	1	NA	1	NA	0	2
THOP1	1	10	0	5	170.61	341.22	15	1	1	1	1	0.0909090909090909	5	11
THPO	3	0	1	0	24.75	49.5	15	1	1	NA	1	0	1	3
THRAP3	1	9	0	1	234.63	469.26	15	1	1	1	1	0.1	1	10
THRB	1	8	1	7	152.13	304.26	15	1	1	-0.142857142857143	1	-0.0138888888888889	8	9
THSD1	11	18	2	4	287.76	575.52	15	1	1	0.181818181818182	1	0.0459770114942529	6	29
THSD4	1	11	1	4	182.16	364.32	15	1	0.514705882352941	-1.75	1	-0.116666666666667	5	12
THSD7A	5	11	1	0	300.96	601.92	15	1	0.352941176470588	-Inf	1	-0.6875	1	16
THSD7B	15	18	3	4	334.62	669.24	15	1	1	0.1	1	0.025974025974026	7	33
THT2L	5	14	0	2	213.84	427.68	15	1	1	1	1	0.263157894736842	2	19
THUMPD1	1	3	0	0	78.21	156.42	15	1	1	NA	1	NA	0	4
THUMPD2	11	17	2	5	139.26	278.52	15	1	0.688886344304129	0.381818181818182	1	0.107142857142857	7	28
THUMPD3	3	6	0	0	89.76	179.52	15	1	1	NA	1	NA	0	9
THY1	1	1	1	0	12.87	25.74	15	1	1	-Inf	1	-0.5	1	2
THYN1	0	3	0	1	70.62	141.24	15	1	1	NA	1	0	1	3
TIA1	0	5	0	3	84.15	168.3	15	1	1	NA	1	0	3	5
TIAM1	10	23	6	3	471.9	943.8	15	1	0.0628166056694336	-3.6	1	-0.363636363636364	9	33
TIAM2	8	27	2	3	609.51	1219.02	15	1	0.583515701936755	-1.25	1	-0.171428571428571	5	35
TICAM1	21	9	3	1	186.78	373.56	15	1	1	-0.285714285714286	1	-0.05	4	30
TICRR	41	43	7	8	518.1	1036.2	15	1	1	0.0823170731707317	1	0.0214285714285714	15	84
TIE1	2	22	2	2	256.41	512.82	15	1	0.0856166056166056	-10	1	-0.416666666666667	4	24
TIFA	1	5	1	0	40.59	81.18	15	1	0.285714285714286	-Inf	1	-0.833333333333333	1	6
TIMD4	5	5	0	0	102.3	204.6	15	1	1	NA	1	NA	0	10
TIMM17A	1	5	0	1	31.35	62.7	15	1	1	1	1	0.166666666666667	1	6
TIMM22	0	5	0	1	33.66	67.32	15	1	1	NA	1	0	1	5
TIMM44	1	5	0	1	141.24	282.48	15	1	1	1	1	0.166666666666667	1	6
TIMM9	0	2	0	0	22.44	44.88	15	1	1	NA	1	NA	0	2
TIMMDC1	5	4	1	1	75.24	150.48	15	1	1	0.2	1	0.0555555555555556	2	9
TIMP2	0	2	0	1	18.48	36.96	15	1	1	NA	1	0	1	2
TINAG	2	3	0	0	135.63	271.26	15	1	1	NA	1	NA	0	5
TIPARP	7	12	0	4	204.27	408.54	15	1	0.272727272727273	1	1	0.368421052631579	4	19
TIPIN	2	4	0	0	79.2	158.4	15	1	1	NA	1	NA	0	6
TIPRL	2	0	1	0	65.67	131.34	15	1	1	NA	1	0	1	2
TJAP1	13	14	4	4	265.32	530.64	15	1	1	-0.0769230769230769	1	-0.0185185185185185	8	27
TJP1	2	19	0	4	484.77	969.54	15	1	1	1	1	0.0952380952380952	4	21
TJP2	2	7	0	0	169.29	338.58	15	1	1	NA	1	NA	0	9
TJP3	4	9	1	4	159.39	318.78	15	1	1	0.4375	1	0.107692307692308	5	13
TKFC	2	3	0	1	33.66	67.32	15	1	1	1	1	0.4	1	5
TKT	1	9	0	1	193.05	386.1	15	1	1	1	1	0.1	1	10
TLCD1	1	0	1	0	16.5	33	15	1	1	NA	1	0	1	1
TLDC1	5	7	1	1	126.72	253.44	15	1	1	-0.4	1	-0.0833333333333333	2	12
TLE1	1	4	0	0	186.12	372.24	15	1	1	NA	1	NA	0	5
TLE3	1	7	1	6	80.19	160.38	15	1	1	-0.166666666666667	1	-0.0178571428571428	7	8
TLE4Z1	2	6	0	0	213.51	427.02	15	1	1	NA	1	NA	0	8
TLK1	1	2	0	0	167.97	335.94	15	1	1	NA	1	NA	0	3
TLL1	3	8	1	0	276.54	553.08	15	1	0.333333333333333	-Inf	1	-0.727272727272727	1	11
TLL2	5	6	0	1	330.99	661.98	15	1	1	1	1	0.454545454545455	1	11
TLN1	1	23	1	4	349.14	698.28	15	1	0.320197044334976	-4.75	1	-0.158333333333333	5	24
TLN2	4	31	0	1	865.92	1731.84	15	1	1	1	1	0.114285714285714	1	35
TLR2B	8	3	0	1	152.13	304.26	15	1	0.333333333333333	1	1	0.727272727272727	1	11
TLR3	6	9	1	0	248.82	497.64	15	1	0.4375	-Inf	1	-0.6	1	15
TLR4	9	11	2	3	225.06	450.12	15	1	1	0.185185185185185	1	0.05	5	20
TLR7	9	23	3	1	442.53	885.06	15	1	0.0980392156862745	-6.66666666666667	1	-0.46875	4	32
TLX3	0	2	0	2	7.26	14.52	15	1	1	NA	1	0	2	2
TM2D3	0	2	0	1	69.63	139.26	15	1	1	NA	1	0	1	2
TM4SF1	1	3	0	0	124.08	248.16	15	1	1	NA	1	NA	0	4
TM4SF1a	6	3	2	1	65.01	130.02	15	1	1	0	1	0	3	9
TM4SF4	3	5	0	0	88.77	177.54	15	1	1	NA	1	NA	0	8
TM7SF3	5	10	0	0	165.66	331.32	15	1	1	NA	1	NA	0	15
TM9SF2	1	3	1	1	189.42	378.84	15	1	1	-2	1	-0.25	2	4
TM9SF2L	1	9	0	1	191.07	382.14	15	1	1	1	1	0.1	1	10
TM9SF3	0	9	0	1	188.76	377.52	15	1	1	NA	1	0	1	9
TM9SF4	0	10	0	3	190.08	380.16	15	1	1	NA	1	0	3	10
TMA16	5	2	0	0	42.57	85.14	15	1	1	NA	1	NA	0	7
TMBIM4	1	2	0	0	57.42	114.84	15	1	1	NA	1	NA	0	3
TMC1	2	4	1	0	66.33	132.66	15	1	0.428571428571428	-Inf	1	-0.666666666666667	1	6
TMC2	10	7	2	1	249.15	498.3	15	1	1	-0.4	1	-0.0784313725490196	3	17
TMC3	8	25	0	0	416.13	832.26	15	1	1	NA	1	NA	0	33
TMC5	15	12	0	1	240.57	481.14	15	1	0.464285714285714	1	1	0.555555555555556	1	27
TMC6	13	13	2	2	178.53	357.06	15	1	1	0	1	0	4	26
TMC7	6	7	0	0	179.19	358.38	15	1	1	NA	1	NA	0	13
TMCC1	0	5	0	0	145.53	291.06	15	1	1	NA	1	NA	0	5
TMCC2	1	5	1	3	69.3	138.6	15	1	1	-0.666666666666667	1	-0.0833333333333333	4	6
TMCC3	2	6	0	0	162.03	324.06	15	1	1	NA	1	NA	0	8
TMCO1	1	2	0	1	53.46	106.92	15	1	1	1	1	0.333333333333333	1	3
TMCO3	1	10	0	0	172.26	344.52	15	1	1	NA	1	NA	0	11
TMCO4	8	18	1	4	184.8	369.6	15	1	1	0.4375	1	0.107692307692308	5	26
TMCO6	4	2	0	1	74.25	148.5	15	1	0.428571428571429	1	1	0.666666666666667	1	6
TMCO7	11	12	3	9	164.01	328.02	15	1	0.281635150166852	0.636363636363636	1	0.228260869565217	12	23
TMED11	0	4	0	0	57.75	115.5	15	1	1	NA	1	NA	0	4
TMED5	0	2	0	0	52.8	105.6	15	1	1	NA	1	NA	0	2
TMED6	5	4	1	1	46.53	93.06	15	1	1	0.2	1	0.0555555555555556	2	9
TMED8	2	3	0	0	98.67	197.34	15	1	1	NA	1	NA	0	5
TMEFF1	1	4	0	1	114.84	229.68	15	1	1	1	1	0.2	1	5
TMEFF2	4	8	1	0	115.5	231	15	1	0.384615384615385	-Inf	1	-0.666666666666667	1	12
TMEM100	0	3	0	1	46.2	92.4	15	1	1	NA	1	0	1	3
TMEM104	3	6	1	1	108.24	216.48	15	1	1	-1	1	-0.166666666666667	2	9
TMEM106B	0	4	0	0	63.69	127.38	15	1	1	NA	1	NA	0	4
TMEM106C	1	4	0	1	29.37	58.74	15	1	1	1	1	0.2	1	5
TMEM108	3	4	1	3	98.67	197.34	15	1	1	0.555555555555556	1	0.178571428571429	4	7
TMEM11	1	2	1	1	53.46	106.92	15	1	1	-1	1	-0.166666666666667	2	3
TMEM114	3	1	0	0	43.23	86.46	15	1	1	NA	1	NA	0	4
TMEM116	4	3	2	0	105.93	211.86	15	1	0.5	-Inf	1	-0.428571428571429	2	7
TMEM117	2	3	1	0	38.61	77.22	15	1	1	-Inf	1	-0.6	1	5
TMEM120B	1	1	1	0	89.43	178.86	15	1	1	-Inf	1	-0.5	1	2
TMEM121	1	6	0	5	111.54	223.08	15	1	1	1	1	0.142857142857143	5	7
TMEM121L	3	5	1	2	79.86	159.72	15	1	1	0.166666666666667	1	0.0416666666666667	3	8
TMEM123	10	5	1	0	54.78	109.56	15	1	1	-Inf	1	-0.333333333333333	1	15
TMEM125	1	3	1	1	22.11	44.22	15	1	1	-2	1	-0.25	2	4
TMEM126A	3	3	0	0	76.56	153.12	15	1	1	NA	1	NA	0	6
TMEM129	4	4	1	0	87.78	175.56	15	1	1	-Inf	1	-0.5	1	8
TMEM130	7	3	1	0	162.03	324.06	15	1	1	-Inf	1	-0.3	1	10
TMEM131	10	20	2	1	566.61	1133.22	15	1	0.538123167155425	-3	1	-0.333333333333333	3	30
TMEM132A	2	3	0	2	38.28	76.56	15	1	1	1	1	0.4	2	5
TMEM132C	7	7	0	2	181.5	363	15	1	0.475	1	1	0.5	2	14
TMEM132D	4	8	1	1	286.11	572.22	15	1	1	-1	1	-0.166666666666667	2	12
TMEM132E	1	3	1	0	118.8	237.6	15	1	0.4	-Inf	1	-0.75	1	4
TMEM135	0	5	0	2	80.19	160.38	15	1	1	NA	1	0	2	5
TMEM136-1	5	2	3	0	42.9	85.8	15	1	1	-Inf	1	-0.285714285714286	3	7
TMEM136-2	5	5	3	2	74.91	149.82	15	1	1	-0.5	1	-0.1	5	10
TMEM139	2	1	0	0	52.47	104.94	15	1	1	NA	1	NA	0	3
TMEM144	4	6	0	1	107.58	215.16	15	1	1	1	1	0.4	1	10
TMEM14A	2	1	0	0	35.31	70.62	15	1	1	NA	1	NA	0	3
TMEM14C	0	1	0	1	22.11	44.22	15	1	1	NA	1	0	1	1
TMEM150A	0	1	0	1	30.03	60.06	15	1	1	NA	1	0	1	1
TMEM150C	1	8	0	0	62.7	125.4	15	1	1	NA	1	NA	0	9
TMEM151B	0	4	0	4	93.39	186.78	15	1	1	NA	1	0	4	4
TMEM154	3	6	0	0	62.04	124.08	15	1	1	NA	1	NA	0	9
TMEM156	4	4	0	0	88.77	177.54	15	1	1	NA	1	NA	0	8
TMEM161A	3	5	2	4	49.17	98.34	15	1	1	0.166666666666667	1	0.0416666666666667	6	8
TMEM161B	0	4	0	0	127.38	254.76	15	1	1	NA	1	NA	0	4
TMEM163	5	4	0	0	94.05	188.1	15	1	1	NA	1	NA	0	9
TMEM164	1	3	1	0	83.16	166.32	15	1	0.4	-Inf	1	-0.75	1	4
TMEM165	1	6	0	2	89.43	178.86	15	1	1	1	1	0.142857142857143	2	7
TMEM168	1	11	1	1	256.08	512.16	15	1	0.274725274725275	-10	1	-0.416666666666667	2	12
TMEM169	0	4	0	1	91.74	183.48	15	1	1	NA	1	0	1	4
TMEM17	4	0	1	0	53.13	106.26	15	1	1	NA	1	0	1	4
TMEM173	5	6	1	3	53.46	106.92	15	1	0.604395604395604	0.6	1	0.204545454545455	4	11
TMEM174	12	7	3	0	145.53	291.06	15	1	0.522727272727273	-Inf	1	-0.368421052631579	3	19
TMEM175	1	6	0	1	124.08	248.16	15	1	1	1	1	0.142857142857143	1	7
TMEM177	4	2	1	0	115.17	230.34	15	1	1	-Inf	1	-0.333333333333333	1	6
TMEM178B	0	2	0	1	37.95	75.9	15	1	1	NA	1	0	1	2
TMEM18	1	1	1	0	23.43	46.86	15	1	1	-Inf	1	-0.5	1	2
TMEM181	2	8	0	1	129.03	258.06	15	1	1	1	1	0.2	1	10
TMEM182L	2	5	1	1	54.78	109.56	15	1	1	-1.5	1	-0.214285714285714	2	7
TMEM184A	2	6	0	0	92.07	184.14	15	1	1	NA	1	NA	0	8
TMEM184B	1	6	0	2	97.02	194.04	15	1	1	1	1	0.142857142857143	2	7
TMEM184C	1	9	1	1	148.83	297.66	15	1	0.318181818181818	-8	1	-0.4	2	10
TMEM186	6	7	1	1	76.89	153.78	15	1	1	-0.166666666666667	1	-0.0384615384615384	2	13
TMEM189	2	2	2	0	80.85	161.7	15	1	0.466666666666667	-Inf	1	-0.5	2	4
TMEM19	1	4	0	0	101.64	203.28	15	1	1	NA	1	NA	0	5
TMEM192	2	4	0	0	80.19	160.38	15	1	1	NA	1	NA	0	6
TMEM199	1	5	0	1	18.81	37.62	15	1	1	1	1	0.166666666666667	1	6
TMEM2	4	10	1	0	336.6	673.2	15	1	0.333333333333333	-Inf	1	-0.714285714285714	1	14
TMEM200A	3	10	1	0	191.4	382.8	15	1	0.285714285714286	-Inf	1	-0.769230769230769	1	13
TMEM200C	7	6	2	0	86.46	172.92	15	1	0.485714285714286	-Inf	1	-0.461538461538462	2	13
TMEM201	1	10	0	1	179.52	359.04	15	1	1	1	1	0.0909090909090909	1	11
TMEM206	2	2	1	0	82.5	165	15	1	1	-Inf	1	-0.5	1	4
TMEM207	1	4	0	1	40.26	80.52	15	1	1	1	1	0.2	1	5
TMEM213	3	2	0	0	28.38	56.76	15	1	1	NA	1	NA	0	5
TMEM215	1	6	0	1	42.57	85.14	15	1	1	1	1	0.142857142857143	1	7
TMEM216	1	1	1	0	7.26	14.52	15	1	1	-Inf	1	-0.5	1	2
TMEM218	3	1	0	0	18.15	36.3	15	1	1	NA	1	NA	0	4
TMEM220	2	5	0	0	29.37	58.74	15	1	1	NA	1	NA	0	7
TMEM221	0	1	0	1	17.82	35.64	15	1	1	NA	1	0	1	1
TMEM222	0	4	0	2	46.2	92.4	15	1	1	NA	1	0	2	4
TMEM234	1	1	0	0	24.42	48.84	15	1	1	NA	1	NA	0	2
TMEM237	1	6	1	0	149.82	299.64	15	1	0.25	-Inf	1	-0.857142857142857	1	7
TMEM238	1	2	0	0	10.89	21.78	15	1	1	NA	1	NA	0	3
TMEM246	2	8	0	2	91.08	182.16	15	1	1	1	1	0.2	2	10
TMEM248	0	5	0	2	122.76	245.52	15	1	1	NA	1	0	2	5
TMEM252	4	1	0	0	25.08	50.16	15	1	1	NA	1	NA	0	5
TMEM254	1	1	0	0	29.7	59.4	15	1	1	NA	1	NA	0	2
TMEM255A	2	8	0	2	190.08	380.16	15	1	1	1	1	0.2	2	10
TMEM255B	2	6	1	0	99	198	15	1	0.333333333333333	-Inf	1	-0.75	1	8
TMEM259	1	10	1	4	171.27	342.54	15	1	1	-1.5	1	-0.109090909090909	5	11
TMEM26	6	3	2	0	136.95	273.9	15	1	1	-Inf	1	-0.333333333333333	2	9
TMEM260	12	12	4	2	200.64	401.28	15	1	0.656704980842912	-1	1	-0.166666666666667	6	24
TMEM263	0	2	0	0	31.68	63.36	15	1	1	NA	1	NA	0	2
TMEM266	2	5	0	0	86.79	173.58	15	1	1	NA	1	NA	0	7
TMEM267	0	2	0	0	41.25	82.5	15	1	1	NA	1	NA	0	2
TMEM268	4	6	4	4	57.09	114.18	15	1	1	-0.5	1	-0.1	8	10
TMEM269	0	2	0	2	18.48	36.96	15	1	1	NA	1	0	2	2
TMEM27	2	2	0	0	84.48	168.96	15	1	1	NA	1	NA	0	4
TMEM272	1	4	1	1	62.7	125.4	15	1	1	-3	1	-0.3	2	5
TMEM30A	1	6	1	2	90.75	181.5	15	1	1	-2	1	-0.19047619047619	3	7
TMEM30CP	6	8	0	1	194.37	388.74	15	1	1	1	1	0.428571428571429	1	14
TMEM33	0	4	0	2	64.02	128.04	15	1	1	NA	1	0	2	4
TMEM35A	1	2	1	0	48.84	97.68	15	1	1	-Inf	1	-0.666666666666667	1	3
TMEM35B	1	1	1	0	10.89	21.78	15	1	1	-Inf	1	-0.5	1	2
TMEM37	1	4	0	1	39.93	79.86	15	1	1	1	1	0.2	1	5
TMEM38A	0	2	0	0	67.98	135.96	15	1	1	NA	1	NA	0	2
TMEM39A	1	4	1	0	175.23	350.46	15	1	0.333333333333333	-Inf	1	-0.8	1	5
TMEM39B	0	7	0	1	148.83	297.66	15	1	1	NA	1	0	1	7
TMEM40L	6	3	0	0	105.6	211.2	15	1	1	NA	1	NA	0	9
TMEM41A	0	4	0	1	48.84	97.68	15	1	1	NA	1	0	1	4
TMEM41B	0	3	0	1	54.45	108.9	15	1	1	NA	1	0	1	3
TMEM42	2	9	2	4	35.97	71.94	15	1	0.584033613445378	-1.25	1	-0.151515151515151	6	11
TMEM43	4	5	2	2	121.11	242.22	15	1	1	-0.25	1	-0.0555555555555556	4	9
TMEM45A	0	4	0	0	108.9	217.8	15	1	1	NA	1	NA	0	4
TMEM45B	2	2	1	0	96.36	192.72	15	1	1	-Inf	1	-0.5	1	4
TMEM45BL	3	1	3	0	63.36	126.72	15	1	1	-Inf	1	-0.25	3	4
TMEM47	0	2	0	0	33.99	67.98	15	1	1	NA	1	NA	0	2
TMEM5	2	3	1	0	112.2	224.4	15	1	1	-Inf	1	-0.6	1	5
TMEM50B	0	6	0	1	67.32	134.64	15	1	1	NA	1	0	1	6
TMEM51	2	1	2	1	56.76	113.52	15	1	1	0	1	0	3	3
TMEM52	5	2	0	0	42.9	85.8	15	1	1	NA	1	NA	0	7
TMEM52B	3	1	0	1	42.9	85.8	15	1	0.4	1	1	0.75	1	4
TMEM53	4	7	0	1	62.7	125.4	15	1	1	1	1	0.363636363636364	1	11
TMEM56	5	3	0	0	97.35	194.7	15	1	1	NA	1	NA	0	8
TMEM61	1	2	0	1	39.6	79.2	15	1	1	1	1	0.333333333333333	1	3
TMEM62	8	8	1	3	163.02	326.04	15	1	0.591331269349845	0.666666666666667	1	0.25	4	16
TMEM63C	5	14	2	2	151.14	302.28	15	1	0.557312252964427	-1.8	1	-0.236842105263158	4	19
TMEM68	3	5	0	0	81.18	162.36	15	1	1	NA	1	NA	0	8
TMEM68L	3	3	0	1	99.33	198.66	15	1	1	1	1	0.5	1	6
TMEM70	1	6	0	1	66.33	132.66	15	1	1	1	1	0.142857142857143	1	7
TMEM72	2	4	1	0	73.92	147.84	15	1	0.428571428571428	-Inf	1	-0.666666666666667	1	6
TMEM74	2	4	0	0	92.07	184.14	15	1	1	NA	1	NA	0	6
TMEM80	2	1	0	1	43.89	87.78	15	1	1	1	1	0.666666666666667	1	3
TMEM82	4	3	2	2	42.57	85.14	15	1	1	0.25	1	0.0714285714285714	4	7
TMEM86A	0	3	0	0	56.43	112.86	15	1	1	NA	1	NA	0	3
TMEM88B	3	2	1	0	51.81	103.62	15	1	1	-Inf	1	-0.4	1	5
TMEM8C	1	4	1	1	65.34	130.68	15	1	1	-3	1	-0.3	2	5
TMEM9	0	4	0	2	38.28	76.56	15	1	1	NA	1	0	2	4
TMEM94	4	24	0	3	466.95	933.9	15	1	1	1	1	0.142857142857143	3	28
TMEM97	1	2	1	1	38.61	77.22	15	1	1	-1	1	-0.166666666666667	2	3
TMEM98	1	4	1	0	37.95	75.9	15	1	0.333333333333333	-Inf	1	-0.8	1	5
TMEM9B	0	4	0	1	43.56	87.12	15	1	1	NA	1	0	1	4
TMF1	8	15	1	1	337.59	675.18	15	1	1	-0.875	1	-0.152173913043478	2	23
TMIE	0	3	0	1	48.51	97.02	15	1	1	NA	1	0	1	3
TMIGD1	3	4	2	3	68.64	137.28	15	1	1	0.111111111111111	1	0.0285714285714285	5	7
TMLHE	1	6	0	2	109.89	219.78	15	1	1	1	1	0.142857142857143	2	7
TMOD1	2	2	1	0	77.22	154.44	15	1	1	-Inf	1	-0.5	1	4
TMOD2	2	4	0	1	116.82	233.64	15	1	1	1	1	0.333333333333333	1	6
TMOD3	0	8	0	1	117.48	234.96	15	1	1	NA	1	0	1	8
TMPO	3	3	1	1	119.79	239.58	15	1	1	0	1	0	2	6
TMPRSS11D	1	3	0	0	111.87	223.74	15	1	1	NA	1	NA	0	4
TMPRSS11F	6	7	0	0	161.7	323.4	15	1	1	NA	1	NA	0	13
TMPRSS12	9	6	0	1	135.3	270.6	15	1	0.4375	1	1	0.6	1	15
TMPRSS13	0	8	0	3	66.66	133.32	15	1	1	NA	1	0	3	8
TMPRSS15	9	11	0	0	215.16	430.32	15	1	1	NA	1	NA	0	20
TMPRSS2	9	7	2	0	156.09	312.18	15	1	0.496732026143791	-Inf	1	-0.4375	2	16
TMPRSS3	2	10	1	4	136.29	272.58	15	1	1	-0.25	1	-0.0333333333333334	5	12
TMPRSS4	7	1	2	1	52.47	104.94	15	1	0.490909090909091	0.714285714285714	1	0.208333333333333	3	8
TMPRSS5	6	5	3	5	44.22	88.44	15	1	0.649916646820672	0.5	1	0.170454545454545	8	11
TMPRSS6	1	7	0	0	209.22	418.44	15	1	1	NA	1	NA	0	8
TMPRSS7	7	11	1	0	234.96	469.92	15	1	0.421052631578948	-Inf	1	-0.611111111111111	1	18
TMPRSS9	12	19	3	3	326.37	652.74	15	1	0.669614467408585	-0.583333333333333	1	-0.112903225806452	6	31
TMTC1	3	2	2	2	111.54	223.08	15	1	1	0.333333333333333	1	0.1	4	5
TMTC2	0	4	0	0	145.86	291.72	15	1	1	NA	1	NA	0	4
TMTC4	1	3	1	0	193.38	386.76	15	1	0.4	-Inf	1	-0.75	1	4
TMX1	0	11	0	2	45.87	91.74	15	1	1	NA	1	0	2	11
TMX3	1	1	0	0	111.21	222.42	15	1	1	NA	1	NA	0	2
TMX4	2	5	0	0	67.32	134.64	15	1	1	NA	1	NA	0	7
TNC	11	25	5	3	557.04	1114.08	15	1	0.117235112697393	-2.78787878787879	1	-0.319444444444444	8	36
TNFAIP1	0	3	0	0	94.05	188.1	15	1	1	NA	1	NA	0	3
TNFAIP2	5	12	1	2	198.99	397.98	15	1	1	-0.2	1	-0.0392156862745098	3	17
TNFAIP3	3	17	1	3	268.29	536.58	15	1	0.544042913608131	-0.888888888888889	1	-0.1	4	20
TNFAIP6	2	4	0	2	72.27	144.54	15	1	1	1	1	0.333333333333333	2	6
TNFAIP8L1	0	3	0	0	46.2	92.4	15	1	1	NA	1	NA	0	3
TNFAIP8L3	0	2	0	0	57.09	114.18	15	1	1	NA	1	NA	0	2
TNFRSF11A	9	14	2	3	194.04	388.08	15	1	1	-0.037037037037037	1	-0.00869565217391305	5	23
TNFRSF11B	1	2	1	1	115.83	231.66	15	1	1	-1	1	-0.166666666666667	2	3
TNFRSF13B	1	5	0	0	35.64	71.28	15	1	1	NA	1	NA	0	6
TNFRSF13C	4	1	2	0	20.79	41.58	15	1	1	-Inf	1	-0.2	2	5
TNFRSF18	3	1	0	1	61.38	122.76	15	1	0.4	1	1	0.75	1	4
TNFRSF19	4	1	3	0	132.66	265.32	15	1	1	-Inf	1	-0.2	3	5
TNFRSF1A	3	3	2	0	79.86	159.72	15	1	0.464285714285714	-Inf	1	-0.5	2	6
TNFRSF1B	1	7	0	1	139.59	279.18	15	1	1	1	1	0.125	1	8
TNFRSF21	5	8	2	1	158.07	316.14	15	1	0.55	-2.2	1	-0.282051282051282	3	13
TNFRSF25	3	11	0	0	78.54	157.08	15	1	1	NA	1	NA	0	14
TNFRSF4	10	7	2	2	116.82	233.64	15	1	1	0.3	1	0.0882352941176471	4	17
TNFRSF8	14	9	1	2	264.33	528.66	15	1	0.555769230769231	0.678571428571429	1	0.27536231884058	3	23
TNFRSF9	2	1	0	0	50.49	100.98	15	1	1	NA	1	NA	0	3
TNFSF10	4	6	0	1	76.89	153.78	15	1	1	1	1	0.4	1	10
TNFSF13B	4	3	0	0	97.02	194.04	15	1	1	NA	1	NA	0	7
TNFSF15	2	2	0	0	69.3	138.6	15	1	1	NA	1	NA	0	4
TNFSF4	9	4	0	0	73.92	147.84	15	1	1	NA	1	NA	0	13
TNFSF8	3	2	0	0	87.12	174.24	15	1	1	NA	1	NA	0	5
TNIK	3	11	0	4	397.98	795.96	15	1	1	1	1	0.214285714285714	4	14
TNIP1	2	2	2	1	89.1	178.2	15	1	1	-1	1	-0.166666666666667	3	4
TNIP2	2	5	0	0	136.62	273.24	15	1	1	NA	1	NA	0	7
TNIP3	9	4	1	0	129.03	258.06	15	1	1	-Inf	1	-0.307692307692308	1	13
TNK2	1	4	1	3	95.7	191.4	15	1	1	-0.333333333333333	1	-0.05	4	5
TNKS2	2	9	1	0	377.19	754.38	15	1	0.25	-Inf	1	-0.818181818181818	1	11
TNMD	6	3	0	0	97.35	194.7	15	1	1	NA	1	NA	0	9
TNN	19	19	4	5	345.18	690.36	15	1	1	0.2	1	0.0555555555555556	9	38
TNNC1	0	3	0	1	58.08	116.16	15	1	1	NA	1	0	1	3
TNNC2	0	1	0	1	37.62	75.24	15	1	1	NA	1	0	1	1
TNNI1	1	4	1	2	23.76	47.52	15	1	1	-1	1	-0.133333333333333	3	5
TNNI2	0	3	0	0	42.57	85.14	15	1	1	NA	1	NA	0	3
TNNI3K	5	10	2	0	216.48	432.96	15	1	0.154411764705882	-Inf	1	-0.666666666666667	2	15
TNNT2	1	2	0	0	72.27	144.54	15	1	1	NA	1	NA	0	3
TNNT3	0	3	0	1	88.77	177.54	15	1	1	NA	1	0	1	3
TNPO2	0	7	0	1	195.03	390.06	15	1	1	NA	1	0	1	7
TNR	4	22	1	6	359.37	718.74	15	1	1	0.0833333333333334	1	0.010989010989011	7	26
TNRC18	9	34	3	8	600.93	1201.86	15	1	0.692561821591546	-0.416666666666667	1	-0.0634249471458773	11	43
TNRC6A	2	12	1	1	525.36	1050.72	15	1	0.35	-5	1	-0.357142857142857	2	14
TNRC6B	5	11	3	4	534.6	1069.2	15	1	0.657019787319962	-0.65	1	-0.116071428571429	7	16
TNRC6C	3	10	3	3	563.64	1127.28	15	1	0.320101724900487	-2.33333333333333	1	-0.269230769230769	6	13
TNS1	7	10	4	7	162.36	324.72	15	1	1	0.183673469387755	1	0.0481283422459893	11	17
TNS3	23	18	4	1	514.14	1028.28	15	1	0.386984097803107	-2.1304347826087	1	-0.239024390243902	5	41
TNS4	5	4	1	2	101.31	202.62	15	1	1	0.6	1	0.222222222222222	3	9
TNX	15	19	6	11	214.5	429	15	1	0.763481280624448	0.309090909090909	1	0.088235294117647	17	34
TNXB	1	5	0	0	51.15	102.3	15	1	1	NA	1	NA	0	6
TOB2	1	3	1	1	39.27	78.54	15	1	1	-2	1	-0.25	2	4
TOE1	8	10	3	2	133.32	266.64	15	1	0.64040536122916	-0.875	1	-0.155555555555556	5	18
TOLLIP	1	2	1	1	74.91	149.82	15	1	1	-1	1	-0.166666666666667	2	3
TOM1	1	11	1	2	160.38	320.76	15	1	0.371428571428571	-4.5	1	-0.25	3	12
TOM1L1	2	4	0	0	95.7	191.4	15	1	1	NA	1	NA	0	6
TOM1L2	0	8	0	0	163.68	327.36	15	1	1	NA	1	NA	0	8
TOMM34	1	1	0	0	58.41	116.82	15	1	1	NA	1	NA	0	2
TOMM70	6	8	1	2	231.33	462.66	15	1	1	0.333333333333333	1	0.0952380952380952	3	14
TOP1	1	4	0	1	249.81	499.62	15	1	1	1	1	0.2	1	5
TOP1MT	11	16	4	7	198.33	396.66	15	1	1	0.168831168831169	1	0.0437710437710437	11	27
TOP2A	3	20	0	4	368.61	737.22	15	1	1	1	1	0.130434782608696	4	23
TOP3A	7	23	3	6	272.91	545.82	15	1	0.668569680054749	-0.642857142857143	1	-0.1	9	30
TOP3B	1	15	0	3	283.14	566.28	15	1	1	1	1	0.0625	3	16
TOPAZ1	55	37	8	8	656.37	1312.74	15	1	0.584472780034325	0.327272727272727	1	0.0978260869565217	16	92
TOPBP1	13	22	5	3	377.19	754.38	15	1	0.247220885576559	-1.82051282051282	1	-0.253571428571429	8	35
TOR1A	0	5	0	1	80.85	161.7	15	1	1	NA	1	0	1	5
TOR1AIP1	3	7	2	3	101.64	203.28	15	1	1	-0.555555555555556	1	-0.1	5	10
TOR1AIP2	14	13	2	1	128.7	257.4	15	1	1	-0.857142857142857	1	-0.148148148148148	3	27
TOR1BL	3	5	2	0	111.21	222.42	15	1	0.444444444444445	-Inf	1	-0.625	2	8
TOR3A	2	4	1	1	85.14	170.28	15	1	1	-1	1	-0.166666666666667	2	6
TOR4A	2	6	0	1	131.34	262.68	15	1	1	1	1	0.25	1	8
TOX	3	7	0	2	123.75	247.5	15	1	1	1	1	0.3	2	10
TOX2	3	6	1	4	115.5	231	15	1	1	0.5	1	0.133333333333333	5	9
TOX3	0	6	0	0	176.88	353.76	15	1	1	NA	1	NA	0	6
TP53BP1	49	30	2	5	718.08	1436.16	15	1	0.115236075074863	0.755102040816326	1	0.334538878842676	7	79
TP53BP2	6	12	3	3	347.49	694.98	15	1	0.63490742666944	-1	1	-0.166666666666667	6	18
TP53I11	1	4	1	3	51.81	103.62	15	1	1	-0.333333333333333	1	-0.05	4	5
TP53I3	2	9	1	2	132.66	265.32	15	1	1	-1.25	1	-0.151515151515151	3	11
TP53INP1	0	3	0	2	58.74	117.48	15	1	1	NA	1	0	2	3
TP53INP2	1	5	1	1	43.89	87.78	15	1	0.464285714285714	-4	1	-0.333333333333333	2	6
TP53RK	0	2	0	0	46.2	92.4	15	1	1	NA	1	NA	0	2
TP53TG5	2	1	0	0	40.59	81.18	15	1	1	NA	1	NA	0	3
TP63	1	13	0	2	206.58	413.16	15	1	1	1	1	0.0714285714285714	2	14
TP73	2	9	0	4	147.84	295.68	15	1	1	1	1	0.181818181818182	4	11
TPBG	1	5	0	0	58.41	116.82	15	1	1	NA	1	NA	0	6
TPBGL	1	0	1	0	10.23	20.46	15	1	1	NA	1	0	1	1
TPCN1	1	8	1	4	235.29	470.58	15	1	1	-1	1	-0.0888888888888889	5	9
TPCN2	4	6	1	0	223.08	446.16	15	1	0.454545454545455	-Inf	1	-0.6	1	10
TPCN3	5	5	1	0	231.33	462.66	15	1	1	-Inf	1	-0.5	1	10
TPD52	1	1	1	0	52.8	105.6	15	1	1	-Inf	1	-0.5	1	2
TPD52L1	0	2	0	0	48.18	96.36	15	1	1	NA	1	NA	0	2
TPD52L2	0	3	0	0	50.82	101.64	15	1	1	NA	1	NA	0	3
TPGS2	0	2	0	0	89.76	179.52	15	1	1	NA	1	NA	0	2
TPH1	4	13	1	3	184.14	368.28	15	1	1	-0.0833333333333333	1	-0.0147058823529412	4	17
TPH2	0	4	0	0	81.51	163.02	15	1	1	NA	1	NA	0	4
TPI1	0	7	0	0	91.74	183.48	15	1	1	NA	1	NA	0	7
TPK1	9	6	1	0	75.24	150.48	15	1	1	-Inf	1	-0.4	1	15
TPM1	0	1	0	1	54.45	108.9	15	1	1	NA	1	0	1	1
TPM4	0	2	0	1	76.56	153.12	15	1	1	NA	1	0	1	2
TPMT	2	2	0	0	76.23	152.46	15	1	1	NA	1	NA	0	4
TPO	13	14	0	3	270.27	540.54	15	1	0.237931034482759	1	1	0.481481481481481	3	27
TPP1	6	10	0	1	99	198	15	1	1	1	1	0.375	1	16
TPP2	0	13	0	0	410.52	821.04	15	1	1	NA	1	NA	0	13
TPPP2	1	2	1	0	57.09	114.18	15	1	1	-Inf	1	-0.666666666666667	1	3
TPPP3	0	2	0	1	22.11	44.22	15	1	1	NA	1	0	1	2
TPR	5	35	1	6	674.52	1349.04	15	1	1	-0.166666666666667	1	-0.0178571428571428	7	40
TPRA1	1	7	0	0	118.47	236.94	15	1	1	NA	1	NA	0	8
TPRG1L	0	5	0	1	56.1	112.2	15	1	1	NA	1	0	1	5
TPRKB	0	3	0	2	29.04	58.08	15	1	1	NA	1	0	2	3
TPST1	0	6	0	1	159.39	318.78	15	1	1	NA	1	0	1	6
TPST2	1	13	0	5	83.49	166.98	15	1	1	1	1	0.0714285714285714	5	14
TPTE2	7	15	0	3	192.06	384.12	15	1	0.534347826086957	1	1	0.318181818181818	3	22
TPX2	9	13	1	2	300.63	601.26	15	1	1	0.277777777777778	1	0.0757575757575758	3	22
TRA2B	0	2	0	0	78.21	156.42	15	1	1	NA	1	NA	0	2
TRABD	1	3	0	0	132.99	265.98	15	1	1	NA	1	NA	0	4
TRABD2A-TRABD2B	3	2	1	0	112.86	225.72	15	1	1	-Inf	1	-0.4	1	5
TRADD	5	5	1	1	104.61	209.22	15	1	1	0	1	0	2	10
TRAF1	4	8	0	0	217.47	434.94	15	1	1	NA	1	NA	0	12
TRAF2	1	4	0	0	140.58	281.16	15	1	1	NA	1	NA	0	5
TRAF3	0	5	0	1	217.8	435.6	15	1	1	NA	1	0	1	5
TRAF3IP1	2	5	1	0	111.54	223.08	15	1	0.375	-Inf	1	-0.714285714285714	1	7
TRAF3IP2	8	2	2	0	165.33	330.66	15	1	1	-Inf	1	-0.2	2	10
TRAF3IP3	3	9	1	0	102.63	205.26	15	1	0.307692307692308	-Inf	1	-0.75	1	12
TRAF5	1	10	0	4	211.53	423.06	15	1	1	1	1	0.0909090909090909	4	11
TRAF6	2	7	1	5	159.06	318.12	15	1	1	0.3	1	0.0555555555555556	6	9
TRAF7	0	9	0	2	165.66	331.32	15	1	1	NA	1	0	2	9
TRAFD1	7	11	1	3	144.87	289.74	15	1	1	0.476190476190476	1	0.138888888888889	4	18
TRAK2	12	7	2	0	204.6	409.2	15	1	0.533333333333333	-Inf	1	-0.368421052631579	2	19
TRAM1	0	2	0	1	79.2	158.4	15	1	1	NA	1	0	1	2
TRAM2	0	4	0	1	88.11	176.22	15	1	1	NA	1	0	1	4
TRANK1	46	43	2	0	843.15	1686.3	15	1	0.495970695970696	-Inf	1	-0.48314606741573	2	89
TRAPPC10	4	16	0	3	434.28	868.56	15	1	1	1	1	0.2	3	20
TRAPPC12	9	7	1	0	247.83	495.66	15	1	1	-Inf	1	-0.4375	1	16
TRAPPC2L	1	3	1	0	23.1	46.2	15	1	0.4	-Inf	1	-0.75	1	4
TRAPPC8	5	19	2	3	434.61	869.22	15	1	0.568818155025051	-1.53333333333333	1	-0.191666666666667	5	24
TRAPPC9	5	21	1	2	232.65	465.3	15	1	0.515325670498084	-1.1	1	-0.141025641025641	3	26
TRDMT1	7	4	0	2	136.95	273.9	15	1	0.192307692307692	1	1	0.636363636363636	2	11
TRDNL	12	1	2	0	70.95	141.9	15	1	1	-Inf	1	-0.0769230769230769	2	13
TREM-B1	18	10	3	2	196.68	393.36	15	1	1	0.166666666666667	1	0.0428571428571429	5	28
TRERF1	7	17	3	2	348.48	696.96	15	1	0.306429202980927	-2.64285714285714	1	-0.308333333333333	5	24
TRH	1	1	0	0	74.25	148.5	15	1	1	NA	1	NA	0	2
TRHDE	1	3	1	0	164.67	329.34	15	1	0.4	-Inf	1	-0.75	1	4
TRHR	5	4	2	0	161.7	323.4	15	1	0.490909090909091	-Inf	1	-0.444444444444444	2	9
TRIL	3	15	0	1	114.84	229.68	15	1	1	1	1	0.166666666666667	1	18
TRIM10	5	6	1	1	74.25	148.5	15	1	1	-0.2	1	-0.0454545454545455	2	11
TRIM13	5	8	1	2	150.81	301.62	15	1	1	0.2	1	0.0512820512820513	3	13
TRIM23	1	5	0	0	130.35	260.7	15	1	1	NA	1	NA	0	6
TRIM24	5	9	1	0	297.99	595.98	15	1	0.4	-Inf	1	-0.642857142857143	1	14
TRIM25	6	7	0	0	179.85	359.7	15	1	1	NA	1	NA	0	13
TRIM27.1	2	4	1	1	89.1	178.2	15	1	1	-1	1	-0.166666666666667	2	6
TRIM27.2	3	8	0	1	91.74	183.48	15	1	1	1	1	0.272727272727273	1	11
TRIM29	1	4	1	0	149.16	298.32	15	1	0.333333333333333	-Inf	1	-0.8	1	5
TRIM3	1	8	0	1	98.67	197.34	15	1	1	1	1	0.111111111111111	1	9
TRIM32	1	7	1	1	129.36	258.72	15	1	0.377777777777778	-6	1	-0.375	2	8
TRIM35	1	2	0	1	51.15	102.3	15	1	1	1	1	0.333333333333333	1	3
TRIM36	0	4	0	0	166.32	332.64	15	1	1	NA	1	NA	0	4
TRIM37	5	7	2	2	320.43	640.86	15	1	1	-0.4	1	-0.0833333333333333	4	12
TRIM39.1	3	0	1	0	35.97	71.94	15	1	1	NA	1	0	1	3
TRIM39.2	4	5	3	2	80.19	160.38	15	1	1	-0.875	1	-0.155555555555556	5	9
TRIM41	0	3	0	1	46.86	93.72	15	1	1	NA	1	0	1	3
TRIM42	10	15	3	1	230.67	461.34	15	1	0.299397920087575	-3.5	1	-0.35	4	25
TRIM45	5	7	1	2	141.24	282.48	15	1	1	0.3	1	0.0833333333333334	3	12
TRIM47	2	2	0	0	72.93	145.86	15	1	1	NA	1	NA	0	4
TRIM50	1	5	1	0	83.82	167.64	15	1	0.285714285714286	-Inf	1	-0.833333333333333	1	6
TRIM58	2	7	0	0	95.37	190.74	15	1	1	NA	1	NA	0	9
TRIM59	4	10	1	1	99	198	15	1	1	-1.5	1	-0.214285714285714	2	14
TRIM62	0	1	0	1	28.38	56.76	15	1	1	NA	1	0	1	1
TRIM63	1	0	1	0	35.31	70.62	15	1	1	NA	1	0	1	1
TRIM65	8	2	0	1	41.25	82.5	15	1	0.272727272727273	1	1	0.8	1	10
TRIM66	22	16	8	2	396.33	792.66	15	1	0.281553306592358	-1.90909090909091	1	-0.221052631578947	10	38
TRIM67	0	7	0	0	166.65	333.3	15	1	1	NA	1	NA	0	7
TRIM7.2	0	5	0	2	55.11	110.22	15	1	1	NA	1	0	2	5
TRIM71	0	7	0	2	193.05	386.1	15	1	1	NA	1	0	2	7
TRIM9	0	7	0	5	88.77	177.54	15	1	1	NA	1	0	5	7
TRIO	0	22	0	3	528.99	1057.98	15	1	1	NA	1	0	3	22
TRIP11	15	14	2	3	518.43	1036.86	15	1	1	0.377777777777778	1	0.117241379310345	5	29
TRIP12	2	16	0	4	606.87	1213.74	15	1	1	1	1	0.111111111111111	4	18
TRIP4	3	7	2	1	161.04	322.08	15	1	0.510489510489511	-3.66666666666667	1	-0.366666666666667	3	10
TRIT1	3	3	0	0	82.5	165	15	1	1	NA	1	NA	0	6
TRMT	7	5	2	2	165.66	331.32	15	1	1	0.285714285714286	1	0.0833333333333334	4	12
TRMT10A	3	5	0	2	83.16	166.32	15	1	1	1	1	0.375	2	8
TRMT10B	0	2	0	0	55.44	110.88	15	1	1	NA	1	NA	0	2
TRMT10C	7	6	0	1	114.84	229.68	15	1	1	1	1	0.538461538461538	1	13
TRMT11	0	6	0	1	128.37	256.74	15	1	1	NA	1	0	1	6
TRMT12	7	12	1	2	102.63	205.26	15	1	1	0.142857142857143	1	0.0350877192982456	3	19
TRMT13	4	3	0	0	98.34	196.68	15	1	1	NA	1	NA	0	7
TRMT1L	3	11	1	2	215.16	430.32	15	1	1	-0.833333333333333	1	-0.119047619047619	3	14
TRMT2A	4	13	1	0	183.48	366.96	15	1	0.277777777777778	-Inf	1	-0.764705882352941	1	17
TRMT44	7	6	1	1	154.44	308.88	15	1	1	0.142857142857143	1	0.0384615384615384	2	13
TRMT5	8	10	1	0	172.92	345.84	15	1	0.473684210526316	-Inf	1	-0.555555555555556	1	18
TRMT6	2	7	0	2	115.5	231	15	1	1	1	1	0.222222222222222	2	9
TRMT61A	2	6	0	0	110.88	221.76	15	1	1	NA	1	NA	0	8
TRMT61B	1	2	0	0	76.23	152.46	15	1	1	NA	1	NA	0	3
TRMU	3	6	0	0	143.55	287.1	15	1	1	NA	1	NA	0	9
TRNAU1AP	0	7	0	2	81.18	162.36	15	1	1	NA	1	0	2	7
TRNT1	4	9	2	4	98.34	196.68	15	1	1	-0.125	1	-0.0256410256410256	6	13
TROVE2	6	8	3	3	159.72	319.44	15	1	1	-0.333333333333333	1	-0.0714285714285715	6	14
TRPA1	2	9	0	1	334.29	668.58	15	1	1	1	1	0.181818181818182	1	11
TRPC1	0	4	0	2	231.33	462.66	15	1	1	NA	1	0	2	4
TRPC3	2	15	0	3	306.57	613.14	15	1	1	1	1	0.117647058823529	3	17
TRPC4AP	0	4	0	1	221.76	443.52	15	1	1	NA	1	0	1	4
TRPC5	1	8	0	0	187.44	374.88	15	1	1	NA	1	NA	0	9
TRPC6	1	14	1	2	309.21	618.42	15	1	0.313725490196079	-6	1	-0.266666666666667	3	15
TRPC7	1	14	0	2	285.78	571.56	15	1	1	1	1	0.0666666666666667	2	15
TRPM1	5	39	1	3	609.51	1219.02	15	1	0.424761023743447	-1.6	1	-0.136363636363636	4	44
TRPM2	7	25	1	4	450.12	900.24	15	1	1	0.107142857142857	1	0.01875	5	32
TRPM3	7	10	0	0	335.94	671.88	15	1	1	NA	1	NA	0	17
TRPM5	6	12	1	2	374.22	748.44	15	1	1	0	1	0	3	18
TRPM6	7	14	0	1	512.82	1025.64	15	1	1	1	1	0.333333333333333	1	21
TRPM7	3	26	0	1	842.82	1685.64	15	1	1	1	1	0.103448275862069	1	29
TRPM8	5	17	1	7	378.18	756.36	15	1	1	0.514285714285714	1	0.102272727272727	8	22
TRPS1	3	12	1	0	300.3	600.6	15	1	0.25	-Inf	1	-0.8	1	15
TRPV1	4	8	0	1	252.45	504.9	15	1	1	1	1	0.333333333333333	1	12
TRPV2	36	26	1	6	696.3	1392.6	15	1	0.0437395053954202	0.87962962962963	1	0.43778801843318	7	62
TRPV4	0	3	0	2	126.39	252.78	15	1	1	NA	1	0	2	3
TRPV6	2	5	0	1	211.2	422.4	15	1	1	1	1	0.285714285714286	1	7
TRRAP	3	49	1	3	1163.58	2327.16	15	1	0.262912140270631	-4.44444444444444	1	-0.192307692307692	4	52
TRUB1	0	2	0	0	87.78	175.56	15	1	1	NA	1	NA	0	2
TSC1	2	9	1	1	351.12	702.24	15	1	0.423076923076923	-3.5	1	-0.318181818181818	2	11
TSC2	4	32	1	11	521.73	1043.46	15	1	1	0.272727272727273	1	0.0277777777777778	12	36
TSC22D1	5	6	3	2	284.79	569.58	15	1	1	-0.8	1	-0.145454545454545	5	11
TSEN15	3	1	0	1	56.43	112.86	15	1	0.4	1	1	0.75	1	4
TSEN54	3	4	1	1	108.57	217.14	15	1	1	-0.333333333333333	1	-0.0714285714285715	2	7
TSG101	0	4	0	1	116.16	232.32	15	1	1	NA	1	0	1	4
TSGA10	7	6	1	1	195.36	390.72	15	1	1	0.142857142857143	1	0.0384615384615384	2	13
TSHR	1	10	0	0	297.66	595.32	15	1	1	NA	1	NA	0	11
TSHZ1	4	16	1	1	334.62	669.24	15	1	0.411255411255411	-3	1	-0.3	2	20
TSHZ2	2	11	0	1	376.53	753.06	15	1	1	1	1	0.153846153846154	1	13
TSHZ3	3	17	0	2	407.55	815.1	15	1	1	1	1	0.15	2	20
TSKU	3	8	1	4	99	198	15	1	1	0.333333333333333	1	0.0727272727272727	5	11
TSN	1	4	0	1	53.13	106.26	15	1	1	1	1	0.2	1	5
TSNARE1	8	4	2	0	148.17	296.34	15	1	1	-Inf	1	-0.333333333333333	2	12
TSNAX	1	1	0	1	87.45	174.9	15	1	1	1	1	0.5	1	2
TSNAXIP1	13	10	0	1	255.09	510.18	15	1	0.458333333333333	1	1	0.565217391304348	1	23
TSPAN1	1	4	0	1	23.76	47.52	15	1	1	1	1	0.2	1	5
TSPAN10	0	1	0	1	3.96	7.92	15	1	1	NA	1	0	1	1
TSPAN12	1	1	0	0	80.19	160.38	15	1	1	NA	1	NA	0	2
TSPAN13	0	3	0	0	65.34	130.68	15	1	1	NA	1	NA	0	3
TSPAN14	2	2	2	0	85.47	170.94	15	1	0.466666666666667	-Inf	1	-0.5	2	4
TSPAN19	3	3	0	0	58.74	117.48	15	1	1	NA	1	NA	0	6
TSPAN2	1	0	1	0	41.58	83.16	15	1	1	NA	1	0	1	1
TSPAN3	1	3	0	0	66.66	133.32	15	1	1	NA	1	NA	0	4
TSPAN32	4	8	1	2	74.58	149.16	15	1	1	0	1	0	3	12
TSPAN33	0	4	0	0	44.55	89.1	15	1	1	NA	1	NA	0	4
TSPAN4	6	5	0	2	123.42	246.84	15	1	0.461538461538462	1	1	0.545454545454545	2	11
TSPAN6	1	3	1	0	53.13	106.26	15	1	0.4	-Inf	1	-0.75	1	4
TSPAN7	2	5	0	1	77.88	155.76	15	1	1	1	1	0.285714285714286	1	7
TSPAN8	11	7	1	1	69.96	139.92	15	1	1	0.363636363636364	1	0.111111111111111	2	18
TSPEAR	0	4	0	0	136.62	273.24	15	1	1	NA	1	NA	0	4
TSPO2	1	1	0	0	46.53	93.06	15	1	1	NA	1	NA	0	2
TSPOAP1	44	31	7	3	940.83	1881.66	15	1	0.733089390250069	-0.643939393939394	1	-0.113333333333333	10	75
TSR1	9	22	2	3	165.99	331.98	15	1	0.630894024276377	-0.62962962962963	1	-0.109677419354839	5	31
TSR3	1	4	0	0	71.61	143.22	15	1	1	NA	1	NA	0	5
TSSC1	1	2	0	0	94.38	188.76	15	1	1	NA	1	NA	0	3
TSSC4	3	9	0	3	80.85	161.7	15	1	1	1	1	0.25	3	12
TSSK3	3	3	0	1	73.92	147.84	15	1	1	1	1	0.5	1	6
TSSK6L2	4	6	0	1	52.8	105.6	15	1	1	1	1	0.4	1	10
TST	2	2	1	1	46.86	93.72	15	1	1	0	1	0	2	4
TSTA3	1	2	1	1	22.11	44.22	15	1	1	-1	1	-0.166666666666667	2	3
TSTD2	2	6	1	1	85.47	170.94	15	1	1	-2	1	-0.25	2	8
TTBK1	4	20	1	1	512.16	1024.32	15	1	0.353846153846154	-4	1	-0.333333333333333	2	24
TTBK2	5	8	0	0	349.47	698.94	15	1	1	NA	1	NA	0	13
TTC1	2	4	0	1	79.86	159.72	15	1	1	1	1	0.333333333333333	1	6
TTC12	9	12	3	1	173.91	347.82	15	1	0.321739130434783	-3	1	-0.321428571428571	4	21
TTC13	1	12	0	2	250.47	500.94	15	1	1	1	1	0.0769230769230769	2	13
TTC14	5	13	0	2	209.88	419.76	15	1	1	1	1	0.277777777777778	2	18
TTC17	5	16	3	2	353.43	706.86	15	1	0.280510793554272	-3.8	1	-0.361904761904762	5	21
TTC19	5	5	1	1	80.52	161.04	15	1	1	0	1	0	2	10
TTC21B	7	19	3	3	417.12	834.24	15	1	0.346148498331479	-1.71428571428571	1	-0.230769230769231	6	26
TTC25	3	5	2	0	151.47	302.94	15	1	0.444444444444445	-Inf	1	-0.625	2	8
TTC26	2	5	0	1	155.43	310.86	15	1	1	1	1	0.285714285714286	1	7
TTC27	2	2	1	0	39.6	79.2	15	1	1	-Inf	1	-0.5	1	4
TTC28	4	24	0	3	711.15	1422.3	15	1	1	1	1	0.142857142857143	3	28
TTC29	5	6	1	1	194.37	388.74	15	1	1	-0.2	1	-0.0454545454545455	2	11
TTC3	19	21	1	2	649.77	1299.54	15	1	1	0.447368421052632	1	0.141666666666667	3	40
TTC30B	2	9	0	2	181.17	362.34	15	1	1	1	1	0.181818181818182	2	11
TTC31	7	2	2	1	75.24	150.48	15	1	1	0.428571428571429	1	0.111111111111111	3	9
TTC32	2	0	1	0	19.14	38.28	15	1	1	NA	1	0	1	2
TTC33	7	1	0	0	70.62	141.24	15	1	1	NA	1	NA	0	8
TTC34	7	18	3	2	381.81	763.62	15	1	0.300029472443265	-2.85714285714286	1	-0.32	5	25
TTC36	2	2	0	0	39.27	78.54	15	1	1	NA	1	NA	0	4
TTC38-TTC38L	3	1	0	0	102.3	204.6	15	1	1	NA	1	NA	0	4
TTC39A	0	9	0	0	182.49	364.98	15	1	1	NA	1	NA	0	9
TTC39B	2	9	0	2	167.31	334.62	15	1	1	1	1	0.181818181818182	2	11
TTC39C	1	6	1	0	164.67	329.34	15	1	0.25	-Inf	1	-0.857142857142857	1	7
TTC4	6	3	3	1	104.28	208.56	15	1	1	-0.5	1	-0.0833333333333334	4	9
TTC6	23	14	1	4	495.99	991.98	15	1	0.146369676536557	0.847826086956522	1	0.421621621621622	5	37
TTC7A	13	10	3	2	321.09	642.18	15	1	1	-0.153846153846154	1	-0.0347826086956522	5	23
TTC7B	1	8	0	1	252.78	505.56	15	1	1	1	1	0.111111111111111	1	9
TTC8	1	6	0	0	154.44	308.88	15	1	1	NA	1	NA	0	7
TTF1	7	8	0	2	134.64	269.28	15	1	0.485294117647059	1	1	0.466666666666667	2	15
TTF2	14	20	2	0	414.81	829.62	15	1	0.19047619047619	-Inf	1	-0.588235294117647	2	34
TTI1	21	33	4	5	374.22	748.44	15	1	1	-0.257142857142857	1	-0.0555555555555555	9	54
TTI2	1	8	1	2	63.03	126.06	15	1	0.454545454545454	-3	1	-0.222222222222222	3	9
TTK	10	19	2	6	309.87	619.74	15	1	1	0.366666666666667	1	0.0948275862068966	8	29
TTL	1	2	1	0	68.97	137.94	15	1	1	-Inf	1	-0.666666666666667	1	3
TTLL10	12	10	2	3	160.38	320.76	15	1	0.648309178743961	0.444444444444444	1	0.145454545454545	5	22
TTLL11	4	6	1	3	184.47	368.94	15	1	1	0.5	1	0.15	4	10
TTLL2	3	10	1	1	205.26	410.52	15	1	0.476190476190476	-2.33333333333333	1	-0.269230769230769	2	13
TTLL4	10	8	5	4	274.89	549.78	15	1	1	0	1	0	9	18
TTLL5	21	19	6	2	414.15	828.3	15	1	0.437105561754857	-1.71428571428571	1	-0.225	8	40
TTLL7	6	8	1	1	289.41	578.82	15	1	1	-0.333333333333333	1	-0.0714285714285715	2	14
TTLL9	1	11	0	3	122.1	244.2	15	1	1	1	1	0.0833333333333333	3	12
TTPA	0	5	0	1	84.15	168.3	15	1	1	NA	1	0	1	5
TTPAL	1	6	1	1	115.17	230.34	15	1	0.416666666666667	-5	1	-0.357142857142857	2	7
TTR	0	2	0	1	43.23	86.46	15	1	1	NA	1	0	1	2
TTYH2	0	1	0	1	8.91	17.82	15	1	1	NA	1	0	1	1
TTYH3	1	9	1	2	163.68	327.36	15	1	0.423076923076923	-3.5	1	-0.233333333333333	3	10
TUB	0	9	0	1	145.53	291.06	15	1	1	NA	1	0	1	9
TUBA3E	0	9	0	4	139.59	279.18	15	1	1	NA	1	0	4	9
TUBA8A	1	5	0	1	112.53	225.06	15	1	1	1	1	0.166666666666667	1	6
TUBA8B	2	4	0	2	172.26	344.52	15	1	1	1	1	0.333333333333333	2	6
TUBB	1	3	1	0	53.13	106.26	15	1	0.4	-Inf	1	-0.75	1	4
TUBB1	1	11	1	2	116.49	232.98	15	1	0.371428571428571	-4.5	1	-0.25	3	12
TUBB3	5	14	5	12	99.66	199.32	15	1	1	-0.166666666666667	1	-0.0309597523219814	17	19
TUBB4B	0	6	0	1	136.95	273.9	15	1	1	NA	1	0	1	6
TUBB6	0	12	0	2	166.32	332.64	15	1	1	NA	1	0	2	12
TUBD1	4	9	0	2	160.05	320.1	15	1	1	1	1	0.307692307692308	2	13
TUBE1	2	7	0	1	152.13	304.26	15	1	1	1	1	0.222222222222222	1	9
TUBG1	0	5	0	2	61.05	122.1	15	1	1	NA	1	0	2	5
TUBGCP2	6	13	0	1	291.06	582.12	15	1	1	1	1	0.315789473684211	1	19
TUBGCP3	0	6	0	0	261.69	523.38	15	1	1	NA	1	NA	0	6
TUBGCP4	2	11	0	0	268.29	536.58	15	1	1	NA	1	NA	0	13
TUBGCP5	1	7	0	1	273.24	546.48	15	1	1	1	1	0.125	1	8
TUBGCP6	27	35	6	5	802.89	1605.78	15	1	0.529610378344952	-0.555555555555556	1	-0.109970674486803	11	62
TUFT1	1	4	0	0	72.6	145.2	15	1	1	NA	1	NA	0	5
TULP1	1	1	1	0	30.03	60.06	15	1	1	-Inf	1	-0.5	1	2
TULP3	3	7	2	3	134.97	269.94	15	1	1	-0.555555555555556	1	-0.1	5	10
TULP4	0	20	0	3	354.42	708.84	15	1	1	NA	1	0	3	20
TUSC5	0	2	0	1	8.25	16.5	15	1	1	NA	1	0	1	2
TUT1	9	14	1	4	86.13	172.26	15	1	0.626373626373626	0.611111111111111	1	0.191304347826087	5	23
TVP23A	1	3	0	0	51.15	102.3	15	1	1	NA	1	NA	0	4
TWF1	2	2	0	0	103.29	206.58	15	1	1	NA	1	NA	0	4
TWF2	0	4	0	1	81.18	162.36	15	1	1	NA	1	0	1	4
TWIST2	0	2	0	2	71.94	143.88	15	1	1	NA	1	0	2	2
TWIST3	0	1	0	1	34.32	68.64	15	1	1	NA	1	0	1	1
TWNK	1	6	0	5	78.87	157.74	15	1	1	1	1	0.142857142857143	5	7
TWSG1	0	7	0	2	75.57	151.14	15	1	1	NA	1	0	2	7
TXK	4	7	1	0	152.13	304.26	15	1	0.416666666666667	-Inf	1	-0.636363636363636	1	11
TXLNA	4	7	1	2	104.94	209.88	15	1	1	0.125	1	0.0303030303030303	3	11
TXLNB	3	6	1	1	180.84	361.68	15	1	1	-1	1	-0.166666666666667	2	9
TXLNG	1	7	0	0	166.32	332.64	15	1	1	NA	1	NA	0	8
TXN2	0	3	0	2	30.69	61.38	15	1	1	NA	1	0	2	3
TXNDC11	17	9	1	0	279.84	559.68	15	1	1	-Inf	1	-0.346153846153846	1	26
TXNDC15	1	11	0	1	72.93	145.86	15	1	1	1	1	0.0833333333333333	1	12
TXNDC16	14	13	4	2	248.82	497.64	15	1	0.664779047426433	-0.857142857142857	1	-0.148148148148148	6	27
TXNDC5	3	6	2	2	91.74	183.48	15	1	1	-1	1	-0.166666666666667	4	9
TXNDC9	0	6	0	0	71.28	142.56	15	1	1	NA	1	NA	0	6
TXNL4B	1	1	1	1	40.26	80.52	15	1	1	0	1	0	2	2
TXNRD1	0	2	0	1	134.97	269.94	15	1	1	NA	1	0	1	2
TXNRD2	3	6	1	0	133.98	267.96	15	1	0.4	-Inf	1	-0.666666666666667	1	9
TXNRD3	1	6	0	1	195.36	390.72	15	1	1	1	1	0.142857142857143	1	7
TYMS	1	4	0	0	97.35	194.7	15	1	1	NA	1	NA	0	5
TYR	2	3	0	0	139.92	279.84	15	1	1	NA	1	NA	0	5
TYRO3	2	11	1	2	320.1	640.2	15	1	0.489285714285714	-1.75	1	-0.179487179487179	3	13
TYRP1	1	1	0	0	141.9	283.8	15	1	1	NA	1	NA	0	2
TYW1	2	14	0	3	151.8	303.6	15	1	1	1	1	0.125	3	16
TYW3	2	1	0	0	58.74	117.48	15	1	1	NA	1	NA	0	3
TYW5	3	7	2	0	77.55	155.1	15	1	0.151515151515152	-Inf	1	-0.7	2	10
U2AF1	0	2	0	1	49.83	99.66	15	1	1	NA	1	0	1	2
U2SURP	0	8	0	2	276.21	552.42	15	1	1	NA	1	0	2	8
UACA	6	13	2	1	320.76	641.52	15	1	0.527272727272727	-3.33333333333333	1	-0.350877192982456	3	19
UAP1L1	8	2	0	0	345.18	690.36	15	1	1	NA	1	NA	0	10
UBA3	1	10	0	1	114.18	228.36	15	1	1	1	1	0.0909090909090909	1	11
UBA5	1	6	0	1	161.04	322.08	15	1	1	1	1	0.142857142857143	1	7
UBA52	0	2	0	2	8.58	17.16	15	1	1	NA	1	0	2	2
UBA6	3	10	1	2	312.51	625.02	15	1	1	-0.666666666666667	1	-0.102564102564103	3	13
UBAC1	0	5	0	1	91.08	182.16	15	1	1	NA	1	0	1	5
UBAC2	6	2	5	0	90.09	180.18	15	1	0.487179487179487	-Inf	1	-0.25	5	8
UBAP1	2	10	1	1	147.18	294.36	15	1	0.395604395604396	-4	1	-0.333333333333333	2	12
UBAP1L	3	14	3	3	85.47	170.94	15	1	0.278552111504057	-3.66666666666667	1	-0.323529411764706	6	17
UBAP2L	1	11	1	6	236.61	473.22	15	1	1	-0.833333333333333	1	-0.0595238095238095	7	12
UBASH3A	3	4	1	1	173.25	346.5	15	1	1	-0.333333333333333	1	-0.0714285714285715	2	7
UBASH3B	2	9	1	2	151.8	303.6	15	1	1	-1.25	1	-0.151515151515151	3	11
UBB-UBC	0	12	0	11	94.38	188.76	15	1	1	NA	1	0	11	12
UBE2B	0	5	0	1	53.79	107.58	15	1	1	NA	1	0	1	5
UBE2D1	1	0	1	0	52.47	104.94	15	1	1	NA	1	0	1	1
UBE2D2	0	1	0	1	43.56	87.12	15	1	1	NA	1	0	1	1
UBE2E2	2	1	0	1	120.12	240.24	15	1	1	1	1	0.666666666666667	1	3
UBE2F	2	1	0	0	78.54	157.08	15	1	1	NA	1	NA	0	3
UBE2G1	0	1	0	1	60.39	120.78	15	1	1	NA	1	0	1	1
UBE2H	1	3	1	0	61.05	122.1	15	1	0.4	-Inf	1	-0.75	1	4
UBE2J1	3	5	0	2	78.21	156.42	15	1	1	1	1	0.375	2	8
UBE2O	4	18	1	6	343.53	687.06	15	1	1	0.25	1	0.038961038961039	7	22
UBE2Q2	0	2	0	1	88.11	176.22	15	1	1	NA	1	0	1	2
UBE2T	2	6	1	1	60.72	121.44	15	1	1	-2	1	-0.25	2	8
UBE2V1	2	2	0	0	50.49	100.98	15	1	1	NA	1	NA	0	4
UBE2Z	1	2	1	0	105.27	210.54	15	1	1	-Inf	1	-0.666666666666667	1	3
UBE3A	0	10	0	5	268.29	536.58	15	1	1	NA	1	0	5	10
UBE3B	3	16	1	2	289.74	579.48	15	1	0.47012987012987	-1.66666666666667	1	-0.175438596491228	3	19
UBE3C	1	18	0	1	327.03	654.06	15	1	1	1	1	0.0526315789473684	1	19
UBE3D	6	5	1	0	101.31	202.62	15	1	1	-Inf	1	-0.454545454545455	1	11
UBE4A	3	18	0	2	297.99	595.98	15	1	1	1	1	0.142857142857143	2	21
UBE4B	2	9	1	1	394.35	788.7	15	1	0.423076923076923	-3.5	1	-0.318181818181818	2	11
UBIAD1	0	3	0	2	46.86	93.72	15	1	1	NA	1	0	2	3
UBL7	0	6	0	1	56.1	112.2	15	1	1	NA	1	0	1	6
UBLCP1	1	4	0	1	100.65	201.3	15	1	1	1	1	0.2	1	5
UBN1	3	13	2	0	326.37	652.74	15	1	0.065359477124183	-Inf	1	-0.8125	2	16
UBN2	1	7	0	1	343.53	687.06	15	1	1	1	1	0.125	1	8
UBP1	1	8	0	0	136.62	273.24	15	1	1	NA	1	NA	0	9
UBQLN4	0	5	0	1	127.05	254.1	15	1	1	NA	1	0	1	5
UBR1	7	24	0	1	550.11	1100.22	15	1	1	1	1	0.225806451612903	1	31
UBR2	5	22	0	3	567.93	1135.86	15	1	1	1	1	0.185185185185185	3	27
UBR3	2	11	0	0	361.35	722.7	15	1	1	NA	1	NA	0	13
UBR5	1	28	1	6	825.99	1651.98	15	1	0.355555555555556	-3.66666666666667	1	-0.108374384236453	7	29
UBR7	0	4	0	2	105.93	211.86	15	1	1	NA	1	0	2	4
UBTD1	1	0	1	0	18.48	36.96	15	1	1	NA	1	0	1	1
UBTF	0	1	0	1	10.89	21.78	15	1	1	NA	1	0	1	1
UBXN10	7	6	2	4	57.09	114.18	15	1	0.628482972136223	0.571428571428571	1	0.205128205128205	6	13
UBXN11	11	4	2	1	98.34	196.68	15	1	1	0.272727272727273	1	0.0666666666666667	3	15
UBXN2A	4	3	0	0	79.53	159.06	15	1	1	NA	1	NA	0	7
UBXN2B	1	3	0	1	100.98	201.96	15	1	1	1	1	0.25	1	4
UBXN4	4	12	0	1	152.13	304.26	15	1	1	1	1	0.25	1	16
UBXN6	5	3	2	1	66.33	132.66	15	1	1	-0.2	1	-0.0416666666666666	3	8
UBXN7	0	3	0	0	158.07	316.14	15	1	1	NA	1	NA	0	3
UCHL1	1	3	0	0	55.11	110.22	15	1	1	NA	1	NA	0	4
UCK1	0	4	0	2	72.6	145.2	15	1	1	NA	1	0	2	4
UCK2	0	3	0	2	79.53	159.06	15	1	1	NA	1	0	2	3
UCKL1	0	5	0	2	100.98	201.96	15	1	1	NA	1	0	2	5
UEVLD	4	4	1	0	130.68	261.36	15	1	1	-Inf	1	-0.5	1	8
UFD1L	0	6	0	4	89.76	179.52	15	1	1	NA	1	0	4	6
UFL1	11	7	0	0	225.06	450.12	15	1	1	NA	1	NA	0	18
UFM1	3	2	0	0	40.59	81.18	15	1	1	NA	1	NA	0	5
UGCG	1	4	0	0	114.51	229.02	15	1	1	NA	1	NA	0	5
UGDH	1	9	1	3	182.49	364.98	15	1	0.505494505494505	-2	1	-0.15	4	10
UGGT1	3	18	2	0	480.81	961.62	15	1	0.0395256916996047	-Inf	1	-0.857142857142857	2	21
UGGT2	13	16	2	2	456.72	913.44	15	1	1	-0.230769230769231	1	-0.0517241379310345	4	29
UGP2	0	6	0	2	182.49	364.98	15	1	1	NA	1	0	2	6
UGT1A1	17	22	2	2	364.65	729.3	15	1	1	-0.294117647058824	1	-0.0641025641025641	4	39
UGT2A1	7	18	1	6	288.42	576.84	15	1	0.646416245971307	0.571428571428571	1	0.137142857142857	7	25
UGT8	1	8	0	1	192.72	385.44	15	1	1	1	1	0.111111111111111	1	9
UGT8L	4	14	1	2	146.52	293.04	15	1	1	-0.75	1	-0.111111111111111	3	18
UHRF1	0	8	0	2	186.45	372.9	15	1	1	NA	1	0	2	8
UHRF1BP1	16	25	5	7	504.24	1008.48	15	1	1	-0.116071428571429	1	-0.0264227642276423	12	41
UHRF1BP1L	4	13	2	0	474.21	948.42	15	1	0.087719298245614	-Inf	1	-0.764705882352941	2	17
UHRF2	1	1	0	0	153.12	306.24	15	1	1	NA	1	NA	0	2
UIMC1	11	12	2	3	177.54	355.08	15	1	1	0.272727272727273	1	0.0782608695652174	5	23
ULK1	1	12	1	3	316.47	632.94	15	1	0.426470588235294	-3	1	-0.173076923076923	4	13
ULK2	0	8	0	2	294.69	589.38	15	1	1	NA	1	0	2	8
ULK4	1	1	0	0	78.21	156.42	15	1	1	NA	1	NA	0	2
UMAD1	1	2	0	0	37.29	74.58	15	1	1	NA	1	NA	0	3
UMOD	1	9	0	1	154.11	308.22	15	1	1	1	1	0.1	1	10
UMODL1	20	16	9	1	390.39	780.78	15	1	0.0667122197343593	-6.2	1	-0.344444444444444	10	36
UMPS	8	13	3	1	139.26	278.52	15	1	0.287826086956522	-3.875	1	-0.369047619047619	4	21
UNC119	0	2	0	0	37.62	75.24	15	1	1	NA	1	NA	0	2
UNC13B	14	26	2	2	518.1	1036.2	15	1	0.613881297375342	-0.857142857142857	1	-0.15	4	40
UNC13C	7	13	2	2	387.09	774.18	15	1	0.614624505928854	-0.857142857142857	1	-0.15	4	20
UNC13D	6	16	4	2	187.11	374.22	15	1	0.147157190635452	-4.33333333333333	1	-0.393939393939394	6	22
UNC45A	1	8	1	0	175.23	350.46	15	1	0.2	-Inf	1	-0.888888888888889	1	9
UNC45B	3	18	0	4	353.76	707.52	15	1	1	1	1	0.142857142857143	4	21
UNC50	4	4	3	2	90.09	180.18	15	1	1	-0.5	1	-0.1	5	8
UNC5A	1	2	1	1	46.53	93.06	15	1	1	-1	1	-0.166666666666667	2	3
UNC5B	2	4	2	2	114.51	229.02	15	1	1	-1	1	-0.166666666666667	4	6
UNC5C	3	11	1	2	262.35	524.7	15	1	1	-0.833333333333333	1	-0.119047619047619	3	14
UNC5D	0	6	0	1	245.52	491.04	15	1	1	NA	1	0	1	6
UNC79	9	34	3	2	818.07	1636.14	15	1	0.091813135985199	-4.66666666666667	1	-0.390697674418605	5	43
UNC80	6	43	2	4	1085.37	2170.74	15	1	0.206300691539315	-2.58333333333333	1	-0.210884353741497	6	49
UNC93A	0	5	0	1	183.81	367.62	15	1	1	NA	1	0	1	5
UNCX	1	1	0	0	24.09	48.18	15	1	1	NA	1	NA	0	2
UNG	2	5	0	1	59.73	119.46	15	1	1	1	1	0.285714285714286	1	7
UNK	2	5	0	2	238.92	477.84	15	1	1	1	1	0.285714285714286	2	7
UNKL	9	9	0	0	275.55	551.1	15	1	1	NA	1	NA	0	18
UPF1	0	13	0	3	327.36	654.72	15	1	1	NA	1	0	3	13
UPF2	3	21	2	2	416.46	832.92	15	1	0.135042735042735	-6	1	-0.375	4	24
UPK1B	2	4	0	1	83.49	166.98	15	1	1	1	1	0.333333333333333	1	6
UPK3A	6	5	0	0	56.1	112.2	15	1	1	NA	1	NA	0	11
UPK3B	1	1	0	0	12.21	24.42	15	1	1	NA	1	NA	0	2
UPK3BL	1	1	0	1	24.09	48.18	15	1	1	1	1	0.5	1	2
UPP1	1	4	1	1	73.59	147.18	15	1	1	-3	1	-0.3	2	5
UPP2	1	5	1	2	84.15	168.3	15	1	1	-1.5	1	-0.166666666666667	3	6
UQCC1	3	3	1	0	84.15	168.3	15	1	1	-Inf	1	-0.5	1	6
UQCRB	0	3	0	0	26.07	52.14	15	1	1	NA	1	NA	0	3
UQCRC2	2	3	1	0	165.66	331.32	15	1	1	-Inf	1	-0.6	1	5
UQCRFS1	0	2	0	0	43.23	86.46	15	1	1	NA	1	NA	0	2
URB1	31	31	6	4	766.59	1533.18	15	1	0.736100399130168	-0.5	1	-0.1	10	62
URB2	23	18	9	6	509.19	1018.38	15	1	1	-0.173913043478261	1	-0.0390243902439024	15	41
URI1	2	3	0	1	118.14	236.28	15	1	1	1	1	0.4	1	5
UROC1	0	6	0	0	231.66	463.32	15	1	1	NA	1	NA	0	6
UROD	1	10	1	1	99.33	198.66	15	1	0.294871794871795	-9	1	-0.409090909090909	2	11
UROS	3	9	1	0	94.71	189.42	15	1	0.307692307692308	-Inf	1	-0.75	1	12
USF3	11	36	3	13	727.32	1454.64	15	1	1	0.244755244755245	1	0.0465425531914894	16	47
USH1C	4	9	0	1	242.88	485.76	15	1	1	1	1	0.307692307692308	1	13
USH1G	2	4	1	0	124.08	248.16	15	1	0.428571428571428	-Inf	1	-0.666666666666667	1	6
USH2A	42	52	6	2	1379.73	2759.46	15	1	0.143437540423703	-2.71428571428571	1	-0.303191489361702	8	94
USHBP1	1	2	1	0	15.84	31.68	15	1	1	-Inf	1	-0.666666666666667	1	3
USO1	4	19	1	3	292.71	585.42	15	1	1	-0.583333333333333	1	-0.0760869565217391	4	23
USP1	0	18	0	2	212.85	425.7	15	1	1	NA	1	0	2	18
USP10	3	7	0	1	277.53	555.06	15	1	1	1	1	0.3	1	10
USP12-USP12-like	1	4	0	1	84.48	168.96	15	1	1	1	1	0.2	1	5
USP13	3	10	0	0	255.42	510.84	15	1	1	NA	1	NA	0	13
USP14	1	8	1	3	138.6	277.2	15	1	1	-1.66666666666667	1	-0.138888888888889	4	9
USP15	0	5	0	2	289.08	578.16	15	1	1	NA	1	0	2	5
USP16	7	14	2	1	244.86	489.72	15	1	0.533102766798419	-3	1	-0.333333333333333	3	21
USP18	8	2	0	0	145.86	291.72	15	1	1	NA	1	NA	0	10
USP19	2	20	0	5	270.6	541.2	15	1	1	1	1	0.0909090909090909	5	22
USP2	0	1	0	1	8.58	17.16	15	1	1	NA	1	0	1	1
USP20	0	14	0	3	244.2	488.4	15	1	1	NA	1	0	3	14
USP24	2	27	1	2	805.53	1611.06	15	1	0.263306451612903	-5.75	1	-0.264367816091954	3	29
USP25	0	8	0	0	334.95	669.9	15	1	1	NA	1	NA	0	8
USP28	6	16	0	4	392.37	784.74	15	1	0.54247491638796	1	1	0.272727272727273	4	22
USP3	0	5	0	0	156.09	312.18	15	1	1	NA	1	NA	0	5
USP30	1	8	0	2	120.45	240.9	15	1	1	1	1	0.111111111111111	2	9
USP31	6	17	1	3	343.53	687.06	15	1	1	0.0555555555555556	1	0.0108695652173913	4	23
USP32	5	19	2	5	535.92	1071.84	15	1	0.641701795917591	-0.52	1	-0.0773809523809524	7	24
USP33	4	13	0	1	298.98	597.96	15	1	1	1	1	0.235294117647059	1	17
USP34	4	27	1	1	1032.24	2064.48	15	1	0.284090909090909	-5.75	1	-0.370967741935484	2	31
USP35	7	26	1	5	391.38	782.76	15	1	1	0.257142857142857	1	0.0454545454545455	6	33
USP36	4	8	1	2	102.96	205.92	15	1	1	0	1	0	3	12
USP37	1	13	0	4	240.24	480.48	15	1	1	1	1	0.0714285714285714	4	14
USP38	6	14	1	3	268.62	537.24	15	1	1	0.222222222222222	1	0.05	4	20
USP4	6	12	3	4	219.78	439.56	15	1	0.672877054295819	-0.5	1	-0.0952380952380952	7	18
USP40	14	15	4	3	375.21	750.42	15	1	1	-0.428571428571429	1	-0.0886699507389162	7	29
USP42	24	26	11	7	353.43	706.86	15	1	0.415019144292796	-0.702380952380952	1	-0.131111111111111	18	50
USP43	0	1	0	1	20.46	40.92	15	1	1	NA	1	0	1	1
USP44	1	3	1	1	166.98	333.96	15	1	1	-2	1	-0.25	2	4
USP45	6	13	2	0	208.56	417.12	15	1	0.133333333333333	-Inf	1	-0.684210526315789	2	19
USP46	2	5	1	1	171.6	343.2	15	1	1	-1.5	1	-0.214285714285714	2	7
USP47	2	12	1	2	354.75	709.5	15	1	0.464705882352941	-2	1	-0.19047619047619	3	14
USP49	1	5	1	1	204.6	409.2	15	1	0.464285714285714	-4	1	-0.333333333333333	2	6
USP5	0	14	0	0	245.85	491.7	15	1	1	NA	1	NA	0	14
USP51	1	1	1	0	122.76	245.52	15	1	1	-Inf	1	-0.5	1	2
USP54	17	13	2	1	554.4	1108.8	15	1	1	-0.529411764705882	1	-0.1	3	30
USP6NL	9	10	1	0	247.5	495	15	1	1	-Inf	1	-0.526315789473684	1	19
USP7	1	12	0	3	297.33	594.66	15	1	1	1	1	0.0769230769230769	3	13
USP8	5	12	1	0	329.67	659.34	15	1	0.333333333333333	-Inf	1	-0.705882352941176	1	17
USP9X	10	29	1	8	794.31	1588.62	15	1	0.662364368195454	0.6375	1	0.145299145299145	9	39
USPL1	26	17	5	4	309.21	618.42	15	1	1	0.182692307692308	1	0.0490956072351421	9	43
UST	1	1	1	0	111.21	222.42	15	1	1	-Inf	1	-0.5	1	2
UT2LZ	2	5	1	1	100.32	200.64	15	1	1	-1.5	1	-0.214285714285714	2	7
UTP11	1	1	0	0	47.85	95.7	15	1	1	NA	1	NA	0	2
UTP14A	10	4	2	1	125.07	250.14	15	1	1	0.2	1	0.0476190476190477	3	14
UTP15	2	8	0	1	116.82	233.64	15	1	1	1	1	0.2	1	10
UTP18	2	6	1	0	161.37	322.74	15	1	0.333333333333333	-Inf	1	-0.75	1	8
UTP20	35	24	5	3	958.32	1916.64	15	1	1	-0.142857142857143	1	-0.0317796610169492	8	59
UTP23	4	3	1	0	53.46	106.92	15	1	1	-Inf	1	-0.428571428571429	1	7
UTP3	5	6	0	0	81.84	163.68	15	1	1	NA	1	NA	0	11
UTP6	1	7	0	0	161.04	322.08	15	1	1	NA	1	NA	0	8
UTRN	20	37	2	4	1078.11	2156.22	15	1	1	0.075	1	0.0175438596491228	6	57
UTS2	4	2	0	0	30.69	61.38	15	1	1	NA	1	NA	0	6
UTS2R	4	14	1	5	159.72	319.44	15	1	1	0.3	1	0.0555555555555556	6	18
UTS2RL	1	4	1	1	66.99	133.98	15	1	1	-3	1	-0.3	2	5
UVRAG	5	16	0	4	274.89	549.78	15	1	0.549407114624506	1	1	0.238095238095238	4	21
UVS.2L	11	7	2	2	108.24	216.48	15	1	1	0.363636363636364	1	0.111111111111111	4	18
UVSSA	10	15	4	5	199.65	399.3	15	1	1	-0.2	1	-0.0444444444444444	9	25
UXS1	0	5	0	1	122.43	244.86	15	1	1	NA	1	0	1	5
VAMP1	4	3	0	1	40.26	80.52	15	1	1	1	1	0.571428571428571	1	7
VAMP2	1	2	0	1	42.9	85.8	15	1	1	1	1	0.333333333333333	1	3
VAMP7	0	2	0	0	63.03	126.06	15	1	1	NA	1	NA	0	2
VAPA	0	2	0	0	63.69	127.38	15	1	1	NA	1	NA	0	2
VAPB	1	1	0	0	63.69	127.38	15	1	1	NA	1	NA	0	2
VAT1	1	5	1	0	66	132	15	1	0.285714285714286	-Inf	1	-0.833333333333333	1	6
VAV3	2	12	1	4	252.78	505.56	15	1	1	-0.5	1	-0.0571428571428572	5	14
VCAM1	9	7	2	0	208.56	417.12	15	1	0.496732026143791	-Inf	1	-0.4375	2	16
VCAN	51	36	6	2	880.11	1760.22	15	1	0.46952204731495	-1.11764705882353	1	-0.163793103448276	8	87
VCL	2	9	0	0	329.67	659.34	15	1	1	NA	1	NA	0	11
VCPIP1	3	18	1	4	359.7	719.4	15	1	1	-0.5	1	-0.0571428571428572	5	21
VCPKMT	1	6	0	0	40.59	81.18	15	1	1	NA	1	NA	0	7
VDAC1	0	3	0	0	66.99	133.98	15	1	1	NA	1	NA	0	3
VDAC2	0	2	0	1	102.3	204.6	15	1	1	NA	1	0	1	2
VDAC3	1	4	0	1	74.58	149.16	15	1	1	1	1	0.2	1	5
VDHAP	2	10	0	1	165.99	331.98	15	1	1	1	1	0.166666666666667	1	12
VDR	0	4	0	0	65.01	130.02	15	1	1	NA	1	NA	0	4
VEGFC	1	6	1	1	123.42	246.84	15	1	0.416666666666667	-5	1	-0.357142857142857	2	7
VEGFD	1	3	1	0	99.99	199.98	15	1	0.4	-Inf	1	-0.75	1	4
VEGFRKDRL	4	19	0	4	440.88	881.76	15	1	1	1	1	0.173913043478261	4	23
VEPH1	1	1	0	0	96.03	192.06	15	1	1	NA	1	NA	0	2
VEZT	8	14	2	3	242.55	485.1	15	1	1	-0.166666666666667	1	-0.0363636363636364	5	22
VGLL1	0	1	0	1	69.96	139.92	15	1	1	NA	1	0	1	1
VGLL4	5	1	0	1	83.49	166.98	15	1	0.285714285714286	1	1	0.833333333333333	1	6
VIL1	2	1	0	0	66.99	133.98	15	1	1	NA	1	NA	0	3
VILL	4	18	3	3	325.38	650.76	15	1	0.144258639910814	-3.5	1	-0.318181818181818	6	22
VIM	0	3	0	2	60.72	121.44	15	1	1	NA	1	0	2	3
VIPR1	2	7	1	1	116.49	232.98	15	1	0.490909090909091	-2.5	1	-0.277777777777778	2	9
VIPR2	4	9	0	1	127.38	254.76	15	1	1	1	1	0.307692307692308	1	13
VIT	7	13	2	2	262.35	524.7	15	1	0.614624505928854	-0.857142857142857	1	-0.15	4	20
VLDLR	5	10	5	1	198	396	15	1	0.0634674922600619	-9	1	-0.5	6	15
VMO1	4	5	1	1	69.3	138.6	15	1	1	-0.25	1	-0.0555555555555556	2	9
VMP1	2	2	0	1	124.74	249.48	15	1	1	1	1	0.5	1	4
VNN1	12	6	6	0	157.08	314.16	15	1	0.277036464679485	-Inf	1	-0.333333333333333	6	18
VPS11	4	15	0	0	300.3	600.6	15	1	1	NA	1	NA	0	19
VPS13A	9	20	1	0	555.39	1110.78	15	1	0.333333333333333	-Inf	1	-0.689655172413793	1	29
VPS13B	22	42	7	10	951.39	1902.78	15	1	0.776617927600724	-0.336363636363636	1	-0.0680147058823529	17	64
VPS13C	23	50	3	2	1070.85	2141.7	15	1	0.326356431619589	-2.26086956521739	1	-0.284931506849315	5	73
VPS13D	19	72	6	11	1357.95	2715.9	15	1	0.216944054584317	-1.06698564593301	1	-0.144149967679379	17	91
VPS18	0	19	0	3	342.21	684.42	15	1	1	NA	1	0	3	19
VPS26A	0	11	0	1	131.01	262.02	15	1	1	NA	1	0	1	11
VPS26B	1	5	1	0	98.67	197.34	15	1	0.285714285714286	-Inf	1	-0.833333333333333	1	6
VPS29L	0	2	0	0	34.98	69.96	15	1	1	NA	1	NA	0	2
VPS33A	0	9	0	3	161.04	322.08	15	1	1	NA	1	0	3	9
VPS33B	3	6	1	1	93.72	187.44	15	1	1	-1	1	-0.166666666666667	2	9
VPS35	1	7	0	0	216.48	432.96	15	1	1	NA	1	NA	0	8
VPS36	1	8	0	3	114.84	229.68	15	1	1	1	1	0.111111111111111	3	9
VPS37A	3	4	2	2	122.76	245.52	15	1	1	-0.333333333333333	1	-0.0714285714285715	4	7
VPS37B	2	1	1	0	50.82	101.64	15	1	1	-Inf	1	-0.333333333333333	1	3
VPS37D	0	2	0	0	48.84	97.68	15	1	1	NA	1	NA	0	2
VPS41	0	12	0	2	273.9	547.8	15	1	1	NA	1	0	2	12
VPS45	1	11	1	5	150.81	301.62	15	1	1	-1.2	1	-0.0833333333333333	6	12
VPS50	2	12	0	2	333.96	667.92	15	1	1	1	1	0.142857142857143	2	14
VPS53	1	21	1	7	299.64	599.28	15	1	0.468965517241379	-2	1	-0.0795454545454545	8	22
VPS54	0	8	0	3	337.92	675.84	15	1	1	NA	1	0	3	8
VPS72	3	5	3	0	58.41	116.82	15	1	0.181818181818182	-Inf	1	-0.625	3	8
VPS8	6	20	1	1	400.29	800.58	15	1	0.444444444444444	-2.33333333333333	1	-0.269230769230769	2	26
VRK1	2	6	1	2	114.84	229.68	15	1	1	-0.5	1	-0.0833333333333333	3	8
VRK2	6	1	0	0	144.87	289.74	15	1	1	NA	1	NA	0	7
VRK3	2	5	0	1	94.05	188.1	15	1	1	1	1	0.285714285714286	1	7
VRTN	2	8	1	4	159.39	318.78	15	1	1	0	1	0	5	10
VSIG1	1	4	0	0	93.72	187.44	15	1	1	NA	1	NA	0	5
VSIG10	5	8	2	3	93.06	186.12	15	1	1	-0.0666666666666667	1	-0.0153846153846154	5	13
VSIG10L	17	4	1	1	127.05	254.1	15	1	0.395256916996047	0.764705882352941	1	0.30952380952381	2	21
VSIG4	10	5	2	1	212.52	425.04	15	1	1	0	1	0	3	15
VSNL1	3	1	2	0	39.27	78.54	15	1	1	-Inf	1	-0.25	2	4
VSTM2A	2	1	0	0	53.46	106.92	15	1	1	NA	1	NA	0	3
VSTM2B	3	2	0	0	17.49	34.98	15	1	1	NA	1	NA	0	5
VSTM2L	0	1	0	1	11.22	22.44	15	1	1	NA	1	0	1	1
VSTM4	5	7	2	2	101.64	203.28	15	1	1	-0.4	1	-0.0833333333333333	4	12
VSTM5	1	4	0	0	53.46	106.92	15	1	1	NA	1	NA	0	5
VSX1	1	1	0	0	43.56	87.12	15	1	1	NA	1	NA	0	2
VSX2	0	3	0	1	53.79	107.58	15	1	1	NA	1	0	1	3
VTA1	2	0	0	0	99.99	199.98	15	1	1	NA	1	NA	0	2
VTCN1	5	2	2	1	63.69	127.38	15	1	1	0.2	1	0.0476190476190477	3	7
VTCN1L	3	2	0	0	37.95	75.9	15	1	1	NA	1	NA	0	5
VTG1	15	25	1	0	513.15	1026.3	15	1	0.390243902439024	-Inf	1	-0.625	1	40
VTG2	17	29	4	4	576.84	1153.68	15	1	0.696619645706948	-0.705882352941176	1	-0.130434782608696	8	46
VTG3	24	36	5	5	684.42	1368.84	15	1	0.730797848602674	-0.5	1	-0.1	10	60
VTI1A	2	0	0	0	50.82	101.64	15	1	1	NA	1	NA	0	2
VTI1B	1	3	0	0	60.06	120.12	15	1	1	NA	1	NA	0	4
VTN	6	4	2	2	53.79	107.58	15	1	1	0.333333333333333	1	0.1	4	10
VWA1	1	8	0	3	145.2	290.4	15	1	1	1	1	0.111111111111111	3	9
VWA2	12	20	5	7	203.61	407.22	15	1	1	-0.19047619047619	1	-0.0416666666666667	12	32
VWA3A	15	8	1	0	361.02	722.04	15	1	1	-Inf	1	-0.347826086956522	1	23
VWA3B	20	11	2	1	426.03	852.06	15	1	1	-0.1	1	-0.021505376344086	3	31
VWA5A	7	6	0	1	111.54	223.08	15	1	1	1	1	0.538461538461538	1	13
VWA5B1	6	13	5	10	145.86	291.72	15	1	1	-0.0833333333333333	1	-0.0175438596491228	15	19
VWA5B2	6	7	2	3	80.52	161.04	15	1	1	0.222222222222222	1	0.0615384615384615	5	13
VWA9	0	6	0	2	157.08	314.16	15	1	1	NA	1	0	2	6
VWCE	0	4	0	3	32.34	64.68	15	1	1	NA	1	0	3	4
VWDE	31	25	2	6	601.59	1203.18	15	1	0.142276363317296	0.731182795698925	1	0.303571428571429	8	56
VWF	6	9	0	1	234.63	469.26	15	1	1	1	1	0.4	1	15
WAC	1	3	0	1	220.77	441.54	15	1	1	1	1	0.25	1	4
WAPL	8	8	2	0	335.61	671.22	15	1	0.477124183006536	-Inf	1	-0.5	2	16
WARS	0	12	0	0	133.65	267.3	15	1	1	NA	1	NA	0	12
WASF1	1	5	1	1	124.08	248.16	15	1	0.464285714285714	-4	1	-0.333333333333333	2	6
WASF2	0	1	0	1	76.56	153.12	15	1	1	NA	1	0	1	1
WASF3	0	7	0	2	156.09	312.18	15	1	1	NA	1	0	2	7
WASHC1	0	9	0	2	112.86	225.72	15	1	1	NA	1	0	2	9
WASHC2C	14	16	5	2	388.74	777.48	15	1	0.404791154791155	-1.85714285714286	1	-0.247619047619048	7	30
WASHC3	1	2	0	0	61.05	122.1	15	1	1	NA	1	NA	0	3
WASHC4	0	11	0	1	356.07	712.14	15	1	1	NA	1	0	1	11
WASHC5	0	7	0	2	379.5	759	15	1	1	NA	1	0	2	7
WASL	0	2	0	1	89.43	178.86	15	1	1	NA	1	0	1	2
WBP11	0	5	0	3	148.17	296.34	15	1	1	NA	1	0	3	5
WBP2NL	3	1	1	1	85.14	170.28	15	1	1	0.666666666666667	1	0.25	2	4
WBP4	4	4	1	0	122.1	244.2	15	1	1	-Inf	1	-0.5	1	8
WBSCR17	1	6	0	1	87.78	175.56	15	1	1	1	1	0.142857142857143	1	7
WBSCR22	0	3	0	0	57.75	115.5	15	1	1	NA	1	NA	0	3
WBSCR27	0	2	0	0	13.2	26.4	15	1	1	NA	1	NA	0	2
WDCP	10	17	4	5	267.96	535.92	15	1	0.711512791991101	-0.36	1	-0.0740740740740741	9	27
WDCPL	12	16	1	0	298.32	596.64	15	1	0.448275862068965	-Inf	1	-0.571428571428571	1	28
WDFY1	0	6	0	2	112.2	224.4	15	1	1	NA	1	0	2	6
WDFY2	3	6	2	0	123.42	246.84	15	1	0.181818181818182	-Inf	1	-0.666666666666667	2	9
WDFY4	17	31	2	2	829.29	1658.58	15	1	0.617087450364761	-0.823529411764706	1	-0.145833333333333	4	48
WDHD1	5	23	1	2	347.49	694.98	15	1	0.488320355951057	-1.3	1	-0.154761904761905	3	28
WDPCP	6	5	2	1	210.21	420.42	15	1	1	-0.666666666666667	1	-0.121212121212121	3	11
WDR1	2	4	1	0	170.28	340.56	15	1	0.428571428571428	-Inf	1	-0.666666666666667	1	6
WDR11	4	13	1	4	394.68	789.36	15	1	1	0.1875	1	0.0352941176470588	5	17
WDR12	1	7	1	2	94.05	188.1	15	1	0.490909090909091	-2.5	1	-0.208333333333333	3	8
WDR17	8	11	2	1	384.78	769.56	15	1	0.571428571428572	-1.75	1	-0.245614035087719	3	19
WDR18	1	5	0	1	77.22	154.44	15	1	1	1	1	0.166666666666667	1	6
WDR19	6	15	1	2	435.27	870.54	15	1	1	-0.25	1	-0.0476190476190476	3	21
WDR25	9	5	0	1	125.73	251.46	15	1	0.4	1	1	0.642857142857143	1	14
WDR26	0	7	0	1	156.42	312.84	15	1	1	NA	1	0	1	7
WDR27	17	16	2	1	271.92	543.84	15	1	1	-0.882352941176471	1	-0.151515151515151	3	33
WDR3	7	12	2	3	260.37	520.74	15	1	1	-0.142857142857143	1	-0.0315789473684211	5	19
WDR31	4	5	1	1	84.48	168.96	15	1	1	-0.25	1	-0.0555555555555556	2	9
WDR33	2	10	2	1	428.34	856.68	15	1	0.153846153846154	-9	1	-0.5	3	12
WDR34	9	14	2	3	141.24	282.48	15	1	1	-0.037037037037037	1	-0.00869565217391305	5	23
WDR35	3	20	1	1	404.91	809.82	15	1	0.3	-5.66666666666667	1	-0.369565217391304	2	23
WDR36	5	10	1	0	228.03	456.06	15	1	0.375	-Inf	1	-0.666666666666667	1	15
WDR37	0	3	0	0	130.02	260.04	15	1	1	NA	1	NA	0	3
WDR4	3	5	0	0	90.75	181.5	15	1	1	NA	1	NA	0	8
WDR41	0	3	0	1	84.15	168.3	15	1	1	NA	1	0	1	3
WDR43	3	9	0	0	213.18	426.36	15	1	1	NA	1	NA	0	12
WDR44	6	14	0	1	272.25	544.5	15	1	1	1	1	0.3	1	20
WDR45B	0	5	0	0	111.54	223.08	15	1	1	NA	1	NA	0	5
WDR47	1	10	0	2	302.61	605.22	15	1	1	1	1	0.0909090909090909	2	11
WDR48	0	6	0	0	276.87	553.74	15	1	1	NA	1	NA	0	6
WDR5	0	6	0	0	123.75	247.5	15	1	1	NA	1	NA	0	6
WDR53	5	7	0	0	74.58	149.16	15	1	1	NA	1	NA	0	12
WDR54	2	2	2	1	38.94	77.88	15	1	1	-1	1	-0.166666666666667	3	4
WDR55	1	2	0	1	29.04	58.08	15	1	1	1	1	0.333333333333333	1	3
WDR6	5	4	3	0	25.08	50.16	15	1	0.490909090909091	-Inf	1	-0.444444444444444	3	9
WDR60	10	6	1	0	316.47	632.94	15	1	1	-Inf	1	-0.375	1	16
WDR61	0	2	0	0	86.79	173.58	15	1	1	NA	1	NA	0	2
WDR63	21	13	1	3	262.02	524.04	15	1	0.290659080132764	0.793650793650794	1	0.367647058823529	4	34
WDR64	13	10	0	0	292.71	585.42	15	1	1	NA	1	NA	0	23
WDR66	10	12	1	3	256.74	513.48	15	1	0.61371237458194	0.6	1	0.204545454545455	4	22
WDR7	5	24	4	4	460.35	920.7	15	1	0.0783618274130608	-3.8	1	-0.327586206896552	8	29
WDR70	5	3	0	1	129.03	258.06	15	1	0.444444444444444	1	1	0.625	1	8
WDR72	6	12	2	0	322.74	645.48	15	1	0.147368421052632	-Inf	1	-0.666666666666667	2	18
WDR73	3	3	0	0	30.69	61.38	15	1	1	NA	1	NA	0	6
WDR75	8	15	3	3	256.41	512.82	15	1	0.645699128457749	-0.875	1	-0.152173913043478	6	23
WDR76	3	20	0	3	163.35	326.7	15	1	1	1	1	0.130434782608696	3	23
WDR77	1	1	0	0	41.58	83.16	15	1	1	NA	1	NA	0	2
WDR78	17	11	5	5	229.02	458.04	15	1	0.712743889607071	0.352941176470588	1	0.107142857142857	10	28
WDR81	10	34	8	12	465.96	931.92	15	1	0.229844275099535	-1.26666666666667	1	-0.172727272727273	20	44
WDR82	0	4	0	1	79.86	159.72	15	1	1	NA	1	0	1	4
WDR86	0	8	0	1	105.27	210.54	15	1	1	NA	1	0	1	8
WDR88	1	2	1	0	100.32	200.64	15	1	1	-Inf	1	-0.666666666666667	1	3
WDR89	8	6	1	0	139.59	279.18	15	1	1	-Inf	1	-0.428571428571429	1	14
WDR91	2	8	0	3	231	462	15	1	1	1	1	0.2	3	10
WDR92	1	5	0	0	98.34	196.68	15	1	1	NA	1	NA	0	6
WDSUB1	4	5	0	1	170.61	341.22	15	1	1	1	1	0.444444444444444	1	9
WDTC1	0	4	0	2	188.1	376.2	15	1	1	NA	1	0	2	4
WDYHV1	3	4	0	2	45.87	91.74	15	1	0.5	1	1	0.428571428571429	2	7
WEE1	0	5	0	1	149.49	298.98	15	1	1	NA	1	0	1	5
WEE2	8	9	3	1	169.29	338.58	15	1	0.586466165413534	-2.375	1	-0.279411764705882	4	17
WFDC2-WFDC8	3	3	2	1	49.83	99.66	15	1	1	-1	1	-0.166666666666667	3	6
WFIKKN1	1	3	1	2	92.07	184.14	15	1	1	-0.5	1	-0.0833333333333333	3	4
WFIKKN2	1	13	0	4	176.22	352.44	15	1	1	1	1	0.0714285714285714	4	14
WFS1	2	12	0	0	218.46	436.92	15	1	1	NA	1	NA	0	14
WHAMM	4	5	1	1	144.54	289.08	15	1	1	-0.25	1	-0.0555555555555556	2	9
WHRN	2	10	1	5	112.53	225.06	15	1	1	0	1	0	6	12
WHSC1	5	9	2	0	425.04	850.08	15	1	0.175	-Inf	1	-0.642857142857143	2	14
WHSC1L1	3	11	1	1	348.48	696.96	15	1	0.45	-2.66666666666667	1	-0.285714285714286	2	14
WIF1	0	6	0	1	111.87	223.74	15	1	1	NA	1	0	1	6
WIPF1	2	8	1	1	64.02	128.04	15	1	0.454545454545455	-3	1	-0.3	2	10
WIPF3	2	3	1	0	59.07	118.14	15	1	1	-Inf	1	-0.6	1	5
WIPI1	0	8	0	1	152.13	304.26	15	1	1	NA	1	0	1	8
WIPI2	0	3	0	1	117.81	235.62	15	1	1	NA	1	0	1	3
WISP1	4	3	0	0	126.39	252.78	15	1	1	NA	1	NA	0	7
WISP2	11	6	2	0	102.63	205.26	15	1	1	-Inf	1	-0.352941176470588	2	17
WISP3	5	5	1	2	123.09	246.18	15	1	1	0.5	1	0.166666666666667	3	10
WLS	0	4	0	2	114.84	229.68	15	1	1	NA	1	0	2	4
WNK1	9	20	1	4	823.02	1646.04	15	1	1	0.444444444444444	1	0.110344827586207	5	29
WNK2	7	37	5	12	660.66	1321.32	15	1	0.287430941954828	-1.20238095238095	1	-0.135026737967914	17	44
WNT10A	0	4	0	3	36.96	73.92	15	1	1	NA	1	0	3	4
WNT11	2	2	2	0	76.23	152.46	15	1	0.466666666666667	-Inf	1	-0.5	2	4
WNT11B	0	1	0	1	56.76	113.52	15	1	1	NA	1	0	1	1
WNT16	1	6	0	0	87.45	174.9	15	1	1	NA	1	NA	0	7
WNT2	1	2	0	0	73.92	147.84	15	1	1	NA	1	NA	0	3
WNT2B	0	2	0	1	43.89	87.78	15	1	1	NA	1	0	1	2
WNT3	1	8	1	0	96.36	192.72	15	1	0.2	-Inf	1	-0.888888888888889	1	9
WNT3A	0	3	0	1	112.86	225.72	15	1	1	NA	1	0	1	3
WNT4	0	4	0	1	85.8	171.6	15	1	1	NA	1	0	1	4
WNT5A	0	2	0	0	85.14	170.28	15	1	1	NA	1	NA	0	2
WNT5B	0	3	0	3	67.32	134.64	15	1	1	NA	1	0	3	3
WNT7A	0	5	0	2	104.28	208.56	15	1	1	NA	1	0	2	5
WNT8A	1	8	1	1	78.87	157.74	15	1	0.345454545454545	-7	1	-0.388888888888889	2	9
WNT8B	0	4	0	0	65.34	130.68	15	1	1	NA	1	NA	0	4
WNT9A	0	6	0	1	113.85	227.7	15	1	1	NA	1	0	1	6
WNT9B	0	6	0	0	112.53	225.06	15	1	1	NA	1	NA	0	6
WRAP73	2	6	0	1	116.16	232.32	15	1	1	1	1	0.25	1	8
WRB	0	3	0	0	39.93	79.86	15	1	1	NA	1	NA	0	3
WRN	21	26	7	3	449.79	899.58	15	1	0.178882277836656	-1.88888888888889	1	-0.253191489361702	10	47
WSB1	1	7	1	1	119.46	238.92	15	1	0.377777777777778	-6	1	-0.375	2	8
WSCD1	0	4	0	1	150.15	300.3	15	1	1	NA	1	0	1	4
WSCD2	0	2	0	2	51.48	102.96	15	1	1	NA	1	0	2	2
WT1	0	2	0	0	97.02	194.04	15	1	1	NA	1	NA	0	2
WTAP	1	3	1	0	125.4	250.8	15	1	0.4	-Inf	1	-0.75	1	4
WWC1	2	9	0	1	367.62	735.24	15	1	1	1	1	0.181818181818182	1	11
WWC3	1	10	0	0	346.5	693	15	1	1	NA	1	NA	0	11
WWOX	2	2	1	0	54.12	108.24	15	1	1	-Inf	1	-0.5	1	4
WWP1	1	8	0	0	282.48	564.96	15	1	1	NA	1	NA	0	9
WWTR1	5	5	0	0	102.3	204.6	15	1	1	NA	1	NA	0	10
XAF1	10	5	0	1	127.71	255.42	15	1	0.375	1	1	0.666666666666667	1	15
XBP1	1	3	0	0	81.84	163.68	15	1	1	NA	1	NA	0	4
xcc-b100_1894L	5	8	1	2	170.61	341.22	15	1	1	0.2	1	0.0512820512820513	3	13
XCL1	0	2	0	0	31.35	62.7	15	1	1	NA	1	NA	0	2
XCR1	1	2	0	0	126.39	252.78	15	1	1	NA	1	NA	0	3
XDH	9	25	4	2	464.31	928.62	15	1	0.0748831538305222	-4.55555555555556	1	-0.401960784313725	6	34
XIAP	10	6	4	3	125.07	250.14	15	1	1	0.2	1	0.0535714285714286	7	16
XIRP1	31	21	12	4	798.6	1597.2	15	1	0.37652371722227	-1.03225806451613	1	-0.153846153846154	16	52
XIRP2	23	12	1	0	287.76	575.52	15	1	1	-Inf	1	-0.342857142857143	1	35
XK	2	10	0	5	163.02	326.04	15	1	1	1	1	0.166666666666667	5	12
XKR4	2	4	0	2	155.1	310.2	15	1	1	1	1	0.333333333333333	2	6
XKR5	16	8	7	3	148.83	297.66	15	1	1	-0.166666666666667	1	-0.0333333333333333	10	24
XKR6	2	1	1	0	104.28	208.56	15	1	1	-Inf	1	-0.333333333333333	1	3
XKR7	0	1	0	1	35.97	71.94	15	1	1	NA	1	0	1	1
XKR8	5	10	0	1	118.8	237.6	15	1	1	1	1	0.333333333333333	1	15
XKR9	4	6	1	0	106.59	213.18	15	1	0.454545454545455	-Inf	1	-0.6	1	10
XKRX	3	9	1	1	84.48	168.96	15	1	0.505494505494505	-2	1	-0.25	2	12
XPC	10	10	2	2	269.28	538.56	15	1	1	0	1	0	4	20
XPNPEP1	2	6	0	1	214.83	429.66	15	1	1	1	1	0.25	1	8
XPNPEP2	3	3	3	3	42.24	84.48	15	1	1	0	1	0	6	6
XPNPEP3	4	10	2	0	163.02	326.04	15	1	0.125	-Inf	1	-0.714285714285714	2	14
XPO1	2	5	2	0	293.04	586.08	15	1	0.166666666666667	-Inf	1	-0.714285714285714	2	7
XPO4	0	7	0	1	309.21	618.42	15	1	1	NA	1	0	1	7
XPO5	0	12	0	2	357.06	714.12	15	1	1	NA	1	0	2	12
XPO7	1	7	0	3	265.98	531.96	15	1	1	1	1	0.125	3	8
XPOT	2	12	0	1	336.6	673.2	15	1	1	1	1	0.142857142857143	1	14
XPR1	2	10	0	2	231.66	463.32	15	1	1	1	1	0.166666666666667	2	12
XRCC2	3	4	2	0	87.45	174.9	15	1	0.444444444444445	-Inf	1	-0.571428571428571	2	7
XRCC3	2	6	0	1	115.17	230.34	15	1	1	1	1	0.25	1	8
XRCC4	1	3	0	0	41.91	83.82	15	1	1	NA	1	NA	0	4
XRCC5	4	7	1	0	203.94	407.88	15	1	0.416666666666667	-Inf	1	-0.636363636363636	1	11
XRCC6	5	9	1	3	192.72	385.44	15	1	1	0.4	1	0.107142857142857	4	14
XRN1	12	22	2	4	552.75	1105.5	15	1	1	0.0833333333333334	1	0.0196078431372549	6	34
XRN2	0	5	0	0	295.35	590.7	15	1	1	NA	1	NA	0	5
XRRA1	19	9	6	1	170.61	341.22	15	1	0.644457894392462	-1.84210526315789	1	-0.178571428571428	7	28
XXYLT1	0	3	0	0	77.22	154.44	15	1	1	NA	1	NA	0	3
XYLB	7	4	2	0	158.73	317.46	15	1	1	-Inf	1	-0.363636363636364	2	11
XYLT1	4	10	2	2	249.15	498.3	15	1	0.568627450980392	-1.5	1	-0.214285714285714	4	14
XYLT2	0	9	0	2	152.46	304.92	15	1	1	NA	1	0	2	9
YAE1D1	4	4	1	0	81.18	162.36	15	1	1	-Inf	1	-0.5	1	8
YARS	1	10	0	1	74.58	149.16	15	1	1	1	1	0.0909090909090909	1	11
YARS2	2	5	2	0	66.99	133.98	15	1	0.166666666666667	-Inf	1	-0.714285714285714	2	7
YBEY	1	2	1	1	9.9	19.8	15	1	1	-1	1	-0.166666666666667	2	3
YBX3	2	2	2	0	74.91	149.82	15	1	0.466666666666667	-Inf	1	-0.5	2	4
YDJC	3	4	2	0	93.39	186.78	15	1	0.444444444444445	-Inf	1	-0.571428571428571	2	7
YEATS2	3	14	1	4	454.41	908.82	15	1	1	-0.166666666666667	1	-0.0235294117647059	5	17
YEATS4	4	7	1	2	81.51	163.02	15	1	1	0.125	1	0.0303030303030303	3	11
YES1	0	9	0	4	192.39	384.78	15	1	1	NA	1	0	4	9
YIPF1	0	4	0	0	76.89	153.78	15	1	1	NA	1	NA	0	4
YIPF3	0	5	0	3	74.25	148.5	15	1	1	NA	1	0	3	5
YIPF4	0	7	0	2	86.79	173.58	15	1	1	NA	1	0	2	7
YIPF5	0	3	0	0	72.6	145.2	15	1	1	NA	1	NA	0	3
YIPF7	2	5	0	2	81.84	163.68	15	1	1	1	1	0.285714285714286	2	7
YLPM1	14	22	3	3	599.94	1199.88	15	1	0.672041520565269	-0.571428571428571	1	-0.111111111111111	6	36
YME1L1	2	5	0	0	234.96	469.92	15	1	1	NA	1	NA	0	7
YRDC	1	6	0	0	33.99	67.98	15	1	1	NA	1	NA	0	7
YTHDC1	1	4	0	0	162.03	324.06	15	1	1	NA	1	NA	0	5
YTHDC2	5	12	1	0	230.67	461.34	15	1	0.333333333333333	-Inf	1	-0.705882352941176	1	17
YTHDF1	0	8	0	0	217.14	434.28	15	1	1	NA	1	NA	0	8
YTHDF3	0	3	0	1	165.99	331.98	15	1	1	NA	1	0	1	3
YWHAB	0	4	0	2	103.95	207.9	15	1	1	NA	1	0	2	4
YWHAG	0	2	0	2	42.9	85.8	15	1	1	NA	1	0	2	2
YWHAZ	0	2	0	0	87.78	175.56	15	1	1	NA	1	NA	0	2
ZAR1L	6	3	0	1	82.83	165.66	15	1	0.4	1	1	0.666666666666667	1	9
ZBBX	16	5	4	0	174.9	349.8	15	1	0.549407114624506	-Inf	1	-0.238095238095238	4	21
ZBED1	3	11	1	3	218.46	436.92	15	1	1	-0.222222222222222	1	-0.0357142857142857	4	14
ZBED4	2	17	1	1	417.12	834.24	15	1	0.271428571428572	-7.5	1	-0.394736842105263	2	19
ZBTB1	1	4	1	0	242.22	484.44	15	1	0.333333333333333	-Inf	1	-0.8	1	5
ZBTB14	0	1	0	1	125.07	250.14	15	1	1	NA	1	0	1	1
ZBTB17	1	4	1	2	86.46	172.92	15	1	1	-1	1	-0.133333333333333	3	5
ZBTB18-ZBTB42	1	2	1	2	125.73	251.46	15	1	1	0	1	0	3	3
ZBTB2	1	5	1	0	172.26	344.52	15	1	0.285714285714286	-Inf	1	-0.833333333333333	1	6
ZBTB20	1	1	1	0	141.24	282.48	15	1	1	-Inf	1	-0.5	1	2
ZBTB21	4	20	2	5	362.67	725.34	15	1	0.595904281110065	-1	1	-0.119047619047619	7	24
ZBTB25	1	4	0	1	100.32	200.64	15	1	1	1	1	0.2	1	5
ZBTB26	0	2	0	1	124.41	248.82	15	1	1	NA	1	0	1	2
ZBTB32	1	7	1	3	183.81	367.62	15	1	1	-1.33333333333333	1	-0.125	4	8
ZBTB33	8	16	0	1	254.76	509.52	15	1	1	1	1	0.333333333333333	1	24
ZBTB34	1	6	0	0	131.34	262.68	15	1	1	NA	1	NA	0	7
ZBTB37	0	4	0	1	155.1	310.2	15	1	1	NA	1	0	1	4
ZBTB38	12	22	4	6	406.23	812.46	15	1	1	-0.222222222222222	1	-0.0470588235294118	10	34
ZBTB39	1	3	0	1	175.89	351.78	15	1	1	1	1	0.25	1	4
ZBTB40	8	2	1	1	65.34	130.68	15	1	0.454545454545455	0.75	1	0.3	2	10
ZBTB41	6	9	2	1	294.69	589.38	15	1	0.558823529411765	-2	1	-0.266666666666667	3	15
ZBTB43	0	7	0	1	168.63	337.26	15	1	1	NA	1	0	1	7
ZBTB44	0	7	0	3	169.62	339.24	15	1	1	NA	1	0	3	7
ZBTB46	1	9	1	4	206.58	413.16	15	1	1	-1.25	1	-0.1	5	10
ZBTB47	0	4	0	2	108.57	217.14	15	1	1	NA	1	0	2	4
ZBTB49	7	16	1	3	256.41	512.82	15	1	1	0.238095238095238	1	0.0543478260869565	4	23
ZBTB6	3	10	0	2	136.29	272.58	15	1	1	1	1	0.230769230769231	2	13
ZBTB7C	2	6	0	3	93.06	186.12	15	1	1	1	1	0.25	3	8
ZBTB8AL	1	6	0	0	131.34	262.68	15	1	1	NA	1	NA	0	7
ZBTB8B	5	2	3	1	103.29	206.58	15	1	1	-0.2	1	-0.0357142857142857	4	7
ZBTB8OS	2	0	0	0	33.66	67.32	15	1	1	NA	1	NA	0	2
ZC2HC1A	3	4	0	0	108.57	217.14	15	1	1	NA	1	NA	0	7
ZC2HC1C	12	6	2	1	104.61	209.22	15	1	1	0	1	0	3	18
ZC3H11A	13	6	2	2	177.54	355.08	15	1	0.58893280632411	0.538461538461538	1	0.184210526315789	4	19
ZC3H12A	5	10	1	2	184.8	369.6	15	1	1	0	1	0	3	15
ZC3H12B	4	8	1	1	358.71	717.42	15	1	1	-1	1	-0.166666666666667	2	12
ZC3H12C	3	10	2	2	268.62	537.24	15	1	0.53781512605042	-2.33333333333333	1	-0.269230769230769	4	13
ZC3H12D	8	12	3	4	173.91	347.82	15	1	1	-0.125	1	-0.0285714285714285	7	20
ZC3H13	2	19	1	1	363.33	726.66	15	1	0.24901185770751	-8.5	1	-0.404761904761905	2	21
ZC3H14	7	8	2	1	191.07	382.14	15	1	1	-1.28571428571429	1	-0.2	3	15
ZC3H15	4	6	0	0	115.5	231	15	1	1	NA	1	NA	0	10
ZC3H18	0	14	0	5	211.86	423.72	15	1	1	NA	1	0	5	14
ZC3H3	6	4	2	0	73.59	147.18	15	1	0.515151515151515	-Inf	1	-0.4	2	10
ZC3H4	1	8	0	0	80.85	161.7	15	1	1	NA	1	NA	0	9
ZC3H6	2	9	1	0	333.3	666.6	15	1	0.25	-Inf	1	-0.818181818181818	1	11
ZC3H7A	2	12	0	1	241.23	482.46	15	1	1	1	1	0.142857142857143	1	14
ZC3H7B	0	8	0	3	284.46	568.92	15	1	1	NA	1	0	3	8
ZC3HAV1	14	4	1	0	142.89	285.78	15	1	1	-Inf	1	-0.222222222222222	1	18
ZC3HC1	2	2	1	1	33.33	66.66	15	1	1	0	1	0	2	4
ZC4H2	0	3	0	0	82.83	165.66	15	1	1	NA	1	NA	0	3
ZCCHC10	0	11	0	3	56.76	113.52	15	1	1	NA	1	0	3	11
ZCCHC11	4	8	3	2	451.11	902.22	15	1	0.592760180995475	-2	1	-0.266666666666667	5	12
ZCCHC14	1	6	0	1	238.26	476.52	15	1	1	1	1	0.142857142857143	1	7
ZCCHC17	3	3	2	0	73.26	146.52	15	1	0.464285714285714	-Inf	1	-0.5	2	6
ZCCHC2	0	12	0	3	306.9	613.8	15	1	1	NA	1	0	3	12
ZCCHC4	9	6	0	3	153.78	307.56	15	1	0.205882352941176	1	1	0.6	3	15
ZCCHC6	8	9	1	1	297	594	15	1	1	-0.125	1	-0.0294117647058824	2	17
ZCCHC7	2	2	0	0	64.35	128.7	15	1	1	NA	1	NA	0	4
ZCCHC8	5	6	0	1	204.93	409.86	15	1	1	1	1	0.454545454545455	1	11
ZCCHC9	5	2	0	0	66.99	133.98	15	1	1	NA	1	NA	0	7
ZDBF2	19	17	4	1	416.13	832.26	15	1	0.362940653698035	-2.57894736842105	1	-0.272222222222222	5	36
ZDHHC1	8	5	2	0	177.87	355.74	15	1	0.523809523809524	-Inf	1	-0.384615384615385	2	13
ZDHHC12	5	4	2	1	88.11	176.22	15	1	1	-0.6	1	-0.111111111111111	3	9
ZDHHC14	0	3	0	2	98.34	196.68	15	1	1	NA	1	0	2	3
ZDHHC16	4	1	1	1	73.59	147.18	15	1	1	0.75	1	0.3	2	5
ZDHHC17	1	11	1	4	175.89	351.78	15	1	0.514705882352941	-1.75	1	-0.116666666666667	5	12
ZDHHC18	0	3	0	1	33.66	67.32	15	1	1	NA	1	0	1	3
ZDHHC2	0	2	0	0	82.17	164.34	15	1	1	NA	1	NA	0	2
ZDHHC20	0	3	0	1	113.19	226.38	15	1	1	NA	1	0	1	3
ZDHHC22	0	1	0	1	68.64	137.28	15	1	1	NA	1	0	1	1
ZDHHC23	2	7	0	3	106.59	213.18	15	1	1	1	1	0.222222222222222	3	9
ZDHHC3	3	3	1	1	92.07	184.14	15	1	1	0	1	0	2	6
ZDHHC4	3	3	0	1	80.19	160.38	15	1	1	1	1	0.5	1	6
ZDHHC6	1	2	0	0	94.71	189.42	15	1	1	NA	1	NA	0	3
ZDHHC8	2	10	0	3	255.75	511.5	15	1	1	1	1	0.166666666666667	3	12
ZDHHC9	4	2	2	0	98.34	196.68	15	1	1	-Inf	1	-0.333333333333333	2	6
ZEB1	7	8	3	2	374.55	749.1	15	1	1	-0.714285714285714	1	-0.133333333333333	5	15
ZER1	1	6	1	1	210.21	420.42	15	1	0.416666666666667	-5	1	-0.357142857142857	2	7
ZFAND2A	2	1	0	0	61.38	122.76	15	1	1	NA	1	NA	0	3
ZFAND2B	0	1	0	1	10.23	20.46	15	1	1	NA	1	0	1	1
ZFAND3	0	2	0	0	67.32	134.64	15	1	1	NA	1	NA	0	2
ZFAND4	4	9	0	2	185.79	371.58	15	1	1	1	1	0.307692307692308	2	13
ZFAND5	0	2	0	0	25.41	50.82	15	1	1	NA	1	NA	0	2
ZFAT	7	25	1	4	391.71	783.42	15	1	1	0.107142857142857	1	0.01875	5	32
ZFC3H1	9	18	3	3	578.82	1157.64	15	1	0.643353726362625	-1	1	-0.166666666666667	6	27
ZFHX3	1	24	0	3	675.84	1351.68	15	1	1	1	1	0.04	3	25
ZFHX4	12	17	3	3	715.77	1431.54	15	1	1	-0.416666666666667	1	-0.0862068965517241	6	29
ZFP2	0	7	0	2	128.7	257.4	15	1	1	NA	1	0	2	7
ZFP36L1	0	1	0	1	23.43	46.86	15	1	1	NA	1	0	1	1
ZFP64	1	11	0	0	208.56	417.12	15	1	1	NA	1	NA	0	12
ZFP91	1	6	0	0	106.59	213.18	15	1	1	NA	1	NA	0	7
ZFP92	7	4	2	1	92.73	185.46	15	1	1	-0.142857142857143	1	-0.0303030303030303	3	11
ZFPM1	1	4	1	2	47.85	95.7	15	1	1	-1	1	-0.133333333333333	3	5
ZFPM2	9	11	2	1	402.93	805.86	15	1	0.590062111801242	-1.44444444444444	1	-0.216666666666667	3	20
ZFX	0	6	0	1	265.32	530.64	15	1	1	NA	1	0	1	6
ZFYVE1	0	4	0	0	222.75	445.5	15	1	1	NA	1	NA	0	4
ZFYVE16	29	17	3	2	474.87	949.74	15	1	1	0.120689655172414	1	0.0304347826086957	5	46
ZFYVE19	7	7	2	0	129.03	258.06	15	1	0.475	-Inf	1	-0.5	2	14
ZFYVE21	1	0	1	0	64.68	129.36	15	1	1	NA	1	0	1	1
ZFYVE26	27	32	6	1	866.58	1733.16	15	1	0.104833963850357	-6.11111111111111	1	-0.399515738498789	7	59
ZFYVE27	0	3	0	1	30.03	60.06	15	1	1	NA	1	0	1	3
ZFYVE28	8	16	1	0	330.66	661.32	15	1	0.36	-Inf	1	-0.666666666666667	1	24
ZFYVE9	12	7	2	0	454.41	908.82	15	1	0.533333333333333	-Inf	1	-0.368421052631579	2	19
ZGPAT	7	20	0	3	132.33	264.66	15	1	1	1	1	0.259259259259259	3	27
ZGRF1	47	42	11	5	693	1386	15	1	0.283767043017673	-0.965957446808511	1	-0.159410112359551	16	89
ZHX1	5	10	4	0	239.91	479.82	15	1	0.0325077399380804	-Inf	1	-0.666666666666667	4	15
ZHX2	3	10	1	2	260.37	520.74	15	1	1	-0.666666666666667	1	-0.102564102564103	3	13
ZHX3	3	11	1	1	245.52	491.04	15	1	0.45	-2.66666666666667	1	-0.285714285714286	2	14
ZIC1	0	3	0	0	51.48	102.96	15	1	1	NA	1	NA	0	3
ZIC3	0	4	0	2	51.15	102.3	15	1	1	NA	1	0	2	4
ZMAT2	0	2	0	0	61.38	122.76	15	1	1	NA	1	NA	0	2
ZMAT3	1	2	0	1	87.45	174.9	15	1	1	1	1	0.333333333333333	1	3
ZMAT4	0	4	0	0	86.13	172.26	15	1	1	NA	1	NA	0	4
ZMAT5	0	4	0	0	28.38	56.76	15	1	1	NA	1	NA	0	4
ZMIZ1	0	6	0	0	235.62	471.24	15	1	1	NA	1	NA	0	6
ZMPSTE24	1	8	0	1	150.81	301.62	15	1	1	1	1	0.111111111111111	1	9
ZMYM2	2	6	0	1	188.1	376.2	15	1	1	1	1	0.25	1	8
ZMYM3	3	11	2	1	406.56	813.12	15	1	0.191176470588235	-6.33333333333333	1	-0.452380952380952	3	14
ZMYM4	7	17	0	4	471.9	943.8	15	1	0.545299145299145	1	1	0.291666666666667	4	24
ZMYND10	6	3	3	0	71.94	143.88	15	1	0.509090909090909	-Inf	1	-0.333333333333333	3	9
ZMYND12	0	6	0	0	81.51	163.02	15	1	1	NA	1	NA	0	6
ZMYND19	0	4	0	0	57.09	114.18	15	1	1	NA	1	NA	0	4
ZNF106	18	19	2	2	628.32	1256.64	15	1	1	-0.0555555555555556	1	-0.0135135135135135	4	37
ZNF142	16	23	6	5	342.87	685.74	15	1	0.502531089069991	-0.725	1	-0.135198135198135	11	39
ZNF143	0	12	0	2	177.21	354.42	15	1	1	NA	1	0	2	12
ZNF148	1	11	0	1	306.9	613.8	15	1	1	1	1	0.0833333333333333	1	12
ZNF185L	19	13	9	2	298.98	597.96	15	1	0.276469150145282	-2.07894736842105	1	-0.224431818181818	11	32
ZNF207	0	3	0	0	136.29	272.58	15	1	1	NA	1	NA	0	3
ZNF217L	12	13	2	0	394.02	788.04	15	1	0.481481481481482	-Inf	1	-0.52	2	25
ZNF236	2	15	0	1	561.99	1123.98	15	1	1	1	1	0.117647058823529	1	17
ZNF276	1	4	1	0	107.25	214.5	15	1	0.333333333333333	-Inf	1	-0.8	1	5
ZNF277	8	5	1	0	166.65	333.3	15	1	1	-Inf	1	-0.384615384615385	1	13
ZNF280D	7	10	1	2	265.32	530.64	15	1	1	0.285714285714286	1	0.0784313725490196	3	17
ZNF292	21	49	1	4	835.56	1671.12	15	1	1	0.416666666666667	1	0.1	5	70
ZNF318	42	35	8	9	784.41	1568.82	15	1	0.602177783368931	0.259259259259259	1	0.0748663101604278	17	77
ZNF319	1	7	0	1	168.96	337.92	15	1	1	1	1	0.125	1	8
ZNF326	0	3	0	0	148.17	296.34	15	1	1	NA	1	NA	0	3
ZNF330	1	2	1	0	93.06	186.12	15	1	1	-Inf	1	-0.666666666666667	1	3
ZNF335	6	20	2	4	378.18	756.36	15	1	0.624768261030775	-0.666666666666667	1	-0.102564102564103	6	26
ZNF341	1	11	0	2	180.51	361.02	15	1	1	1	1	0.0833333333333333	2	12
ZNF346	2	2	0	0	36.63	73.26	15	1	1	NA	1	NA	0	4
ZNF365	4	1	2	1	66.66	133.32	15	1	1	0.5	1	0.133333333333333	3	5
ZNF366	4	8	1	1	202.29	404.58	15	1	1	-1	1	-0.166666666666667	2	12
ZNF367	0	3	0	0	50.16	100.32	15	1	1	NA	1	NA	0	3
ZNF384	0	6	0	0	78.87	157.74	15	1	1	NA	1	NA	0	6
ZNF385B	2	7	0	0	104.28	208.56	15	1	1	NA	1	NA	0	9
ZNF385C	1	3	1	2	51.81	103.62	15	1	1	-0.5	1	-0.0833333333333333	3	4
ZNF395	0	3	0	1	26.4	52.8	15	1	1	NA	1	0	1	3
ZNF398L	10	6	10	4	99.99	199.98	15	1	0.708945527236382	-0.5	1	-0.0892857142857143	14	16
ZNF407	33	18	4	3	583.77	1167.54	15	1	0.695556173101288	0.272727272727273	1	0.0756302521008404	7	51
ZNF408	14	7	3	1	138.27	276.54	15	1	1	-0.5	1	-0.0833333333333334	4	21
ZNF410	0	3	0	0	158.07	316.14	15	1	1	NA	1	NA	0	3
ZNF423	1	24	0	6	506.55	1013.1	15	1	1	1	1	0.04	6	25
ZNF438	12	16	0	3	232.32	464.64	15	1	0.264516129032258	1	1	0.428571428571429	3	28
ZNF451	11	8	1	3	304.26	608.52	15	1	0.316770186335404	0.757575757575758	1	0.328947368421053	4	19
ZNF488	7	11	2	1	168.3	336.6	15	1	0.553383458646617	-2.14285714285714	1	-0.277777777777778	3	18
ZNF503	0	2	0	0	45.54	91.08	15	1	1	NA	1	NA	0	2
ZNF507	10	10	1	0	307.23	614.46	15	1	1	-Inf	1	-0.5	1	20
ZNF511	1	1	0	0	62.04	124.08	15	1	1	NA	1	NA	0	2
ZNF512	2	9	0	2	215.16	430.32	15	1	1	1	1	0.181818181818182	2	11
ZNF512B	1	8	1	5	138.6	277.2	15	1	1	-0.6	1	-0.0555555555555556	6	9
ZNF516	12	26	5	5	423.72	847.44	15	1	0.294675620627201	-1.16666666666667	1	-0.184210526315789	10	38
ZNF518A	22	17	1	2	471.24	942.48	15	1	0.581271777003484	0.613636363636364	1	0.230769230769231	3	39
ZNF518B	14	16	2	0	351.12	702.24	15	1	0.483870967741935	-Inf	1	-0.533333333333333	2	30
ZNF521	1	19	0	2	445.17	890.34	15	1	1	1	1	0.05	2	20
ZNF532	8	12	0	1	329.34	658.68	15	1	1	1	1	0.4	1	20
ZNF536	4	6	1	3	200.64	401.28	15	1	1	0.5	1	0.15	4	10
ZNF592	9	31	1	7	438.57	877.14	15	1	1	0.507936507936508	1	0.1	8	40
ZNF598	4	13	2	4	262.35	524.7	15	1	0.632203037237362	-0.625	1	-0.0980392156862745	6	17
ZNF608	5	6	0	0	430.65	861.3	15	1	1	NA	1	NA	0	11
ZNF609	5	16	2	6	290.07	580.14	15	1	1	-0.0666666666666667	1	-0.0119047619047619	8	21
ZNF622	7	10	0	1	127.05	254.1	15	1	1	1	1	0.411764705882353	1	17
ZNF628	3	2	2	0	71.94	143.88	15	1	1	-Inf	1	-0.4	2	5
ZNF638	35	44	7	7	509.52	1019.04	15	1	0.77479057936	-0.257142857142857	1	-0.0569620253164557	14	79
ZNF639	2	7	0	0	173.91	347.82	15	1	1	NA	1	NA	0	9
ZNF644	6	16	0	1	463.32	926.64	15	1	1	1	1	0.272727272727273	1	22
ZNF648	6	10	2	1	142.23	284.46	15	1	0.545923632610939	-2.33333333333333	1	-0.291666666666667	3	16
ZNF652	0	6	0	0	129.03	258.06	15	1	1	NA	1	NA	0	6
ZNF654	4	14	0	3	347.16	694.32	15	1	1	1	1	0.222222222222222	3	18
ZNF687	0	14	0	0	295.35	590.7	15	1	1	NA	1	NA	0	14
ZNF710	1	7	0	5	116.82	233.64	15	1	1	1	1	0.125	5	8
ZNF746	5	7	2	4	73.26	146.52	15	1	1	0.3	1	0.0833333333333334	6	12
ZNF750	3	16	1	5	267.63	535.26	15	1	1	-0.0666666666666667	1	-0.0087719298245614	6	19
ZNF76	6	7	1	1	137.94	275.88	15	1	1	-0.166666666666667	1	-0.0384615384615384	2	13
ZNF767	11	15	2	7	216.15	432.3	15	1	0.431106458156121	0.61038961038961	1	0.200854700854701	9	26
ZNF800	1	6	1	0	204.6	409.2	15	1	0.25	-Inf	1	-0.857142857142857	1	7
ZNF804A	14	17	2	1	321.75	643.5	15	1	0.590909090909091	-1.42857142857143	1	-0.21505376344086	3	31
ZNF821	3	4	1	1	129.36	258.72	15	1	1	-0.333333333333333	1	-0.0714285714285715	2	7
ZNF827	12	25	5	6	485.43	970.86	15	1	0.485611045235056	-0.736111111111111	1	-0.13022113022113	11	37
ZNF830	1	6	1	1	88.77	177.54	15	1	0.416666666666667	-5	1	-0.357142857142857	2	7
ZNF831	21	18	4	2	591.03	1182.06	15	1	0.678087085914652	-0.714285714285714	1	-0.128205128205128	6	39
ZNF839	7	14	1	2	228.36	456.72	15	1	1	0	1	0	3	21
ZNF862L	2	9	2	4	163.68	327.36	15	1	0.584033613445378	-1.25	1	-0.151515151515151	6	11
ZNF91L	5	11	1	1	149.49	298.98	15	1	1	-1.2	1	-0.1875	2	16
ZNHIT3	1	0	1	0	8.91	17.82	15	1	1	NA	1	0	1	1
ZNHIT6	1	7	0	0	94.05	188.1	15	1	1	NA	1	NA	0	8
ZNRF3	7	7	1	0	404.58	809.16	15	1	1	-Inf	1	-0.5	1	14
ZNRF4	4	4	1	0	73.59	147.18	15	1	1	-Inf	1	-0.5	1	8
ZONADHL	41	43	10	5	901.56	1803.12	15	1	0.265760491754051	-1.09756097560976	1	-0.178571428571429	15	84
ZP2	13	10	0	0	251.79	503.58	15	1	1	NA	1	NA	0	23
ZP3	0	3	0	3	36.63	73.26	15	1	1	NA	1	0	3	3
ZP3L1	5	4	2	2	67.98	135.96	15	1	1	0.2	1	0.0555555555555556	4	9
ZP3L2	11	11	5	1	117.48	234.96	15	1	0.196475022561979	-4	1	-0.333333333333333	6	22
ZP4	8	8	3	0	164.34	328.68	15	1	0.228070175438596	-Inf	1	-0.5	3	16
ZPAX	21	21	2	1	324.06	648.12	15	1	1	-1	1	-0.166666666666667	3	42
ZPBP2	2	3	1	0	72.93	145.86	15	1	1	-Inf	1	-0.6	1	5
ZPLD1	0	9	0	1	128.7	257.4	15	1	1	NA	1	0	1	9
ZPR1	3	9	1	2	93.39	186.78	15	1	1	-0.5	1	-0.0833333333333333	3	12
ZRANB1	0	12	0	3	224.73	449.46	15	1	1	NA	1	0	3	12
ZRANB2	0	2	0	0	81.51	163.02	15	1	1	NA	1	NA	0	2
ZRANB3	8	12	1	1	351.45	702.9	15	1	1	-0.5	1	-0.1	2	20
ZRSR2	0	4	0	3	94.71	189.42	15	1	1	NA	1	0	3	4
ZSWIM5	0	14	0	4	216.15	432.3	15	1	1	NA	1	0	4	14
ZSWIM7	0	2	0	1	45.21	90.42	15	1	1	NA	1	0	1	2
ZSWIM8	5	19	1	1	532.29	1064.58	15	1	0.415384615384615	-2.8	1	-0.291666666666667	2	24
ZUFSP	4	11	0	1	148.5	297	15	1	1	1	1	0.266666666666667	1	15
ZW10	3	12	0	2	234.3	468.6	15	1	1	1	1	0.2	2	15
ZWILCH	4	6	1	1	143.55	287.1	15	1	1	-0.5	1	-0.1	2	10
ZXDC	2	6	0	1	186.12	372.24	15	1	1	1	1	0.25	1	8
ZYG11B	2	13	1	2	215.49	430.98	15	1	0.442401960784314	-2.25	1	-0.2	3	15
ZYX	5	4	1	1	165.33	330.66	15	1	1	0.2	1	0.0555555555555556	2	9
ZZZ3	3	6	0	0	326.7	653.4	15	1	1	NA	1	NA	0	9
