gene	FR	FS	PR	PS	Tsil	Trepl	npop	nout	mk_pval	alpha	mk_pval_fdr	dos	total_poly	total_div
2KTGRL-LOC420808	6	11	5	4	325.71	651.42	15	2	0.418535469107552	-1.29166666666667	1	-0.202614379084967	9	17
A2M	53	57	6	11	1295.58	2591.16	15	2	0.434918429015963	0.413379073756432	1	0.128877005347594	17	110
A2ML1	40	51	6	10	1440.45	2880.9	15	2	0.785923296453456	0.235	1	0.0645604395604396	16	91
A2ML2	55	65	7	6	1410.42	2820.84	15	2	0.771021223969781	-0.378787878787879	1	-0.0801282051282051	13	120
A4GALT	15	22	0	0	357.39	714.78	15	2	1	NA	1	NA	0	37
AAMDC	3	6	1	1	121.77	243.54	15	2	1	-1	1	-0.166666666666667	2	9
AARS2	17	52	2	17	957.33	1914.66	15	2	0.225910656491031	0.640138408304498	1	0.141113653699466	19	69
AASDHPPT	1	22	2	2	294.03	588.06	15	2	0.0485470085470086	-21	1	-0.456521739130435	4	23
AASS	6	35	1	4	875.82	1751.64	15	2	1	-0.458333333333333	1	-0.0536585365853659	5	41
ABCA13	214	112	32	17	3554.1	7108.2	15	2	1	0.0148433205057724	1	0.00338049330161516	49	326
ABCB1	35	55	5	6	1277.1	2554.2	15	2	0.749145854022072	-0.30952380952381	1	-0.0656565656565656	11	90
ABCB10	1	24	0	2	572.22	1144.44	15	2	1	1	1	0.04	2	25
ABCB1LA	43	39	6	6	1295.91	2591.82	15	2	1	0.0930232558139535	1	0.024390243902439	12	82
ABCB5	23	62	7	3	1324.62	2649.24	15	2	0.0100998023914922	-5.28985507246377	1	-0.429411764705882	10	85
ABCC10	52	71	17	12	1524.6	3049.2	15	2	0.14672221291134	-0.934294871794872	1	-0.163442668909448	29	123
ABCC13	39	46	11	3	1271.16	2542.32	15	2	0.0407146849345353	-3.32478632478632	1	-0.326890756302521	14	85
ABCC9	16	56	5	5	1631.19	3262.38	15	2	0.114117769070042	-2.5	1	-0.277777777777778	10	72
ABCD2	3	20	0	10	631.29	1262.58	15	2	0.536290322580645	1	1	0.130434782608696	10	23
ABCF2	3	17	0	9	617.76	1235.52	15	2	0.532019704433498	1	1	0.15	9	20
ABCG1	1	32	0	2	660.33	1320.66	15	2	1	1	1	0.0303030303030303	2	33
ABHD10	5	12	2	1	275.88	551.76	15	2	0.270175438596491	-3.8	1	-0.372549019607843	3	17
ABHD12	1	29	2	10	367.29	734.58	15	2	0.191637630662021	-4.8	1	-0.133333333333333	12	30
ABHD13	1	5	0	0	334.62	669.24	15	2	1	NA	1	NA	0	6
ABHD5	1	27	1	3	372.24	744.48	15	2	0.237903225806452	-8	1	-0.214285714285714	4	28
ABI3BP	29	29	2	2	1142.46	2284.92	15	2	1	0	1	0	4	58
ABRA	18	22	3	4	405.9	811.8	15	2	1	0.0833333333333334	1	0.0214285714285715	7	40
ABRACL	1	2	0	2	81.18	162.36	15	2	1	1	1	0.333333333333333	2	3
ACAA1	8	37	2	9	429.66	859.32	15	2	1	-0.0277777777777777	1	-0.00404040404040404	11	45
ACAD11	12	23	2	6	532.95	1065.9	15	2	1	0.361111111111111	1	0.0928571428571429	8	35
ACAD6L	7	21	2	3	403.92	807.84	15	2	0.597052280311457	-1	1	-0.15	5	28
ACAT1	11	31	3	7	459.03	918.06	15	2	1	-0.207792207792208	1	-0.0380952380952381	10	42
ACAT2	2	21	1	2	388.41	776.82	15	2	0.318846153846154	-4.25	1	-0.246376811594203	3	23
ACBD5	12	16	5	4	488.07	976.14	15	2	0.703388695602266	-0.666666666666667	1	-0.126984126984127	9	28
ACCSL	62	27	6	10	559.68	1119.36	15	2	0.0212795343797256	0.738709677419355	1	0.321629213483146	16	89
ACE2	35	35	3	7	800.91	1601.82	15	2	0.317818343451316	0.571428571428571	1	0.2	10	70
ACER3	3	15	1	0	265.32	530.64	15	2	0.210526315789474	-Inf	1	-0.833333333333333	1	18
ACKR4	2	17	3	1	354.42	708.84	15	2	0.0208921513269339	-24.5	1	-0.644736842105263	4	19
ACO2	3	40	1	7	766.26	1532.52	15	2	0.506162464985994	-0.904761904761905	1	-0.0552325581395349	8	43
ACOD1	9	28	2	5	470.25	940.5	15	2	1	-0.244444444444444	1	-0.0424710424710424	7	37
ACOT13	2	5	0	1	143.55	287.1	15	2	1	1	1	0.285714285714286	1	7
ACOT9	6	20	3	2	442.53	885.06	15	2	0.131256952169077	-4	1	-0.369230769230769	5	26
ACP1	1	3	1	0	157.41	314.82	15	2	0.4	-Inf	1	-0.75	1	4
ACP6	2	14	4	3	304.59	609.18	15	2	0.0450038138825324	-8.33333333333333	1	-0.446428571428571	7	16
ACPP	6	9	1	0	368.28	736.56	15	2	0.4375	-Inf	1	-0.6	1	15
ACR-ACRL	22	16	10	6	369.93	739.86	15	2	1	-0.212121212121212	1	-0.0460526315789473	16	38
ACRBP	32	27	7	3	488.4	976.8	15	2	0.495751035832447	-0.96875	1	-0.157627118644068	10	59
ACSS1	4	27	5	7	662.31	1324.62	15	2	0.087986601763955	-3.82142857142857	1	-0.287634408602151	12	31
ACSS3	43	17	3	1	365.97	731.94	15	2	1	-0.186046511627907	1	-0.0333333333333333	4	60
ACTA1	0	7	0	6	374.22	748.44	15	2	1	NA	1	0	6	7
ACTN2	1	20	1	1	889.02	1778.04	15	2	0.1699604743083	-19	1	-0.452380952380952	2	21
ACTR2	0	5	0	1	391.05	782.1	15	2	1	NA	1	0	1	5
ACTR3B	0	12	1	1	313.83	627.66	15	2	0.142857142857143	-Inf	1	-0.5	2	12
ACTR6	0	12	0	3	393.03	786.06	15	2	1	NA	1	0	3	12
ACYP2	2	1	0	0	77.22	154.44	15	2	1	NA	1	NA	0	3
ADAM15	36	76	14	29	978.45	1956.9	15	2	1	-0.0191570881226053	1	-0.00415282392026578	43	112
ADAM17	11	41	1	16	822.69	1645.38	15	2	0.268942233574226	0.767045454545455	1	0.152714932126697	17	52
ADAM22	3	23	0	8	945.45	1890.9	15	2	1	1	1	0.115384615384615	8	26
ADAMTS1	17	72	4	3	921.69	1843.38	15	2	0.0389952323347328	-4.64705882352941	1	-0.380417335473515	7	89
ADAMTS20	29	76	8	7	1838.43	3676.86	15	2	0.0695786671100272	-1.99507389162562	1	-0.257142857142857	15	105
ADAMTS5	6	32	1	3	793.32	1586.64	15	2	0.532207629768605	-0.777777777777778	1	-0.0921052631578947	4	38
ADARB2	1	21	1	7	682.11	1364.22	15	2	0.468965517241379	-2	1	-0.0795454545454545	8	22
ADAT2	5	5	0	1	94.38	188.76	15	2	1	1	1	0.5	1	10
ADCK2	8	18	1	8	313.83	627.66	15	2	0.390714238977015	0.71875	1	0.196581196581197	9	26
ADCY1	2	19	0	1	652.41	1304.82	15	2	1	1	1	0.0952380952380952	1	21
ADCY2	5	31	4	2	1057.32	2114.64	15	2	0.0134908286384538	-11.4	1	-0.527777777777778	6	36
ADCY3	5	39	5	28	1115.4	2230.8	15	2	0.736683550991731	-0.392857142857143	1	-0.0378787878787879	33	44
ADCY8	5	24	3	4	866.91	1733.82	15	2	0.167457305502846	-2.6	1	-0.25615763546798	7	29
ADCYAP1	0	3	1	0	152.46	304.92	15	2	0.25	-Inf	1	-1	1	3
ADCYAP1R1	0	16	1	2	451.44	902.88	15	2	0.157894736842105	-Inf	1	-0.333333333333333	3	16
ADGB	84	70	16	8	1681.02	3362.04	15	2	0.376682433298575	-0.666666666666667	1	-0.121212121212121	24	154
ADGRB1	3	47	1	15	1292.94	2585.88	15	2	1	-0.0444444444444445	1	-0.0025	16	50
ADGRB3	2	20	0	3	594.99	1189.98	15	2	1	1	1	0.0909090909090909	3	22
ADGRF4	19	36	4	1	671.22	1342.44	15	2	0.0661509120551232	-6.57894736842105	1	-0.454545454545455	5	55
ADGRF5	108	57	9	6	1330.56	2661.12	15	2	0.778654499797087	0.208333333333333	1	0.0545454545454546	15	165
ADGRG2	46	43	12	7	1295.91	2591.82	15	2	0.450669195466713	-0.602484472049689	1	-0.114725014784151	19	89
ADGRG6	97	66	6	4	2221.56	4443.12	15	2	1	-0.0206185567010309	1	-0.00490797546012267	10	163
ADGRG7	41	28	3	3	773.19	1546.38	15	2	0.686509951973969	0.317073170731707	1	0.0942028985507246	6	69
ADHFE1	4	16	7	3	455.4	910.8	15	2	0.0146919214385481	-8.33333333333333	1	-0.5	10	20
ADI1	3	6	1	3	179.19	358.38	15	2	1	0.333333333333333	1	0.0833333333333333	4	9
ADIPOR2	3	9	0	1	382.14	764.28	15	2	1	1	1	0.25	1	12
ADNP2	21	44	1	11	1063.26	2126.52	15	2	0.161921688445566	0.80952380952381	1	0.23974358974359	12	65
ADPRH	9	12	1	8	380.16	760.32	15	2	0.203514326752708	0.833333333333333	1	0.317460317460317	9	21
ADPRHL1	112	87	36	27	1928.52	3857.04	15	2	1	-0.0357142857142858	1	-0.00861450107681261	63	199
ADSL	3	15	0	4	481.14	962.28	15	2	1	1	1	0.166666666666667	4	18
ADSS	1	12	2	2	411.84	823.68	15	2	0.120588235294118	-11	1	-0.423076923076923	4	13
ADTRP	5	9	0	0	231.66	463.32	15	2	1	NA	1	NA	0	14
AFDN	7	58	4	9	1877.37	3754.74	15	2	0.0796374782466384	-2.68253968253968	1	-0.2	13	65
AFF3	17	17	4	1	419.1	838.2	15	2	0.348944085786191	-3	1	-0.3	5	34
AFG1L	3	14	1	4	460.35	920.7	15	2	1	-0.166666666666667	1	-0.0235294117647059	5	17
AFG3L2	6	38	0	11	797.94	1595.88	15	2	0.330368726106795	1	1	0.136363636363636	11	44
AFTPH	30	29	14	8	843.48	1686.96	15	2	0.328880907536325	-0.691666666666667	1	-0.12788906009245	22	59
AGAP3	5	37	3	17	922.68	1845.36	15	2	0.705214347723189	-0.305882352941176	1	-0.030952380952381	20	42
AGBL3	39	28	3	2	767.25	1534.5	15	2	1	-0.0769230769230769	1	-0.017910447761194	5	67
AGK	9	13	5	3	420.75	841.5	15	2	0.417082569826198	-1.40740740740741	1	-0.215909090909091	8	22
AGPAT3	1	16	1	2	314.49	628.98	15	2	0.28421052631579	-7	1	-0.274509803921569	3	17
AGPAT4	1	13	1	2	332.97	665.94	15	2	0.330882352941176	-5.5	1	-0.261904761904762	3	14
AGPAT5	1	9	0	1	362.34	724.68	15	2	1	1	1	0.1	1	10
AGR2	3	8	0	2	171.27	342.54	15	2	1	1	1	0.272727272727273	2	11
AGR3	0	6	0	2	164.34	328.68	15	2	1	NA	1	0	2	6
AGT	11	23	4	0	460.35	920.7	15	2	0.0184921763869132	-Inf	1	-0.676470588235294	4	34
AHI1	31	35	8	1	1013.76	2027.52	15	2	0.0294681178842609	-8.03225806451613	1	-0.419191919191919	9	66
AHR	15	23	1	3	851.73	1703.46	15	2	1	0.488888888888889	1	0.144736842105263	4	38
AHRR	13	23	6	5	660	1320	15	2	0.312066740229567	-1.12307692307692	1	-0.184343434343434	11	36
AHSA2	3	12	0	3	333.63	667.26	15	2	1	1	1	0.2	3	15
AICDA	0	4	0	1	197.01	394.02	15	2	1	NA	1	0	1	4
AIG1	7	5	0	0	150.48	300.96	15	2	1	NA	1	NA	0	12
AIM1	36	60	8	9	1731.51	3463.02	15	2	0.590476225839404	-0.481481481481481	1	-0.0955882352941176	17	96
AK9	82	77	13	14	2411.64	4823.28	15	2	0.836013301893333	0.128048780487805	1	0.0342417889587701	27	159
AKAIN1	0	3	0	0	68.31	136.62	15	2	1	NA	1	NA	0	3
AKAP12	94	66	27	10	1879.35	3758.7	15	2	0.134638246025064	-0.895744680851064	1	-0.14222972972973	37	160
AKAP17A	13	42	1	5	686.07	1372.14	15	2	1	0.353846153846154	1	0.0696969696969697	6	55
AKAP7	11	11	1	1	238.26	476.52	15	2	1	0	1	0	2	22
AKAP7L	42	42	12	2	652.41	1304.82	15	2	0.0183841750073606	-5	1	-0.357142857142857	14	84
AKAP9	103	115	28	19	3895.65	7791.3	15	2	0.148373035659536	-0.645375574859479	1	-0.12326761663088	47	218
AKR1B10L2	6	12	0	2	314.82	629.64	15	2	1	1	1	0.333333333333333	2	18
AKR1B10L3	2	11	2	1	267.3	534.6	15	2	0.135714285714286	-10	1	-0.512820512820513	3	13
AKR1D1	0	9	0	4	293.04	586.08	15	2	1	NA	1	0	4	9
AKT3	2	17	1	1	470.25	940.5	15	2	0.271428571428572	-7.5	1	-0.394736842105263	2	19
ALDH1L2	8	31	3	4	896.94	1793.88	15	2	0.332840102920746	-1.90625	1	-0.223443223443223	7	39
ALDH5A1	3	18	1	1	401.94	803.88	15	2	0.324110671936759	-5	1	-0.357142857142857	2	21
ALDH8A1	11	38	0	3	970.2	1940.4	15	2	1	1	1	0.224489795918367	3	49
ALG10	12	25	6	7	468.27	936.54	15	2	0.504171038541677	-0.785714285714286	1	-0.137214137214137	13	37
ALG11	10	17	4	6	402.93	805.86	15	2	1	-0.133333333333333	1	-0.0296296296296297	10	27
ALG12	1	16	2	0	351.78	703.56	15	2	0.0175438596491228	-Inf	1	-0.941176470588235	2	17
ALG2	5	21	2	8	392.7	785.4	15	2	1	-0.05	1	-0.00769230769230769	10	26
ALG5	9	11	5	1	322.74	645.48	15	2	0.169565217391304	-5.11111111111111	1	-0.383333333333333	6	20
ALG8	11	25	8	3	412.83	825.66	15	2	0.0176069075855675	-5.06060606060606	1	-0.421717171717172	11	36
ALK	29	41	7	5	1171.5	2343	15	2	0.350703444808237	-0.979310344827586	1	-0.169047619047619	12	70
ALKBH8	18	27	6	7	624.69	1249.38	15	2	0.755445619266955	-0.285714285714286	1	-0.0615384615384615	13	45
ALOX5AP	0	6	0	5	160.38	320.76	15	2	1	NA	1	0	5	6
ALS2CL	8	50	5	9	970.2	1940.4	15	2	0.11352100031028	-2.47222222222222	1	-0.219211822660099	14	58
ALX1	4	8	1	0	323.73	647.46	15	2	0.384615384615385	-Inf	1	-0.666666666666667	1	12
AMD1	0	2	0	2	332.31	664.62	15	2	1	NA	1	0	2	2
AMDHD1	5	14	3	1	431.64	863.28	15	2	0.102766798418972	-7.4	1	-0.486842105263158	4	19
AMER2	10	30	3	3	609.84	1219.68	15	2	0.329854884566468	-2	1	-0.25	6	40
AMIGO2	11	24	4	3	516.78	1033.56	15	2	0.225228116434792	-1.90909090909091	1	-0.257142857142857	7	35
AMN1	0	14	1	1	264.33	528.66	15	2	0.125	-Inf	1	-0.5	2	14
AMPH	50	50	8	7	1394.91	2789.82	15	2	1	-0.142857142857143	1	-0.0333333333333333	15	100
ANAPC1	12	66	4	9	1877.7	3755.4	15	2	0.233305066991803	-1.44444444444444	1	-0.153846153846154	13	78
ANGEL2	19	24	4	5	552.42	1104.84	15	2	1	-0.0105263157894737	1	-0.00258397932816534	9	43
ANGPT2	1	11	1	0	768.24	1536.48	15	2	0.153846153846154	-Inf	1	-0.916666666666667	1	12
ANGPTL5	6	17	2	1	387.09	774.18	15	2	0.215384615384615	-4.66666666666667	1	-0.405797101449275	3	23
ANKEF1	34	48	10	5	764.28	1528.56	15	2	0.0929232343750373	-1.82352941176471	1	-0.252032520325203	15	82
ANKH	5	17	0	1	481.8	963.6	15	2	1	1	1	0.227272727272727	1	22
ANKIB1	5	39	2	6	1084.05	2168.1	15	2	0.291450493240774	-1.6	1	-0.136363636363636	8	44
ANKMY2	7	18	2	1	454.41	908.82	15	2	0.234432234432234	-4.14285714285714	1	-0.386666666666667	3	25
ANKRD10	0	6	1	2	306.57	613.14	15	2	0.333333333333333	-Inf	1	-0.333333333333333	3	6
ANKRD12	36	68	12	17	1996.5	3993	15	2	0.518556289517055	-0.333333333333333	1	-0.0676392572944297	29	104
ANKRD26	104	106	24	11	2431.44	4862.88	15	2	0.0443691931419141	-1.22377622377622	1	-0.19047619047619	35	210
ANKRD28	3	34	2	10	1006.83	2013.66	15	2	0.584379542751421	-1.26666666666667	1	-0.0855855855855856	12	37
ANKRD29	0	16	2	2	298.98	597.96	15	2	0.0315789473684211	-Inf	1	-0.5	4	16
ANKRD33B	10	17	2	9	509.85	1019.7	15	2	0.443780351552833	0.622222222222222	1	0.188552188552189	11	27
ANKRD46	1	14	0	2	226.71	453.42	15	2	1	1	1	0.0666666666666667	2	15
ANKRD49	2	25	0	4	241.56	483.12	15	2	1	1	1	0.0740740740740741	4	27
ANKRD54	3	12	1	6	257.4	514.8	15	2	1	0.333333333333333	1	0.0571428571428572	7	15
ANKRD6	15	45	5	9	812.79	1625.58	15	2	0.506431787254619	-0.666666666666667	1	-0.107142857142857	14	60
ANKRD66	6	7	0	3	181.17	362.34	15	2	0.25	1	1	0.461538461538462	3	13
ANKRD9L	0	8	0	1	294.03	588.06	15	2	1	NA	1	0	1	8
ANKS1B	8	20	1	0	640.2	1280.4	15	2	0.310344827586207	-Inf	1	-0.714285714285714	1	28
ANKS6	29	37	7	4	1086.03	2172.06	15	2	0.329649481789352	-1.23275862068966	1	-0.196969696969697	11	66
ANLN	53	39	4	2	1085.04	2170.08	15	2	1	-0.471698113207547	1	-0.0905797101449275	6	92
ANO10	6	30	3	2	544.5	1089	15	2	0.0611450791168378	-6.5	1	-0.433333333333333	5	36
ANO4	1	17	2	2	944.46	1888.92	15	2	0.0727272727272727	-16	1	-0.444444444444444	4	18
ANO6	14	46	3	3	873.51	1747.02	15	2	0.172165970817478	-2.28571428571429	1	-0.266666666666667	6	60
ANOS1	28	27	2	5	780.78	1561.56	15	2	0.4267413462804	0.614285714285714	1	0.223376623376623	7	55
ANXA13	15	14	7	4	417.78	835.56	15	2	0.723469250888606	-0.633333333333333	1	-0.119122257053291	11	29
AOAH	19	30	2	2	560.34	1120.68	15	2	1	-0.578947368421053	1	-0.112244897959184	4	49
AOC1	29	20	14	16	738.87	1477.74	15	2	0.353403923242169	0.396551724137931	1	0.125170068027211	30	49
AP1S2	0	5	0	1	147.51	295.02	15	2	1	NA	1	0	1	5
APAF1	18	48	1	6	1235.52	2471.04	15	2	0.668094841081191	0.555555555555556	1	0.12987012987013	7	66
APBB1	11	31	2	11	631.62	1263.24	15	2	0.710007150784956	0.487603305785124	1	0.108058608058608	13	42
APBB1IP	25	33	2	4	724.02	1448.04	15	2	1	0.34	1	0.0977011494252873	6	58
APCDD1	3	24	0	4	507.87	1015.74	15	2	1	1	1	0.111111111111111	4	27
APLF	26	22	2	2	399.3	798.6	15	2	1	0.153846153846154	1	0.0416666666666666	4	48
APMAP	1	14	3	0	403.92	807.84	15	2	0.00490196078431373	-Inf	1	-0.933333333333333	3	15
APOB	110	139	13	12	4636.17	9272.34	15	2	0.528881452995627	-0.368939393939394	1	-0.0782329317269077	25	249
APOLD1	3	11	1	3	232.65	465.3	15	2	1	-0.222222222222222	1	-0.0357142857142857	4	14
APOO	5	5	3	1	220.77	441.54	15	2	0.58041958041958	-2	1	-0.25	4	10
APOV1	0	4	0	1	105.93	211.86	15	2	1	NA	1	0	1	4
APP	0	32	1	6	726.66	1453.32	15	2	0.179487179487179	-Inf	1	-0.142857142857143	7	32
APPL2	5	39	1	6	652.41	1304.82	15	2	1	-0.3	1	-0.0292207792207792	7	44
AQP1	1	15	0	1	269.28	538.56	15	2	1	1	1	0.0625	1	16
AQP11	12	16	5	3	258.39	516.78	15	2	0.433849057875754	-1.22222222222222	1	-0.196428571428571	8	28
AQP4	5	18	2	2	366.3	732.6	15	2	0.269230769230769	-2.6	1	-0.282608695652174	4	23
AR	0	15	0	1	378.51	757.02	15	2	1	NA	1	0	1	15
ARC	2	15	1	4	400.95	801.9	15	2	1	-0.875	1	-0.0823529411764706	5	17
ARF1	0	9	0	2	180.18	360.36	15	2	1	NA	1	0	2	9
ARFGAP3	18	10	1	0	513.81	1027.62	15	2	1	-Inf	1	-0.357142857142857	1	28
ARFGEF1	6	55	3	8	1826.22	3652.44	15	2	0.13374270223394	-2.4375	1	-0.174366616989568	11	61
ARFGEF3	19	86	7	17	2184.27	4368.54	15	2	0.260555344560802	-0.863777089783282	1	-0.110714285714286	24	105
ARGLU1	1	3	0	0	270.27	540.54	15	2	1	NA	1	NA	0	4
ARHGAP12	12	25	3	3	895.95	1791.9	15	2	0.647356479684748	-1.08333333333333	1	-0.175675675675676	6	37
ARHGAP18	19	21	3	2	653.4	1306.8	15	2	0.665154093401399	-0.657894736842105	1	-0.125	5	40
ARHGAP20	11	33	8	12	915.75	1831.5	15	2	0.249600502845191	-1	1	-0.15	20	44
ARHGAP21	27	86	11	11	1971.09	3942.18	15	2	0.0190616915906661	-2.18518518518519	1	-0.261061946902655	22	113
ARHGAP28	4	16	5	1	644.49	1288.98	15	2	0.00966859227728791	-19	1	-0.633333333333333	6	20
ARHGAP39L	15	34	7	25	1166.22	2332.44	15	2	0.450919448903615	0.365333333333333	1	0.0873724489795918	32	49
ARHGAP42	1	19	1	2	635.25	1270.5	15	2	0.24901185770751	-8.5	1	-0.283333333333333	3	20
ARHGAP8	22	3	0	0	196.02	392.04	15	2	1	NA	1	NA	0	25
ARHGDIB	0	6	0	0	198.99	397.98	15	2	1	NA	1	NA	0	6
ARHGEF10	8	54	4	6	1335.84	2671.68	15	2	0.0551753752952202	-3.5	1	-0.270967741935484	10	62
ARHGEF17	5	22	3	16	876.48	1752.96	15	2	1	0.175	1	0.0272904483430799	19	27
ARHGEF33	4	27	38	14	803.88	1607.76	15	2	7.9654050030333e-08	-17.3214285714286	0.000433198551089966	-0.601736972704715	52	31
ARHGEF5	90	56	4	3	1715.67	3431.34	15	2	1	0.17037037037037	1	0.0450097847358122	7	146
ARHGEF7	7	22	4	6	782.1	1564.2	15	2	0.423806484003228	-1.0952380952381	1	-0.158620689655172	10	29
ARID1B	3	14	0	5	1091.64	2183.28	15	2	1	1	1	0.176470588235294	5	17
ARID2	8	29	2	5	1846.35	3692.7	15	2	0.649038605064518	-0.45	1	-0.0694980694980695	7	37
ARID4B	15	38	3	6	1352.34	2704.68	15	2	0.71098905548167	-0.266666666666667	1	-0.050314465408805	9	53
ARL1	0	15	0	2	180.18	360.36	15	2	1	NA	1	0	2	15
ARL11	10	10	4	2	198	396	15	2	0.652173913043478	-1	1	-0.166666666666667	6	20
ARL13B	0	4	0	0	136.95	273.9	15	2	1	NA	1	NA	0	4
ARL4A	0	10	0	0	198.99	397.98	15	2	1	NA	1	NA	0	10
ARL5B	0	12	0	0	165.33	330.66	15	2	1	NA	1	NA	0	12
ARL6	3	6	1	1	185.13	370.26	15	2	1	-1	1	-0.166666666666667	2	9
ARL8BL	1	5	0	1	206.91	413.82	15	2	1	1	1	0.166666666666667	1	6
ARMC1	2	6	0	2	277.2	554.4	15	2	1	1	1	0.25	2	8
ARMC10	6	17	2	2	250.47	500.94	15	2	0.558290598290598	-1.83333333333333	1	-0.239130434782609	4	23
ARMC2	38	34	7	5	807.84	1615.68	15	2	0.764814764520193	-0.252631578947368	1	-0.0555555555555556	12	72
ARMC3	21	31	4	6	854.37	1708.74	15	2	1	0.0158730158730159	1	0.00384615384615383	10	52
ARMC4	18	46	2	9	1005.84	2011.68	15	2	0.716627057665993	0.432098765432099	1	0.0994318181818182	11	64
ARMT1	11	18	1	0	423.06	846.12	15	2	0.4	-Inf	1	-0.620689655172414	1	29
ARNTL2	16	30	2	3	607.2	1214.4	15	2	1	-0.25	1	-0.0521739130434783	5	46
ARPP21	16	28	2	1	748.44	1496.88	15	2	0.549306197964847	-2.5	1	-0.303030303030303	3	44
ARR3	1	15	2	9	360.03	720.06	15	2	0.548717948717949	-2.33333333333333	1	-0.119318181818182	11	16
ARSA	8	20	1	1	467.94	935.88	15	2	0.517241379310345	-1.5	1	-0.214285714285714	2	28
ARSE	39	35	2	6	840.18	1680.36	15	2	0.263981588032221	0.700854700854701	1	0.277027027027027	8	74
ARSH	32	28	2	1	542.52	1085.04	15	2	1	-0.75	1	-0.133333333333333	3	60
ART4	8	9	6	1	298.98	597.96	15	2	0.171780736426045	-5.75	1	-0.386554621848739	7	17
ARV1	2	5	4	2	232.65	465.3	15	2	0.286130536130536	-4	1	-0.380952380952381	6	7
ARX	1	7	0	2	218.79	437.58	15	2	1	1	1	0.125	2	8
ASAP1	14	41	3	6	1302.84	2605.68	15	2	0.689431287840925	-0.464285714285714	1	-0.0787878787878788	9	55
ASAP2	25	34	1	10	1091.97	2183.94	15	2	0.0443978876952344	0.864	1	0.332819722650231	11	59
ASB10	7	22	4	5	427.68	855.36	15	2	0.400758743363357	-1.51428571428571	1	-0.203065134099617	9	29
ASB11	8	12	1	3	319.77	639.54	15	2	1	0.5	1	0.15	4	20
ASB15	13	17	6	2	586.08	1172.16	15	2	0.231988586827297	-2.92307692307692	1	-0.316666666666667	8	30
ASB3	9	24	4	5	487.08	974.16	15	2	0.422289097438233	-1.13333333333333	1	-0.171717171717172	9	33
ASB4	5	21	2	4	431.64	863.28	15	2	0.58959028550241	-1.1	1	-0.141025641025641	6	26
ASB9	6	18	0	1	250.8	501.6	15	2	1	1	1	0.25	1	24
ASCC3	12	57	2	3	1729.2	3458.4	15	2	0.237160467432511	-2.16666666666667	1	-0.226086956521739	5	69
ASCL4	2	9	1	3	187.11	374.22	15	2	1	-0.5	1	-0.0681818181818182	4	11
ASF1A	0	6	0	1	202.95	405.9	15	2	1	NA	1	0	1	6
ASMT	10	13	1	1	343.53	687.06	15	2	1	-0.3	1	-0.0652173913043478	2	23
ASMTL	22	24	6	3	626.67	1253.34	15	2	0.468772071435778	-1.18181818181818	1	-0.188405797101449	9	46
ASNS	6	21	1	5	556.38	1112.76	15	2	1	0.3	1	0.0555555555555556	6	27
ASRGL1	9	14	3	3	313.83	627.66	15	2	0.669319186560566	-0.555555555555556	1	-0.108695652173913	6	23
ASTE1	31	34	5	8	663.3	1326.6	15	2	0.76168162200515	0.314516129032258	1	0.0923076923076923	13	65
ASXL2	41	84	14	20	1293.6	2587.2	15	2	0.41756874480748	-0.434146341463415	1	-0.0837647058823529	34	125
ASXL3	21	57	11	12	2157.87	4315.74	15	2	0.0753742980623757	-1.48809523809524	1	-0.209030100334448	23	78
ASZ1	17	24	3	3	490.71	981.42	15	2	1	-0.411764705882353	1	-0.0853658536585366	6	41
ATAD2	87	70	19	13	805.86	1611.72	15	2	0.701470889786634	-0.175950486295314	1	-0.039609872611465	32	157
ATAD2B	6	28	3	2	1428.57	2857.14	15	2	0.0702483860378597	-6	1	-0.423529411764706	5	34
ATF3	0	4	0	1	180.18	360.36	15	2	1	NA	1	0	1	4
ATF4	4	10	3	3	351.45	702.9	15	2	0.612616099071208	-1.5	1	-0.214285714285714	6	14
ATF7IP	28	45	12	1	1596.87	3193.74	15	2	0.000426021230232929	-18.2857142857143	0.42125753829487	-0.539515279241307	13	73
ATG9B	7	26	4	19	781.11	1562.22	15	2	1	0.218045112781955	1	0.0382081686429513	23	33
ATL2	6	14	3	4	594	1188	15	2	0.652660383095166	-0.75	1	-0.128571428571429	7	20
ATM	75	109	16	19	2974.95	5949.9	15	2	0.581380012955457	-0.223859649122807	1	-0.0495341614906832	35	184
ATN1	5	61	4	22	1136.85	2273.7	15	2	0.264841895771224	-1.21818181818182	1	-0.0780885780885781	26	66
ATP10A	14	37	4	6	1320.99	2641.98	15	2	0.462378566642782	-0.761904761904762	1	-0.125490196078431	10	51
ATP11A	16	40	4	8	1211.1	2422.2	15	2	0.737449211432387	-0.25	1	-0.0476190476190476	12	56
ATP1A1	1	48	0	8	1013.76	2027.52	15	2	1	1	1	0.0204081632653061	8	49
ATP1B1	4	16	0	6	282.15	564.3	15	2	0.54247491638796	1	1	0.2	6	20
ATP23	2	9	0	1	236.94	473.88	15	2	1	1	1	0.181818181818182	1	11
ATP2C1	14	31	1	6	952.38	1904.76	15	2	0.657888884935601	0.630952380952381	1	0.168253968253968	7	45
ATP4B	2	18	3	4	286.11	572.22	15	2	0.0913043478260869	-5.75	1	-0.328571428571429	7	20
ATP5C1	2	12	0	1	292.05	584.1	15	2	1	1	1	0.142857142857143	1	14
ATP5J	1	3	0	0	86.46	172.92	15	2	1	NA	1	NA	0	4
ATP5O	4	9	0	2	209.88	419.76	15	2	1	1	1	0.307692307692308	2	13
ATP6AP1	10	9	5	0	478.17	956.34	15	2	0.118083003952569	-Inf	1	-0.473684210526316	5	19
ATP6AP2	3	17	2	5	352.44	704.88	15	2	0.579895949461167	-1.26666666666667	1	-0.135714285714286	7	20
ATP6V0A4	2	37	4	6	835.56	1671.12	15	2	0.0118456936218268	-11.3333333333333	1	-0.348717948717949	10	39
ATP6V0D2	0	15	1	1	348.48	696.96	15	2	0.117647058823529	-Inf	1	-0.5	2	15
ATP6V1A-ATP6V1AL	0	19	0	4	611.82	1223.64	15	2	1	NA	1	0	4	19
ATP6V1E1	2	6	2	0	224.73	449.46	15	2	0.133333333333333	-Inf	1	-0.75	2	8
ATP6V1H	0	19	1	3	476.19	952.38	15	2	0.173913043478261	-Inf	1	-0.25	4	19
ATP7B	37	88	9	9	1430.55	2861.1	15	2	0.106087973909334	-1.37837837837838	1	-0.204	18	125
ATP8A2	8	23	2	1	764.94	1529.88	15	2	0.200534759358289	-4.75	1	-0.408602150537634	3	31
ATP9B	5	29	4	2	1144.77	2289.54	15	2	0.0163037531458584	-10.6	1	-0.519607843137255	6	34
ATXN1	5	19	6	17	793.98	1587.96	15	2	0.739967499613171	-0.341176470588235	1	-0.052536231884058	23	24
ATXN10	31	22	0	1	411.18	822.36	15	2	0.425925925925926	1	1	0.584905660377358	1	53
ATXN7L1	4	17	1	2	619.74	1239.48	15	2	0.521245059288538	-1.125	1	-0.142857142857143	3	21
AVL9	15	25	3	0	634.59	1269.18	15	2	0.0661210598816952	-Inf	1	-0.625	3	40
AVPR1A	1	6	0	1	315.48	630.96	15	2	1	1	1	0.142857142857143	1	7
AVPR2	2	9	2	0	368.28	736.56	15	2	0.0769230769230769	-Inf	1	-0.818181818181818	2	11
AWAT1	3	8	2	7	358.38	716.76	15	2	1	0.238095238095238	1	0.0505050505050505	9	11
AZI2	8	18	2	1	386.1	772.2	15	2	0.266830870279146	-3.5	1	-0.358974358974359	3	26
AZIN1	1	10	1	1	446.49	892.98	15	2	0.294871794871795	-9	1	-0.409090909090909	2	11
AvBD1-AvBD5	16	7	1	1	102.3	204.6	15	2	1	0.5625	1	0.195652173913043	2	23
AvBD10-AvBD9	1	5	0	3	68.31	136.62	15	2	1	1	1	0.166666666666667	3	6
AvBD12	3	6	0	1	93.06	186.12	15	2	1	1	1	0.333333333333333	1	9
AvBD4-AvBD6-AvBD7	3	4	0	0	66.33	132.66	15	2	1	NA	1	NA	0	7
B3GALNT2	8	24	2	2	481.8	963.6	15	2	0.304812834224599	-2	1	-0.25	4	32
B3GALT5	16	11	3	4	316.8	633.6	15	2	0.672173627262615	0.484375	1	0.164021164021164	7	27
B3GAT1L	4	17	0	4	341.55	683.1	15	2	1	1	1	0.19047619047619	4	21
B3GAT2	0	4	0	1	125.73	251.46	15	2	1	NA	1	0	1	4
B3GLCT	9	16	5	4	561.99	1123.98	15	2	0.435129942360198	-1.22222222222222	1	-0.195555555555556	9	25
B3GNT2	0	20	0	4	394.02	788.04	15	2	1	NA	1	0	4	20
B4GALNT3	38	53	6	8	1002.54	2005.08	15	2	1	-0.0460526315789473	1	-0.0109890109890109	14	91
B4GALT3	9	13	3	5	339.57	679.14	15	2	1	0.133333333333333	1	0.0340909090909091	8	22
B4GALT4	8	20	4	5	351.45	702.9	15	2	0.431783415948828	-1	1	-0.158730158730159	9	28
B4GALT6	1	9	0	2	379.17	758.34	15	2	1	1	1	0.1	2	10
BAALC	2	5	2	1	145.53	291.06	15	2	0.5	-4	1	-0.380952380952381	3	7
BACE2	5	11	4	4	340.56	681.12	15	2	0.412033921119936	-1.2	1	-0.1875	8	16
BACH1	16	27	4	4	758.34	1516.68	15	2	0.695807506418596	-0.6875	1	-0.127906976744186	8	43
BACH2	1	13	3	5	817.74	1635.48	15	2	0.116746411483254	-6.8	1	-0.303571428571429	8	14
BAG1	3	10	0	1	200.64	401.28	15	2	1	1	1	0.230769230769231	1	13
BAG2	0	6	2	4	223.74	447.48	15	2	0.454545454545454	-Inf	1	-0.333333333333333	6	6
BAIAP2L2	12	29	4	3	490.05	980.1	15	2	0.20137806436023	-2.22222222222222	1	-0.278745644599303	7	41
BAMBI	0	5	0	1	257.4	514.8	15	2	1	NA	1	0	1	5
BASP1	5	11	2	2	242.55	485.1	15	2	0.586790505675955	-1.2	1	-0.1875	4	16
BATF3	2	2	0	2	104.94	209.88	15	2	0.466666666666667	1	1	0.5	2	4
BBS10	40	35	11	10	642.51	1285.02	15	2	1	0.0375	1	0.00952380952380949	21	75
BBX	9	14	0	3	930.6	1861.2	15	2	0.529230769230769	1	1	0.391304347826087	3	23
BCAP29	4	3	1	0	241.56	483.12	15	2	1	-Inf	1	-0.428571428571429	1	7
BCAT1	11	16	2	0	429.66	859.32	15	2	0.192118226600985	-Inf	1	-0.592592592592593	2	27
BCKDHB	25	17	2	1	427.35	854.7	15	2	1	-0.36	1	-0.0714285714285714	3	42
BCL11A	3	23	1	7	645.15	1290.3	15	2	1	-0.0952380952380953	1	-0.00961538461538461	8	26
BCL2L11	3	2	1	0	128.04	256.08	15	2	1	-Inf	1	-0.4	1	5
BCL2L13	17	19	3	2	493.68	987.36	15	2	0.662796004259419	-0.676470588235294	1	-0.127777777777778	5	36
BCL9	3	36	9	8	1415.37	2830.74	15	2	0.00042456303206183	-12.5	0.42125753829487	-0.452488687782805	17	39
BCOR	20	62	12	24	1731.51	3463.02	15	2	0.3702278930749	-0.55	1	-0.0894308943089431	36	82
BDH1	4	14	3	5	316.8	633.6	15	2	0.635293402249924	-1.1	1	-0.152777777777778	8	18
BEND2	13	33	3	5	575.85	1151.7	15	2	0.681602486901564	-0.523076923076923	1	-0.0923913043478261	8	46
BEND3	2	34	0	9	828.63	1657.26	15	2	1	1	1	0.0555555555555556	9	36
BEND6	15	14	2	0	474.21	948.42	15	2	0.488172043010753	-Inf	1	-0.482758620689655	2	29
BEND7	7	8	0	5	462.33	924.66	15	2	0.113712590299278	1	1	0.466666666666667	5	15
BEST3	7	21	1	5	662.31	1324.62	15	2	1	0.4	1	0.0833333333333333	6	28
BET1	0	8	0	1	114.84	229.68	15	2	1	NA	1	0	1	8
BFSP1	12	26	6	6	651.42	1302.84	15	2	0.308791481296111	-1.16666666666667	1	-0.184210526315789	12	38
BFSP2	2	14	2	5	397.98	795.96	15	2	0.557312252964427	-1.8	1	-0.160714285714286	7	16
BICD1	6	40	1	7	825.99	1651.98	15	2	1	0.0476190476190477	1	0.00543478260869565	8	46
BID	2	13	0	1	192.06	384.12	15	2	1	1	1	0.133333333333333	1	15
BIRC2	7	24	2	3	605.88	1211.76	15	2	0.581025592055004	-1.28571428571429	1	-0.174193548387097	5	31
BIRC5	3	4	1	1	145.53	291.06	15	2	1	-0.333333333333333	1	-0.0714285714285715	2	7
BIRC6	13	152	9	20	4801.5	9603	15	2	0.00143546956641104	-4.26153846153846	0.821768551255416	-0.231556948798328	29	165
BIVM	5	28	4	3	524.7	1049.4	15	2	0.0336630986785785	-6.46666666666667	1	-0.41991341991342	7	33
BLK	4	35	0	6	521.73	1043.46	15	2	1	1	1	0.102564102564103	6	39
BLOC1S4	7	9	4	4	215.82	431.64	15	2	1	-0.285714285714286	1	-0.0625	8	16
BLOC1S5	7	10	1	0	193.05	386.1	15	2	0.444444444444444	-Inf	1	-0.588235294117647	1	17
BLZF1	10	20	1	3	394.02	788.04	15	2	1	0.333333333333333	1	0.0833333333333333	4	30
BMI1	0	2	0	1	294.36	588.72	15	2	1	NA	1	0	1	2
BMP2	0	1	1	0	393.03	786.06	15	2	1	-Inf	1	-1	1	1
BMP5	1	9	2	1	372.24	744.48	15	2	0.108391608391608	-17	1	-0.566666666666667	3	10
BMP6	5	16	0	1	302.94	605.88	15	2	1	1	1	0.238095238095238	1	21
BMPER	22	28	3	2	771.87	1543.74	15	2	0.649875343549039	-0.909090909090909	1	-0.16	5	50
BMT2	3	20	0	1	373.23	746.46	15	2	1	1	1	0.130434782608696	1	23
BMX	15	27	1	0	605.88	1211.76	15	2	0.372093023255814	-Inf	1	-0.642857142857143	1	42
BOC	26	56	5	18	1144.44	2288.88	15	2	0.443480009625942	0.401709401709402	1	0.0996818663838812	23	82
BOP1	2	3	2	2	326.37	652.74	15	2	1	-0.5	1	-0.1	4	5
BORA	17	30	2	4	614.13	1228.26	15	2	1	0.117647058823529	1	0.0283687943262412	6	47
BORCS5	8	5	0	0	81.18	162.36	15	2	1	NA	1	NA	0	13
BORCS6	5	10	1	4	200.64	401.28	15	2	1	0.5	1	0.133333333333333	5	15
BPGM	3	12	0	1	257.4	514.8	15	2	1	1	1	0.2	1	15
BPHL	4	18	4	1	287.1	574.2	15	2	0.0171683389074693	-17	1	-0.618181818181818	5	22
BPIFCB	25	21	1	1	462.99	925.98	15	2	1	0.16	1	0.0434782608695652	2	46
BPNT1	7	10	1	2	304.92	609.84	15	2	1	0.285714285714286	1	0.0784313725490196	3	17
BRAF	0	16	0	1	748.44	1496.88	15	2	1	NA	1	0	1	16
BRCA2	246	155	46	24	3346.86	6693.72	15	2	0.508131011436525	-0.207655826558266	1	-0.0436765229782686	70	401
BRD1	3	34	0	0	1204.17	2408.34	15	2	1	NA	1	NA	0	37
BRE	24	21	9	4	518.76	1037.52	15	2	0.357756151542575	-0.96875	1	-0.158974358974359	13	45
BTBD11	10	22	4	8	772.2	1544.4	15	2	1	-0.1	1	-0.0208333333333333	12	32
BTBD9	0	15	1	0	438.57	877.14	15	2	0.0625	-Inf	1	-1	1	15
BTD	18	29	10	6	515.79	1031.58	15	2	0.144731959792306	-1.68518518518519	1	-0.242021276595745	16	47
BTG1	1	2	0	1	169.29	338.58	15	2	1	1	1	0.333333333333333	1	3
BTLA	12	8	3	3	265.32	530.64	15	2	1	0.333333333333333	1	0.1	6	20
BUB1	49	50	5	14	1070.52	2141.04	15	2	0.0800693060731717	0.635568513119534	1	0.231791600212653	19	99
BVES	3	6	2	4	356.4	712.8	15	2	1	0	1	0	6	9
BZW2	1	5	0	3	415.8	831.6	15	2	1	1	1	0.166666666666667	3	6
C11orf97	4	3	2	0	84.15	168.3	15	2	0.5	-Inf	1	-0.428571428571429	2	7
C12orf74-PLEKHG7	24	32	3	2	747.12	1494.24	15	2	0.646943671084275	-1	1	-0.171428571428571	5	56
C18orf63	37	29	8	4	640.53	1281.06	15	2	0.544301518900035	-0.567567567567568	1	-0.106060606060606	12	66
C1D	11	5	4	0	166.32	332.64	15	2	0.530443756449948	-Inf	1	-0.3125	4	16
C1GALT1	3	11	1	4	363.33	726.66	15	2	1	0.0833333333333334	1	0.0142857142857143	5	14
C1H11ORF54	2	18	2	6	313.83	627.66	15	2	0.554578754578755	-2	1	-0.15	8	20
C1H11ORF70	4	8	3	2	265.32	530.64	15	2	0.592760180995475	-2	1	-0.266666666666667	5	12
C1H11ORF87	2	4	1	1	172.92	345.84	15	2	1	-1	1	-0.166666666666667	2	6
C1H12ORF45	5	5	2	1	162.36	324.72	15	2	1	-1	1	-0.166666666666667	3	10
C1H12ORF57	1	4	0	3	125.73	251.46	15	2	1	1	1	0.2	3	5
C1H12ORF66	0	11	0	3	442.53	885.06	15	2	1	NA	1	0	3	11
C1H12ORF73	2	1	0	2	67.32	134.64	15	2	0.4	1	1	0.666666666666667	2	3
C1H21ORF33	3	12	1	1	228.69	457.38	15	2	0.426470588235294	-3	1	-0.3	2	15
C1H21ORF59	3	20	3	2	288.09	576.18	15	2	0.0504273504273504	-9	1	-0.469565217391304	5	23
C1H21ORF62	4	5	2	1	223.74	447.48	15	2	1	-1.5	1	-0.222222222222222	3	9
C1H21ORF91	2	5	0	0	114.84	229.68	15	2	1	NA	1	NA	0	7
C1H22orf23	11	11	5	3	215.16	430.32	15	2	0.688733411072242	-0.666666666666667	1	-0.125	8	22
C1H2ORF40	3	4	0	2	143.22	286.44	15	2	0.5	1	1	0.428571428571429	2	7
C1H2ORF49	4	13	2	1	239.58	479.16	15	2	0.201754385964912	-5.5	1	-0.431372549019608	3	17
C1H3ORF30	14	6	1	1	146.52	293.04	15	2	1	0.571428571428571	1	0.2	2	20
C1H3ORF38	10	12	1	1	306.9	613.8	15	2	1	-0.2	1	-0.0454545454545455	2	22
C1HXORF36	5	22	5	3	427.68	855.36	15	2	0.0274324412746189	-6.33333333333333	1	-0.439814814814815	8	27
C1HXORF59	94	77	16	5	2035.77	4071.54	15	2	0.0999330858257663	-1.62127659574468	1	-0.212197159565581	21	171
C1QL3	0	3	1	2	245.52	491.04	15	2	1	-Inf	1	-0.333333333333333	3	3
C1QTNF6	2	11	0	0	257.4	514.8	15	2	1	NA	1	NA	0	13
C1QTNF9	7	11	4	3	341.55	683.1	15	2	0.656407322654462	-1.0952380952381	1	-0.182539682539683	7	18
C1R	18	29	4	5	705.87	1411.74	15	2	0.726615522841938	-0.288888888888889	1	-0.0614657210401891	9	47
C1S	21	35	5	4	684.09	1368.18	15	2	0.465369891710743	-1.08333333333333	1	-0.180555555555556	9	56
C21orf140	12	9	3	3	251.46	502.92	15	2	1	0.25	1	0.0714285714285714	6	21
C2CD2	14	20	5	2	713.79	1427.58	15	2	0.218911312813752	-2.57142857142857	1	-0.302521008403361	7	34
C2CD3	180	225	58	44	2320.56	4641.12	15	2	0.0266895731504685	-0.647727272727273	1	-0.124183006535948	102	405
C2CD5	10	33	1	1	997.59	1995.18	15	2	0.433333333333333	-2.3	1	-0.267441860465116	2	43
C2H18ORF21	22	14	2	4	328.68	657.36	15	2	0.375239096676837	0.681818181818182	1	0.277777777777778	6	36
C2H18ORF8	4	24	2	7	674.19	1348.38	15	2	0.619525943055355	-0.714285714285714	1	-0.0793650793650794	9	28
C2H1orf35	12	12	6	8	303.93	607.86	15	2	0.74486967501428	0.25	1	0.0714285714285715	14	24
C2H6ORF62	0	3	0	1	227.7	455.4	15	2	1	NA	1	0	1	3
C2H6orf52	5	4	0	0	256.41	512.82	15	2	1	NA	1	NA	0	9
C2H7ORF57	7	10	0	3	147.51	295.02	15	2	0.521052631578947	1	1	0.411764705882353	3	17
C2H7orf31	26	18	4	2	395.01	790.02	15	2	1	-0.384615384615385	1	-0.0757575757575757	6	44
C2H8ORF22	4	2	0	0	85.14	170.28	15	2	1	NA	1	NA	0	6
C2H8ORF34	17	17	1	0	383.13	766.26	15	2	1	-Inf	1	-0.5	1	34
C2H8ORF37	8	13	2	1	210.87	421.74	15	2	0.550395256916996	-2.25	1	-0.285714285714286	3	21
C2H8ORF46	8	10	3	6	194.04	388.08	15	2	0.692448512585812	0.375	1	0.111111111111111	9	18
C2H8ORF76	36	35	6	5	403.92	807.84	15	2	1	-0.166666666666667	1	-0.0384122919334187	11	71
C2orf71	55	49	19	8	1286.01	2572.02	15	2	0.128747469809039	-1.11590909090909	1	-0.17485754985755	27	104
C3AR1	29	18	5	3	463.32	926.64	15	2	1	-0.0344827586206897	1	-0.00797872340425532	8	47
C3H1ORF115	2	1	1	0	128.7	257.4	15	2	1	-Inf	1	-0.333333333333333	1	3
C3H1ORF131	11	15	5	2	242.22	484.44	15	2	0.224503095470838	-2.40909090909091	1	-0.291208791208791	7	26
C3H1ORF198	3	7	3	4	332.64	665.28	15	2	0.643665158371041	-0.75	1	-0.128571428571429	7	10
C3H1orf95	1	4	0	0	132.66	265.32	15	2	1	NA	1	NA	0	5
C3H2ORF3-GCFC2-LOC112530730	34	43	7	3	832.59	1665.18	15	2	0.180120383967379	-1.95098039215686	1	-0.258441558441558	10	77
C3H2ORF70	10	8	0	2	125.73	251.46	15	2	0.473684210526316	1	1	0.555555555555556	2	18
C3H6ORF203	5	19	2	3	223.74	447.48	15	2	0.568818155025051	-1.53333333333333	1	-0.191666666666667	5	24
C3H6orf120	7	6	2	3	184.14	368.28	15	2	1	0.428571428571429	1	0.138461538461538	5	13
C3H8ORF80	55	42	8	8	755.7	1511.4	15	2	0.78675521337033	0.236363636363636	1	0.0670103092783505	16	97
C4A	46	85	9	12	1670.13	3340.26	15	2	0.625376389007333	-0.385869565217391	1	-0.0774263904034896	21	131
C6orf58	24	23	4	3	382.14	764.28	15	2	1	-0.277777777777778	1	-0.060790273556231	7	47
C7orf49	5	6	3	1	91.08	182.16	15	2	0.569230769230769	-2.6	1	-0.295454545454545	4	11
C8orf59	4	5	0	0	101.97	203.94	15	2	1	NA	1	NA	0	9
CA13	2	6	0	0	204.93	409.86	15	2	1	NA	1	NA	0	8
CA2	6	13	1	0	258.39	516.78	15	2	0.35	-Inf	1	-0.684210526315789	1	19
CA3A	3	12	2	1	260.37	520.74	15	2	0.171568627450981	-7	1	-0.466666666666667	3	15
CA3B	2	11	1	1	263.34	526.68	15	2	0.371428571428571	-4.5	1	-0.346153846153846	2	13
CA8	1	6	1	1	281.16	562.32	15	2	0.416666666666667	-5	1	-0.357142857142857	2	7
CAB39L	0	10	0	3	331.65	663.3	15	2	1	NA	1	0	3	10
CABYR	31	25	4	1	467.94	935.88	15	2	0.382411461676775	-2.2258064516129	1	-0.246428571428571	5	56
CACNA1C	0	16	3	12	883.08	1766.16	15	2	0.101223581757508	-Inf	1	-0.2	15	16
CACNA1I	42	83	9	25	2251.26	4502.52	15	2	0.535672742044296	0.288571428571429	1	0.0712941176470588	34	125
CACNA2D1	7	23	2	1	836.55	1673.1	15	2	0.17375366568915	-5.57142857142857	1	-0.433333333333333	3	30
CACNA2D4	8	41	4	6	815.76	1631.52	15	2	0.189185947461339	-2.41666666666667	1	-0.236734693877551	10	49
CACNG2	2	3	0	3	271.26	542.52	15	2	0.464285714285714	1	1	0.4	3	5
CADPS2	16	51	2	5	1121.01	2242.02	15	2	1	-0.275	1	-0.046908315565032	7	67
CALCR	1	21	1	1	465.3	930.6	15	2	0.16304347826087	-20	1	-0.454545454545455	2	22
CALD1	7	17	1	2	396.99	793.98	15	2	1	-0.214285714285714	1	-0.0416666666666666	3	24
CALM1-CALM2	0	2	0	0	148.5	297	15	2	1	NA	1	NA	0	2
CAND1	1	33	1	7	1217.04	2434.08	15	2	0.348432055749129	-3.71428571428571	1	-0.0955882352941176	8	34
CAP2	6	13	1	3	474.21	948.42	15	2	1	0.277777777777778	1	0.0657894736842105	4	19
CAPN11	8	25	1	8	698.94	1397.88	15	2	0.655087345066957	0.609375	1	0.131313131313131	9	33
CAPN13	28	32	4	2	608.85	1217.7	15	2	0.420164534918633	-1.28571428571429	1	-0.2	6	60
CAPN2	3	40	1	7	670.89	1341.78	15	2	0.506162464985994	-0.904761904761905	1	-0.0552325581395349	8	43
CAPN5	11	40	2	6	779.13	1558.26	15	2	1	-0.212121212121212	1	-0.0343137254901961	8	51
CAPN7	0	34	1	9	772.2	1544.4	15	2	0.227272727272727	-Inf	1	-0.1	10	34
CAPN8	18	31	6	7	692.01	1384.02	15	2	0.541330438965642	-0.476190476190476	1	-0.0941915227629513	13	49
CAPN9	10	28	8	7	687.06	1374.12	15	2	0.105602882651585	-2.2	1	-0.270175438596491	15	38
CAPRIN2	8	31	3	4	1163.25	2326.5	15	2	0.332840102920746	-1.90625	1	-0.223443223443223	7	39
CAPS2	26	13	6	3	588.06	1176.12	15	2	1	0	1	0	9	39
CAPZA2	0	6	1	2	305.91	611.82	15	2	0.333333333333333	-Inf	1	-0.333333333333333	3	6
CAPZA3	12	9	1	1	274.23	548.46	15	2	1	0.25	1	0.0714285714285714	2	21
CARD10	11	44	6	18	1010.79	2021.58	15	2	0.766678890663034	-0.333333333333333	1	-0.05	24	55
CARMIL1	15	56	3	5	1538.13	3076.26	15	2	0.373360739617025	-1.24	1	-0.163732394366197	8	71
CARS2	14	9	2	8	505.56	1011.12	15	2	0.057026325546904	0.839285714285714	1	0.408695652173913	10	23
CASC1	31	23	3	1	707.85	1415.7	15	2	0.635053150116671	-1.2258064516129	1	-0.175925925925926	4	54
CASD1	8	25	2	7	791.01	1582.02	15	2	1	0.107142857142857	1	0.0202020202020202	9	33
CASK	6	21	0	9	891	1782	15	2	0.302610340323813	1	1	0.222222222222222	9	27
CASP2	7	18	4	6	422.73	845.46	15	2	0.688923913879747	-0.714285714285714	1	-0.12	10	25
CASP8AP2	142	124	37	21	2446.95	4893.9	15	2	0.18943250467421	-0.538564721663313	1	-0.104096448016593	58	266
CASQ2	3	28	3	6	389.07	778.14	15	2	0.114673377831273	-3.66666666666667	1	-0.236559139784946	9	31
CASR	2	41	2	7	1049.4	2098.8	15	2	0.133884938590821	-4.85714285714286	1	-0.175710594315245	9	43
CATH3	7	11	5	5	231	462	15	2	0.697940503432494	-0.571428571428571	1	-0.111111111111111	10	18
CAV1	0	7	0	5	177.21	354.42	15	2	1	NA	1	0	5	7
CAV2	2	4	2	1	157.74	315.48	15	2	0.523809523809524	-3	1	-0.333333333333333	3	6
CBLL1	2	25	1	7	489.06	978.12	15	2	0.553093964858671	-0.785714285714286	1	-0.0509259259259259	8	27
CBLN2	0	4	0	0	157.41	314.82	15	2	1	NA	1	NA	0	4
CBR1	3	10	0	1	238.59	477.18	15	2	1	1	1	0.230769230769231	1	13
CBS	4	29	1	8	561.33	1122.66	15	2	1	0.09375	1	0.0101010101010101	9	33
CBX3	0	8	0	1	173.25	346.5	15	2	1	NA	1	0	1	8
CBX6	2	17	0	8	392.37	784.74	15	2	1	1	1	0.105263157894737	8	19
CBX7	1	6	0	3	242.55	485.1	15	2	1	1	1	0.142857142857143	3	7
CBY1	1	7	0	1	110.88	221.76	15	2	1	1	1	0.125	1	8
CCDC102B	25	6	4	0	234.63	469.26	15	2	1	-Inf	1	-0.193548387096774	4	31
CCDC107	11	8	3	4	300.96	601.92	15	2	0.665217391304348	0.454545454545455	1	0.150375939849624	7	19
CCDC12	2	11	2	3	133.32	266.64	15	2	0.532679738562091	-2.66666666666667	1	-0.246153846153846	5	13
CCDC122	13	9	5	0	258.39	516.78	15	2	0.135785953177258	-Inf	1	-0.409090909090909	5	22
CCDC126	1	5	1	2	138.6	277.2	15	2	1	-1.5	1	-0.166666666666667	3	6
CCDC127	5	9	0	1	262.35	524.7	15	2	1	1	1	0.357142857142857	1	14
CCDC129	78	36	4	1	789.03	1578.06	15	2	1	-0.846153846153846	1	-0.115789473684211	5	114
CCDC13	19	27	6	5	708.84	1417.68	15	2	0.508295377499879	-0.705263157894737	1	-0.132411067193676	11	46
CCDC146	48	30	8	7	959.31	1918.62	15	2	0.575840134611961	0.285714285714286	1	0.0820512820512821	15	78
CCDC166	13	6	1	1	305.91	611.82	15	2	1	0.538461538461538	1	0.184210526315789	2	19
CCDC167	2	4	1	0	96.03	192.06	15	2	0.428571428571428	-Inf	1	-0.666666666666667	1	6
CCDC169	10	11	2	0	207.57	415.14	15	2	0.478260869565218	-Inf	1	-0.523809523809524	2	21
CCDC170	44	35	7	5	827.64	1655.28	15	2	1	-0.113636363636364	1	-0.0263713080168777	12	79
CCDC171	6	2	2	0	1198.56	2397.12	15	2	1	-Inf	1	-0.25	2	8
CCDC178	40	21	5	2	744.48	1488.96	15	2	1	-0.3125	1	-0.0585480093676816	7	61
CCDC181	19	10	2	2	520.74	1041.48	15	2	0.609970674486803	0.473684210526316	1	0.155172413793103	4	29
CCDC191	39	20	16	2	876.15	1752.3	15	2	0.0772508405640483	-3.1025641025641	1	-0.227871939736346	18	59
CCDC28A	0	4	0	2	183.15	366.3	15	2	1	NA	1	0	2	4
CCDC3	1	8	0	1	285.12	570.24	15	2	1	1	1	0.111111111111111	1	9
CCDC58	0	10	0	1	143.55	287.1	15	2	1	NA	1	0	1	10
CCDC59	1	4	0	0	160.05	320.1	15	2	1	NA	1	NA	0	5
CCDC71L	7	3	1	0	133.65	267.3	15	2	1	-Inf	1	-0.3	1	10
CCDC77	12	10	4	1	437.58	875.16	15	2	0.618481357611792	-2.33333333333333	1	-0.254545454545455	5	22
CCDC80	15	42	10	7	947.43	1894.86	15	2	0.0193669490396544	-3	1	-0.325077399380805	17	57
CCDC82	26	21	2	1	464.31	928.62	15	2	1	-0.615384615384615	1	-0.113475177304964	3	47
CCDC83	31	18	0	1	443.19	886.38	15	2	0.38	1	1	0.63265306122449	1	49
CCDC85A	11	23	0	1	408.87	817.74	15	2	1	1	1	0.323529411764706	1	34
CCDC88A	23	76	3	0	2020.59	4041.18	15	2	0.0151426907396622	-Inf	1	-0.767676767676768	3	99
CCDC91	17	2	0	0	189.09	378.18	15	2	1	NA	1	NA	0	19
CCKBR	2	13	2	8	382.8	765.6	15	2	1	-0.625	1	-0.0666666666666667	10	15
CCM2	0	10	3	2	191.07	382.14	15	2	0.021978021978022	-Inf	1	-0.6	5	10
CCNA1	12	16	2	3	401.94	803.88	15	2	1	0.111111111111111	1	0.0285714285714285	5	28
CCNC	0	5	0	0	270.6	541.2	15	2	1	NA	1	NA	0	5
CCND2	1	1	0	0	188.43	376.86	15	2	1	NA	1	NA	0	2
CCNE2	1	25	0	4	401.94	803.88	15	2	1	1	1	0.0384615384615385	4	26
CCNY	5	10	0	4	355.74	711.48	15	2	0.530443756449948	1	1	0.333333333333333	4	15
CCR4	8	18	0	0	355.41	710.82	15	2	1	NA	1	NA	0	26
CCR5	3	12	1	4	320.76	641.52	15	2	1	0	1	0	5	15
CCR6	9	13	1	3	361.35	722.7	15	2	1	0.518518518518519	1	0.159090909090909	4	22
CCR8L	2	15	2	6	348.48	696.96	15	2	0.5699604743083	-1.5	1	-0.132352941176471	8	17
CCR9	16	16	6	3	384.12	768.24	15	2	0.465868870746919	-1	1	-0.166666666666667	9	32
CCSAP	6	9	1	2	244.53	489.06	15	2	1	0.25	1	0.0666666666666667	3	15
CCT2	3	23	2	5	530.64	1061.28	15	2	0.281904135908585	-2.06666666666667	1	-0.17032967032967	7	26
CCT4-FAM161A	36	59	8	11	1292.94	2585.88	15	2	0.798590236672797	-0.191919191919192	1	-0.0421052631578947	19	95
CCT5	3	25	4	5	536.58	1073.16	15	2	0.0449510231293913	-5.66666666666667	1	-0.337301587301587	9	28
CCT8	6	20	3	2	564.3	1128.6	15	2	0.131256952169077	-4	1	-0.369230769230769	5	26
CD101	67	57	25	16	867.24	1734.48	15	2	0.472741794725905	-0.329291044776119	1	-0.0694335169158143	41	124
CD109	25	53	9	6	1361.25	2722.5	15	2	0.0759404310489756	-2.18	1	-0.279487179487179	15	78
CD163	55	41	4	8	1057.65	2115.3	15	2	0.135059692653787	0.627272727272727	1	0.239583333333333	12	96
CD164	13	7	1	4	173.91	347.82	15	2	0.133333333333333	0.865384615384615	1	0.45	5	20
CD2	33	12	0	2	304.92	609.84	15	2	0.0841813135985199	1	1	0.733333333333333	2	45
CD200	36	29	7	2	569.58	1139.16	15	2	0.288296493759102	-1.81944444444444	1	-0.223931623931624	9	65
CD200R1-CD200R1L	28	22	8	3	563.31	1126.62	15	2	0.499910870489949	-1.0952380952381	1	-0.167272727272727	11	50
CD247	2	10	0	3	164.34	328.68	15	2	1	1	1	0.166666666666667	3	12
CD2AP	12	16	0	1	511.83	1023.66	15	2	1	1	1	0.428571428571429	1	28
CD36	2	17	1	1	467.28	934.56	15	2	0.271428571428572	-7.5	1	-0.394736842105263	2	19
CD4	62	17	5	6	473.22	946.44	15	2	0.0285590809045996	0.771505376344086	1	0.330264672036824	11	79
CD47	11	6	1	3	311.85	623.7	15	2	0.272180451127819	0.818181818181818	1	0.397058823529412	4	17
CD80	10	10	1	3	310.86	621.72	15	2	0.596273291925466	0.666666666666667	1	0.25	4	20
CD83	3	12	0	0	212.85	425.7	15	2	1	NA	1	NA	0	15
CD86	7	6	4	1	282.15	564.3	15	2	0.595588235294118	-2.42857142857143	1	-0.261538461538462	5	13
CD9	3	13	0	1	222.75	445.5	15	2	1	1	1	0.1875	1	16
CD99	3	10	0	2	175.23	350.46	15	2	1	1	1	0.230769230769231	2	13
CDADC1	8	14	0	1	487.08	974.16	15	2	1	1	1	0.363636363636364	1	22
CDC123	1	13	2	0	332.64	665.28	15	2	0.025	-Inf	1	-0.928571428571429	2	14
CDC16	7	32	3	4	637.23	1274.46	15	2	0.163185282004488	-2.42857142857143	1	-0.249084249084249	7	39
CDC25A	15	35	1	6	515.13	1030.26	15	2	0.659861657641902	0.611111111111111	1	0.157142857142857	7	50
CDC40	3	22	0	2	574.2	1148.4	15	2	1	1	1	0.12	2	25
CDC42BPA	10	49	3	8	1305.81	2611.62	15	2	0.416268456821496	-0.8375	1	-0.103235747303544	11	59
CDC42EP1	7	20	2	6	411.84	823.68	15	2	1	0.0476190476190477	1	0.00925925925925924	8	27
CDC42EP3	2	8	1	0	251.46	502.92	15	2	0.272727272727273	-Inf	1	-0.8	1	10
CDC5L	0	36	1	2	795.96	1591.92	15	2	0.0769230769230769	-Inf	1	-0.333333333333333	3	36
CDCA3	12	8	3	3	165.33	330.66	15	2	1	0.333333333333333	1	0.1	6	20
CDCA7L	8	19	1	1	406.56	813.12	15	2	0.532019704433498	-1.375	1	-0.203703703703704	2	27
CDCP1	11	37	7	9	828.63	1657.26	15	2	0.122287502130863	-1.61616161616162	1	-0.208333333333333	16	48
CDH12	4	21	0	0	508.53	1017.06	15	2	1	NA	1	NA	0	25
CDH18	20	32	0	0	661.32	1322.64	15	2	1	NA	1	NA	0	52
CDH19	26	25	5	6	768.9	1537.8	15	2	1	0.198717948717949	1	0.0552584670231729	11	51
CDH2	8	32	2	4	842.16	1684.32	15	2	0.597523983328812	-1	1	-0.133333333333333	6	40
CDH20	8	39	2	7	815.76	1631.52	15	2	0.655578269043466	-0.392857142857143	1	-0.0520094562647754	9	47
CDH6	6	22	1	2	783.09	1566.18	15	2	0.54972191323693	-0.833333333333333	1	-0.119047619047619	3	28
CDH7	15	26	3	1	798.6	1597.2	15	2	0.286197523406826	-4.2	1	-0.384146341463415	4	41
CDHR3	39	30	5	5	766.26	1532.52	15	2	0.743446282503465	0.230769230769231	1	0.0652173913043478	10	69
CDK13	16	38	3	11	1204.83	2409.66	15	2	0.741530682781938	0.352272727272727	1	0.082010582010582	14	54
CDK14	2	6	1	1	238.26	476.52	15	2	1	-2	1	-0.25	2	8
CDK17	0	17	0	3	518.76	1037.52	15	2	1	NA	1	0	3	17
CDK19	0	16	0	0	447.15	894.3	15	2	1	NA	1	NA	0	16
CDK5	0	7	0	4	206.58	413.16	15	2	1	NA	1	0	4	7
CDK6	3	1	0	0	122.76	245.52	15	2	1	NA	1	NA	0	4
CDK8	0	10	0	2	407.88	815.76	15	2	1	NA	1	0	2	10
CDKAL1	27	23	10	9	559.02	1118.04	15	2	1	0.0534979423868313	1	0.0136842105263159	19	50
CDKL5	10	38	3	5	941.49	1882.98	15	2	0.370333949474587	-1.28	1	-0.166666666666667	8	48
CDPF1	7	1	0	1	123.75	247.5	15	2	0.222222222222222	1	1	0.875	1	8
CDV3	2	10	0	3	221.1	442.2	15	2	1	1	1	0.166666666666667	3	12
CDX2	3	6	0	4	265.32	530.64	15	2	0.496503496503496	1	1	0.333333333333333	4	9
CDYL	3	13	0	1	346.17	692.34	15	2	1	1	1	0.1875	1	16
CEBPD	3	7	1	0	331.65	663.3	15	2	0.363636363636364	-Inf	1	-0.7	1	10
CECR1	5	4	0	0	177.87	355.74	15	2	1	NA	1	NA	0	9
CECR2	22	74	9	11	1496.22	2992.44	15	2	0.0538707417859842	-1.75206611570248	1	-0.220833333333333	20	96
CELSR1	13	54	3	11	1563.21	3126.42	15	2	1	-0.132867132867133	1	-0.0202558635394456	14	67
CENPF	164	72	24	16	2636.37	5272.74	15	2	0.271431818057165	0.341463414634146	1	0.0949152542372882	40	236
CENPJ	47	60	10	14	1237.5	2475	15	2	1	0.0881458966565349	1	0.0225856697819314	24	107
CENPM	8	13	0	3	176.22	352.44	15	2	0.525691699604743	1	1	0.380952380952381	3	21
CENPO	31	22	5	3	295.02	590.04	15	2	1	-0.182795698924731	1	-0.0400943396226415	8	53
CENPQ	20	19	1	0	230.67	461.34	15	2	1	-Inf	1	-0.487179487179487	1	39
CEP126	59	26	11	8	819.72	1639.44	15	2	0.418227860750406	0.394067796610169	1	0.115170278637771	19	85
CEP170	21	58	7	8	1579.05	3158.1	15	2	0.133611884385282	-1.41666666666667	1	-0.20084388185654	15	79
CEP192	124	114	16	15	2525.49	5050.98	15	2	1	0.0193548387096775	1	0.00487937110328007	31	238
CEP295	111	108	23	8	1884.96	3769.92	15	2	0.0198545328214216	-1.7972972972973	1	-0.235086168802475	31	219
CEP41	13	26	4	6	367.29	734.58	15	2	0.721485579668643	-0.333333333333333	1	-0.0666666666666667	10	39
CEP57	14	19	3	2	493.02	986.04	15	2	0.63963963963964	-1.03571428571429	1	-0.175757575757576	5	33
CEP57L1	15	14	7	4	451.44	902.88	15	2	0.723469250888606	-0.633333333333333	1	-0.119122257053291	11	29
CEP68	54	57	19	13	719.73	1439.46	15	2	0.32015098628697	-0.542735042735043	1	-0.107263513513513	32	111
CEP76	10	39	5	6	656.37	1312.74	15	2	0.121915046787408	-2.25	1	-0.250463821892393	11	49
CEP83	9	30	4	7	709.83	1419.66	15	2	0.444623838297011	-0.904761904761905	1	-0.132867132867133	11	39
CEP85L	19	32	4	8	738.54	1477.08	15	2	1	0.157894736842105	1	0.0392156862745098	12	51
CEP97	31	31	4	1	833.25	1666.5	15	2	0.358278537383015	-3	1	-0.3	5	62
CERK	5	19	4	4	505.56	1011.12	15	2	0.176005533213542	-2.8	1	-0.291666666666667	8	24
CFAP206	26	28	3	2	615.78	1231.56	15	2	0.670748519990268	-0.615384615384615	1	-0.118518518518519	5	54
CFAP36	13	17	1	0	401.94	803.88	15	2	0.451612903225806	-Inf	1	-0.566666666666667	1	30
CFAP44	80	70	14	6	1798.5	3597	15	2	0.231048330001185	-1.04166666666667	1	-0.166666666666667	20	150
CFAP54	157	93	19	10	3208.59	6417.18	15	2	0.841253059737347	-0.12547770700637	1	-0.0271724137931034	29	250
CFAP61	42	42	13	10	1302.18	2604.36	15	2	0.642372613382528	-0.3	1	-0.0652173913043478	23	84
CFAP69	19	40	5	7	1273.47	2546.94	15	2	0.523584117171721	-0.503759398496241	1	-0.094632768361582	12	59
CFTR	26	57	3	6	1467.18	2934.36	15	2	1	-0.0961538461538463	1	-0.0200803212851405	9	83
CGA	2	4	0	2	119.79	239.58	15	2	1	1	1	0.333333333333333	2	6
CGGBP1	0	9	0	3	166.32	332.64	15	2	1	NA	1	0	3	9
CGTL	4	20	3	6	470.25	940.5	15	2	0.35826844642195	-1.5	1	-0.166666666666667	9	24
CHAC2	0	2	0	1	151.47	302.94	15	2	1	NA	1	0	1	2
CHADL	50	58	13	13	722.7	1445.4	15	2	0.827817497538437	-0.16	1	-0.037037037037037	26	108
CHAF1B	9	21	3	1	561.33	1122.66	15	2	0.115037950664137	-6	1	-0.45	4	30
CHAMP1	27	40	12	11	945.45	1890.9	15	2	0.340649880903547	-0.616161616161616	1	-0.118754055807917	23	67
CHCHD3	10	16	2	2	384.78	769.56	15	2	1	-0.6	1	-0.115384615384615	4	26
CHCHD7	1	1	0	0	84.15	168.3	15	2	1	NA	1	NA	0	2
CHD1L	27	53	12	14	1401.84	2803.68	15	2	0.349198129895381	-0.682539682539683	1	-0.124038461538462	26	80
CHD4	5	65	2	11	1901.79	3803.58	15	2	0.300737132606444	-1.36363636363636	1	-0.0824175824175824	13	70
CHD7	5	54	8	14	2989.8	5979.6	15	2	0.00492709746711149	-5.17142857142857	1	-0.278890600924499	22	59
CHDSD	10	10	4	5	310.86	621.72	15	2	1	0.2	1	0.0555555555555556	9	20
CHGB	36	30	22	12	659.34	1318.68	15	2	0.39498207894165	-0.527777777777778	1	-0.101604278074866	34	66
CHMP1B	0	10	0	3	195.03	390.06	15	2	1	NA	1	0	3	10
CHMP2B	0	7	0	0	212.85	425.7	15	2	1	NA	1	NA	0	7
CHMP5	0	12	0	2	217.8	435.6	15	2	1	NA	1	0	2	12
CHORDC1	2	9	1	2	326.04	652.08	15	2	1	-1.25	1	-0.151515151515151	3	11
CHPF2	3	32	3	7	751.41	1502.82	15	2	0.11287577992059	-3.57142857142857	1	-0.214285714285714	10	35
CHRAC1	14	2	3	0	229.68	459.36	15	2	1	-Inf	1	-0.125	3	16
CHRDL2	2	16	4	3	429.66	859.32	15	2	0.0324110671936759	-9.66666666666667	1	-0.46031746031746	7	18
CHRM2	2	16	0	2	462.33	924.66	15	2	1	1	1	0.111111111111111	2	18
CHRM3	7	22	0	3	623.7	1247.4	15	2	1	1	1	0.241379310344828	3	29
CHRNA10	7	15	7	7	298.32	596.64	15	2	0.314227348691246	-1.14285714285714	1	-0.181818181818182	14	22
CHST10	3	9	4	1	359.37	718.74	15	2	0.100678733031674	-11	1	-0.55	5	12
CHST11	1	13	0	2	288.09	576.18	15	2	1	1	1	0.0714285714285714	2	14
CHST7	6	7	1	3	466.62	933.24	15	2	0.602941176470588	0.611111111111111	1	0.211538461538462	4	13
CHST9	11	18	0	2	335.61	671.22	15	2	0.526881720430108	1	1	0.379310344827586	2	29
CIDEA	5	6	0	3	216.81	433.62	15	2	0.258241758241758	1	1	0.454545454545455	3	11
CITED2	0	3	0	0	239.58	479.16	15	2	1	NA	1	NA	0	3
CKAP2	45	29	7	4	694.98	1389.96	15	2	1	-0.127777777777778	1	-0.0282555282555282	11	74
CKAP4	5	18	2	5	486.09	972.18	15	2	1	-0.44	1	-0.0683229813664596	7	23
CLASP2	17	38	0	3	1336.83	2673.66	15	2	0.548224008296604	1	1	0.309090909090909	3	55
CLCN1	16	26	11	3	1001.88	2003.76	15	2	0.0129937820747582	-4.95833333333333	1	-0.404761904761905	14	42
CLCN4	4	31	7	2	792.99	1585.98	15	2	0.000253536838902692	-26.125	0.393960028106369	-0.663492063492063	9	35
CLDN10	0	7	1	1	226.71	453.42	15	2	0.222222222222222	-Inf	1	-0.5	2	7
CLDN12	2	15	3	3	243.54	487.08	15	2	0.0885910428244524	-6.5	1	-0.382352941176471	6	17
CLDN14	1	7	1	5	232.65	465.3	15	2	1	-0.4	1	-0.0416666666666667	6	8
CLDN34	6	11	2	2	212.85	425.7	15	2	0.617710944026733	-0.833333333333333	1	-0.147058823529412	4	17
CLDN8	5	11	2	1	218.79	437.58	15	2	0.523219814241486	-3.4	1	-0.354166666666667	3	16
CLDND1	3	24	3	5	249.48	498.96	15	2	0.117000172503019	-3.8	1	-0.263888888888889	8	27
CLEC3B	2	9	1	1	199.98	399.96	15	2	0.423076923076923	-3.5	1	-0.318181818181818	2	11
CLIC5	2	7	1	1	249.48	498.96	15	2	0.490909090909091	-2.5	1	-0.277777777777778	2	9
CLIP4	7	24	2	3	663.96	1327.92	15	2	0.581025592055004	-1.28571428571429	1	-0.174193548387097	5	31
CLN5	6	12	1	6	330.66	661.32	15	2	0.625695860203869	0.666666666666667	1	0.19047619047619	7	18
CLN8	8	13	1	0	283.14	566.28	15	2	0.409090909090909	-Inf	1	-0.619047619047619	1	21
CLNS1A	3	16	0	1	236.61	473.22	15	2	1	1	1	0.157894736842105	1	19
CLPTM1L	1	20	1	6	537.57	1075.14	15	2	0.444444444444444	-2.33333333333333	1	-0.0952380952380952	7	21
CLSTN3	33	54	5	4	1167.87	2335.74	15	2	0.475776067105972	-1.04545454545455	1	-0.176245210727969	9	87
CLUL1	18	10	11	1	308.88	617.76	15	2	0.124441941692017	-5.11111111111111	1	-0.273809523809524	12	28
CLVS1	0	6	1	1	151.47	302.94	15	2	0.25	-Inf	1	-0.5	2	6
CLYBL	2	4	1	1	213.18	426.36	15	2	1	-1	1	-0.166666666666667	2	6
CMAS	7	9	2	2	402.6	805.2	15	2	1	-0.285714285714286	1	-0.0625	4	16
CMBL	1	11	1	1	235.29	470.58	15	2	0.274725274725275	-10	1	-0.416666666666667	2	12
CMBLL	4	7	1	1	240.57	481.14	15	2	1	-0.75	1	-0.136363636363636	2	11
CMC1	1	4	0	6	106.92	213.84	15	2	0.454545454545455	1	1	0.2	6	5
CMPK2	10	11	0	1	251.46	502.92	15	2	1	1	1	0.476190476190476	1	21
CMTM6	7	5	0	0	179.19	358.38	15	2	1	NA	1	NA	0	12
CMTM7	2	2	0	0	175.23	350.46	15	2	1	NA	1	NA	0	4
CMTM8	1	4	3	0	182.16	364.32	15	2	0.142857142857143	-Inf	1	-0.8	3	5
CMTR1	10	33	3	13	850.41	1700.82	15	2	1	0.238461538461539	1	0.0450581395348837	16	43
CNDP1	8	25	6	4	489.06	978.12	15	2	0.0548537839779023	-3.6875	1	-0.357575757575758	10	33
CNDP2	6	19	3	1	471.24	942.48	15	2	0.0760389036251105	-8.5	1	-0.51	4	25
CNGA3	6	35	2	9	724.68	1449.36	15	2	1	-0.296296296296296	1	-0.0354767184035477	11	41
CNGB3	10	29	3	1	719.4	1438.8	15	2	0.0753180455392594	-7.7	1	-0.493589743589744	4	39
CNIH4	0	4	0	2	115.83	231.66	15	2	1	NA	1	0	2	4
CNKSR2	6	40	3	5	1023.66	2047.32	15	2	0.118479488883532	-3	1	-0.244565217391304	8	46
CNKSR3	4	29	1	3	520.74	1041.48	15	2	0.455522749640397	-1.41666666666667	1	-0.128787878787879	4	33
CNMD	7	22	4	6	350.46	700.92	15	2	0.423806484003228	-1.0952380952381	1	-0.158620689655172	10	29
CNOT10	1	25	2	7	710.82	1421.64	15	2	0.155844155844156	-6.14285714285714	1	-0.183760683760684	9	26
CNOT11	0	19	0	7	426.69	853.38	15	2	1	NA	1	0	7	19
CNOT2	1	3	0	1	515.79	1031.58	15	2	1	1	1	0.25	1	4
CNOT4	9	17	1	3	815.76	1631.52	15	2	1	0.37037037037037	1	0.0961538461538461	4	26
CNP1	3	8	3	1	124.74	249.48	15	2	0.235164835164835	-7	1	-0.477272727272727	4	11
CNR1	1	11	0	3	513.81	1027.62	15	2	1	1	1	0.0833333333333333	3	12
CNRIP1	0	7	1	3	161.37	322.74	15	2	0.363636363636364	-Inf	1	-0.25	4	7
CNST	14	25	4	4	714.78	1429.56	15	2	0.691837270407563	-0.785714285714286	1	-0.141025641025641	8	39
CNTN1	5	29	3	3	998.91	1997.82	15	2	0.0818835029361345	-4.8	1	-0.352941176470588	6	34
CNTN5	11	12	2	0	272.58	545.16	15	2	0.48	-Inf	1	-0.521739130434783	2	23
CNTNAP2	4	12	0	0	314.82	629.64	15	2	1	NA	1	NA	0	16
COA5	2	1	1	1	75.24	150.48	15	2	1	0.5	1	0.166666666666667	2	3
COA6	3	2	0	0	79.2	158.4	15	2	1	NA	1	NA	0	5
COG3	2	41	6	2	817.74	1635.48	15	2	4.02488806472047e-05	-60.5	0.109446768699911	-0.703488372093023	8	43
COG5	8	29	7	4	713.13	1426.26	15	2	0.0218944455434271	-5.34375	1	-0.42014742014742	11	37
COG6	3	24	2	3	637.56	1275.12	15	2	0.163356109963451	-4.33333333333333	1	-0.288888888888889	5	27
COL10A1	4	31	0	5	671.22	1342.44	15	2	1	1	1	0.114285714285714	5	35
COL12A1	20	114	5	7	3056.46	6112.92	15	2	0.0336406460494494	-3.07142857142857	1	-0.267412935323383	12	134
COL14A1	29	70	12	5	1766.49	3532.98	15	2	0.00185857929436099	-4.79310344827586	0.878946390641932	-0.412953060011884	17	99
COL15A1	53	15	9	8	1279.41	2558.82	15	2	0.0638517137519468	0.681603773584906	1	0.25	17	68
COL19A1	22	15	2	2	471.24	942.48	15	2	1	0.318181818181818	1	0.0945945945945946	4	37
COL1A2	3	37	0	13	1350.36	2700.72	15	2	0.567147613762486	1	1	0.075	13	40
COL21A1	10	30	1	5	912.78	1825.56	15	2	1	0.4	1	0.0833333333333333	6	40
COL22A1	44	94	16	12	1716	3432	15	2	0.0167603733996585	-1.84848484848485	1	-0.252587991718426	28	138
COL28A1	47	41	7	8	1390.95	2781.9	15	2	0.78109061448527	0.236702127659574	1	0.0674242424242424	15	88
COL4A1	19	68	5	15	1748.34	3496.68	15	2	0.770291839459169	-0.192982456140351	1	-0.0316091954022988	20	87
COL4A2	31	78	10	18	1689.93	3379.86	15	2	0.491387524653307	-0.397849462365591	1	-0.0727391874180865	28	109
COL6A6	180	111	37	22	2462.79	4925.58	15	2	1	-0.0371212121212121	1	-0.00856194303686875	59	291
COL8A1	2	69	4	10	728.31	1456.62	15	2	0.00601945483192134	-12.8	1	-0.257545271629779	14	71
COL9A1	13	42	7	4	910.8	1821.6	15	2	0.0137278347547793	-4.65384615384615	1	-0.4	11	55
COLEC10	5	16	1	3	301.95	603.9	15	2	1	-0.0666666666666667	1	-0.0119047619047619	4	21
COLEC11	0	14	0	1	269.28	538.56	15	2	1	NA	1	0	1	14
COLEC12	9	33	3	6	785.07	1570.14	15	2	0.423653255721754	-0.833333333333333	1	-0.119047619047619	9	42
COLQ	4	21	5	3	448.47	896.94	15	2	0.020100681669091	-7.75	1	-0.465	8	25
COMMD1	7	6	6	5	195.03	390.06	15	2	1	-0.0285714285714285	1	-0.00699300699300698	11	13
COMMD6	5	15	3	3	189.75	379.5	15	2	0.330130738826391	-2	1	-0.25	6	20
COPG2	6	47	2	13	863.28	1726.56	15	2	1	-0.205128205128205	1	-0.020125786163522	15	53
COPS5	0	10	2	3	329.01	658.02	15	2	0.0952380952380952	-Inf	1	-0.4	5	10
COPS7A	0	4	0	0	273.24	546.48	15	2	1	NA	1	NA	0	4
COQ3	12	16	3	1	367.29	734.58	15	2	0.319243604004449	-3	1	-0.321428571428571	4	28
COQ8A	4	22	1	3	643.5	1287	15	2	0.538405400474366	-0.833333333333333	1	-0.0961538461538461	4	26
COX17	0	3	0	0	67.32	134.64	15	2	1	NA	1	NA	0	3
COX20	1	2	1	1	116.82	233.64	15	2	1	-1	1	-0.166666666666667	2	3
COX7A2	0	2	0	0	83.16	166.32	15	2	1	NA	1	NA	0	2
COX7A2L	0	3	0	1	115.83	231.66	15	2	1	NA	1	0	1	3
CPA1	11	26	4	4	412.17	824.34	15	2	0.409952587341607	-1.36363636363636	1	-0.202702702702703	8	37
CPA2	12	17	0	5	382.14	764.28	15	2	0.136622390891841	1	1	0.413793103448276	5	29
CPA5	10	27	6	11	415.8	831.6	15	2	0.540192649014186	-0.472727272727273	1	-0.082670906200318	17	37
CPA6	7	15	2	1	396.33	792.66	15	2	0.530434782608696	-3.28571428571429	1	-0.348484848484848	3	22
CPB2	9	15	3	2	418.77	837.54	15	2	0.622079070354932	-1.5	1	-0.225	5	24
CPED1	23	9	4	0	492.36	984.72	15	2	0.553093964858671	-Inf	1	-0.28125	4	32
CPM	21	27	5	8	439.23	878.46	15	2	1	0.196428571428571	1	0.0528846153846154	13	48
CPNE3	7	20	0	2	528.66	1057.32	15	2	1	1	1	0.259259259259259	2	27
CPNE8	4	18	1	1	567.27	1134.54	15	2	0.380434782608696	-3.5	1	-0.318181818181818	2	22
CPOX	0	15	1	2	335.61	671.22	15	2	0.166666666666667	-Inf	1	-0.333333333333333	3	15
CPQ	2	5	2	2	212.85	425.7	15	2	0.575757575757576	-1.5	1	-0.214285714285714	4	7
CPSF3	1	30	0	5	642.51	1285.02	15	2	1	1	1	0.032258064516129	5	31
CPSF6	7	14	0	3	563.31	1126.62	15	2	0.529644268774704	1	1	0.333333333333333	3	21
CRCBL	62	37	8	1	754.05	1508.1	15	2	0.155686290563919	-3.7741935483871	1	-0.262626262626263	9	99
CREB3L2	3	14	3	4	505.56	1011.12	15	2	0.306844185562721	-2.5	1	-0.252100840336134	7	17
CREB5	2	1	0	0	96.03	192.06	15	2	1	NA	1	NA	0	3
CREBL2	2	6	0	0	131.67	263.34	15	2	1	NA	1	NA	0	8
CREG1	3	9	0	2	194.04	388.08	15	2	1	1	1	0.25	2	12
CREG2	22	5	3	4	211.53	423.06	15	2	0.0612935941896225	0.829545454545455	1	0.386243386243386	7	27
CRELD2	4	12	1	0	341.55	683.1	15	2	0.294117647058824	-Inf	1	-0.75	1	16
CREM	7	11	0	1	381.15	762.3	15	2	1	1	1	0.388888888888889	1	18
CRH	1	0	2	0	177.21	354.42	15	2	1	NA	1	0	2	1
CRHR2	0	9	0	3	347.49	694.98	15	2	1	NA	1	0	3	9
CRIM1	3	33	1	2	876.15	1752.3	15	2	0.28383849436481	-4.5	1	-0.25	3	36
CRIPT	0	5	0	1	100.98	201.96	15	2	1	NA	1	0	1	5
CRISP2	17	8	0	0	256.41	512.82	15	2	1	NA	1	NA	0	25
CRISPLD1	9	18	0	0	485.43	970.86	15	2	1	NA	1	NA	0	27
CRLF2	11	9	0	1	374.22	748.44	15	2	0.476190476190476	1	1	0.55	1	20
CRNKL1	30	28	6	7	853.05	1706.1	15	2	0.766806928088708	0.2	1	0.0557029177718833	13	58
CROT	18	27	2	4	616.77	1233.54	15	2	1	0.25	1	0.0666666666666667	6	45
CRTAP	8	17	3	0	457.71	915.42	15	2	0.0503663003663004	-Inf	1	-0.68	3	25
CRY1	9	20	2	1	571.23	1142.46	15	2	0.266129032258064	-3.44444444444444	1	-0.35632183908046	3	29
CRYAA	1	7	3	1	172.26	344.52	15	2	0.0666666666666667	-20	1	-0.625	4	8
CRYBG3	175	95	28	12	2551.23	5102.46	15	2	0.595302934666663	-0.266666666666667	1	-0.0518518518518518	40	270
CRYGN	9	13	6	2	327.69	655.38	15	2	0.214759287023155	-3.33333333333333	1	-0.340909090909091	8	22
CRYL1	7	15	2	3	316.8	633.6	15	2	1	-0.428571428571429	1	-0.0818181818181818	5	22
CRYZL1	4	8	3	4	297.99	595.98	15	2	1	-0.5	1	-0.0952380952380952	7	12
CSDC2	0	5	0	1	133.32	266.64	15	2	1	NA	1	0	1	5
CSF2RA	39	15	2	2	399.96	799.92	15	2	0.572866335116789	0.615384615384615	1	0.222222222222222	4	54
CSF2RB	37	32	9	6	619.74	1239.48	15	2	0.77765902860216	-0.297297297297297	1	-0.0637681159420289	15	69
CSMD1	24	62	3	3	1683.66	3367.32	15	2	0.353977760864205	-1.58333333333333	1	-0.22093023255814	6	86
CSMD3	10	62	4	8	1818.96	3637.92	15	2	0.108749163552409	-2.1	1	-0.194444444444444	12	72
CSNK1E	0	19	0	7	412.83	825.66	15	2	1	NA	1	0	7	19
CSPG5	1	1	1	1	53.13	106.26	15	2	1	0	1	0	2	2
CSPP1	28	53	10	3	1203.84	2407.68	15	2	0.00564513758949844	-5.30952380952381	1	-0.42355175688509	13	81
CSRNP1	18	38	6	4	565.29	1130.58	15	2	0.151206202125055	-2.16666666666667	1	-0.278571428571429	10	56
CSRP2	0	11	0	6	193.05	386.1	15	2	1	NA	1	0	6	11
CST3	15	8	1	2	138.6	277.2	15	2	0.538461538461539	0.733333333333333	1	0.318840579710145	3	23
CST7	6	9	0	4	146.52	293.04	15	2	0.255417956656347	1	1	0.4	4	15
CSTA-CSTB	2	0	0	0	31.68	63.36	15	2	1	NA	1	NA	0	2
CTC1	62	47	10	11	1272.15	2544.3	15	2	0.478446058145295	0.310850439882698	1	0.0926168632590652	21	109
CTDP1	17	36	4	6	835.23	1670.46	15	2	0.719251759736371	-0.411764705882353	1	-0.079245283018868	10	53
CTDSPL	4	2	1	0	327.69	655.38	15	2	1	-Inf	1	-0.333333333333333	1	6
CTGF	4	16	1	0	344.52	689.04	15	2	0.238095238095238	-Inf	1	-0.8	1	20
CTHRC1	1	13	0	2	245.52	491.04	15	2	1	1	1	0.0714285714285714	2	14
CTNNAL1	6	19	3	3	785.07	1570.14	15	2	0.320441516214597	-2.16666666666667	1	-0.26	6	25
CTNNB1	0	21	3	5	774.18	1548.36	15	2	0.0153256704980843	-Inf	1	-0.375	8	21
CTNND2	9	17	9	9	1249.05	2498.1	15	2	0.361268429674619	-0.888888888888889	1	-0.153846153846154	18	26
CTPS2	3	15	1	4	579.15	1158.3	15	2	1	-0.25	1	-0.0333333333333334	5	18
CTSB	1	22	1	6	337.59	675.18	15	2	0.418390804597701	-2.66666666666667	1	-0.0993788819875776	7	23
CTSC	8	31	0	3	426.36	852.72	15	2	1	1	1	0.205128205128205	3	39
CTSEAL	2	20	1	9	401.94	803.88	15	2	1	-0.111111111111111	1	-0.00909090909090909	10	22
CTTNBP2	16	28	3	4	1165.56	2331.12	15	2	1	-0.3125	1	-0.0649350649350649	7	44
CUBN	85	144	29	26	3676.53	7353.06	15	2	0.0458299398315538	-0.889592760180995	1	-0.156093687971417	55	229
CUL1	0	25	0	3	752.4	1504.8	15	2	1	NA	1	0	3	25
CUL2	2	17	1	0	704.88	1409.76	15	2	0.15	-Inf	1	-0.894736842105263	1	19
CUL4A	1	21	2	2	697.95	1395.9	15	2	0.0523076923076923	-20	1	-0.454545454545455	4	22
CUL5	0	13	0	6	773.19	1546.38	15	2	1	NA	1	0	6	13
CUL9	21	28	14	10	945.78	1891.56	15	2	0.318644552076154	-0.866666666666667	1	-0.154761904761905	24	49
CWC15	0	13	0	1	228.69	457.38	15	2	1	NA	1	0	1	13
CWF19L2	8	13	3	3	400.95	801.9	15	2	0.661835748792271	-0.625	1	-0.119047619047619	6	21
CX3CR1	14	17	0	1	351.45	702.9	15	2	1	1	1	0.451612903225806	1	31
CXADR	5	7	1	1	311.85	623.7	15	2	1	-0.4	1	-0.0833333333333333	2	12
CXorf21	12	17	2	0	289.08	578.16	15	2	0.195698924731183	-Inf	1	-0.586206896551724	2	29
CXorf23	11	28	1	10	713.79	1427.58	15	2	0.256712605164975	0.745454545454545	1	0.191142191142191	11	39
CYB5A	1	5	0	3	138.6	277.2	15	2	1	1	1	0.166666666666667	3	6
CYB5R3	7	18	0	0	292.71	585.42	15	2	1	NA	1	NA	0	25
CYBB	8	26	1	5	565.29	1130.58	15	2	1	0.35	1	0.0686274509803922	6	34
CYCS	0	7	0	5	104.94	209.88	15	2	1	NA	1	0	5	7
CYFIP1	1	68	0	7	1241.46	2482.92	15	2	1	1	1	0.0144927536231884	7	69
CYP1B1	4	13	0	3	480.81	961.62	15	2	1	1	1	0.235294117647059	3	17
CYP2AC1-CYP2AC2	28	31	3	0	925.65	1851.3	15	2	0.237704918032787	-Inf	1	-0.525423728813559	3	59
CYP2D6	13	29	4	6	498.96	997.92	15	2	0.710956599281363	-0.487179487179487	1	-0.0904761904761905	10	42
CYP39A1	12	15	0	1	489.06	978.12	15	2	1	1	1	0.444444444444444	1	27
CYP51A1	61	57	7	8	1303.83	2607.66	15	2	0.788034153812451	0.182377049180328	1	0.0502824858757062	15	118
CYP7A1	11	21	0	2	507.87	1015.74	15	2	1	1	1	0.34375	2	32
CYP8B1	31	55	20	21	874.17	1748.34	15	2	0.181556272262422	-0.689708141321045	1	-0.127339761769711	41	86
CYSLTR1	0	10	1	2	342.54	685.08	15	2	0.230769230769231	-Inf	1	-0.333333333333333	3	10
CYSLTR2	8	14	2	4	307.89	615.78	15	2	1	0.125	1	0.0303030303030303	6	22
CYTH4	7	14	0	4	461.34	922.68	15	2	0.294466403162055	1	1	0.333333333333333	4	21
CYYR1	4	3	0	0	128.7	257.4	15	2	1	NA	1	NA	0	7
DAAM2	22	39	4	4	1181.73	2363.46	15	2	0.463717371894804	-0.772727272727273	1	-0.139344262295082	8	61
DACH1	31	16	0	1	506.88	1013.76	15	2	0.354166666666667	1	1	0.659574468085106	1	47
DACT2	27	32	2	5	811.8	1623.6	15	2	0.453159380281274	0.525925925925926	1	0.171912832929782	7	59
DAP	17	7	0	2	178.2	356.4	15	2	0.110769230769231	1	1	0.708333333333333	2	24
DAZL	4	11	0	5	287.1	574.2	15	2	0.530443756449948	1	1	0.266666666666667	5	15
DBF4	15	32	1	2	696.96	1393.92	15	2	1	-0.0666666666666667	1	-0.0141843971631205	3	47
DBX2	1	10	0	3	328.02	656.04	15	2	1	1	1	0.0909090909090909	3	11
DCAF13	12	21	4	6	475.86	951.72	15	2	1	-0.166666666666667	1	-0.0363636363636364	10	33
DCAF6	11	28	2	4	866.91	1733.82	15	2	1	-0.272727272727273	1	-0.0512820512820513	6	39
DCBLD1	9	28	6	6	761.31	1522.62	15	2	0.148397995944314	-2.11111111111111	1	-0.256756756756757	12	37
DCBLD2	6	36	2	8	678.15	1356.3	15	2	0.641502188294374	-0.5	1	-0.0571428571428572	10	42
DCDC2	6	11	5	3	316.14	632.28	15	2	0.389168573607933	-2.05555555555556	1	-0.272058823529412	8	17
DCLK1	3	22	0	2	784.08	1568.16	15	2	1	1	1	0.12	2	25
DCLK3	50	38	4	2	819.06	1638.12	15	2	1	-0.52	1	-0.0984848484848484	6	88
DCLRE1C	4	18	7	3	454.74	909.48	15	2	0.0128259691494203	-9.5	1	-0.518181818181818	10	22
DCN	9	17	3	1	403.92	807.84	15	2	0.274220032840722	-4.66666666666667	1	-0.403846153846154	4	26
DCP1B	10	20	7	5	632.94	1265.88	15	2	0.174386308946746	-1.8	1	-0.25	12	30
DCSTAMP	14	22	2	3	471.57	943.14	15	2	1	-0.0476190476190477	1	-0.0111111111111111	5	36
DCT	19	24	7	3	587.4	1174.8	15	2	0.175080710726683	-1.94736842105263	1	-0.258139534883721	10	43
DCUN1D1-DCUN1D2	2	8	0	1	257.4	514.8	15	2	1	1	1	0.2	1	10
DCUN1D5	2	8	0	1	237.6	475.2	15	2	1	1	1	0.2	1	10
DDIAS	81	24	58	28	961.62	1923.24	15	2	0.144582780019295	0.386243386243386	1	0.0970099667774087	86	105
DDO	10	17	8	5	338.58	677.16	15	2	0.185392177494514	-1.72	1	-0.245014245014245	13	27
DDX10	13	34	3	4	653.4	1306.8	15	2	0.410482180293501	-0.961538461538461	1	-0.151975683890577	7	47
DDX11	14	50	11	9	882.42	1764.84	15	2	0.00999074146324687	-3.36507936507936	1	-0.33125	20	64
DDX17	0	18	2	5	581.79	1163.58	15	2	0.0700000000000001	-Inf	1	-0.285714285714286	7	18
DDX3X	2	27	0	5	639.87	1279.74	15	2	1	1	1	0.0689655172413793	5	29
DDX43	26	26	6	1	655.38	1310.76	15	2	0.111955011059874	-5	1	-0.357142857142857	7	52
DDX47	3	20	5	1	449.46	898.92	15	2	0.00253463012083701	-32.3333333333333	0.978194853943075	-0.702898550724638	6	23
DEGS1	1	25	1	4	320.76	641.52	15	2	0.301075268817204	-5.25	1	-0.161538461538462	5	26
DEK	6	12	1	1	369.27	738.54	15	2	1	-1	1	-0.166666666666667	2	18
DENND2A	7	27	4	7	1078.11	2156.22	15	2	0.420665270084621	-1.20408163265306	1	-0.157754010695187	11	34
DENND3	23	56	5	7	1258.29	2516.58	15	2	0.502910477450826	-0.739130434782609	1	-0.125527426160338	12	79
DENND5B	2	49	3	16	1230.57	2461.14	15	2	0.119373488289776	-3.59375	1	-0.118679050567595	19	51
DENND6B	3	32	3	3	521.73	1043.46	15	2	0.0311441094496293	-9.66666666666667	1	-0.414285714285714	6	35
DEPDC6	6	11	2	2	369.27	738.54	15	2	0.617710944026733	-0.833333333333333	1	-0.147058823529412	4	17
DERA	2	5	0	1	105.6	211.2	15	2	1	1	1	0.285714285714286	1	7
DERL1	1	8	0	1	249.48	498.96	15	2	1	1	1	0.111111111111111	1	9
DESI1	0	5	0	0	155.76	311.52	15	2	1	NA	1	NA	0	5
DESI2	0	7	2	3	192.06	384.12	15	2	0.151515151515152	-Inf	1	-0.4	5	7
DEUP1	43	26	7	5	668.25	1336.5	15	2	1	0.153488372093023	1	0.0398550724637681	12	69
DFNA5	23	25	21	7	590.04	1180.08	15	2	0.0300244589084531	-2.26086956521739	1	-0.270833333333333	28	48
DGAT2	3	8	0	3	355.41	710.82	15	2	1	1	1	0.272727272727273	3	11
DGKI	5	39	3	1	985.05	1970.1	15	2	0.0118717237126118	-22.4	1	-0.636363636363636	4	44
DHRS12	6	18	0	5	320.76	641.52	15	2	0.552608311229001	1	1	0.25	5	24
DHRSX	4	8	0	0	308.88	617.76	15	2	1	NA	1	NA	0	12
DHTKD1	20	44	5	6	914.43	1828.86	15	2	0.489946586832689	-0.833333333333333	1	-0.142045454545455	11	64
DHX30	3	54	1	15	1218.69	2437.38	15	2	1	-0.2	1	-0.00986842105263158	16	57
DHX57	10	61	10	11	1358.28	2716.56	15	2	0.00230615917643978	-4.54545454545455	0.978161257260591	-0.335345405767941	21	71
DIAPH3	13	22	1	1	643.5	1287	15	2	1	-0.692307692307692	1	-0.128571428571429	2	35
DIEXF	19	46	6	9	765.27	1530.54	15	2	0.537724753960716	-0.614035087719298	1	-0.107692307692308	15	65
DIP2C	20	43	2	1	1703.46	3406.92	15	2	0.255769230769231	-3.3	1	-0.349206349206349	3	63
DIS3	8	22	2	1	557.7	1115.4	15	2	0.211693548387097	-4.5	1	-0.4	3	30
DISC1	27	30	11	2	710.16	1420.32	15	2	0.0280782793904008	-5.11111111111111	1	-0.37246963562753	13	57
DISP1	17	38	7	9	1362.24	2724.48	15	2	0.377659102051967	-0.738562091503268	1	-0.128409090909091	16	55
DLD	2	16	0	2	503.91	1007.82	15	2	1	1	1	0.111111111111111	2	18
DLEC1	79	78	22	9	1651.98	3303.96	15	2	0.0478626204454261	-1.41350210970464	1	-0.206492705979043	31	157
DLEU7	18	12	3	1	227.7	455.4	15	2	1	-1	1	-0.15	4	30
DLG2	10	11	1	1	473.55	947.1	15	2	1	-0.1	1	-0.0238095238095238	2	21
DLG2-DLG3	0	12	0	0	344.52	689.04	15	2	1	NA	1	NA	0	12
DLGAP1L	2	4	0	1	461.34	922.68	15	2	1	1	1	0.333333333333333	1	6
DLGAP2	2	21	2	4	683.1	1366.2	15	2	0.179781903919835	-4.25	1	-0.246376811594203	6	23
DLK2	5	25	5	7	393.03	786.06	15	2	0.116667448993961	-2.57142857142857	1	-0.25	12	30
DLL1	2	23	1	6	721.71	1443.42	15	2	0.536290322580645	-0.916666666666667	1	-0.0628571428571428	7	25
DLX5	1	2	0	1	170.94	341.88	15	2	1	1	1	0.333333333333333	1	3
DLX6	0	1	2	0	256.74	513.48	15	2	0.333333333333333	-Inf	1	-1	2	1
DMC1	2	22	1	4	339.57	679.14	15	2	0.446086480569239	-1.75	1	-0.116666666666667	5	24
DMD	32	62	10	9	1642.41	3284.82	15	2	0.191918814570848	-1.15277777777778	1	-0.185890257558791	19	94
DMTF1	4	27	4	2	760.32	1520.64	15	2	0.0129353952883365	-12.5	1	-0.537634408602151	6	31
DNAH14	20	18	4	0	335.61	671.22	15	2	0.122272849102117	-Inf	1	-0.473684210526316	4	38
DNAH5	83	167	21	27	4557.96	9115.92	15	2	0.186415125617768	-0.564926372155288	1	-0.1055	48	250
DNAH5L	84	150	25	21	4580.73	9161.46	15	2	0.0213099367236604	-1.12585034013605	1	-0.184503901895206	46	234
DNAH8	63	144	7	16	4532.55	9065.1	15	2	1	0	1	0	23	207
DNAJB13	23	18	1	7	296.01	592.02	15	2	0.0487971536957188	0.888198757763975	1	0.435975609756098	8	41
DNAJB6	3	12	2	3	321.75	643.5	15	2	0.559791021671827	-1.66666666666667	1	-0.2	5	15
DNAJB9	3	6	0	2	213.84	427.68	15	2	1	1	1	0.333333333333333	2	9
DNAJC1	21	21	8	4	537.57	1075.14	15	2	0.346555946139344	-1	1	-0.166666666666667	12	42
DNAJC13	6	78	6	18	2218.59	4437.18	15	2	0.0240069320877168	-3.33333333333333	1	-0.178571428571429	24	84
DNAJC15	8	10	1	2	147.51	295.02	15	2	1	0.375	1	0.111111111111111	3	18
DNAJC2	0	23	1	2	613.8	1227.6	15	2	0.115384615384615	-Inf	1	-0.333333333333333	3	23
DNAJC27	6	10	1	9	271.26	542.52	15	2	0.190392216479173	0.814814814814815	1	0.275	10	16
DNAJC28	2	14	6	3	355.41	710.82	15	2	0.00986061992926982	-13	1	-0.541666666666667	9	16
DNAJC3	6	22	1	4	499.95	999.9	15	2	1	0.0833333333333334	1	0.0142857142857143	5	28
DNAJC5B	6	10	3	2	228.69	457.38	15	2	0.610791685095091	-1.5	1	-0.225	5	16
DNAL4	0	9	0	2	105.93	211.86	15	2	1	NA	1	0	2	9
DNM1L	4	15	0	3	632.28	1264.56	15	2	1	1	1	0.210526315789474	3	19
DNMT3A	7	20	2	23	824.34	1648.68	15	2	0.143125335240479	0.751552795031056	1	0.179259259259259	25	27
DOCK4	4	49	3	8	2005.74	4011.48	15	2	0.0912857033192077	-3.59375	1	-0.197255574614065	11	53
DOCK9	19	69	3	9	2306.7	4613.4	15	2	0.723281452370161	-0.210526315789474	1	-0.0340909090909091	12	88
DONSON	25	40	5	5	555.39	1110.78	15	2	0.508455379010109	-0.6	1	-0.115384615384615	10	65
DOPEY1	10	97	8	14	2424.51	4849.02	15	2	0.00300634819033483	-4.54285714285714	0.991296422875371	-0.27017841971113	22	107
DPH3	0	2	0	2	61.71	123.42	15	2	1	NA	1	0	2	2
DPP6	7	28	2	3	851.73	1703.46	15	2	0.311412627202101	-1.66666666666667	1	-0.2	5	35
DPT	2	10	1	0	198	396	15	2	0.230769230769231	-Inf	1	-0.833333333333333	1	12
DPY19L1	19	25	2	1	765.6	1531.2	15	2	0.579093432007401	-1.63157894736842	1	-0.234848484848485	3	44
DPY19L4	2	20	0	3	670.56	1341.12	15	2	1	1	1	0.0909090909090909	3	22
DPYS	16	25	1	3	591.36	1182.72	15	2	1	0.479166666666667	1	0.140243902439024	4	41
DRAM1	4	4	1	1	224.4	448.8	15	2	1	0	1	0	2	8
DRC1	62	49	5	11	755.7	1511.4	15	2	0.1060234374764	0.640762463343108	1	0.246058558558559	16	111
DRD3	10	16	3	2	452.76	905.52	15	2	0.625403887917792	-1.4	1	-0.215384615384615	5	26
DROSHA	0	24	0	0	476.19	952.38	15	2	1	NA	1	NA	0	24
DSC1	18	31	2	3	874.17	1748.34	15	2	1	-0.148148148148148	1	-0.0326530612244898	5	49
DSCAM	7	73	3	6	1832.82	3665.64	15	2	0.0605449324536334	-4.21428571428571	1	-0.245833333333333	9	80
DSCR3	1	14	0	2	295.02	590.04	15	2	1	1	1	0.0666666666666667	2	15
DSE	11	45	2	6	950.4	1900.8	15	2	0.659959315826448	-0.363636363636364	1	-0.0535714285714286	8	56
DSG2	70	62	8	8	1181.07	2362.14	15	2	1	0.114285714285714	1	0.0303030303030303	16	132
DSG4	24	44	1	2	1118.37	2236.74	15	2	1	0.0833333333333334	1	0.0196078431372549	3	68
DSP	5	100	3	13	2789.82	5579.64	15	2	0.0707282913861888	-3.61538461538461	1	-0.139880952380952	16	105
DST	280	320	43	49	10074.9	20149.8	15	2	1	-0.00291545189504383	1	-0.000724637681159435	92	600
DSTN	11	3	0	0	196.02	392.04	15	2	1	NA	1	NA	0	14
DTD1	0	5	0	2	154.44	308.88	15	2	1	NA	1	0	2	5
DTL	14	48	7	8	719.73	1439.46	15	2	0.102481975843305	-2	1	-0.240860215053763	15	62
DTNA	0	24	0	4	815.76	1631.52	15	2	1	NA	1	0	4	24
DTNB	1	2	2	5	130.68	261.36	15	2	1	0.2	1	0.0476190476190476	7	3
DTNBP1	19	16	0	0	256.41	512.82	15	2	1	NA	1	NA	0	35
DUS4L	2	16	3	4	313.83	627.66	15	2	0.113043478260869	-5	1	-0.317460317460317	7	18
DUSP10	3	12	2	5	475.2	950.4	15	2	1	-0.6	1	-0.0857142857142857	7	15
DUSP12	9	15	1	2	306.9	613.8	15	2	1	0.166666666666667	1	0.0416666666666667	3	24
DUSP16	13	26	2	0	547.47	1094.94	15	2	0.128048780487805	-Inf	1	-0.666666666666667	2	39
DUSP27	28	35	10	12	1150.38	2300.76	15	2	1	-0.0416666666666667	1	-0.0101010101010101	22	63
DYNC1I1	1	11	0	2	473.22	946.44	15	2	1	1	1	0.0833333333333333	2	12
DYNC1LI1	5	14	0	5	525.69	1051.38	15	2	0.544042913608131	1	1	0.263157894736842	5	19
DYNC2H1	76	135	19	13	4239.51	8479.02	15	2	0.0185044590882188	-1.59615384615385	1	-0.233560426540284	32	211
DYNLT1	0	4	0	1	112.86	225.72	15	2	1	NA	1	0	1	4
DYNLT3	1	1	0	0	108.57	217.14	15	2	1	NA	1	NA	0	2
DYRK1A	0	10	3	4	774.84	1549.68	15	2	0.0514705882352941	-Inf	1	-0.428571428571429	7	10
DYRK2	1	6	2	6	588.72	1177.44	15	2	1	-1	1	-0.107142857142857	8	7
DZANK1	28	31	7	8	769.23	1538.46	15	2	1	0.03125	1	0.00790960451977402	15	59
DZIP1	31	35	10	4	832.59	1665.18	15	2	0.141540650796255	-1.82258064516129	1	-0.244588744588745	14	66
E2F3	6	10	1	1	379.83	759.66	15	2	1	-0.666666666666667	1	-0.125	2	16
E2F5	1	13	1	3	347.49	694.98	15	2	0.405228758169935	-3.33333333333333	1	-0.178571428571429	4	14
E2F7	22	43	2	7	894.96	1789.92	15	2	0.70899773919608	0.441558441558442	1	0.116239316239316	9	65
EAF1	0	6	0	1	247.83	495.66	15	2	1	NA	1	0	1	6
ECHDC1	7	20	5	3	326.7	653.4	15	2	0.0911559061889494	-3.76190476190476	1	-0.365740740740741	8	27
ECHDC3	7	12	1	2	290.07	580.14	15	2	1	0.142857142857143	1	0.0350877192982456	3	19
ECI2	7	17	4	6	389.07	778.14	15	2	0.691516214597416	-0.619047619047619	1	-0.108333333333333	10	24
EDA	2	11	1	2	260.37	520.74	15	2	0.489285714285714	-1.75	1	-0.179487179487179	3	13
EDA2R	16	25	6	6	502.92	1005.84	15	2	0.52413314624579	-0.5625	1	-0.109756097560976	12	41
EDAR	1	17	0	5	464.31	928.62	15	2	1	1	1	0.0555555555555556	5	18
EDN1	17	14	0	0	201.96	403.92	15	2	1	NA	1	NA	0	31
EDNRB	5	27	0	1	402.93	805.86	15	2	1	1	1	0.15625	1	32
EED	5	24	0	6	439.56	879.12	15	2	0.561022942901501	1	1	0.172413793103448	6	29
EEF1A1	1	14	0	2	344.19	688.38	15	2	1	1	1	0.0666666666666667	2	15
EEF1AKMT1	3	14	0	4	211.86	423.72	15	2	1	1	1	0.176470588235294	4	17
EEF1E1	3	3	0	0	185.46	370.92	15	2	1	NA	1	NA	0	6
EEPD1	14	47	2	8	569.25	1138.5	15	2	1	0.160714285714286	1	0.0295081967213115	10	61
EFCAB1	4	6	1	2	206.91	413.82	15	2	1	0.25	1	0.0666666666666667	3	10
EFCAB10	7	7	3	2	127.71	255.42	15	2	1	-0.5	1	-0.1	5	14
EFCAB2	2	6	0	1	168.3	336.6	15	2	1	1	1	0.25	1	8
EFEMP1	1	12	0	1	447.48	894.96	15	2	1	1	1	0.0769230769230769	1	13
EFHB	26	25	6	0	685.41	1370.82	15	2	0.0298524161483447	-Inf	1	-0.490196078431373	6	51
EFHC1	14	21	5	2	636.57	1273.14	15	2	0.21422595203083	-2.75	1	-0.314285714285714	7	35
EFHC2	19	25	4	5	821.7	1643.4	15	2	1	-0.0526315789473684	1	-0.0126262626262626	9	44
EFNB1	1	2	4	5	293.37	586.74	15	2	1	-0.6	1	-0.111111111111111	9	3
EFNB2	1	11	0	1	330.66	661.32	15	2	1	1	1	0.0833333333333333	1	12
EFR3A	1	25	2	2	838.53	1677.06	15	2	0.0394088669950739	-24	1	-0.461538461538462	4	26
EFR3B	9	46	4	11	838.53	1677.06	15	2	0.454939328711403	-0.858585858585859	1	-0.103030303030303	15	55
EGFL6	12	17	1	0	353.43	706.86	15	2	0.433333333333333	-Inf	1	-0.586206896551724	1	29
EGLN1	0	1	0	1	223.74	447.48	15	2	1	NA	1	0	1	1
EHBP1	23	35	8	16	1301.85	2603.7	15	2	0.626879241594482	0.239130434782609	1	0.0632183908045977	24	58
EHD3	1	19	1	2	530.64	1061.28	15	2	0.24901185770751	-8.5	1	-0.283333333333333	3	20
EIF1AY	0	5	0	1	143.55	287.1	15	2	1	NA	1	0	1	5
EIF2AK2	58	25	4	6	518.76	1037.52	15	2	0.0784600765160216	0.71264367816092	1	0.298795180722892	10	83
EIF2S3	2	20	0	0	457.38	914.76	15	2	1	NA	1	NA	0	22
EIF3D	5	81	8	15	1029.6	2059.2	15	2	0.000809753160890912	-7.64	0.629120366500747	-0.289686552072801	23	86
EIF3E	0	18	0	3	441.54	883.08	15	2	1	NA	1	0	3	18
EIF3H	3	8	1	2	272.25	544.5	15	2	1	-0.333333333333333	1	-0.0606060606060606	3	11
EIF3L	0	25	0	8	559.35	1118.7	15	2	1	NA	1	0	8	25
EIF4A3	0	18	0	5	408.87	817.74	15	2	1	NA	1	0	5	18
EIF5B	8	53	3	9	1170.51	2341.02	15	2	0.374263290543608	-1.20833333333333	1	-0.118852459016393	12	61
ELF1	4	21	2	4	617.76	1235.52	15	2	0.567040301189356	-1.625	1	-0.173333333333333	6	25
ELFN2	0	25	3	9	800.91	1601.82	15	2	0.0283140283140283	-Inf	1	-0.25	12	25
ELK3	7	9	0	4	403.92	807.84	15	2	0.248710010319918	1	1	0.4375	4	16
ELMO1	3	11	1	0	293.04	586.08	15	2	0.266666666666667	-Inf	1	-0.785714285714286	1	14
ELMOD1	1	14	0	3	323.73	647.46	15	2	1	1	1	0.0666666666666667	3	15
ELOVL2	7	8	2	2	294.03	588.06	15	2	1	-0.142857142857143	1	-0.0333333333333333	4	15
ELOVL4	0	6	1	0	291.06	582.12	15	2	0.142857142857143	-Inf	1	-1	1	6
ELOVL5	0	10	0	1	293.04	586.08	15	2	1	NA	1	0	1	10
ELP2	20	30	9	4	818.73	1637.46	15	2	0.0705494988815441	-2.375	1	-0.292307692307692	13	50
ELP3	11	43	4	8	611.49	1222.98	15	2	0.446276945061767	-0.954545454545455	1	-0.12962962962963	12	54
EMC2	1	7	0	2	295.02	590.04	15	2	1	1	1	0.125	2	8
EMG1	1	8	2	2	227.37	454.74	15	2	0.202797202797203	-7	1	-0.388888888888889	4	9
EMILIN2	15	40	4	9	1081.74	2163.48	15	2	1	-0.185185185185185	1	-0.034965034965035	13	55
EML4	9	32	2	5	925.65	1851.3	15	2	0.652683059756614	-0.422222222222222	1	-0.0662020905923345	7	41
EML6	4	57	1	7	2031.81	4063.62	15	2	0.47064642804613	-1.03571428571429	1	-0.0594262295081967	8	61
EMP1	9	7	0	0	160.38	320.76	15	2	1	NA	1	NA	0	16
EMSY	14	46	3	6	1273.14	2546.28	15	2	0.678947696974959	-0.642857142857143	1	-0.1	9	60
EN2	0	4	0	1	241.89	483.78	15	2	1	NA	1	0	1	4
ENAH	3	23	1	4	779.13	1558.26	15	2	0.524868901954553	-0.916666666666667	1	-0.0846153846153846	5	26
ENDOD1	18	30	6	9	488.07	976.14	15	2	1	-0.111111111111111	1	-0.025	15	48
ENKUR	3	6	2	0	229.02	458.04	15	2	0.181818181818182	-Inf	1	-0.666666666666667	2	9
ENO2	2	18	0	1	430.65	861.3	15	2	1	1	1	0.1	1	20
ENOX1	3	18	1	4	462	924	15	2	1	-0.5	1	-0.0571428571428572	5	21
ENPP1	22	30	0	2	873.51	1747.02	15	2	0.508036338225017	1	1	0.423076923076923	2	52
ENPP2	5	25	2	2	852.39	1704.78	15	2	0.180071588752803	-4	1	-0.333333333333333	4	30
ENPP3	22	33	5	6	878.13	1756.26	15	2	0.748682833983273	-0.25	1	-0.0545454545454545	11	55
ENPP4	12	26	0	1	447.48	894.96	15	2	1	1	1	0.315789473684211	1	38
ENTPD3	16	28	4	6	506.88	1013.76	15	2	1	-0.166666666666667	1	-0.0363636363636364	10	44
ENTPD6	9	16	4	4	438.57	877.14	15	2	0.680632801878631	-0.777777777777778	1	-0.14	8	25
ENY2	0	3	0	0	96.03	192.06	15	2	1	NA	1	NA	0	3
EP300	5	81	2	20	2448.93	4897.86	15	2	0.629045269033165	-0.62	1	-0.03276955602537	22	86
EPAS1	8	26	5	3	868.23	1736.46	15	2	0.0825432070618207	-4.41666666666667	1	-0.389705882352941	8	34
EPB41L2	21	33	4	7	1001.88	2003.76	15	2	1	0.102040816326531	1	0.0252525252525252	11	54
EPB41L3	18	43	5	7	1349.37	2698.74	15	2	0.500087097679149	-0.706349206349206	1	-0.121584699453552	12	61
EPCAM	15	17	11	8	303.93	607.86	15	2	0.565303853216312	-0.558333333333333	1	-0.110197368421053	19	32
EPDR1	6	8	0	0	206.91	413.82	15	2	1	NA	1	NA	0	14
EPHA1	6	37	4	7	962.28	1924.56	15	2	0.185331885786001	-2.52380952380952	1	-0.224101479915433	11	43
EPHA6	2	4	0	0	294.03	588.06	15	2	1	NA	1	NA	0	6
EPHA7	4	26	0	4	986.04	1972.08	15	2	1	1	1	0.133333333333333	4	30
EPHB6	35	53	12	9	1157.64	2315.28	15	2	0.219657320513191	-1.01904761904762	1	-0.173701298701299	21	88
EPHX1	6	10	4	1	460.35	920.7	15	2	0.148606811145511	-5.66666666666667	1	-0.425	5	16
EPHX1L	17	17	10	6	482.13	964.26	15	2	0.545555884221153	-0.666666666666667	1	-0.125	16	34
EPM2A	5	12	4	5	316.8	633.6	15	2	0.667285209070106	-0.92	1	-0.150326797385621	9	17
EPPKL	25	52	15	13	924.33	1848.66	15	2	0.0686694721590536	-1.4	1	-0.211038961038961	28	77
EPRS	28	53	3	4	1662.21	3324.42	15	2	0.693304847088233	-0.419642857142857	1	-0.0828924162257496	7	81
EPS8	9	23	2	7	820.71	1641.42	15	2	1	0.26984126984127	1	0.0590277777777778	9	32
EPSTI1	9	9	1	0	215.82	431.64	15	2	1	-Inf	1	-0.5	1	18
EPT1L	3	15	1	2	385.11	770.22	15	2	0.488721804511278	-1.5	1	-0.166666666666667	3	18
ERC1	8	14	3	0	424.05	848.1	15	2	0.0717391304347827	-Inf	1	-0.636363636363636	3	22
ERCC5	44	37	4	4	1077.12	2154.24	15	2	1	0.159090909090909	1	0.0432098765432098	8	81
ERG	1	20	0	2	502.92	1005.84	15	2	1	1	1	0.0476190476190476	2	21
ERGIC2	0	14	0	3	374.22	748.44	15	2	1	NA	1	0	3	14
ERICH1	14	10	4	2	327.69	655.38	15	2	1	-0.428571428571429	1	-0.0833333333333333	6	24
ERICH5	8	10	7	4	207.9	415.8	15	2	0.449725137431284	-1.1875	1	-0.191919191919192	11	18
ERICH6B	40	16	10	8	603.9	1207.8	15	2	0.252531532363163	0.5	1	0.158730158730159	18	56
ERLEC1	0	17	0	1	453.75	907.5	15	2	1	NA	1	0	1	17
ERMARD	24	25	8	6	577.17	1154.34	15	2	0.763267769095728	-0.388888888888889	1	-0.0816326530612245	14	49
ERO1B	1	18	0	2	429.66	859.32	15	2	1	1	1	0.0526315789473684	2	19
ERP44	3	10	1	7	402.93	805.86	15	2	1	0.523809523809524	1	0.105769230769231	8	13
ES1ML1	6	13	0	2	223.74	447.48	15	2	1	1	1	0.315789473684211	2	19
ESCO1	24	42	7	13	1189.98	2379.96	15	2	1	0.0576923076923077	1	0.0136363636363637	20	66
ESCO2	56	50	3	16	473.22	946.44	15	2	0.00282888260946624	0.832589285714286	0.991296422875371	0.370407149950348	19	106
ESD	2	19	0	3	280.17	560.34	15	2	1	1	1	0.0952380952380952	3	21
ESF1	33	41	4	2	832.59	1665.18	15	2	0.407385985100842	-1.48484848484848	1	-0.220720720720721	6	74
ESR1	2	17	0	2	574.2	1148.4	15	2	1	1	1	0.105263157894737	2	19
ESRP1	2	22	5	12	597.96	1195.92	15	2	0.105438587595199	-3.58333333333333	1	-0.21078431372549	17	24
ESYT2	6	29	3	5	888.36	1776.72	15	2	0.332224805311947	-1.9	1	-0.203571428571429	8	35
ETAA1	39	35	12	4	902.22	1804.44	15	2	0.163290848644775	-1.69230769230769	1	-0.222972972972973	16	74
ETFBKMT	6	14	2	9	269.28	538.56	15	2	0.675719460369071	0.481481481481482	1	0.118181818181818	11	20
ETFRF1	2	2	0	0	85.14	170.28	15	2	1	NA	1	NA	0	4
ETNK1	3	8	1	2	360.36	720.72	15	2	1	-0.333333333333333	1	-0.0606060606060606	3	11
ETS2	2	32	1	2	475.2	950.4	15	2	0.22985842985843	-7	1	-0.274509803921569	3	34
ETV6	3	6	0	1	294.69	589.38	15	2	1	1	1	0.333333333333333	1	9
EVA1A	19	20	4	2	498.96	997.92	15	2	0.665154093401399	-1.10526315789474	1	-0.179487179487179	6	39
EVA1C	5	17	7	3	324.72	649.44	15	2	0.0183864643360702	-6.93333333333333	1	-0.472727272727273	10	22
EVX1	0	11	0	1	398.97	797.94	15	2	1	NA	1	0	1	11
EXO1	26	25	6	3	780.12	1560.24	15	2	0.482023371071223	-0.923076923076923	1	-0.156862745098039	9	51
EXOC3	5	27	1	4	738.54	1477.08	15	2	1	-0.35	1	-0.04375	5	32
EXOC4	12	37	5	13	942.48	1884.96	15	2	0.761655450689535	-0.185897435897436	1	-0.0328798185941043	18	49
EXOC8	2	24	3	6	702.9	1405.8	15	2	0.094574780058651	-5	1	-0.256410256410256	9	26
EXOG	3	16	3	1	360.36	720.72	15	2	0.0400903444381705	-15	1	-0.592105263157895	4	19
EXOSC7	12	8	5	0	358.38	716.76	15	2	0.139920948616601	-Inf	1	-0.4	5	20
EXOSC8	4	8	2	1	274.23	548.46	15	2	0.525274725274725	-3	1	-0.333333333333333	3	12
EXPH5	101	89	17	11	1969.11	3938.22	15	2	0.543999550703589	-0.361836183618362	1	-0.0755639097744361	28	190
EXT1	1	9	1	0	430.65	861.3	15	2	0.181818181818182	-Inf	1	-0.9	1	10
EXTL3	1	24	2	15	910.8	1821.6	15	2	0.555749128919861	-2.2	1	-0.0776470588235294	17	25
EYA4	5	16	1	1	619.08	1238.16	15	2	0.462450592885375	-2.2	1	-0.261904761904762	2	21
EYS	53	52	3	8	1104.84	2209.68	15	2	0.206802773423728	0.632075471698113	1	0.232034632034632	11	105
EZR	3	28	1	1	580.14	1160.28	15	2	0.231060606060606	-8.33333333333333	1	-0.403225806451613	2	31
F10	5	20	0	4	471.24	942.48	15	2	1	1	1	0.2	4	25
F5	65	72	11	15	2136.42	4272.84	15	2	0.673142873163238	0.187692307692308	1	0.0513756316676025	26	137
F7	6	12	2	2	422.73	845.46	15	2	0.601913875598086	-1	1	-0.166666666666667	4	18
FAAHL	14	26	5	3	605.88	1211.76	15	2	0.235824407683461	-2.0952380952381	1	-0.275	8	40
FABP7	1	3	0	0	131.67	263.34	15	2	1	NA	1	NA	0	4
FAM105A	10	16	2	1	367.29	734.58	15	2	0.553366174055829	-2.2	1	-0.282051282051282	3	26
FAM105B	13	15	1	2	324.72	649.44	15	2	1	0.423076923076923	1	0.130952380952381	3	28
FAM109B	3	4	4	9	256.41	512.82	15	2	0.651354489164087	0.407407407407407	1	0.120879120879121	13	7
FAM110B	0	8	1	6	367.29	734.58	15	2	0.466666666666667	-Inf	1	-0.142857142857143	7	8
FAM110C	11	22	4	4	363.33	726.66	15	2	0.43375150427933	-1	1	-0.166666666666667	8	33
FAM120B	16	25	3	4	681.12	1362.24	15	2	1	-0.171875	1	-0.0383275261324041	7	41
FAM124A	7	20	1	2	541.53	1083.06	15	2	1	-0.428571428571429	1	-0.0740740740740741	3	27
FAM126A	4	11	0	0	510.84	1021.68	15	2	1	NA	1	NA	0	15
FAM133B	3	10	3	0	215.82	431.64	15	2	0.0357142857142857	-Inf	1	-0.769230769230769	3	13
FAM134B	6	11	0	2	359.37	718.74	15	2	1	1	1	0.352941176470588	2	17
FAM135A	41	49	3	9	1527.24	3054.48	15	2	0.22423718239592	0.601626016260163	1	0.205555555555556	12	90
FAM135B	30	42	8	5	1186.02	2372.04	15	2	0.231784109104587	-1.24	1	-0.198717948717949	13	72
FAM160A2	10	45	6	13	1001.55	2003.1	15	2	0.331248969484996	-1.07692307692308	1	-0.133971291866029	19	55
FAM162A	3	5	1	2	147.51	295.02	15	2	1	0.166666666666667	1	0.0416666666666667	3	8
FAM162B	4	2	0	1	139.26	278.52	15	2	0.428571428571429	1	1	0.666666666666667	1	6
FAM167A	0	8	2	7	209.88	419.76	15	2	0.470588235294118	-Inf	1	-0.222222222222222	9	8
FAM168A	1	6	4	6	239.58	479.16	15	2	0.338235294117647	-3	1	-0.257142857142857	10	7
FAM171A1	7	26	4	7	905.19	1810.38	15	2	0.424712329959332	-1.12244897959184	1	-0.151515151515152	11	33
FAM172BP	21	17	2	1	362.34	724.68	15	2	1	-0.619047619047619	1	-0.114035087719298	3	38
FAM173B	12	17	4	2	220.77	441.54	15	2	0.379136992040218	-1.83333333333333	1	-0.252873563218391	6	29
FAM179A	69	54	8	6	1256.64	2513.28	15	2	1	-0.0434782608695652	1	-0.0104529616724738	14	123
FAM180A	2	5	0	1	164.34	328.68	15	2	1	1	1	0.285714285714286	1	7
FAM181B	9	9	1	6	266.97	533.94	15	2	0.179353026835864	0.833333333333333	1	0.357142857142857	7	18
FAM184A	2	30	0	1	677.49	1354.98	15	2	1	1	1	0.0625	1	32
FAM185A	4	4	1	1	204.93	409.86	15	2	1	0	1	0	2	8
FAM188A	8	4	2	1	409.53	819.06	15	2	1	0	1	0	3	12
FAM188B	19	21	7	4	805.86	1611.72	15	2	0.498556473554291	-0.934210526315789	1	-0.161363636363636	11	40
FAM198A	22	32	12	12	446.49	892.98	15	2	0.468971713872631	-0.454545454545455	1	-0.0925925925925926	24	54
FAM206A	3	5	1	1	172.26	344.52	15	2	1	-0.666666666666667	1	-0.125	2	8
FAM20CL	18	21	8	12	520.08	1040.16	15	2	0.78361011806193	0.222222222222222	1	0.0615384615384615	20	39
FAM210A	6	18	3	3	273.24	546.48	15	2	0.328700265251989	-2	1	-0.25	6	24
FAM221A	11	15	3	2	294.03	588.06	15	2	0.635809335475631	-1.04545454545455	1	-0.176923076923077	5	26
FAM228	18	14	2	2	282.15	564.3	15	2	1	0.222222222222222	1	0.0625	4	32
FAM234B	10	17	3	5	617.76	1235.52	15	2	1	-0.02	1	-0.00462962962962965	8	27
FAM26D	2	26	1	3	315.81	631.62	15	2	0.339516129032258	-3.33333333333333	1	-0.178571428571429	4	28
FAM26E	5	14	2	1	306.9	613.8	15	2	0.227272727272727	-4.6	1	-0.403508771929825	3	19
FAM26F	27	15	2	1	307.89	615.78	15	2	1	-0.111111111111111	1	-0.0238095238095237	3	42
FAM3B	14	4	1	1	233.64	467.28	15	2	0.447368421052631	0.714285714285714	1	0.277777777777778	2	18
FAM3C	2	7	0	0	225.72	451.44	15	2	1	NA	1	NA	0	9
FAM46A	0	12	1	7	400.95	801.9	15	2	0.4	-Inf	1	-0.125	8	12
FAM46C	0	21	1	6	387.09	774.18	15	2	0.25	-Inf	1	-0.142857142857143	7	21
FAM46D	2	15	2	1	388.08	776.16	15	2	0.087719298245614	-14	1	-0.549019607843137	3	17
FAM49A	4	12	0	0	337.59	675.18	15	2	1	NA	1	NA	0	16
FAM49B	1	6	0	4	321.75	643.5	15	2	1	1	1	0.142857142857143	4	7
FAM65B	13	35	8	10	1017.06	2034.12	15	2	0.237070096528269	-1.15384615384615	1	-0.173611111111111	18	48
FAM69C	4	10	3	4	411.84	823.68	15	2	0.63844169246646	-0.875	1	-0.142857142857143	7	14
FAM76B	0	12	1	3	340.56	681.12	15	2	0.25	-Inf	1	-0.25	4	12
FAM83A	7	27	4	8	466.29	932.58	15	2	0.441101195750217	-0.928571428571429	1	-0.127450980392157	12	34
FAM83B	13	19	3	7	1057.65	2115.3	15	2	0.715232864821327	0.373626373626374	1	0.10625	10	32
FAM83F	8	16	1	3	502.92	1005.84	15	2	1	0.333333333333333	1	0.0833333333333333	4	24
FAM83H	9	30	1	4	1121.67	2243.34	15	2	1	0.166666666666667	1	0.0307692307692308	5	39
FAM84B	1	18	1	0	297.99	595.98	15	2	0.1	-Inf	1	-0.947368421052632	1	19
FAM89A	13	6	4	3	136.62	273.24	15	2	0.661343873517787	0.384615384615385	1	0.112781954887218	7	19
FAM91A1	1	40	2	7	835.56	1671.12	15	2	0.0795918367346939	-10.4285714285714	1	-0.197831978319783	9	41
FAM98A	3	22	1	2	539.55	1079.1	15	2	0.382173382173382	-2.66666666666667	1	-0.213333333333333	3	25
FANCB	39	35	12	7	809.82	1619.64	15	2	0.450551450055701	-0.538461538461539	1	-0.104551920341394	19	74
FANCD2OS	4	4	0	0	50.49	100.98	15	2	1	NA	1	NA	0	8
FANCL	9	19	1	1	370.26	740.52	15	2	1	-1.11111111111111	1	-0.178571428571429	2	28
FARP1	2	17	2	5	552.75	1105.5	15	2	0.287023411371238	-2.4	1	-0.180451127819549	7	19
FASTK	8	12	2	9	305.25	610.5	15	2	0.261717032302707	0.666666666666667	1	0.218181818181818	11	20
FASTKD3	35	28	6	6	650.1	1300.2	15	2	0.760535860572483	0.2	1	0.0555555555555556	12	63
FAXC	1	7	0	0	404.91	809.82	15	2	1	NA	1	NA	0	8
FBLN1	22	31	3	0	920.04	1840.08	15	2	0.082972582972583	-Inf	1	-0.584905660377358	3	53
FBLN7	8	28	4	9	444.51	889.02	15	2	0.708173768080606	-0.555555555555556	1	-0.0854700854700855	13	36
FBXL14	0	6	1	6	378.84	757.68	15	2	1	-Inf	1	-0.142857142857143	7	6
FBXL2	2	4	0	0	150.15	300.3	15	2	1	NA	1	NA	0	6
FBXL3	0	24	2	2	429.66	859.32	15	2	0.0158730158730159	-Inf	1	-0.5	4	24
FBXL4	3	16	2	4	561.33	1122.66	15	2	0.562281197063806	-1.66666666666667	1	-0.175438596491228	6	19
FBXL7	0	14	0	4	440.55	881.1	15	2	1	NA	1	0	4	14
FBXO15	16	18	6	2	514.8	1029.6	15	2	0.243091121139902	-2.375	1	-0.279411764705882	8	34
FBXO16	13	26	6	4	514.8	1029.6	15	2	0.156458780579343	-2	1	-0.266666666666667	10	39
FBXO18	14	8	1	4	124.74	249.48	15	2	0.138981791155704	0.857142857142857	1	0.436363636363636	5	22
FBXO25	3	10	1	1	357.39	714.78	15	2	0.476190476190476	-2.33333333333333	1	-0.269230769230769	2	13
FBXO28	1	13	1	2	347.49	694.98	15	2	0.330882352941176	-5.5	1	-0.261904761904762	3	14
FBXO30	8	26	4	3	751.41	1502.82	15	2	0.165406099295701	-3.33333333333333	1	-0.336134453781513	7	34
FBXO32	1	16	0	3	352.44	704.88	15	2	1	1	1	0.0588235294117647	3	17
FBXO43	36	41	9	3	658.35	1316.7	15	2	0.118427316052809	-2.41666666666667	1	-0.282467532467532	12	77
FBXO48	6	15	3	3	149.82	299.64	15	2	0.36734569778048	-1.5	1	-0.214285714285714	6	21
FBXO5	25	14	3	3	415.8	831.6	15	2	0.658124065384417	0.44	1	0.141025641025641	6	39
FBXO7	12	18	2	2	484.44	968.88	15	2	1	-0.5	1	-0.1	4	30
FBXO9	1	9	0	2	431.64	863.28	15	2	1	1	1	0.1	2	10
FDFT1	5	11	5	3	297	594	15	2	0.203795934849912	-2.66666666666667	1	-0.3125	8	16
FDX1	6	9	0	3	179.19	358.38	15	2	0.514705882352941	1	1	0.4	3	15
FDX1L	14	8	1	1	183.15	366.3	15	2	1	0.428571428571429	1	0.136363636363636	2	22
FER1L6	46	74	17	14	1960.86	3921.72	15	2	0.106381272261052	-0.953416149068323	1	-0.16505376344086	31	120
FERD3L	4	4	0	3	109.89	219.78	15	2	0.236363636363636	1	1	0.5	3	8
FERMT1	8	23	0	6	635.58	1271.16	15	2	0.305282555282555	1	1	0.258064516129032	6	31
FEZ2	0	13	3	1	370.26	740.52	15	2	0.00588235294117647	-Inf	1	-0.75	4	13
FEZF1	3	16	0	1	415.8	831.6	15	2	1	1	1	0.157894736842105	1	19
FGD4	16	31	4	3	893.64	1787.28	15	2	0.40295344068929	-1.58333333333333	1	-0.231003039513678	7	47
FGD6	32	45	3	6	1420.65	2841.3	15	2	0.732532220119797	0.296875	1	0.0822510822510823	9	77
FGF14	0	8	0	1	272.58	545.16	15	2	1	NA	1	0	1	8
FGF9	0	1	1	0	199.98	399.96	15	2	1	-Inf	1	-1	1	1
FGFR1OP	16	13	1	0	378.18	756.36	15	2	1	-Inf	1	-0.448275862068966	1	29
FGL1L	22	17	6	5	274.23	548.46	15	2	1	0.0727272727272728	1	0.0186480186480187	11	39
FGL2	5	16	2	4	438.57	877.14	15	2	0.633363737711564	-0.6	1	-0.0952380952380952	6	21
FH	0	25	0	2	462.33	924.66	15	2	1	NA	1	0	2	25
FHL2	2	8	2	2	277.2	554.4	15	2	0.520479520479521	-3	1	-0.3	4	10
FHL5	5	6	1	0	278.19	556.38	15	2	1	-Inf	1	-0.545454545454545	1	11
FHOD3	7	36	0	5	1187.67	2375.34	15	2	1	1	1	0.162790697674419	5	43
FIG4	1	31	1	3	900.9	1801.8	15	2	0.212698412698413	-9.33333333333333	1	-0.21875	4	32
FILIP1	6	33	1	7	1200.87	2401.74	15	2	1	0.214285714285714	1	0.0288461538461539	8	39
FILIP1L	4	12	2	0	227.7	455.4	15	2	0.0980392156862745	-Inf	1	-0.75	2	16
FKBP14	8	8	0	8	247.17	494.34	15	2	0.0222428892505619	1	1	0.5	8	16
FKBP1B	0	6	0	3	107.91	215.82	15	2	1	NA	1	0	3	6
FKBP4	3	12	1	0	445.5	891	15	2	0.25	-Inf	1	-0.8	1	15
FKBP9	7	29	2	3	579.15	1158.3	15	2	0.299416331508758	-1.76190476190476	1	-0.205555555555556	5	36
FLRT3	2	20	1	10	641.52	1283.04	15	2	1	0	1	0	11	22
FLT1	5	38	7	11	852.39	1704.78	15	2	0.0298574804719666	-3.83636363636364	1	-0.272609819121447	18	43
FLT3	26	37	5	9	956.34	1912.68	15	2	0.771281377391832	0.209401709401709	1	0.0555555555555555	14	63
FLVCR1	5	21	1	7	476.19	952.38	15	2	1	0.4	1	0.0673076923076923	8	26
FMC1	0	6	2	2	109.89	219.78	15	2	0.133333333333333	-Inf	1	-0.5	4	6
FNDC1	32	59	11	9	1595.88	3191.76	15	2	0.129216171891514	-1.25347222222222	1	-0.198351648351648	20	91
FNDC3A	12	37	6	4	1129.26	2258.52	15	2	0.0537693243095579	-3.625	1	-0.355102040816327	10	49
FNDC3AL	14	57	3	9	1180.08	2360.16	15	2	0.703737291299506	-0.357142857142857	1	-0.0528169014084507	12	71
FNDC4	4	6	1	2	226.71	453.42	15	2	1	0.25	1	0.0666666666666667	3	10
FOLH1	10	25	1	1	744.48	1488.96	15	2	0.512012012012012	-1.5	1	-0.214285714285714	2	35
FOSL2	0	6	0	2	320.76	641.52	15	2	1	NA	1	0	2	6
FOXA2	2	19	2	5	341.22	682.44	15	2	0.252991452991453	-2.8	1	-0.19047619047619	7	21
FOXJ2	2	12	0	2	540.21	1080.42	15	2	1	1	1	0.142857142857143	2	14
FOXM1	16	27	3	6	776.16	1552.32	15	2	1	0.15625	1	0.0387596899224806	9	43
FOXN2	0	12	2	2	433.62	867.24	15	2	0.05	-Inf	1	-0.5	4	12
FOXO1	1	7	1	3	446.49	892.98	15	2	1	-1.33333333333333	1	-0.125	4	8
FOXO3	3	15	1	7	490.05	980.1	15	2	1	0.285714285714286	1	0.0416666666666667	8	18
FOXP2	1	10	1	0	586.74	1173.48	15	2	0.166666666666667	-Inf	1	-0.909090909090909	1	11
FREM2	61	161	14	10	3193.74	6387.48	15	2	0.00396987264371699	-2.69508196721311	1	-0.308558558558559	24	222
FRK	17	26	1	4	525.69	1051.38	15	2	0.637225632831553	0.617647058823529	1	0.195348837209302	5	43
FRMD1	6	13	2	3	603.9	1207.8	15	2	1	-0.444444444444444	1	-0.0842105263157895	5	19
FRMD4A	0	33	2	3	1015.08	2030.16	15	2	0.0142247510668563	-Inf	1	-0.4	5	33
FRMPD4	20	36	4	6	1625.58	3251.16	15	2	1	-0.2	1	-0.0428571428571429	10	56
FRRS1L	0	14	0	5	212.52	425.04	15	2	1	NA	1	0	5	14
FRS2	0	10	0	3	503.91	1007.82	15	2	1	NA	1	0	3	10
FRY	9	106	1	27	2939.31	5878.62	15	2	0.686933984930986	0.563786008230453	1	0.0425465838509317	28	115
FSBP	4	9	0	0	296.01	592.02	15	2	1	NA	1	NA	0	13
FUCA2	9	13	2	1	452.43	904.86	15	2	0.564782608695652	-1.88888888888889	1	-0.257575757575758	3	22
FUNDC1	0	12	0	3	150.15	300.3	15	2	1	NA	1	0	3	12
FUT4	7	23	3	2	330.99	661.98	15	2	0.127843219399197	-3.92857142857143	1	-0.366666666666667	5	30
FUT9	0	17	0	2	356.4	712.8	15	2	1	NA	1	0	2	17
FYCO1	38	53	14	8	1530.54	3061.08	15	2	0.094327417271818	-1.44078947368421	1	-0.218781218781219	22	91
FYN	0	12	4	8	529.65	1059.3	15	2	0.093167701863354	-Inf	1	-0.333333333333333	12	12
FZD1	1	29	0	7	551.76	1103.52	15	2	1	1	1	0.0333333333333333	7	30
FZD3	4	32	1	8	660.33	1320.66	15	2	1	0	1	0	9	36
FZD4	1	16	0	1	529.65	1059.3	15	2	1	1	1	0.0588235294117647	1	17
FZD6	6	42	2	5	700.92	1401.84	15	2	0.266773019802986	-1.8	1	-0.160714285714286	7	48
FZD8	2	24	0	1	654.72	1309.44	15	2	1	1	1	0.0769230769230769	1	26
GAB2	12	60	3	9	719.73	1439.46	15	2	0.441906815667496	-0.666666666666667	1	-0.0833333333333333	12	72
GABARAPL1	2	5	0	0	112.86	225.72	15	2	1	NA	1	NA	0	7
GABBR2	5	16	0	3	348.48	696.96	15	2	1	1	1	0.238095238095238	3	21
GABPA	0	22	0	0	450.45	900.9	15	2	1	NA	1	NA	0	22
GABRR1	3	19	1	9	450.45	900.9	15	2	1	0.296296296296296	1	0.0363636363636363	10	22
GABRR2	9	22	5	3	484.11	968.22	15	2	0.108508961450138	-3.07407407407407	1	-0.334677419354839	8	31
GABRR3	2	15	3	3	465.3	930.6	15	2	0.0885910428244524	-6.5	1	-0.382352941176471	6	17
GAD2	0	17	2	5	577.17	1154.34	15	2	0.0760869565217393	-Inf	1	-0.285714285714286	7	17
GADL1	4	14	2	1	462.99	925.98	15	2	0.184210526315789	-6	1	-0.444444444444444	3	18
GALM	5	16	3	6	338.91	677.82	15	2	0.666234575020182	-0.6	1	-0.0952380952380952	9	21
GALNT1	0	17	0	2	524.7	1049.4	15	2	1	NA	1	0	2	17
GALNT11	3	30	0	6	602.91	1205.82	15	2	1	1	1	0.0909090909090909	6	33
GALNT12	9	16	1	0	578.16	1156.32	15	2	0.384615384615385	-Inf	1	-0.64	1	25
GALNT14	7	21	3	2	561.66	1123.32	15	2	0.149332591768632	-3.5	1	-0.35	5	28
GALNT15	14	33	5	8	611.82	1223.64	15	2	0.737184526557003	-0.473214285714286	1	-0.0867430441898527	13	47
GALNT2	1	19	2	1	551.1	1102.2	15	2	0.0344438170525127	-37	1	-0.616666666666667	3	20
GALR3	7	14	3	4	297.99	595.98	15	2	0.674369109151718	-0.5	1	-0.0952380952380952	7	21
GAP43	3	3	4	5	275.22	550.44	15	2	1	0.2	1	0.0555555555555556	9	6
GAPDH	0	9	1	14	324.06	648.12	15	2	1	-Inf	1	-0.0666666666666667	15	9
GAREM1	5	31	2	4	816.09	1632.18	15	2	0.257387930045183	-2.1	1	-0.194444444444444	6	36
GAREM2	16	47	16	37	781.11	1562.22	15	2	0.677326746571116	-0.27027027027027	1	-0.0479185384845762	53	63
GARS	2	25	0	5	647.46	1294.92	15	2	1	1	1	0.0740740740740741	5	27
GART	11	42	9	5	1011.45	2022.9	15	2	0.00299867341128793	-5.87272727272727	0.991296422875371	-0.435309973045822	14	53
GART-B	15	43	4	9	1025.64	2051.28	15	2	0.736172877671599	-0.274074074074074	1	-0.0490716180371353	13	58
GAS2L3	29	24	1	3	724.68	1449.36	15	2	0.335953520164046	0.724137931034483	1	0.297169811320755	4	53
GAS6	9	25	2	10	664.29	1328.58	15	2	0.700589926294759	0.444444444444444	1	0.0980392156862745	12	34
GATA4	2	8	2	6	236.61	473.22	15	2	1	-0.333333333333333	1	-0.05	8	10
GATA6	6	11	0	2	477.84	955.68	15	2	1	1	1	0.352941176470588	2	17
GATAD1	0	15	2	2	265.32	530.64	15	2	0.0350877192982456	-Inf	1	-0.5	4	15
GBE	44	41	1	6	718.74	1437.48	15	2	0.111212112180729	0.84469696969697	1	0.374789915966387	7	85
GBE1	9	21	2	3	644.49	1288.98	15	2	0.639943074003795	-0.555555555555556	1	-0.1	5	30
GBX1	2	7	1	0	309.21	618.42	15	2	0.3	-Inf	1	-0.777777777777778	1	9
GCAT	6	15	3	6	417.78	835.56	15	2	1	-0.25	1	-0.0476190476190476	9	21
GCC1	38	49	13	16	768.9	1537.8	15	2	1	-0.0476973684210527	1	-0.0114942528735632	29	87
GCC2	51	67	15	5	1648.68	3297.36	15	2	0.0139837565995875	-2.94117647058824	1	-0.317796610169492	20	118
GCLC	3	26	0	4	630.63	1261.26	15	2	1	1	1	0.103448275862069	4	29
GCM1	22	23	7	7	380.82	761.64	15	2	1	-0.0454545454545454	1	-0.0111111111111111	14	45
GCM2	15	31	2	3	469.26	938.52	15	2	1	-0.377777777777778	1	-0.0739130434782609	5	46
GCNT2	18	30	1	7	403.59	807.18	15	2	0.24257855352195	0.761904761904762	1	0.25	8	48
GDAP1	4	16	1	2	340.56	681.12	15	2	0.539243365330322	-1	1	-0.133333333333333	3	20
GDAP2	1	13	0	5	491.04	982.08	15	2	1	1	1	0.0714285714285714	5	14
GDF6	2	2	0	2	166.98	333.96	15	2	0.466666666666667	1	1	0.5	2	4
GDF7	6	12	1	6	325.05	650.1	15	2	0.625695860203869	0.666666666666667	1	0.19047619047619	7	18
GDPD4	19	23	1	3	600.93	1201.86	15	2	0.621595122100683	0.596491228070176	1	0.202380952380952	4	42
GDPD5	1	16	3	6	550.44	1100.88	15	2	0.103946488294314	-7	1	-0.274509803921569	9	17
GEMIN8	7	11	6	1	226.71	453.42	15	2	0.0730434782608696	-8.42857142857143	1	-0.468253968253968	7	18
GEN1	47	42	3	2	928.62	1857.24	15	2	1	-0.340425531914894	1	-0.0719101123595506	5	89
GFOD1	9	23	0	0	352.44	704.88	15	2	1	NA	1	NA	0	32
GFRAL	12	12	3	1	403.92	807.84	15	2	0.6	-2	1	-0.25	4	24
GGA1	20	48	5	8	657.36	1314.72	15	2	0.52653089855724	-0.5	1	-0.0904977375565611	13	68
GGACT	2	8	0	4	201.96	403.92	15	2	1	1	1	0.2	4	10
GGCT	3	6	1	4	158.73	317.46	15	2	1	0.5	1	0.133333333333333	5	9
GGGT5L	22	56	3	3	1105.83	2211.66	15	2	0.356188604715593	-1.54545454545455	1	-0.217948717948718	6	78
GGH	15	18	7	0	322.74	645.48	15	2	0.0108545792756319	-Inf	1	-0.545454545454545	7	33
GGPS1	0	14	1	4	297	594	15	2	0.263157894736842	-Inf	1	-0.2	5	14
GHRHR	5	13	3	1	408.87	817.74	15	2	0.116746411483254	-6.8	1	-0.472222222222222	4	18
GHRHR-LR	8	10	1	1	439.56	879.12	15	2	1	-0.25	1	-0.0555555555555556	2	18
GINM1	9	12	2	1	297.33	594.66	15	2	0.576086956521739	-1.66666666666667	1	-0.238095238095238	3	21
GINS1	2	11	1	3	186.12	372.24	15	2	1	-0.833333333333333	1	-0.0961538461538461	4	13
GJA1	1	15	0	2	378.18	756.36	15	2	1	1	1	0.0625	2	16
GJA3	11	37	4	9	506.88	1013.76	15	2	0.717533253587584	-0.494949494949495	1	-0.0785256410256411	13	48
GJA5	4	19	2	8	366.3	732.6	15	2	1	-0.1875	1	-0.0260869565217391	10	23
GJA8	7	12	2	1	396.99	793.98	15	2	0.544155844155844	-2.42857142857143	1	-0.298245614035088	3	19
GJB2	1	12	0	2	223.74	447.48	15	2	1	1	1	0.0769230769230769	2	13
GJB6	1	9	0	4	261.36	522.72	15	2	1	1	1	0.1	4	10
GJC2	1	12	1	12	411.84	823.68	15	2	1	0	1	0	13	13
GJD4	14	19	3	0	411.84	823.68	15	2	0.0952380952380953	-Inf	1	-0.575757575757576	3	33
GK	2	19	0	0	495.99	991.98	15	2	1	NA	1	NA	0	21
GLCCI1	8	10	4	1	517.11	1034.22	15	2	0.316770186335404	-4	1	-0.355555555555556	5	18
GLIPR1L	19	10	5	2	411.51	823.02	15	2	1	-0.315789473684211	1	-0.0591133004926109	7	29
GLIPR2	0	6	0	1	153.45	306.9	15	2	1	NA	1	0	1	6
GLO1	1	14	1	2	171.6	343.2	15	2	0.313725490196079	-6	1	-0.266666666666667	3	15
GLP1R	3	24	1	2	550.44	1100.88	15	2	0.359605911330049	-3	1	-0.222222222222222	3	27
GLT8D2	0	11	2	3	347.49	694.98	15	2	0.0833333333333334	-Inf	1	-0.4	5	11
GLTSCR1L	11	38	2	3	1079.1	2158.2	15	2	0.583713569285156	-1.3030303030303	1	-0.175510204081633	5	49
GMNN	10	8	3	3	230.67	461.34	15	2	1	0.2	1	0.0555555555555556	6	18
GMPR	19	23	8	5	475.2	950.4	15	2	0.355035564028156	-0.936842105263158	1	-0.163003663003663	13	42
GMSRAL	42	13	2	1	381.15	762.3	15	2	1	0.380952380952381	1	0.096969696969697	3	55
GNAT3	4	15	2	0	351.45	702.9	15	2	0.0714285714285714	-Inf	1	-0.789473684210526	2	19
GNG11	0	1	0	1	73.26	146.52	15	2	1	NA	1	0	1	1
GNG4	1	4	1	0	74.25	148.5	15	2	0.333333333333333	-Inf	1	-0.8	1	5
GNPAT	14	35	3	6	652.41	1304.82	15	2	1	-0.25	1	-0.0476190476190476	9	49
GNPTAB	14	44	5	4	1429.89	2859.78	15	2	0.104531243679355	-2.92857142857143	1	-0.314176245210728	9	58
GNS	4	25	3	8	536.58	1073.16	15	2	0.369393774579533	-1.34375	1	-0.134796238244514	11	29
GOLGA4	103	99	18	10	2257.2	4514.4	15	2	0.227410261674939	-0.730097087378641	1	-0.132956152758133	28	202
GOLGB1	170	116	17	13	3414.18	6828.36	15	2	0.845870744213978	0.107692307692308	1	0.0277389277389277	30	286
GOLT1B	1	8	0	0	137.61	275.22	15	2	1	NA	1	NA	0	9
GOPC	1	14	0	2	367.29	734.58	15	2	1	1	1	0.0666666666666667	2	15
GORASP1	15	22	6	4	423.06	846.12	15	2	0.306428838657511	-1.2	1	-0.194594594594595	10	37
GPA33	13	16	3	0	289.08	578.16	15	2	0.225806451612903	-Inf	1	-0.551724137931034	3	29
GPALPP1	52	34	6	9	659.67	1319.34	15	2	0.164390245740755	0.564102564102564	1	0.204651162790698	15	86
GPATCH11	2	4	1	1	253.44	506.88	15	2	1	-1	1	-0.166666666666667	2	6
GPC5	5	3	0	0	98.67	197.34	15	2	1	NA	1	NA	0	8
GPCPD1	3	37	2	3	672.21	1344.42	15	2	0.0874157669393064	-7.22222222222222	1	-0.325	5	40
GPD1L	3	10	0	4	350.46	700.92	15	2	0.541176470588235	1	1	0.230769230769231	4	13
GPLD1	29	30	6	5	827.64	1655.28	15	2	1	-0.241379310344828	1	-0.0539291217257318	11	59
GPN1	5	13	2	2	357.39	714.78	15	2	0.564593301435407	-1.6	1	-0.222222222222222	4	18
GPNMB	6	19	5	7	554.4	1108.8	15	2	0.443394890950999	-1.26190476190476	1	-0.176666666666667	12	25
GPR12	0	5	0	1	331.65	663.3	15	2	1	NA	1	0	1	5
GPR137B	1	9	0	2	332.64	665.28	15	2	1	1	1	0.1	2	10
GPR141	11	19	2	2	383.46	766.92	15	2	0.627177850612386	-0.727272727272727	1	-0.133333333333333	4	30
GPR143	9	25	2	5	389.07	778.14	15	2	1	-0.111111111111111	1	-0.0210084033613445	7	34
GPR15	4	24	0	2	366.3	732.6	15	2	1	1	1	0.142857142857143	2	28
GPR158	24	35	6	5	1025.64	2051.28	15	2	0.51109252804388	-0.75	1	-0.138674884437596	11	59
GPR161	4	19	1	3	520.74	1041.48	15	2	1	-0.583333333333333	1	-0.0760869565217391	4	23
GPR162	2	25	2	4	563.31	1126.62	15	2	0.142228739002933	-5.25	1	-0.259259259259259	6	27
GPR174	8	15	2	5	325.71	651.42	15	2	1	0.25	1	0.062111801242236	7	23
GPR18	3	19	0	6	318.78	637.56	15	2	1	1	1	0.136363636363636	6	22
GPR180	2	5	7	2	431.64	863.28	15	2	0.126223776223776	-7.75	1	-0.492063492063492	9	7
GPR183,UBAC2	3	1	1	0	352.44	704.88	15	2	1	-Inf	1	-0.25	1	4
GPR19	8	12	1	0	411.84	823.68	15	2	0.428571428571429	-Inf	1	-0.6	1	20
GPR20	3	14	1	2	352.44	704.88	15	2	0.508771929824561	-1.33333333333333	1	-0.156862745098039	3	17
GPR22	0	12	2	4	429.66	859.32	15	2	0.0980392156862745	-Inf	1	-0.333333333333333	6	12
GPR37	8	26	1	4	486.09	972.18	15	2	1	0.1875	1	0.0352941176470588	5	34
GPR6	1	13	0	5	325.71	651.42	15	2	1	1	1	0.0714285714285714	5	14
GPR63	2	13	0	0	415.8	831.6	15	2	1	NA	1	NA	0	15
GPR83	13	19	7	7	419.76	839.52	15	2	0.747563786134404	-0.461538461538461	1	-0.09375	14	32
GPR83L	2	25	3	5	415.8	831.6	15	2	0.0665430395031913	-6.5	1	-0.300925925925926	8	27
GPR89B	1	9	0	1	451.44	902.88	15	2	1	1	1	0.1	1	10
GPRC5A	15	11	1	3	353.43	706.86	15	2	0.315453384418902	0.755555555555556	1	0.326923076923077	4	26
GPRC6A	13	46	1	4	918.72	1837.44	15	2	1	0.115384615384615	1	0.0203389830508474	5	59
GRAMD1C	6	27	3	6	662.31	1324.62	15	2	0.374845812933859	-1.25	1	-0.151515151515151	9	33
GRAMD4	5	23	6	5	695.31	1390.62	15	2	0.0442693603627493	-4.52	1	-0.366883116883117	11	28
GRAP2	6	17	0	2	293.04	586.08	15	2	1	1	1	0.260869565217391	2	23
GREB1L	10	91	11	20	1947.33	3894.66	15	2	0.00158525371811897	-4.005	0.861654992358069	-0.25582880868732	31	101
GREM2	0	17	0	2	167.31	334.62	15	2	1	NA	1	0	2	17
GRHL1	2	27	1	2	632.61	1265.22	15	2	0.263306451612903	-5.75	1	-0.264367816091954	3	29
GRHL2	2	22	2	7	633.6	1267.2	15	2	0.295161290322581	-2.14285714285714	1	-0.138888888888889	9	24
GRIA4	7	26	1	2	741.84	1483.68	15	2	0.541176470588235	-0.857142857142857	1	-0.121212121212121	3	33
GRIK1	1	39	3	5	915.42	1830.84	15	2	0.0118717237126118	-22.4	1	-0.35	8	40
GRIN2B	14	38	4	10	1305.81	2611.62	15	2	1	-0.0857142857142856	1	-0.0164835164835165	14	52
GRIP1	9	37	6	7	1090.98	2181.96	15	2	0.0733423140042772	-2.52380952380952	1	-0.265886287625418	13	46
GRM1	10	39	4	7	842.16	1684.32	15	2	0.263774308914733	-1.22857142857143	1	-0.159554730983302	11	49
GRM3	5	51	0	1	934.56	1869.12	15	2	1	1	1	0.0892857142857143	1	56
GRM5	5	40	3	6	971.19	1942.38	15	2	0.118479488883532	-3	1	-0.222222222222222	9	45
GRM8	3	12	1	2	324.72	649.44	15	2	1	-1	1	-0.133333333333333	3	15
GRPR	8	25	2	3	397.98	795.96	15	2	0.592084344406326	-1.08333333333333	1	-0.157575757575758	5	33
GRTP1	1	19	2	7	335.61	671.22	15	2	0.220032840722496	-4.42857142857143	1	-0.172222222222222	9	20
GSAP	17	42	5	6	838.53	1677.06	15	2	0.303495750737758	-1.05882352941176	1	-0.166409861325116	11	59
GSG1	1	15	1	7	312.84	625.68	15	2	1	-1.14285714285714	1	-0.0625	8	16
GSK3B	6	6	2	2	391.05	782.1	15	2	1	0	1	0	4	12
GSTA4L	10	11	2	1	221.76	443.52	15	2	1	-1.2	1	-0.19047619047619	3	21
GSTAL3	6	11	0	0	227.7	455.4	15	2	1	NA	1	NA	0	17
GSTK1	3	6	2	2	222.75	445.5	15	2	1	-1	1	-0.166666666666667	4	9
GTF2A1L	18	28	4	4	488.07	976.14	15	2	0.701942108062967	-0.555555555555556	1	-0.108695652173913	8	46
GTF2F2	2	7	0	1	156.42	312.84	15	2	1	1	1	0.222222222222222	1	9
GTF2H5	0	4	0	1	71.28	142.56	15	2	1	NA	1	0	1	4
GTF3A	9	14	3	6	348.15	696.3	15	2	1	0.222222222222222	1	0.0579710144927537	9	23
GTF3C6	6	14	1	1	243.54	487.08	15	2	1	-1.33333333333333	1	-0.2	2	20
GTPBP1	4	38	1	9	664.29	1328.58	15	2	1	-0.0555555555555556	1	-0.00476190476190477	10	42
GTPBP10	16	20	3	2	427.68	855.36	15	2	0.648597941280868	-0.875	1	-0.155555555555556	5	36
GTPBP2	2	22	0	7	583.11	1166.22	15	2	1	1	1	0.0833333333333333	7	24
GTPBP4	10	16	0	4	625.68	1251.36	15	2	0.272030651340996	1	1	0.384615384615385	4	26
GTPBP6	19	28	5	4	524.04	1048.08	15	2	0.475452671634692	-0.842105263157895	1	-0.151300236406619	9	47
GTPBP8	4	6	0	1	240.57	481.14	15	2	1	1	1	0.4	1	10
GTSE1	32	36	7	8	709.83	1419.66	15	2	1	0.015625	1	0.00392156862745097	15	68
GUCA1C	3	5	2	1	171.27	342.54	15	2	0.545454545454546	-2.33333333333333	1	-0.291666666666667	3	8
GUCY1A2	6	26	2	0	640.86	1281.72	15	2	0.0499108734402852	-Inf	1	-0.8125	2	32
GUCY2C	22	32	0	5	952.05	1904.1	15	2	0.146390230397736	1	1	0.407407407407407	5	54
GUCY2F	7	54	5	16	1114.74	2229.48	15	2	0.280294114668739	-1.41071428571429	1	-0.123341139734582	21	61
GUK1	1	19	1	3	187.44	374.88	15	2	0.311594202898551	-5.33333333333333	1	-0.2	4	20
GYG2	24	28	4	2	412.83	825.66	15	2	0.415455448226054	-1.33333333333333	1	-0.205128205128205	6	52
GYS2	6	19	1	2	726.66	1453.32	15	2	1	-0.583333333333333	1	-0.0933333333333333	3	25
GZF1	60	71	11	23	1573.11	3146.22	15	2	0.177893315786886	0.434057971014493	1	0.134485855410867	34	131
H1F0	5	10	3	4	193.05	386.1	15	2	1	-0.5	1	-0.0952380952380952	7	15
HAAO	4	15	0	0	284.13	568.26	15	2	1	NA	1	NA	0	19
HACD1	0	4	0	1	243.54	487.08	15	2	1	NA	1	0	1	4
HACL1	6	33	6	4	566.28	1132.56	15	2	0.00821595936201172	-7.25	1	-0.446153846153846	10	39
HADHA	9	47	3	19	738.54	1477.08	15	2	1	0.175438596491228	1	0.0243506493506494	22	56
HAL	3	27	3	6	654.39	1308.78	15	2	0.122513082265404	-3.5	1	-0.233333333333333	9	30
HAO1	7	18	5	2	367.29	734.58	15	2	0.0734648184592567	-5.42857142857143	1	-0.434285714285714	7	25
HAO2	3	18	3	3	352.44	704.88	15	2	0.100932400932401	-5	1	-0.357142857142857	6	21
HAS2	0	8	0	0	547.47	1094.94	15	2	1	NA	1	NA	0	8
HBBA	1	3	0	1	144.54	289.08	15	2	1	1	1	0.25	1	4
HBE	2	3	0	1	47.19	94.38	15	2	1	1	1	0.4	1	5
HBE1	2	10	0	1	146.52	293.04	15	2	1	1	1	0.166666666666667	1	12
HBP1	4	9	2	5	525.69	1051.38	15	2	1	0.1	1	0.021978021978022	7	13
HCFC2	7	25	8	9	784.74	1569.48	15	2	0.104132857425152	-2.17460317460317	1	-0.251838235294118	17	32
HCLS1	12	22	5	2	479.16	958.32	15	2	0.105438587595199	-3.58333333333333	1	-0.361344537815126	7	34
HCRTR2	6	9	1	1	496.98	993.96	15	2	1	-0.5	1	-0.1	2	15
HDAC2	0	16	1	3	484.11	968.22	15	2	0.2	-Inf	1	-0.25	4	16
HDDC2	4	4	0	0	195.03	390.06	15	2	1	NA	1	NA	0	8
HEATR1	34	91	5	17	2136.42	4272.84	15	2	0.796544687698266	0.21280276816609	1	0.0447272727272728	22	125
HEATR5B	7	93	2	4	2053.26	4106.52	15	2	0.0807302766012704	-5.64285714285714	1	-0.263333333333333	6	100
HEBP1	9	9	3	2	338.58	677.16	15	2	1	-0.5	1	-0.1	5	18
HECA	12	17	1	3	510.84	1021.68	15	2	1	0.527777777777778	1	0.163793103448276	4	29
HELB	50	53	16	9	1019.7	2039.4	15	2	0.186837254904771	-0.884444444444444	1	-0.154563106796117	25	103
HEPACAM2	11	16	3	4	460.68	921.36	15	2	1	-0.0909090909090908	1	-0.0211640211640212	7	27
HEPH	12	41	5	3	1141.47	2282.94	15	2	0.0321042850531532	-4.69444444444444	1	-0.398584905660377	8	53
HEPHL1	11	59	3	12	1151.37	2302.74	15	2	0.705995063942996	-0.340909090909091	1	-0.0428571428571429	15	70
HERC2	9	212	4	28	4574.46	9148.92	15	2	0.0663080212390618	-2.36507936507937	1	-0.0842760180995475	32	221
HERPUD2	7	7	1	0	265.32	530.64	15	2	1	-Inf	1	-0.5	1	14
HEY1	1	7	0	2	272.91	545.82	15	2	1	1	1	0.125	2	8
HEY2	3	18	3	3	332.64	665.28	15	2	0.100932400932401	-5	1	-0.357142857142857	6	21
HGF	15	24	2	3	781.11	1562.22	15	2	1	-0.0666666666666667	1	-0.0153846153846154	5	39
HGH1	8	12	0	6	194.37	388.74	15	2	0.131650957737914	1	1	0.4	6	20
HHAT	4	13	4	5	299.97	599.94	15	2	0.382101102558769	-1.6	1	-0.209150326797386	9	17
HHATL	11	22	7	9	498.96	997.92	15	2	0.537402758027787	-0.555555555555556	1	-0.104166666666667	16	33
HHLA1-OC90	52	37	4	1	957.99	1915.98	15	2	0.644984540093609	-1.84615384615385	1	-0.215730337078652	5	89
HIBADH	1	8	0	1	324.72	649.44	15	2	1	1	1	0.111111111111111	1	9
HIGD1A	0	6	0	1	94.05	188.1	15	2	1	NA	1	0	1	6
HINT3	1	11	0	2	168.3	336.6	15	2	1	1	1	0.0833333333333333	2	12
HIPK2	2	13	1	10	841.83	1683.66	15	2	1	0.35	1	0.0424242424242424	11	15
HIST1H103-HIST1H111R	5	35	6	14	202.29	404.58	15	2	0.155346034476632	-2	1	-0.175	20	40
HIST1H110-HISTH1	2	17	7	6	161.04	322.08	15	2	0.0146523915461624	-8.91666666666667	1	-0.433198380566802	13	19
HIST1H2A4L1-HIST1H2A4L3-HISTH2A4L1	0	5	0	1	10.89	21.78	15	2	1	NA	1	0	1	5
HIST1H2B5L	0	4	0	0	125.73	251.46	15	2	1	NA	1	NA	0	4
HIST1H3A-HIST1H3G-HIST2H3	0	2	0	1	30.36	60.72	15	2	1	NA	1	0	1	2
HIVEP1	143	132	4	3	2654.52	5309.04	15	2	1	-0.230769230769231	1	-0.0514285714285714	7	275
HIVEP2	30	60	8	14	2497.77	4995.54	15	2	0.805312014540317	-0.142857142857143	1	-0.0303030303030303	22	90
HJURP	86	31	13	5	752.4	1504.8	15	2	1	0.0627906976744186	1	0.0128205128205129	18	117
HLCS	28	31	3	4	872.19	1744.38	15	2	1	0.169642857142857	1	0.0460048426150121	7	59
HMBOX1	3	17	1	5	427.68	855.36	15	2	1	-0.133333333333333	1	-0.0166666666666667	6	20
HMGB1	1	3	0	1	213.84	427.68	15	2	1	1	1	0.25	1	4
HMGCLL1	15	14	3	1	401.94	803.88	15	2	0.607404692082111	-1.8	1	-0.232758620689655	4	29
HMGN1	4	2	2	0	80.19	160.38	15	2	1	-Inf	1	-0.333333333333333	2	6
HMGXB4	11	33	1	2	596.31	1192.62	15	2	1	-0.5	1	-0.0833333333333333	3	44
HMOX1	8	13	0	1	294.03	588.06	15	2	1	1	1	0.380952380952381	1	21
HNF4G	2	20	1	0	428.67	857.34	15	2	0.130434782608696	-Inf	1	-0.909090909090909	1	22
HNRNPA2B1	0	10	0	0	340.56	681.12	15	2	1	NA	1	NA	0	10
HNRNPLL	1	11	1	5	455.4	910.8	15	2	1	-1.2	1	-0.0833333333333333	6	12
HNRNPU-HNRNPUL1	6	18	1	2	787.38	1574.76	15	2	1	-0.5	1	-0.0833333333333333	3	24
HOXA1	1	7	2	1	293.37	586.74	15	2	0.151515151515152	-13	1	-0.541666666666667	3	8
HOXA10	1	6	1	2	247.5	495	15	2	1	-2	1	-0.19047619047619	3	7
HOXA13	0	7	0	2	296.01	592.02	15	2	1	NA	1	0	2	7
HOXA2	0	1	0	3	372.24	744.48	15	2	1	NA	1	0	3	1
HOXA3	7	6	1	4	410.85	821.7	15	2	0.313725490196079	0.785714285714286	1	0.338461538461538	5	13
HOXA4	1	1	0	0	143.55	287.1	15	2	1	NA	1	NA	0	2
HOXA6	1	4	0	0	229.68	459.36	15	2	1	NA	1	NA	0	5
HOXA7	1	2	1	1	217.8	435.6	15	2	1	-1	1	-0.166666666666667	2	3
HPX	11	25	2	7	376.2	752.4	15	2	1	0.350649350649351	1	0.0833333333333334	9	36
HRH3L-HRH4	27	45	3	4	807.84	1615.68	15	2	1	-0.25	1	-0.0535714285714285	7	72
HS1BP3	19	15	2	2	380.16	760.32	15	2	1	0.210526315789474	1	0.0588235294117647	4	34
HS3ST5	3	18	0	1	342.54	685.08	15	2	1	1	1	0.142857142857143	1	21
HSF1	13	18	2	3	438.24	876.48	15	2	1	0.0769230769230769	1	0.0193548387096774	5	31
HSF2	2	27	1	2	561.33	1122.66	15	2	0.263306451612903	-5.75	1	-0.264367816091954	3	29
HSF2BP	3	8	3	3	333.63	667.26	15	2	0.600032320620556	-1.66666666666667	1	-0.227272727272727	6	11
HSF3	8	17	5	1	505.89	1011.78	15	2	0.0590073626781079	-9.625	1	-0.513333333333333	6	25
HSFL1-HSFL2	20	12	2	3	233.64	467.28	15	2	0.377318494965554	0.6	1	0.225	5	32
HSP90AB1	6	40	6	15	799.92	1599.84	15	2	0.170884743252422	-1.66666666666667	1	-0.15527950310559	21	46
HSP90B1	1	40	1	3	784.41	1568.82	15	2	0.171717171717172	-12.3333333333333	1	-0.225609756097561	4	41
HSPA13	16	25	5	3	468.27	936.54	15	2	0.263000353990608	-1.60416666666667	1	-0.234756097560976	8	41
HSPA14	5	31	3	1	500.94	1001.88	15	2	0.0203742203742204	-17.6	1	-0.611111111111111	4	36
HSPH1	5	36	4	8	846.12	1692.24	15	2	0.183233759180107	-2.6	1	-0.211382113821138	12	41
HTR1B	2	10	1	4	376.2	752.4	15	2	1	-0.25	1	-0.0333333333333334	5	12
HTR1E	0	17	0	9	361.35	722.7	15	2	1	NA	1	0	9	17
HTR1F	2	11	0	0	363.33	726.66	15	2	1	NA	1	NA	0	13
HTR2A	1	16	1	2	467.28	934.56	15	2	0.28421052631579	-7	1	-0.274509803921569	3	17
HTR5A	2	19	0	3	352.44	704.88	15	2	1	1	1	0.0952380952380952	3	21
HUNK	7	14	2	8	601.92	1203.84	15	2	0.677001201632434	0.5	1	0.133333333333333	10	21
HYAL6	9	24	2	4	474.21	948.42	15	2	1	-0.333333333333333	1	-0.0606060606060606	6	33
IAH1	7	22	2	3	241.56	483.12	15	2	0.59084440227704	-1.0952380952381	1	-0.158620689655172	5	29
IAPP	4	4	0	0	134.64	269.28	15	2	1	NA	1	NA	0	8
IARS2	21	36	2	6	1007.82	2015.64	15	2	0.70152186631993	0.428571428571429	1	0.118421052631579	8	57
IBA57	6	17	2	7	341.22	682.44	15	2	1	0.19047619047619	1	0.0386473429951691	9	23
IBTK	26	47	4	8	1342.44	2684.88	15	2	1	0.0961538461538461	1	0.0228310502283105	12	73
ICA1	13	17	2	2	554.4	1108.8	15	2	1	-0.307692307692308	1	-0.0666666666666667	4	30
ICK	8	21	3	2	612.81	1225.62	15	2	0.299889310562935	-2.9375	1	-0.324137931034483	5	29
ICOSLG	11	10	1	0	304.92	609.84	15	2	1	-Inf	1	-0.476190476190476	1	21
ID2-ID3	12	12	14	9	125.73	251.46	15	2	0.561214940972018	-0.555555555555556	1	-0.108695652173913	23	24
ID4	0	5	0	2	139.59	279.18	15	2	1	NA	1	0	2	5
IDI1	2	11	1	3	225.72	451.44	15	2	1	-0.833333333333333	1	-0.0961538461538461	4	13
IFFO1	3	18	0	5	466.29	932.58	15	2	1	1	1	0.142857142857143	5	21
IFI6	6	8	4	1	106.92	213.84	15	2	0.303405572755418	-4.33333333333333	1	-0.371428571428571	5	14
IFNAR1	29	20	4	6	563.31	1126.62	15	2	0.311179998567687	0.540229885057471	1	0.191836734693878	10	49
IFNAR2	34	30	5	1	429.66	859.32	15	2	0.21716574069897	-3.41176470588235	1	-0.302083333333333	6	64
IFNG	6	12	0	3	163.35	326.7	15	2	0.526315789473684	1	1	0.333333333333333	3	18
IFNGR1	43	17	1	3	424.71	849.42	15	2	0.086570786431971	0.868217054263566	1	0.466666666666667	4	60
IFNGR2	28	23	8	7	331.65	663.3	15	2	1	0.0612244897959183	1	0.015686274509804	15	51
IFRD1	1	18	1	2	430.65	861.3	15	2	0.25974025974026	-8	1	-0.280701754385965	3	19
IFT172	29	62	8	5	1887.27	3774.54	15	2	0.0600155972171309	-2.42068965517241	1	-0.296703296703297	13	91
IFT27	2	3	0	0	185.13	370.26	15	2	1	NA	1	NA	0	5
IFT57	1	13	1	2	406.89	813.78	15	2	0.330882352941176	-5.5	1	-0.261904761904762	3	14
IFT88	8	32	4	7	810.48	1620.96	15	2	0.261946090387075	-1.28571428571429	1	-0.163636363636364	11	40
IGBP1	13	23	2	3	341.55	683.1	15	2	1	-0.17948717948718	1	-0.0388888888888889	5	36
IGF2BP3	2	18	0	4	505.89	1011.78	15	2	1	1	1	0.1	4	20
IGF2R	49	97	20	14	2197.14	4394.28	15	2	0.0101697841961792	-1.82798833819242	1	-0.252618855761483	34	146
IGFBP1	3	13	0	2	263.67	527.34	15	2	1	1	1	0.1875	2	16
IGFBP3	1	4	0	0	271.26	542.52	15	2	1	NA	1	NA	0	5
IGSF11	6	14	3	3	470.25	940.5	15	2	0.627850410459106	-1.33333333333333	1	-0.2	6	20
IGSF3	9	38	12	18	1107.48	2214.96	15	2	0.0659507277827111	-1.81481481481481	1	-0.208510638297872	30	47
IGSF5	10	9	2	3	363.33	726.66	15	2	1	0.4	1	0.126315789473684	5	19
IKBIP	24	21	2	1	629.97	1259.94	15	2	1	-0.75	1	-0.133333333333333	3	45
IL10RB	35	29	2	1	340.56	681.12	15	2	1	-0.657142857142857	1	-0.119791666666667	3	64
IL15RA	11	11	8	2	232.65	465.3	15	2	0.140832809401751	-3	1	-0.3	10	22
IL17A	4	6	2	3	168.3	336.6	15	2	1	0	1	0	5	10
IL17F	9	9	0	1	166.32	332.64	15	2	1	1	1	0.5	1	18
IL17REL	19	16	0	1	405.57	811.14	15	2	0.472222222222222	1	1	0.542857142857143	1	35
IL1R1	10	21	7	3	550.44	1100.88	15	2	0.0632094027472717	-3.9	1	-0.37741935483871	10	31
IL1R2	15	15	5	4	407.88	815.76	15	2	1	-0.25	1	-0.0555555555555556	9	30
IL1RAPL1	2	6	2	2	455.4	910.8	15	2	0.547474747474747	-2	1	-0.25	4	8
IL1RL2	17	16	3	5	579.15	1158.3	15	2	0.696516403833477	0.435294117647059	1	0.140151515151515	8	33
IL20RA	22	30	11	6	599.94	1199.88	15	2	0.16204711220786	-1.5	1	-0.223981900452489	17	52
IL22	6	7	1	1	196.02	392.04	15	2	1	-0.166666666666667	1	-0.0384615384615384	2	13
IL22RA2	12	14	2	2	248.49	496.98	15	2	1	-0.166666666666667	1	-0.0384615384615384	4	26
IL2RA	8	11	1	2	223.74	447.48	15	2	1	0.3125	1	0.087719298245614	3	19
IL2RB	19	26	1	7	579.15	1158.3	15	2	0.233621848637953	0.804511278195489	1	0.297222222222222	8	45
IL6	1	10	0	1	230.34	460.68	15	2	1	1	1	0.0909090909090909	1	11
IL7	7	3	0	0	180.18	360.36	15	2	1	NA	1	NA	0	10
ILDR1	16	35	7	5	539.55	1079.1	15	2	0.102646711463264	-2.0625	1	-0.269607843137255	12	51
ILDR2	2	19	4	9	586.08	1172.16	15	2	0.173363303254359	-3.22222222222222	1	-0.212454212454212	13	21
ILK	1	24	1	0	445.83	891.66	15	2	0.0769230769230769	-Inf	1	-0.96	1	25
IMP3	5	8	0	2	183.15	366.3	15	2	0.523809523809524	1	1	0.384615384615385	2	13
IMPA2	0	4	0	0	292.05	584.1	15	2	1	NA	1	NA	0	4
IMPACT	7	22	1	1	316.8	633.6	15	2	0.455913978494623	-2.14285714285714	1	-0.258620689655172	2	29
IMPAD1	7	12	2	5	355.41	710.82	15	2	1	0.314285714285714	1	0.0827067669172932	7	19
IMPG1	31	28	5	2	844.47	1688.94	15	2	0.441664232119018	-1.25806451612903	1	-0.188861985472155	7	59
IMPG2	60	69	13	7	1470.81	2941.62	15	2	0.152089947916054	-1.13571428571429	1	-0.184883720930233	20	129
ING1	0	7	0	2	279.18	558.36	15	2	1	NA	1	0	2	7
ING3	7	12	0	3	440.22	880.44	15	2	0.522727272727273	1	1	0.368421052631579	3	19
ING4	0	9	0	1	247.5	495	15	2	1	NA	1	0	1	9
INO80C	0	2	0	2	133.65	267.3	15	2	1	NA	1	0	2	2
INPPL1	25	53	22	23	1101.87	2203.74	15	2	0.0831921500886767	-1.02782608695652	1	-0.168376068376068	45	78
INSIG1	3	13	2	1	256.74	513.48	15	2	0.154798761609907	-7.66666666666667	1	-0.479166666666667	3	16
INSM1	4	10	1	1	270.6	541.2	15	2	1	-1.5	1	-0.214285714285714	2	14
INTS4	7	78	1	5	992.64	1985.28	15	2	0.433741987628619	-1.22857142857143	1	-0.0843137254901961	6	85
INTS6	8	20	0	3	855.69	1711.38	15	2	0.54972191323693	1	1	0.285714285714286	3	28
INTS7	4	38	2	4	889.02	1778.04	15	2	0.156599936503342	-3.75	1	-0.238095238095238	6	42
INTS8	9	48	2	9	982.08	1964.16	15	2	1	-0.185185185185185	1	-0.0239234449760766	11	57
INTS9	3	29	2	4	535.59	1071.18	15	2	0.168955775766921	-3.83333333333333	1	-0.239583333333333	6	32
INVS	37	62	8	6	1107.81	2215.62	15	2	0.242513461636616	-1.23423423423423	1	-0.197691197691198	14	99
IPCEF1	5	16	0	2	413.82	827.64	15	2	1	1	1	0.238095238095238	2	21
IPO5	2	24	3	4	723.03	1446.06	15	2	0.0518505410051572	-8	1	-0.351648351648352	7	26
IPO8	5	34	0	5	1038.51	2077.02	15	2	1	1	1	0.128205128205128	5	39
IQSEC3	7	32	1	7	1080.42	2160.84	15	2	1	0.346938775510204	1	0.0544871794871795	8	39
IQUB	26	27	4	5	796.95	1593.9	15	2	1	0.169230769230769	1	0.0461215932914046	9	53
IRAK1BP1	11	6	3	0	234.63	469.26	15	2	0.521052631578947	-Inf	1	-0.352941176470588	3	17
IRAK4	8	24	6	1	454.74	909.48	15	2	0.00510417538281315	-17	1	-0.607142857142857	7	32
IRF2BP2	5	8	2	2	278.52	557.04	15	2	1	-0.6	1	-0.115384615384615	4	13
IRS2	4	42	5	13	1165.23	2330.46	15	2	0.102274018794798	-3.03846153846154	1	-0.190821256038647	18	46
IRX1	8	20	1	3	375.54	751.08	15	2	1	0.166666666666667	1	0.0357142857142857	4	28
IRX2	3	19	1	0	464.31	928.62	15	2	0.173913043478261	-Inf	1	-0.863636363636364	1	22
IRX4	4	14	2	1	483.45	966.9	15	2	0.184210526315789	-6	1	-0.444444444444444	3	18
ISM1	2	15	2	2	455.4	910.8	15	2	0.147869674185464	-6.5	1	-0.382352941176471	4	17
ISPD	16	6	1	1	445.83	891.66	15	2	0.507246376811594	0.625	1	0.227272727272727	2	22
ISX	14	9	2	1	305.91	611.82	15	2	1	-0.285714285714286	1	-0.0579710144927535	3	23
ITFG2	4	21	2	5	454.41	908.82	15	2	0.58959028550241	-1.1	1	-0.125714285714286	7	25
ITGA8	11	33	3	6	1031.58	2063.16	15	2	0.684163510376486	-0.5	1	-0.0833333333333333	9	44
ITGA9	5	5	0	1	179.19	358.38	15	2	1	1	1	0.5	1	10
ITGB1	1	25	1	3	795.63	1591.26	15	2	0.252873563218391	-7.33333333333333	1	-0.211538461538462	4	26
ITGB1BP1	0	5	0	0	198.99	397.98	15	2	1	NA	1	NA	0	5
ITGB8	16	21	0	1	741.18	1482.36	15	2	1	1	1	0.432432432432432	1	37
ITGBL1	7	7	0	0	313.83	627.66	15	2	1	NA	1	NA	0	14
ITIH2	3	34	2	10	939.51	1879.02	15	2	0.584379542751421	-1.26666666666667	1	-0.0855855855855856	12	37
ITIH5	13	42	3	11	942.48	1884.96	15	2	1	0.118881118881119	1	0.0220779220779221	14	55
ITM2A	2	24	0	4	249.48	498.96	15	2	1	1	1	0.0769230769230769	4	26
ITM2B	0	17	0	1	261.36	522.72	15	2	1	NA	1	0	1	17
ITPKB	2	9	3	2	323.73	647.46	15	2	0.244505494505494	-5.75	1	-0.418181818181818	5	11
ITSN1	6	43	4	7	1663.2	3326.4	15	2	0.0742738284023615	-3.09523809523809	1	-0.241187384044527	11	49
ITSN2	11	65	7	3	1746.36	3492.72	15	2	0.000479517866598878	-12.7878787878788	0.434642986249666	-0.555263157894737	10	76
IYD	5	9	3	1	308.88	617.76	15	2	0.274509803921569	-4.4	1	-0.392857142857143	4	14
JADE3	3	25	2	12	815.76	1631.52	15	2	1	-0.388888888888889	1	-0.0357142857142857	14	28
JAG1	4	41	0	12	1172.16	2344.32	15	2	0.568922305764411	1	1	0.0888888888888889	12	45
JAM2	5	12	1	1	287.1	574.2	15	2	1	-1.4	1	-0.205882352941176	2	17
JARID2	4	15	2	6	1222.65	2445.3	15	2	1	-0.25	1	-0.0394736842105263	8	19
JAZF1	0	7	0	2	187.11	374.22	15	2	1	NA	1	0	2	7
JMJD4	2	16	3	3	423.72	847.44	15	2	0.0784867306606437	-7	1	-0.388888888888889	6	18
JOSD1	1	4	0	3	200.97	401.94	15	2	1	1	1	0.2	3	5
JPH1	3	22	4	2	660.33	1320.66	15	2	0.0138140193757547	-13.6666666666667	1	-0.546666666666667	6	25
K123	7	13	3	2	276.21	552.42	15	2	0.357707509881423	-1.78571428571429	1	-0.25	5	20
KAT14	2	34	0	6	774.18	1548.36	15	2	1	1	1	0.0555555555555556	6	36
KAT2B	11	20	1	1	792	1584	15	2	1	-0.818181818181818	1	-0.145161290322581	2	31
KATNA1	1	16	0	0	491.04	982.08	15	2	1	NA	1	NA	0	17
KBTBD11	14	64	2	7	590.04	1180.08	15	2	0.668121593955118	-0.306122448979592	1	-0.0427350427350427	9	78
KBTBD2	3	27	0	3	617.76	1235.52	15	2	1	1	1	0.1	3	30
KBTBD3	2	16	1	2	608.85	1217.7	15	2	0.386466165413534	-3	1	-0.222222222222222	3	18
KCNA1	1	13	0	0	487.08	974.16	15	2	1	NA	1	NA	0	14
KCNA5	12	46	1	0	502.92	1005.84	15	2	0.220338983050847	-Inf	1	-0.793103448275862	1	58
KCNA6	3	35	3	6	512.82	1025.64	15	2	0.0746978856395202	-4.83333333333333	1	-0.254385964912281	9	38
KCNB2	13	21	0	1	725.67	1451.34	15	2	1	1	1	0.382352941176471	1	34
KCNC2	2	18	1	1	406.89	813.78	15	2	0.25974025974026	-8	1	-0.4	2	20
KCND2	8	25	2	1	459.69	919.38	15	2	0.180672268907563	-5.25	1	-0.424242424242424	3	33
KCNE1	3	7	2	3	125.73	251.46	15	2	1	-0.555555555555556	1	-0.1	5	10
KCNE2	1	9	0	0	124.74	249.48	15	2	1	NA	1	NA	0	10
KCNG2	8	12	4	8	512.82	1025.64	15	2	1	0.25	1	0.0666666666666667	12	20
KCNG3	0	7	0	6	387.09	774.18	15	2	1	NA	1	0	6	7
KCNH2	3	15	6	18	738.54	1477.08	15	2	0.708309870055698	-0.666666666666667	1	-0.0833333333333333	24	18
KCNH8	14	32	1	0	754.38	1508.76	15	2	0.319148936170213	-Inf	1	-0.695652173913043	1	46
KCNJ15	2	22	0	0	399.96	799.92	15	2	1	NA	1	NA	0	24
KCNJ4	0	14	0	3	451.44	902.88	15	2	1	NA	1	0	3	14
KCNJ8	0	24	3	1	417.78	835.56	15	2	0.00122100122100122	-Inf	0.737823904490573	-0.75	4	24
KCNK12	5	13	1	3	354.42	708.84	15	2	1	0.133333333333333	1	0.0277777777777778	4	18
KCNK16	3	10	0	0	292.05	584.1	15	2	1	NA	1	NA	0	13
KCNK17	4	16	0	5	315.81	631.62	15	2	0.549407114624506	1	1	0.2	5	20
KCNK2	10	21	1	2	489.39	978.78	15	2	1	-0.05	1	-0.010752688172043	3	31
KCNK5	5	15	1	3	480.15	960.3	15	2	1	0	1	0	4	20
KCNK9	0	5	0	0	280.17	560.34	15	2	1	NA	1	NA	0	5
KCNMB4	1	0	0	1	98.01	196.02	15	2	1	1	1	1	1	1
KCNQ3	2	19	0	2	763.29	1526.58	15	2	1	1	1	0.0952380952380952	2	21
KCNQ5	2	15	3	6	766.59	1533.18	15	2	0.302219519610824	-2.75	1	-0.215686274509804	9	17
KCNRG	30	26	8	6	297	594	15	2	1	-0.155555555555555	1	-0.0357142857142857	14	56
KCNS2	0	11	1	3	473.22	946.44	15	2	0.266666666666667	-Inf	1	-0.25	4	11
KCNS3	2	15	0	0	490.05	980.1	15	2	1	NA	1	NA	0	17
KCNV1	1	25	2	4	501.93	1003.86	15	2	0.0826612903225807	-11.5	1	-0.294871794871795	6	26
KCTD1	2	10	1	9	641.85	1283.7	15	2	1	0.444444444444444	1	0.0666666666666667	10	12
KCTD12	0	4	2	1	203.61	407.22	15	2	0.142857142857143	-Inf	1	-0.666666666666667	3	4
KCTD14	4	16	1	2	241.56	483.12	15	2	0.539243365330322	-1	1	-0.133333333333333	3	20
KCTD17	2	8	0	0	239.58	479.16	15	2	1	NA	1	NA	0	10
KCTD21	0	6	0	1	258.39	516.78	15	2	1	NA	1	0	1	6
KCTD3	2	38	1	3	783.42	1566.84	15	2	0.254001812141347	-5.33333333333333	1	-0.2	4	40
KCTD4	1	11	2	3	255.42	510.84	15	2	0.191176470588235	-6.33333333333333	1	-0.316666666666667	5	12
KDELC1	4	21	2	1	462.66	925.32	15	2	0.106837606837607	-9.5	1	-0.506666666666667	3	25
KDELC2	6	11	2	7	472.89	945.78	15	2	0.667285209070106	0.476190476190476	1	0.130718954248366	9	17
KDELR3	2	12	1	3	212.85	425.7	15	2	1	-1	1	-0.107142857142857	4	14
KDM1B	3	23	0	1	845.46	1690.92	15	2	1	1	1	0.115384615384615	1	26
KDM5A	13	56	4	8	1688.28	3376.56	15	2	0.265187946120596	-1.15384615384615	1	-0.144927536231884	12	69
KDM6A	7	15	2	3	1295.58	2591.16	15	2	1	-0.428571428571429	1	-0.0818181818181818	5	22
KDM7A	6	19	3	6	898.92	1797.84	15	2	0.670070817751247	-0.583333333333333	1	-0.0933333333333333	9	25
KEL	36	40	2	5	822.69	1645.38	15	2	0.444989924788093	0.555555555555556	1	0.18796992481203	7	76
KERA	9	7	1	0	350.46	700.92	15	2	1	-Inf	1	-0.4375	1	16
KHDRBS3	9	10	2	2	285.78	571.56	15	2	1	-0.111111111111111	1	-0.0263157894736842	4	19
KIAA0319	41	49	10	6	1286.34	2572.68	15	2	0.279851849855039	-0.991869918699187	1	-0.169444444444444	16	90
KIAA0408	30	34	9	5	1253.01	2506.02	15	2	0.376758651524232	-1.04	1	-0.174107142857143	14	64
KIAA0895	29	37	3	1	607.53	1215.06	15	2	0.325288064609361	-2.82758620689655	1	-0.310606060606061	4	66
KIAA1143	3	5	2	0	158.4	316.8	15	2	0.444444444444445	-Inf	1	-0.625	2	8
KIAA1147	2	6	1	1	439.56	879.12	15	2	1	-2	1	-0.25	2	8
KIAA1211L	37	52	9	4	961.29	1922.58	15	2	0.0772115488912532	-2.16216216216216	1	-0.276577355229041	13	89
KIAA1217	45	63	10	14	1743.06	3486.12	15	2	1	0	1	0	24	108
KIAA1324L	7	32	2	2	957.33	1914.66	15	2	0.187812981119844	-3.57142857142857	1	-0.32051282051282	4	39
KIAA1429	7	118	5	25	1803.78	3607.56	15	2	0.0566220165985603	-2.37142857142857	1	-0.110666666666667	30	125
KIAA1462	39	64	19	16	1311.75	2623.5	15	2	0.113215367701852	-0.948717948717949	1	-0.164216366158114	35	103
KIAA1468	4	25	3	8	964.92	1929.84	15	2	0.369393774579533	-1.34375	1	-0.134796238244514	11	29
KIAA1524	28	43	13	5	879.12	1758.24	15	2	0.0171299841103863	-2.99285714285714	1	-0.327856025039124	18	71
KIAA1549	69	81	21	13	1920.6	3841.2	15	2	0.128186806767005	-0.896321070234114	1	-0.157647058823529	34	150
KIAA1551	132	87	18	5	1879.02	3758.04	15	2	0.114865568991278	-1.37272727272727	1	-0.179868969624777	23	219
KIAA1644	12	5	0	0	252.45	504.9	15	2	1	NA	1	NA	0	17
KIAA1841	8	24	4	4	712.8	1425.6	15	2	0.210777340808301	-2	1	-0.25	8	32
KIDINS220	5	70	3	7	1763.19	3526.38	15	2	0.0487065598854308	-5	1	-0.233333333333333	10	75
KIF13A	18	72	8	14	1911.69	3823.38	15	2	0.15613085602317	-1.28571428571429	1	-0.163636363636364	22	90
KIF13B	34	110	10	21	1965.15	3930.3	15	2	0.36218340027717	-0.5406162464986	1	-0.0864695340501792	31	144
KIF15	20	54	5	6	1312.74	2625.48	15	2	0.287314473241699	-1.25	1	-0.184275184275184	11	74
KIF16B	43	66	7	10	1874.07	3748.14	15	2	1	-0.0744186046511628	1	-0.0172692930383162	17	109
KIF20AL	19	37	10	9	825.66	1651.32	15	2	0.17849979638278	-1.16374269005848	1	-0.18703007518797	19	56
KIF21A	5	27	1	2	601.92	1203.84	15	2	0.441711229946524	-1.7	1	-0.177083333333333	3	32
KIF21B	3	42	3	1	1026.63	2053.26	15	2	0.0041297740187657	-41	1	-0.683333333333333	4	45
KIF25	20	28	3	8	583.11	1166.22	15	2	0.50170051124202	0.475	1	0.143939393939394	11	48
KIF26B	22	69	2	9	1669.14	3338.28	15	2	1	0.303030303030303	1	0.0599400599400599	11	91
KIF3C	3	20	4	14	713.13	1426.26	15	2	0.678600690153964	-0.904761904761905	1	-0.0917874396135266	18	23
KIF4A	9	46	6	11	1215.72	2431.44	15	2	0.167891403745154	-1.78787878787879	1	-0.189304812834225	17	55
KIF6	33	29	1	3	798.93	1597.86	15	2	0.348229548229548	0.707070707070707	1	0.282258064516129	4	62
KIF9	33	79	9	16	825.66	1651.32	15	2	0.631882391941079	-0.346590909090909	1	-0.0653571428571428	25	112
KIN	4	19	2	3	387.09	774.18	15	2	0.285470085470086	-2.16666666666667	1	-0.226086956521739	5	23
KIZ	49	33	8	5	608.85	1217.7	15	2	1	-0.0775510204081633	1	-0.0178236397748593	13	82
KL	19	55	8	14	979.11	1958.22	15	2	0.41838883442134	-0.654135338345865	1	-0.106879606879607	22	74
KLF10	7	21	0	2	279.18	558.36	15	2	1	1	1	0.25	2	28
KLF5	0	12	1	4	439.56	879.12	15	2	0.294117647058824	-Inf	1	-0.2	5	12
KLF6	1	11	1	0	281.16	562.32	15	2	0.153846153846154	-Inf	1	-0.916666666666667	1	12
KLHDC10	3	30	1	11	360.69	721.38	15	2	1	0.0909090909090909	1	0.00757575757575758	12	33
KLHDC3	0	19	0	7	339.24	678.48	15	2	1	NA	1	0	7	19
KLHL14	4	15	0	4	649.11	1298.22	15	2	1	1	1	0.210526315789474	4	19
KLHL18	5	36	2	13	538.23	1076.46	15	2	1	-0.107692307692308	1	-0.0113821138211382	15	41
KLHL29	0	17	2	3	550.44	1100.88	15	2	0.0432900432900433	-Inf	1	-0.4	5	17
KLHL31	2	30	2	8	628.65	1257.3	15	2	0.235593674618065	-2.75	1	-0.1375	10	32
KLHL34	13	37	2	2	589.05	1178.1	15	2	0.306449623874707	-1.84615384615385	1	-0.24	4	50
KLHL35	3	44	4	9	581.13	1162.26	15	2	0.0338350747314419	-5.51851851851852	1	-0.243862520458265	13	47
KLHL40	5	30	6	13	613.8	1227.6	15	2	0.166150746605601	-1.76923076923077	1	-0.172932330827068	19	35
KLHL42	4	33	0	1	501.93	1003.86	15	2	1	1	1	0.108108108108108	1	37
KLHL7	1	22	0	4	579.15	1158.3	15	2	1	1	1	0.0434782608695652	4	23
KMT2C	54	228	22	32	4894.56	9789.12	15	2	0.00114932304627612	-1.90277777777778	0.735363927902668	-0.21591804570528	54	282
KMT2E	9	27	2	4	1245.42	2490.84	15	2	0.643710017907707	-0.5	1	-0.0833333333333333	6	36
KPNA1	1	18	0	0	533.61	1067.22	15	2	1	NA	1	NA	0	19
KPNA3	0	6	2	3	485.1	970.2	15	2	0.181818181818182	-Inf	1	-0.4	5	6
KPNA5	1	14	2	2	488.07	976.14	15	2	0.0970072239422085	-13	1	-0.433333333333333	4	15
KRAS	0	3	0	0	187.11	374.22	15	2	1	NA	1	NA	0	3
KRIT1	1	15	0	1	729.63	1459.26	15	2	1	1	1	0.0625	1	16
KRR1	4	9	2	3	373.23	746.46	15	2	1	-0.5	1	-0.0923076923076923	5	13
KRTCAP3	6	9	4	3	216.81	433.62	15	2	0.651702786377709	-1	1	-0.171428571428571	7	15
L3MBTL2	3	36	2	11	710.82	1421.64	15	2	0.588580432172869	-1.18181818181818	1	-0.0769230769230769	13	39
L3MBTL3	19	19	2	1	807.84	1615.68	15	2	1	-1	1	-0.166666666666667	3	38
LACC1	10	14	4	1	434.61	869.22	15	2	0.168582375478927	-4.6	1	-0.383333333333333	5	24
LACTB2	5	5	0	0	286.11	572.22	15	2	1	NA	1	NA	0	10
LAG3	48	20	3	7	500.94	1001.88	15	2	0.0272975926478775	0.821428571428571	1	0.405882352941177	10	68
LAMA1	70	122	13	20	2993.43	5986.86	15	2	0.845489292438274	-0.132857142857143	1	-0.0293560606060606	33	192
LAMA2	52	109	14	8	3047.22	6094.44	15	2	0.00783062698755779	-2.66826923076923	1	-0.313382269904009	22	161
LAMA3	121	114	26	20	3353.13	6706.26	15	2	0.62870312133956	-0.224793388429752	1	-0.0503237742830712	46	235
LAMA4	44	59	7	8	1780.68	3561.36	15	2	0.787131470862433	-0.173295454545455	1	-0.0394822006472492	15	103
LAMB1	19	68	8	17	1764.18	3528.36	15	2	0.300136122837335	-0.684210526315789	1	-0.101609195402299	25	87
LAMB4	66	87	9	13	1706.76	3413.52	15	2	1	0.0874125874125874	1	0.0222816399286987	22	153
LAMP1	16	16	0	3	412.83	825.66	15	2	0.233613445378151	1	1	0.5	3	32
LAMP5	6	8	3	0	270.27	540.54	15	2	0.205882352941176	-Inf	1	-0.571428571428571	3	14
LANCL3	16	31	6	6	632.61	1265.22	15	2	0.33440928731069	-0.9375	1	-0.159574468085106	12	47
LAPTM4A	0	12	0	1	270.27	540.54	15	2	1	NA	1	0	1	12
LAPTM4B	0	10	0	2	222.75	445.5	15	2	1	NA	1	0	2	10
LARGE1	0	14	0	5	455.07	910.14	15	2	1	NA	1	0	5	14
LARP4B	96	77	14	10	1811.7	3623.4	15	2	0.829998615168244	-0.122916666666667	1	-0.0284200385356456	24	173
LARS2	19	28	8	8	895.95	1791.9	15	2	0.566468373589848	-0.473684210526316	1	-0.0957446808510639	16	47
LAS1L	10	22	0	0	595.32	1190.64	15	2	1	NA	1	NA	0	32
LATS1	3	59	1	9	1128.6	2257.2	15	2	0.457765919186618	-1.18518518518519	1	-0.0516129032258065	10	62
LATS2	3	47	0	4	1114.74	2229.48	15	2	1	1	1	0.06	4	50
LBH	3	4	0	2	127.71	255.42	15	2	0.5	1	1	0.428571428571429	2	7
LBR	3	23	3	5	602.91	1205.82	15	2	0.126279645238619	-3.6	1	-0.259615384615385	8	26
LCA5	16	23	6	4	675.18	1350.36	15	2	0.311396279828353	-1.15625	1	-0.18974358974359	10	39
LCA5L	36	26	5	4	527.34	1054.68	15	2	1	0.0972222222222222	1	0.025089605734767	9	62
LCLAT1	11	8	1	3	375.21	750.42	15	2	0.316770186335404	0.757575757575758	1	0.328947368421053	4	19
LCMT2	40	30	2	2	831.93	1663.86	15	2	1	0.25	1	0.0714285714285714	4	70
LCP1	1	26	1	3	618.75	1237.5	15	2	0.24516129032258	-7.66666666666667	1	-0.212962962962963	4	27
LDAH	1	11	0	1	334.62	669.24	15	2	1	1	1	0.0833333333333333	1	12
LDHB	1	14	0	3	330.66	661.32	15	2	1	1	1	0.0666666666666667	3	15
LDLRAD4	0	5	3	4	253.44	506.88	15	2	0.204545454545455	-Inf	1	-0.428571428571429	7	5
LEMD3	5	13	6	6	852.39	1704.78	15	2	0.266258299421718	-1.6	1	-0.222222222222222	12	18
LGALS1	5	9	1	3	133.65	267.3	15	2	1	0.4	1	0.107142857142857	4	14
LGALS2	11	8	1	1	130.68	261.36	15	2	1	0.272727272727273	1	0.0789473684210527	2	19
LGALS8	6	9	3	3	294.03	588.06	15	2	1	-0.5	1	-0.1	6	15
LGALSL	0	3	0	1	170.28	340.56	15	2	1	NA	1	0	1	3
LGR5	4	26	1	4	897.93	1795.86	15	2	0.561022942901501	-0.625	1	-0.0666666666666667	5	30
LGSN	36	27	1	5	791.01	1582.02	15	2	0.0891067172320751	0.85	1	0.404761904761905	6	63
LHCGR	7	39	2	9	688.71	1377.42	15	2	1	-0.238095238095238	1	-0.0296442687747036	11	46
LHFP	0	4	2	3	141.57	283.14	15	2	0.444444444444445	-Inf	1	-0.4	5	4
LIG4	16	41	0	2	903.87	1807.74	15	2	1	1	1	0.280701754385965	2	57
LIMD1	19	33	16	12	609.51	1219.02	15	2	0.0996234026701748	-1.31578947368421	1	-0.206043956043956	28	52
LIMS1	2	16	2	2	384.12	768.24	15	2	0.135475051264525	-7	1	-0.388888888888889	4	18
LIN7A	1	4	0	2	216.81	433.62	15	2	1	1	1	0.2	2	5
LINC00954	25	40	8	3	906.51	1813.02	15	2	0.0487795270287569	-3.26666666666667	1	-0.342657342657343	11	65
LIPI	9	23	2	2	457.38	914.76	15	2	0.570494864612512	-1.55555555555556	1	-0.21875	4	32
LIPT1	14	27	4	6	368.94	737.88	15	2	0.727181892699855	-0.285714285714286	1	-0.0585365853658537	10	41
LLPH	4	3	0	0	113.85	227.7	15	2	1	NA	1	NA	0	7
LMBR1	0	12	0	0	452.1	904.2	15	2	1	NA	1	NA	0	12
LMBRD1	3	16	0	0	534.6	1069.2	15	2	1	NA	1	NA	0	19
LMO3	1	3	0	0	144.54	289.08	15	2	1	NA	1	NA	0	4
LMO7	58	72	4	6	1875.06	3750.12	15	2	1	0.172413793103448	1	0.0461538461538462	10	130
LMOD2	9	27	3	1	544.5	1089	15	2	0.0728197833460991	-8	1	-0.5	4	36
LNP1	4	4	0	1	198	396	15	2	1	1	1	0.5	1	8
LOC100857421-LOC107049109-LOC107053040-LOC107053041-LOC112532176-LOC112532200	48	10	5	5	368.28	736.56	15	2	0.0352297547478483	0.791666666666667	1	0.327586206896552	10	58
LOC100857560-LOC101749671-LOC107050609-LOC107052549-LOC107055882-LOC107055885-LOC107055896-LOC107055944-LOC107055956-LOC107055976-LOC112529950-LOC112531710-LOC112531711-LOC112531712-LOC420615-NUPL2	11	15	2	2	166.98	333.96	15	2	1	-0.363636363636364	1	-0.0769230769230769	4	26
LOC100858131	51	38	21	10	694.98	1389.96	15	2	0.395545433209518	-0.564705882352941	1	-0.104385646973541	31	89
LOC100858196	50	33	15	22	937.53	1875.06	15	2	0.0502914171932803	0.55	1	0.197004233148811	37	83
LOC100858460	13	23	2	2	385.11	770.22	15	2	0.622496990918044	-0.769230769230769	1	-0.138888888888889	4	36
LOC100858777	4	19	0	4	404.91	809.82	15	2	1	1	1	0.173913043478261	4	23
LOC100859173	4	20	1	2	408.87	817.74	15	2	0.473504273504273	-1.5	1	-0.166666666666667	3	24
LOC100859230	13	56	8	31	663.63	1327.26	15	2	1	-0.11166253101737	1	-0.0167224080267558	39	69
LOC100859314	0	2	0	0	68.31	136.62	15	2	1	NA	1	NA	0	2
LOC100859837	20	30	5	15	594	1188	15	2	0.280410059562081	0.5	1	0.15	20	50
LOC101747255	27	13	4	9	363.33	726.66	15	2	0.0264055784946857	0.786008230452675	1	0.367307692307692	13	40
LOC101747868	5	7	2	4	126.72	253.44	15	2	1	0.3	1	0.0833333333333334	6	12
LOC101747958	11	11	2	2	212.85	425.7	15	2	1	0	1	0	4	22
LOC101747995	5	6	1	0	130.68	261.36	15	2	1	-Inf	1	-0.545454545454545	1	11
LOC101748011	22	17	11	3	278.19	556.38	15	2	0.203104151838775	-1.83333333333333	1	-0.221611721611722	14	39
LOC101748058	8	25	6	3	722.7	1445.4	15	2	0.0406558487808959	-5.25	1	-0.424242424242424	9	33
LOC101748060	91	69	21	9	2239.71	4479.42	15	2	0.226272836324623	-0.769230769230769	1	-0.13125	30	160
LOC101748311	7	13	5	2	266.31	532.62	15	2	0.185024154589372	-3.64285714285714	1	-0.364285714285714	7	20
LOC101748329	5	8	4	0	196.02	392.04	15	2	0.0823529411764705	-Inf	1	-0.615384615384615	4	13
LOC101748521	11	43	4	8	803.88	1607.76	15	2	0.446276945061767	-0.954545454545455	1	-0.12962962962963	12	54
LOC101748650-THRSP-THRSPB	9	2	0	3	131.67	263.34	15	2	0.0274725274725275	1	1	0.818181818181818	3	11
LOC101748683	28	30	18	13	501.27	1002.54	15	2	0.504629985998838	-0.483516483516484	1	-0.0978865406006674	31	58
LOC101748694	20	23	7	6	583.77	1167.54	15	2	0.755540835362648	-0.341666666666667	1	-0.073345259391771	13	43
LOC101748883	10	14	2	3	298.98	597.96	15	2	1	0.0666666666666667	1	0.0166666666666667	5	24
LOC101749023	3	15	4	8	675.84	1351.68	15	2	0.391547303271441	-1.5	1	-0.166666666666667	12	18
LOC101749223	21	70	4	13	2067.45	4134.9	15	2	1	-0.0256410256410255	1	-0.00452488687782804	17	91
LOC101749641	14	9	0	3	327.69	655.38	15	2	0.0846153846153846	1	1	0.608695652173913	3	23
LOC101750112-LOC420486	18	31	1	1	479.49	958.98	15	2	1	-0.722222222222222	1	-0.13265306122449	2	49
LOC101750690	1	15	1	3	333.96	667.92	15	2	0.368421052631579	-4	1	-0.1875	4	16
LOC101751687	8	2	1	2	119.46	238.92	15	2	0.202797202797203	0.875	1	0.466666666666667	3	10
LOC101751874	71	71	26	14	1436.16	2872.32	15	2	0.108019175728469	-0.857142857142857	1	-0.15	40	142
LOC101752020-LOC107049176	3	0	0	0	80.52	161.04	15	2	1	NA	1	NA	0	3
LOC101752065	18	14	7	10	421.41	842.82	15	2	0.377154177611742	0.455555555555556	1	0.150735294117647	17	32
LOC101752250	9	8	0	1	229.68	459.36	15	2	1	1	1	0.529411764705882	1	17
LOC107048995	12	14	0	1	278.19	556.38	15	2	1	1	1	0.461538461538462	1	26
LOC107049066	7	14	0	1	321.75	643.5	15	2	1	1	1	0.333333333333333	1	21
LOC107050254	3	17	6	5	282.15	564.3	15	2	0.0377327465299608	-5.8	1	-0.395454545454545	11	20
LOC107050336	10	6	0	0	102.63	205.26	15	2	1	NA	1	NA	0	16
LOC107050437	65	133	19	22	2423.85	4847.7	15	2	0.108311341906692	-0.767132867132867	1	-0.135131805863513	41	198
LOC107050879	3	35	1	11	956.01	1912.02	15	2	1	-0.0606060606060606	1	-0.0043859649122807	12	38
LOC107051671	25	14	1	1	262.35	524.7	15	2	1	0.44	1	0.141025641025641	2	39
LOC107051674	12	8	0	0	93.06	186.12	15	2	1	NA	1	NA	0	20
LOC107051902-LRRC63	32	23	7	4	369.27	738.54	15	2	1	-0.2578125	1	-0.0545454545454546	11	55
LOC107052104	43	30	11	11	691.02	1382.04	15	2	0.473297969035739	0.302325581395349	1	0.089041095890411	22	73
LOC107052456	9	13	3	4	307.23	614.46	15	2	1	-0.0833333333333333	1	-0.0194805194805194	7	22
LOC107052463	11	20	2	0	315.81	631.62	15	2	0.147727272727273	-Inf	1	-0.645161290322581	2	31
LOC107052467	7	9	7	8	291.72	583.44	15	2	1	-0.125	1	-0.0291666666666667	15	16
LOC107052576	2	3	1	0	134.64	269.28	15	2	1	-Inf	1	-0.6	1	5
LOC107052690	8	12	3	4	250.47	500.94	15	2	1	-0.125	1	-0.0285714285714285	7	20
LOC107052763	3	7	0	1	193.38	386.76	15	2	1	1	1	0.3	1	10
LOC107052882	12	7	4	2	265.32	530.64	15	2	1	-0.166666666666667	1	-0.0350877192982456	6	19
LOC107053055	54	59	8	5	1619.64	3239.28	15	2	0.392618619606331	-0.748148148148148	1	-0.137508509189925	13	113
LOC107054332-PARP11	4	10	0	0	340.56	681.12	15	2	1	NA	1	NA	0	14
LOC107055625-LOC107055677-LOC107055678	20	13	0	3	304.26	608.52	15	2	0.0784313725490197	1	1	0.606060606060606	3	33
LOC107055878	6	21	4	12	450.12	900.24	15	2	1	-0.166666666666667	1	-0.0277777777777778	16	27
LOC107055922-RP1	200	152	21	10	4660.59	9321.18	15	2	0.261039751481872	-0.596	1	-0.109237536656891	31	352
LOC112529930	18	9	1	2	187.11	374.22	15	2	0.536699507389163	0.75	1	0.333333333333333	3	27
LOC112530493	7	2	1	0	380.49	760.98	15	2	1	-Inf	1	-0.222222222222222	1	9
LOC112530510-SAMSN1	26	21	0	1	628.65	1257.3	15	2	0.458333333333333	1	1	0.553191489361702	1	47
LOC112530847	5	12	2	0	177.21	354.42	15	2	0.12280701754386	-Inf	1	-0.705882352941176	2	17
LOC112530909	69	43	22	15	813.45	1626.9	15	2	0.847390311970575	0.0859903381642512	1	0.021476833976834	37	112
LOC112530976	6	6	0	3	208.89	417.78	15	2	0.228571428571429	1	1	0.5	3	12
LOC112531016-LOC112531021	17	16	15	16	439.56	879.12	15	2	1	0.117647058823529	1	0.0312805474095796	31	33
LOC112531540	2	0	0	0	23.43	46.86	15	2	1	NA	1	NA	0	2
LOC112531549	46	12	4	3	2052.93	4105.86	15	2	0.338068732216076	0.652173913043478	1	0.221674876847291	7	58
LOC112531692	11	21	7	9	548.46	1096.92	15	2	0.54506824885182	-0.484848484848485	1	-0.09375	16	32
LOC112531842	6	3	1	0	139.59	279.18	15	2	1	-Inf	1	-0.333333333333333	1	9
LOC112531844	3	0	1	0	88.11	176.22	15	2	1	NA	1	0	1	3
LOC112531899	14	7	0	0	104.61	209.22	15	2	1	NA	1	NA	0	21
LOC112532681	21	16	3	1	474.21	948.42	15	2	0.629347289424311	-1.28571428571429	1	-0.182432432432432	4	37
LOC112533211	18	5	5	3	116.16	232.32	15	2	0.393086715533879	0.537037037037037	1	0.157608695652174	8	23
LOC395159	4	5	0	1	203.28	406.56	15	2	1	1	1	0.444444444444444	1	9
LOC395944	46	68	6	4	1873.08	3746.16	15	2	0.318430460809675	-1.21739130434783	1	-0.196491228070175	10	114
LOC396098	13	19	1	4	331.65	663.3	15	2	0.630277336159689	0.634615384615385	1	0.20625	5	32
LOC414835	76	148	20	26	2599.74	5199.48	15	2	0.238607929204593	-0.497975708502024	1	-0.0954968944099379	46	224
LOC417741	5	10	1	2	284.13	568.26	15	2	1	0	1	0	3	15
LOC417937	14	24	3	8	617.76	1235.52	15	2	0.725056277365199	0.357142857142857	1	0.0956937799043062	11	38
LOC417973	52	20	2	3	334.62	669.24	15	2	0.154172918412284	0.743589743589744	1	0.322222222222222	5	72
LOC418108	16	20	2	0	297.33	594.66	15	2	0.217638691322902	-Inf	1	-0.555555555555556	2	36
LOC418114	21	35	8	6	698.94	1397.88	15	2	0.230498935014317	-1.22222222222222	1	-0.196428571428571	14	56
LOC418222	14	8	1	1	313.5	627	15	2	1	0.428571428571429	1	0.136363636363636	2	22
LOC418298	1	15	3	0	313.83	627.66	15	2	0.00412796697626419	-Inf	1	-0.9375	3	16
LOC418355	5	15	0	2	216.81	433.62	15	2	1	1	1	0.25	2	20
LOC418414	5	3	1	0	119.79	239.58	15	2	1	-Inf	1	-0.375	1	8
LOC418421	27	19	2	0	717.75	1435.5	15	2	0.511524822695036	-Inf	1	-0.41304347826087	2	46
LOC418544	9	20	0	6	527.67	1055.34	15	2	0.303691564602381	1	1	0.310344827586207	6	29
LOC418667	8	19	2	0	282.15	564.3	15	2	0.110837438423645	-Inf	1	-0.703703703703704	2	27
LOC418701	4	15	2	4	198	396	15	2	0.606053077357425	-0.875	1	-0.12280701754386	6	19
LOC418927	1	6	1	0	128.7	257.4	15	2	0.25	-Inf	1	-0.857142857142857	1	7
LOC419074	5	41	0	5	734.91	1469.82	15	2	1	1	1	0.108695652173913	5	46
LOC419080	2	19	0	5	273.9	547.8	15	2	1	1	1	0.0952380952380952	5	21
LOC419112	3	8	1	2	266.31	532.62	15	2	1	-0.333333333333333	1	-0.0606060606060606	3	11
LOC420294	49	51	9	12	765.27	1530.54	15	2	0.639299759019817	0.219387755102041	1	0.0614285714285714	21	100
LOC420734	13	12	0	1	248.49	496.98	15	2	1	1	1	0.52	1	25
LOC420748	67	40	1	4	774.18	1548.36	15	2	0.0769048865379141	0.850746268656716	1	0.426168224299065	5	107
LOC420807	12	11	3	3	375.54	751.08	15	2	1	0.0833333333333334	1	0.0217391304347826	6	23
LOC420992	15	16	2	4	477.18	954.36	15	2	0.666549666549667	0.466666666666667	1	0.150537634408602	6	31
LOC421081	15	12	3	1	203.94	407.88	15	2	0.620721436516765	-1.4	1	-0.194444444444444	4	27
LOC421106	35	37	12	2	886.71	1773.42	15	2	0.0168228852009226	-5.34285714285714	1	-0.371031746031746	14	72
LOC421108	23	31	5	7	818.73	1637.46	15	2	1	0.0372670807453416	1	0.00925925925925924	12	54
LOC421195	160	124	10	9	2456.85	4913.7	15	2	0.813657712419469	0.138888888888889	1	0.0370644922164567	19	284
LOC421255	3	0	2	0	663.63	1327.26	15	2	1	NA	1	0	2	3
LOC421285	77	69	28	27	846.45	1692.9	15	2	0.874685778218057	0.0707070707070707	1	0.0183063511830636	55	146
LOC421502	43	17	3	0	419.76	839.52	15	2	0.556923774269094	-Inf	1	-0.283333333333333	3	60
LOC421584	16	28	2	5	550.44	1100.88	15	2	1	0.3	1	0.0779220779220779	7	44
LOC421690	22	22	2	4	569.25	1138.5	15	2	0.668837747865104	0.5	1	0.166666666666667	6	44
LOC421856	2	7	0	2	216.81	433.62	15	2	1	1	1	0.222222222222222	2	9
LOC421892	35	24	2	4	616.77	1233.54	15	2	0.389585790993776	0.657142857142857	1	0.259887005649718	6	59
LOC421965	6	23	4	2	480.15	960.3	15	2	0.0428238744178023	-6.66666666666667	1	-0.459770114942529	6	29
LOC422147	6	18	6	9	368.28	736.56	15	2	0.477531562184445	-1	1	-0.15	15	24
LOC422150	5	5	4	1	240.57	481.14	15	2	0.580419580419581	-3	1	-0.3	5	10
LOC422171	32	39	5	4	1099.56	2199.12	15	2	0.7258529390535	-0.5234375	1	-0.104851330203443	9	71
LOC425623	1	1	0	0	21.45	42.9	15	2	1	NA	1	NA	0	2
LOC426037	4	9	1	2	118.8	237.6	15	2	1	-0.125	1	-0.0256410256410256	3	13
LOC426385	3	9	1	9	329.67	659.34	15	2	0.593984962406015	0.666666666666667	1	0.15	10	12
LOC427933	3	13	1	0	283.14	566.28	15	2	0.235294117647059	-Inf	1	-0.8125	1	16
LOC428094	16	31	2	4	539.55	1079.1	15	2	1	0.03125	1	0.00709219858156029	6	47
LOC428383	6	13	3	4	264.33	528.66	15	2	0.661343873517787	-0.625	1	-0.112781954887218	7	19
LOC428667	10	11	2	4	393.69	787.38	15	2	0.661835748792271	0.45	1	0.142857142857143	6	21
LOC429348	4	17	3	4	236.61	473.22	15	2	0.318285699807439	-2.1875	1	-0.238095238095238	7	21
LOC430443	0	6	0	1	187.11	374.22	15	2	1	NA	1	0	1	6
LOC431250	7	17	0	6	349.47	698.94	15	2	0.290138520483348	1	1	0.291666666666667	6	24
LOC693258	10	17	5	6	249.81	499.62	15	2	0.721903842106845	-0.416666666666667	1	-0.0841750841750842	11	27
LOC769510	72	77	17	24	883.08	1766.16	15	2	0.482581358218976	0.242476851851852	1	0.0685873301686037	41	149
LOC769512	2	15	3	10	303.93	607.86	15	2	0.627805145046525	-1.25	1	-0.113122171945701	13	17
LOC770026	16	23	2	3	306.9	613.8	15	2	1	0.0416666666666666	1	0.0102564102564102	5	39
LOC770271	48	21	5	5	275.55	551.1	15	2	0.283643288206199	0.5625	1	0.195652173913043	10	69
LOC770996	9	31	7	8	727.65	1455.3	15	2	0.101732698134908	-2.01388888888889	1	-0.241666666666667	15	40
LOC771012	22	25	1	2	343.53	687.06	15	2	1	0.431818181818182	1	0.134751773049645	3	47
LOC771085	18	21	7	2	395.01	790.02	15	2	0.140216748530672	-3.08333333333333	1	-0.316239316239316	9	39
LOC776067	130	150	9	19	3059.43	6118.86	15	2	0.167109566913494	0.453441295546559	1	0.142857142857143	28	280
LOC776273	0	48	2	24	1278.09	2556.18	15	2	0.120325805257312	-Inf	1	-0.0769230769230769	26	48
LPAR4	1	16	2	4	345.51	691.02	15	2	0.15527950310559	-7	1	-0.274509803921569	6	17
LPAR5	15	17	0	2	367.29	734.58	15	2	0.491978609625668	1	1	0.46875	2	32
LPCAT1	5	18	0	2	518.76	1037.52	15	2	1	1	1	0.217391304347826	2	23
LPCAT3	9	26	2	4	552.42	1104.84	15	2	0.65137216806023	-0.444444444444444	1	-0.0761904761904762	6	35
LPGAT1	1	8	0	0	311.85	623.7	15	2	1	NA	1	NA	0	9
LPIN2	10	34	1	6	878.13	1756.26	15	2	1	0.433333333333333	1	0.0844155844155844	7	44
LRCH1	15	19	2	3	667.26	1334.52	15	2	1	0.155555555555556	1	0.0411764705882353	5	34
LRFN2	1	16	1	1	297	594	15	2	0.204678362573099	-15	1	-0.441176470588235	2	17
LRGUK	31	33	5	14	700.26	1400.52	15	2	0.11586743176348	0.619815668202765	1	0.221217105263158	19	64
LRIG3	20	33	5	4	1092.96	2185.92	15	2	0.464616795131004	-1.0625	1	-0.178197064989518	9	53
LRMP	64	64	10	5	1433.52	2867.04	15	2	0.279709817804313	-1	1	-0.166666666666667	15	128
LRP11	4	15	0	2	308.88	617.76	15	2	1	1	1	0.210526315789474	2	19
LRP12	2	42	2	5	825.66	1651.32	15	2	0.0857983193277311	-7.4	1	-0.24025974025974	7	44
LRP6	7	84	1	4	1596.87	3193.74	15	2	0.359078087477953	-2	1	-0.123076923076923	5	91
LRRC1	13	30	9	7	764.28	1528.56	15	2	0.0784630253388981	-1.96703296703297	1	-0.260174418604651	16	43
LRRC10	0	12	1	3	275.22	550.44	15	2	0.25	-Inf	1	-0.25	4	12
LRRC14B	34	35	6	9	959.97	1919.94	15	2	0.577923210862027	0.313725490196078	1	0.0927536231884058	15	69
LRRC17	1	9	1	0	433.62	867.24	15	2	0.181818181818182	-Inf	1	-0.9	1	10
LRRC23	10	17	4	5	332.64	665.28	15	2	0.711512791991101	-0.36	1	-0.0740740740740741	9	27
LRRC30	13	15	3	1	296.01	592.02	15	2	0.599555061179088	-2.46153846153846	1	-0.285714285714286	4	28
LRRC32	11	25	3	2	669.24	1338.48	15	2	0.316951739929917	-2.40909090909091	1	-0.294444444444444	5	36
LRRC6	23	26	4	3	717.75	1435.5	15	2	0.700446473615175	-0.507246376811594	1	-0.102040816326531	7	49
LRRC72	8	12	2	1	226.71	453.42	15	2	0.55957086391869	-2	1	-0.266666666666667	3	20
LRRC73	1	9	2	1	298.65	597.3	15	2	0.108391608391608	-17	1	-0.566666666666667	3	10
LRRCC1	45	41	9	6	1019.7	2039.4	15	2	0.78006432356292	-0.366666666666667	1	-0.0767441860465116	15	86
LRRIQ1	84	43	5	2	1466.85	2933.7	15	2	1	-0.279761904761905	1	-0.0528683914510686	7	127
LRRK2	21	103	7	15	2506.68	5013.36	15	2	0.138464027022025	-1.28888888888889	1	-0.148826979472141	22	124
LRRN3	10	26	1	2	701.91	1403.82	15	2	1	-0.3	1	-0.0555555555555555	3	36
LRRN4	40	43	11	5	775.17	1550.34	15	2	0.174675450835946	-1.365	1	-0.205572289156627	16	83
LRTM2	2	9	0	3	367.29	734.58	15	2	1	1	1	0.181818181818182	3	11
LSAMP	0	4	0	1	165.99	331.98	15	2	1	NA	1	0	1	4
LSM5	0	3	1	1	91.08	182.16	15	2	0.4	-Inf	1	-0.5	2	3
LSMEM1	10	7	2	2	156.42	312.84	15	2	1	0.3	1	0.0882352941176471	4	17
LTA4H	7	21	2	6	601.92	1203.84	15	2	1	0	1	0	8	28
LTBP1	16	40	6	5	1859.88	3719.76	15	2	0.157162532967073	-2	1	-0.25974025974026	11	56
LTN1	46	68	12	11	1746.36	3492.72	15	2	0.357038194051676	-0.612648221343874	1	-0.118230358504958	23	114
LTV1	17	31	3	9	626.67	1253.34	15	2	0.733732916211598	0.392156862745098	1	0.104166666666667	12	48
LUC7L2	0	7	0	1	375.21	750.42	15	2	1	NA	1	0	1	7
LUM	2	13	0	0	340.56	681.12	15	2	1	NA	1	NA	0	15
LY6CLEL	6	13	1	4	125.73	251.46	15	2	1	0.458333333333333	1	0.11578947368421	5	19
LY6E	4	5	0	0	125.73	251.46	15	2	1	NA	1	NA	0	9
LY6EL	2	5	1	0	125.73	251.46	15	2	0.375	-Inf	1	-0.714285714285714	1	7
LY96	6	6	0	0	154.44	308.88	15	2	1	NA	1	NA	0	12
LYG2	13	15	0	3	207.9	415.8	15	2	0.245161290322581	1	1	0.464285714285714	3	28
LYPD2	9	4	1	2	126.72	253.44	15	2	0.517857142857143	0.777777777777778	1	0.358974358974359	3	13
LYPLA1	1	9	0	2	224.73	449.46	15	2	1	1	1	0.1	2	10
LYPLAL1	4	8	0	1	234.63	469.26	15	2	1	1	1	0.333333333333333	1	12
LYRM2	3	3	0	2	88.11	176.22	15	2	0.464285714285714	1	1	0.5	2	6
LYST	75	130	24	30	3763.98	7527.96	15	2	0.345195698290916	-0.386666666666667	1	-0.0785907859078591	54	205
LZTFL1	2	17	1	4	295.02	590.04	15	2	0.521245059288538	-1.125	1	-0.0947368421052632	5	19
M6PR	11	15	1	2	276.21	552.42	15	2	1	0.318181818181818	1	0.0897435897435898	3	26
MAATS1	22	25	2	5	665.28	1330.56	15	2	0.443201760626844	0.545454545454545	1	0.182370820668693	7	47
MAB21L1	0	13	0	1	356.07	712.14	15	2	1	NA	1	0	1	13
MAB21L3	4	9	2	2	384.12	768.24	15	2	0.584033613445378	-1.25	1	-0.192307692307692	4	13
MACC1	22	35	3	5	860.31	1720.62	15	2	1	0.0454545454545454	1	0.0109649122807017	8	57
MACROD2	14	10	3	1	289.08	578.16	15	2	1	-1.14285714285714	1	-0.166666666666667	4	24
MAD2L1BP	15	9	2	1	269.28	538.56	15	2	1	-0.2	1	-0.0416666666666666	3	24
MAEL	15	15	2	3	406.89	813.78	15	2	1	0.333333333333333	1	0.1	5	30
MAFF	0	4	1	1	148.5	297	15	2	0.333333333333333	-Inf	1	-0.5	2	4
MAGI2	7	38	4	4	1067.22	2134.44	15	2	0.0481229539971959	-4.42857142857143	1	-0.344444444444444	8	45
MAK	23	16	7	3	639.21	1278.42	15	2	0.719941396894629	-0.623188405797102	1	-0.11025641025641	10	39
MAL	19	10	0	2	154.44	308.88	15	2	0.141935483870968	1	1	0.655172413793103	2	29
MAL2	0	8	0	0	147.84	295.68	15	2	1	NA	1	NA	0	8
MALL	4	4	0	1	153.45	306.9	15	2	1	1	1	0.5	1	8
MALSU1	13	9	7	3	199.98	399.96	15	2	0.702595972485221	-0.615384615384615	1	-0.109090909090909	10	22
MAN1A1	0	21	1	1	462.33	924.66	15	2	0.0869565217391305	-Inf	1	-0.5	2	21
MANEA	8	18	1	0	453.42	906.84	15	2	0.333333333333333	-Inf	1	-0.692307692307692	1	26
MANSC1	31	16	1	0	439.56	879.12	15	2	1	-Inf	1	-0.340425531914894	1	47
MANSC4	15	10	1	1	242.22	484.44	15	2	1	0.333333333333333	1	0.1	2	25
MAOA	9	15	2	4	526.68	1053.36	15	2	1	0.166666666666667	1	0.0416666666666667	6	24
MAOB	13	22	3	4	607.2	1214.4	15	2	1	-0.269230769230769	1	-0.0571428571428571	7	35
MAP1LC3C	2	4	1	1	141.57	283.14	15	2	1	-1	1	-0.166666666666667	2	6
MAP3K15	35	54	6	10	1431.21	2862.42	15	2	1	0.0742857142857143	1	0.0182584269662922	16	89
MAP3K21	15	34	2	10	1022.67	2045.34	15	2	0.481139035404001	0.546666666666667	1	0.139455782312925	12	49
MAP3K4	14	57	4	5	1543.41	3086.82	15	2	0.10929659714123	-2.25714285714286	1	-0.247261345852895	9	71
MAP3K5	4	55	3	9	1321.32	2642.64	15	2	0.0884509490575016	-3.58333333333333	1	-0.182203389830508	12	59
MAP3K7	1	7	0	3	601.92	1203.84	15	2	1	1	1	0.125	3	8
MAP3K7CL	1	3	0	0	178.2	356.4	15	2	1	NA	1	NA	0	4
MAP3K8	7	26	1	2	483.12	966.24	15	2	0.541176470588235	-0.857142857142857	1	-0.121212121212121	3	33
MAP4	221	171	30	22	1988.91	3977.82	15	2	0.882824942418287	-0.0551213492389964	1	-0.0131475667189952	52	392
MAP4K3	4	44	0	5	858.33	1716.66	15	2	1	1	1	0.0833333333333333	5	48
MAP4K4	11	43	4	11	1439.46	2878.92	15	2	0.724688168210353	-0.421487603305785	1	-0.062962962962963	15	54
MAP6	2	9	2	3	409.2	818.4	15	2	0.546703296703297	-2	1	-0.218181818181818	5	11
MAP7	13	15	2	3	731.61	1463.22	15	2	1	0.230769230769231	1	0.0642857142857143	5	28
MAP7D2	7	15	3	2	693	1386	15	2	0.326148891366283	-2.21428571428571	1	-0.281818181818182	5	22
MAPK12	9	7	3	2	442.2	884.4	15	2	1	-0.166666666666667	1	-0.0375	5	16
MAPK15	19	18	2	1	486.09	972.18	15	2	1	-0.894736842105263	1	-0.153153153153153	3	37
MAPKKK3L	1	21	1	7	638.55	1277.1	15	2	0.468965517241379	-2	1	-0.0795454545454545	8	22
MAPRE2	2	9	1	3	264.66	529.32	15	2	1	-0.5	1	-0.0681818181818182	4	11
MARC1	5	11	2	3	244.53	489.06	15	2	1	-0.466666666666667	1	-0.0875	5	16
MARCH11	1	8	1	0	238.59	477.18	15	2	0.2	-Inf	1	-0.888888888888889	1	9
MARCH6	1	35	5	5	902.88	1805.76	15	2	0.000990944738016181	-34	0.673656619712625	-0.472222222222222	10	36
MARCKS	2	3	1	3	267.63	535.26	15	2	1	0.5	1	0.15	4	5
MARK1	4	13	0	2	720.72	1441.44	15	2	1	1	1	0.235294117647059	2	17
MAS1	2	12	2	0	326.7	653.4	15	2	0.05	-Inf	1	-0.857142857142857	2	14
MASTL	34	46	5	9	895.95	1791.9	15	2	0.772060394063168	0.248366013071895	1	0.0678571428571428	14	80
MATN2	26	42	7	12	1210.77	2421.54	15	2	1	0.0576923076923077	1	0.0139318885448916	19	68
MATN3	5	24	3	2	466.29	932.58	15	2	0.0721493876142833	-6.2	1	-0.427586206896552	5	29
MB	2	5	0	3	153.45	306.9	15	2	1	1	1	0.285714285714286	3	7
MB21D1	18	15	2	2	343.86	687.72	15	2	1	0.166666666666667	1	0.0454545454545454	4	33
MBNL2	7	3	0	1	359.37	718.74	15	2	0.363636363636364	1	1	0.7	1	10
MBOAT1	1	12	0	4	490.05	980.1	15	2	1	1	1	0.0769230769230769	4	13
MBOAT2	3	12	0	2	438.57	877.14	15	2	1	1	1	0.2	2	15
MBP	2	3	1	1	278.19	556.38	15	2	1	-0.5	1	-0.1	2	5
MBTPS2	5	18	1	2	490.05	980.1	15	2	1	-0.8	1	-0.115942028985507	3	23
MC2R	3	13	1	0	316.8	633.6	15	2	0.235294117647059	-Inf	1	-0.8125	1	16
MC5R	0	4	2	2	322.74	645.48	15	2	0.428571428571429	-Inf	1	-0.5	4	4
MCFD2	3	6	1	0	142.56	285.12	15	2	0.4	-Inf	1	-0.666666666666667	1	9
MCM10	11	25	6	5	406.23	812.46	15	2	0.170630172699559	-1.72727272727273	1	-0.23989898989899	11	36
MCM3	4	46	2	16	802.89	1605.78	15	2	0.651562221799272	-0.4375	1	-0.0311111111111111	18	50
MCM4	4	52	5	9	852.39	1704.78	15	2	0.0126705902054779	-6.22222222222222	1	-0.285714285714286	14	56
MCM5	3	46	2	27	727.65	1455.3	15	2	1	-0.135802469135802	1	-0.00774102744546094	29	49
MCM8	10	78	2	13	987.03	1974.06	15	2	0.686039873880683	-0.2	1	-0.0196969696969697	15	88
MCM9	31	40	5	7	784.08	1568.16	15	2	1	0.0783410138248848	1	0.0199530516431924	12	71
MCMDC2	30	42	7	4	675.18	1350.36	15	2	0.205037388407596	-1.45	1	-0.21969696969697	11	72
MCPH1	36	15	2	1	697.95	1395.9	15	2	1	0.166666666666667	1	0.0392156862745099	3	51
MCUR1	4	10	1	3	250.47	500.94	15	2	1	0.166666666666667	1	0.0357142857142857	4	14
MDH1	0	11	1	2	331.65	663.3	15	2	0.214285714285714	-Inf	1	-0.333333333333333	3	11
MDM1	31	31	2	4	731.61	1463.22	15	2	0.673746651358592	0.5	1	0.166666666666667	6	62
MDM2	7	22	2	6	480.15	960.3	15	2	1	-0.0476190476190477	1	-0.0086206896551724	8	29
MDN1	142	217	34	28	5346.99	10693.98	15	2	0.0262969644169794	-0.855633802816901	1	-0.152843921286728	62	359
ME1	2	25	4	1	537.57	1075.14	15	2	0.00196647068170984	-49	0.891220900206579	-0.725925925925926	5	27
ME3	12	11	1	1	304.92	609.84	15	2	1	0.0833333333333334	1	0.0217391304347826	2	23
MEA1	5	5	3	0	166.32	332.64	15	2	0.230769230769231	-Inf	1	-0.5	3	10
MED10	1	7	0	0	135.63	271.26	15	2	1	NA	1	NA	0	8
MED14	0	47	0	7	1433.52	2867.04	15	2	1	NA	1	0	7	47
MED17	2	32	0	8	637.56	1275.12	15	2	1	1	1	0.0588235294117647	8	34
MED21	2	3	0	1	143.55	287.1	15	2	1	1	1	0.4	1	5
MED30	0	2	0	0	178.2	356.4	15	2	1	NA	1	NA	0	2
MED4	1	19	1	7	258.06	516.12	15	2	0.497354497354497	-1.71428571428571	1	-0.075	8	20
MEI1	34	54	11	16	1416.36	2832.72	15	2	1	-0.0919117647058822	1	-0.021043771043771	27	88
MEI4	5	1	2	2	129.69	259.38	15	2	0.5	0.8	1	0.333333333333333	4	6
MEIG1	3	4	1	0	130.68	261.36	15	2	1	-Inf	1	-0.571428571428571	1	7
MEIS1	0	2	0	0	323.4	646.8	15	2	1	NA	1	NA	0	2
MEOX2	1	7	0	0	139.59	279.18	15	2	1	NA	1	NA	0	8
MEP1A	47	60	9	12	1204.5	2409	15	2	1	0.0425531914893617	1	0.0106809078771696	21	107
MEP1B	19	20	8	6	759	1518	15	2	0.757008728326124	-0.403508771929824	1	-0.0842490842490842	14	39
MERTK	33	73	11	18	969.21	1938.42	15	2	0.508354789096648	-0.351851851851852	1	-0.0679895901106051	29	106
MEST	11	23	4	6	316.8	633.6	15	2	0.713792257900686	-0.393939393939394	1	-0.0764705882352941	10	34
MET	10	36	5	4	1282.05	2564.1	15	2	0.0947744653863151	-3.5	1	-0.33816425120773	9	46
METAP2	2	19	1	7	480.15	960.3	15	2	1	-0.357142857142857	1	-0.0297619047619048	8	21
METTL16	6	20	2	0	554.4	1108.8	15	2	0.0740740740740741	-Inf	1	-0.769230769230769	2	26
METTL21C	5	9	1	0	265.32	530.64	15	2	0.4	-Inf	1	-0.642857142857143	1	14
METTL21EP	2	10	0	0	253.44	506.88	15	2	1	NA	1	NA	0	12
METTL24	13	22	4	6	356.4	712.8	15	2	1	-0.128205128205128	1	-0.0285714285714286	10	35
METTL25	16	13	2	1	510.18	1020.36	15	2	1	-0.625	1	-0.114942528735632	3	29
METTL4	39	22	6	3	589.38	1178.76	15	2	1	-0.128205128205128	1	-0.0273224043715846	9	61
METTL6	5	15	4	2	290.07	580.14	15	2	0.137853450896929	-5	1	-0.416666666666667	6	20
MFAP5	0	6	0	0	165.33	330.66	15	2	1	NA	1	NA	0	6
MFNG	13	12	3	4	351.45	702.9	15	2	1	0.307692307692308	1	0.0914285714285715	7	25
MFSD2B	5	20	5	4	508.2	1016.4	15	2	0.0847359308230865	-4	1	-0.355555555555556	9	25
MFSD4B	25	48	7	15	568.26	1136.52	15	2	1	0.104	1	0.0242839352428393	22	73
MGAT3	1	28	1	5	507.87	1015.74	15	2	0.31764705882353	-4.6	1	-0.132183908045977	6	29
MGAT4A	2	13	0	1	527.67	1055.34	15	2	1	1	1	0.133333333333333	1	15
MGME1	23	15	2	0	338.58	677.16	15	2	0.519230769230769	-Inf	1	-0.394736842105263	2	38
MGP	0	4	0	0	102.96	205.92	15	2	1	NA	1	NA	0	4
MGST1	3	4	1	0	154.44	308.88	15	2	1	-Inf	1	-0.571428571428571	1	7
MIB1	1	42	0	6	978.45	1956.9	15	2	1	1	1	0.0232558139534884	6	43
MICALL1	18	39	6	18	919.71	1839.42	15	2	0.60564761479994	0.277777777777778	1	0.0657894736842105	24	57
MICU2	5	16	1	2	384.12	768.24	15	2	1	-0.6	1	-0.0952380952380952	3	21
MID1	0	7	0	2	242.55	485.1	15	2	1	NA	1	0	2	7
MID1IP1	0	5	3	4	156.75	313.5	15	2	0.204545454545455	-Inf	1	-0.428571428571429	7	5
MIEF1	4	26	3	3	460.35	920.7	15	2	0.0732706572365016	-5.5	1	-0.366666666666667	6	30
MINA	11	19	4	4	468.27	936.54	15	2	0.686928389490059	-0.727272727272727	1	-0.133333333333333	8	30
MIOS	0	20	2	4	440.55	881.1	15	2	0.0461538461538462	-Inf	1	-0.333333333333333	6	20
MIPEP	15	26	2	9	761.31	1522.62	15	2	0.303804084820801	0.614814814814815	1	0.184035476718404	11	41
MIS18A	18	12	2	2	191.07	382.14	15	2	1	0.333333333333333	1	0.1	4	30
MITD1	0	9	1	2	248.49	496.98	15	2	0.25	-Inf	1	-0.333333333333333	3	9
MKKS	16	24	6	9	529.65	1059.3	15	2	1	0	1	0	15	40
MKL1	11	31	4	7	1005.84	2011.68	15	2	0.70808195651971	-0.61038961038961	1	-0.101731601731602	11	42
MKLN1	2	23	1	5	723.69	1447.38	15	2	0.488320355951057	-1.3	1	-0.0866666666666667	6	25
MKRN1	7	6	1	0	339.9	679.8	15	2	1	-Inf	1	-0.461538461538462	1	13
MKX	5	6	0	3	211.2	422.4	15	2	0.258241758241758	1	1	0.454545454545455	3	11
MLC1	3	12	0	0	376.2	752.4	15	2	1	NA	1	NA	0	15
MLF2	1	15	1	4	241.56	483.12	15	2	0.428571428571429	-2.75	1	-0.1375	5	16
MLH1	29	32	24	26	728.64	1457.28	15	2	1	-0.0185676392572944	1	-0.00459016393442624	50	61
MLIP	54	28	7	5	581.46	1162.92	15	2	0.747661643457145	0.274074074074074	1	0.0752032520325203	12	82
MLLT10	8	29	1	11	1040.49	2080.98	15	2	0.420306960009047	0.670454545454545	1	0.132882882882883	12	37
MLNR	7	16	4	11	355.41	710.82	15	2	1	0.168831168831169	1	0.0376811594202899	15	23
MMP1	9	15	2	1	462.33	924.66	15	2	0.548717948717949	-2.33333333333333	1	-0.291666666666667	3	24
MMP10	24	21	0	0	520.74	1041.48	15	2	1	NA	1	NA	0	45
MMP13	4	16	1	4	468.27	936.54	15	2	1	0	1	0	5	20
MMP16	17	16	1	0	367.29	734.58	15	2	1	-Inf	1	-0.484848484848485	1	33
MMP27	19	19	7	4	482.13	964.26	15	2	0.506200429750109	-0.75	1	-0.136363636363636	11	38
MMP7	11	9	0	1	265.32	530.64	15	2	0.476190476190476	1	1	0.55	1	20
MMR1L1	110	110	22	9	2620.2	5240.4	15	2	0.0344284141028011	-1.44444444444444	1	-0.209677419354839	31	220
MMR1L2	43	59	7	4	1423.62	2847.24	15	2	0.210525540343705	-1.40116279069767	1	-0.214795008912656	11	102
MMR1L4	32	62	9	9	1426.59	2853.18	15	2	0.284988164205737	-0.9375	1	-0.159574468085106	18	94
MMS22L	34	41	6	9	1239.48	2478.96	15	2	0.781435047079739	0.196078431372549	1	0.0533333333333333	15	75
MNX1	4	8	1	0	359.37	718.74	15	2	0.384615384615385	-Inf	1	-0.666666666666667	1	12
MOCOS	20	20	6	2	534.27	1068.54	15	2	0.2602899320304	-2	1	-0.25	8	40
MOCS1	8	23	6	2	590.04	1180.08	15	2	0.016086519956489	-7.625	1	-0.491935483870968	8	31
MON2	3	62	2	10	1696.86	3393.72	15	2	0.17073988191508	-3.13333333333333	1	-0.120512820512821	12	65
MORC3	18	41	1	5	899.91	1799.82	15	2	0.662166908316433	0.544444444444445	1	0.138418079096045	6	59
MOS	16	24	4	7	346.5	693	15	2	1	0.142857142857143	1	0.0363636363636364	11	40
MOSPD2	8	15	1	1	512.82	1025.64	15	2	1	-0.875	1	-0.152173913043478	2	23
MOV10L1	44	61	2	4	1194.93	2389.86	15	2	1	0.306818181818182	1	0.0857142857142857	6	105
MOXD1	5	12	0	3	566.94	1133.88	15	2	0.539473684210526	1	1	0.294117647058824	3	17
MPC1	6	5	1	1	132.33	264.66	15	2	1	0.166666666666667	1	0.0454545454545454	2	11
MPC2	1	4	0	2	125.73	251.46	15	2	1	1	1	0.2	2	5
MPHOSPH8	29	39	3	8	857.34	1714.68	15	2	0.510471446997807	0.495689655172414	1	0.153743315508021	11	68
MPLKIP	3	4	0	2	184.14	368.28	15	2	0.5	1	1	0.428571428571429	2	7
MPP2	0	20	2	3	485.1	970.2	15	2	0.0333333333333333	-Inf	1	-0.4	5	20
MPP7	0	14	2	2	571.23	1142.46	15	2	0.0392156862745098	-Inf	1	-0.5	4	14
MPPE1	11	18	4	2	395.01	790.02	15	2	0.367021735380369	-2.27272727272727	1	-0.28735632183908	6	29
MPST	5	21	1	4	294.03	588.06	15	2	1	-0.05	1	-0.00769230769230769	5	26
MRC1	17	35	8	16	1437.48	2874.96	15	2	1	-0.0294117647058822	1	-0.00641025641025639	24	52
MRE11	16	33	3	7	696.96	1393.92	15	2	1	0.116071428571429	1	0.0265306122448979	10	49
MROH1L1	26	72	13	25	1552.98	3105.96	15	2	0.402444422112291	-0.44	1	-0.0767991407089151	38	98
MRPL13	50	30	9	4	531.63	1063.26	15	2	0.762281683805961	-0.35	1	-0.0673076923076923	13	80
MRPL14	5	11	1	3	144.54	289.08	15	2	1	0.266666666666667	1	0.0625	4	16
MRPL15	1	7	0	1	292.05	584.1	15	2	1	1	1	0.125	1	8
MRPL18	5	11	4	5	181.17	362.34	15	2	0.670738995827164	-0.76	1	-0.131944444444444	9	16
MRPL19	5	16	1	0	226.71	453.42	15	2	0.272727272727273	-Inf	1	-0.761904761904762	1	21
MRPL3	6	28	1	2	334.62	669.24	15	2	0.477477477477477	-1.33333333333333	1	-0.156862745098039	3	34
MRPL30	4	4	1	2	151.47	302.94	15	2	1	0.5	1	0.166666666666667	3	8
MRPL39	13	17	3	0	341.55	683.1	15	2	0.102639296187683	-Inf	1	-0.566666666666667	3	30
MRPL42	7	4	0	1	145.53	291.06	15	2	0.416666666666667	1	1	0.636363636363636	1	11
MRPL48	12	15	4	4	210.87	421.74	15	2	1	-0.25	1	-0.0555555555555556	8	27
MRPL51	4	4	2	2	149.49	298.98	15	2	1	0	1	0	4	8
MRPL55	7	6	3	3	125.73	251.46	15	2	1	0.142857142857143	1	0.0384615384615384	6	13
MRPL57	0	6	1	0	102.96	205.92	15	2	0.142857142857143	-Inf	1	-1	1	6
MRPS10	13	7	4	0	196.02	392.04	15	2	0.283267457180501	-Inf	1	-0.35	4	20
MRPS18A	5	6	4	0	189.09	378.18	15	2	0.103296703296703	-Inf	1	-0.545454545454545	4	11
MRPS28	0	2	0	1	132.66	265.32	15	2	1	NA	1	0	1	2
MRPS31	16	16	4	5	392.37	784.74	15	2	1	0.2	1	0.0555555555555556	9	32
MRPS33	1	3	0	0	105.93	211.86	15	2	1	NA	1	NA	0	4
MRPS35	14	16	2	0	329.67	659.34	15	2	0.483870967741935	-Inf	1	-0.533333333333333	2	30
MRPS5	6	16	1	4	399.63	799.26	15	2	1	0.333333333333333	1	0.0727272727272727	5	22
MRPS6	0	4	0	0	112.86	225.72	15	2	1	NA	1	NA	0	4
MRPS9	8	16	0	3	373.23	746.46	15	2	0.532307692307692	1	1	0.333333333333333	3	24
MRS2	2	16	0	0	354.09	708.18	15	2	1	NA	1	NA	0	18
MSANTD3	1	8	0	1	272.25	544.5	15	2	1	1	1	0.111111111111111	1	9
MSANTD4	2	10	0	1	342.54	685.08	15	2	1	1	1	0.166666666666667	1	12
MSC	3	12	1	1	186.12	372.24	15	2	0.426470588235294	-3	1	-0.3	2	15
MSGN1	3	13	1	0	168.3	336.6	15	2	0.235294117647059	-Inf	1	-0.8125	1	16
MSH2	11	42	4	3	921.03	1842.06	15	2	0.0584504803797923	-4.09090909090909	1	-0.363881401617251	7	53
MSH6	17	110	11	17	1276.11	2552.22	15	2	0.00480083433616986	-3.18685121107266	1	-0.258998875140607	28	127
MSL3	0	21	1	4	517.77	1035.54	15	2	0.192307692307692	-Inf	1	-0.2	5	21
MSRA	3	5	0	1	176.22	352.44	15	2	1	1	1	0.375	1	8
MSRB3	1	2	1	1	181.17	362.34	15	2	1	-1	1	-0.166666666666667	2	3
MTA3	6	21	2	0	621.72	1243.44	15	2	0.0689655172413793	-Inf	1	-0.777777777777778	2	27
MTBP	29	36	9	6	871.2	1742.4	15	2	0.391207067432244	-0.862068965517241	1	-0.153846153846154	15	65
MTCL1	16	32	8	11	1499.85	2999.7	15	2	0.576347612584185	-0.454545454545455	1	-0.087719298245614	19	48
MTDH	4	18	2	6	614.79	1229.58	15	2	0.645198938992042	-0.5	1	-0.0681818181818182	8	22
MTERF2	23	25	6	2	394.02	788.04	15	2	0.254360955359845	-2.26086956521739	1	-0.270833333333333	8	48
MTERF3	13	17	4	4	410.85	821.7	15	2	1	-0.307692307692308	1	-0.0666666666666667	8	30
MTFR1	11	11	3	2	370.26	740.52	15	2	1	-0.5	1	-0.1	5	22
MTFR2	14	12	0	0	362.34	724.68	15	2	1	NA	1	NA	0	26
MTHFD1L	21	34	10	7	888.03	1776.06	15	2	0.166172689515465	-1.31292517006803	1	-0.206417112299465	17	55
MTIF2	15	39	1	3	719.73	1439.46	15	2	1	0.133333333333333	1	0.0277777777777778	4	54
MTIF3	10	18	3	5	265.32	530.64	15	2	1	-0.0800000000000001	1	-0.0178571428571428	8	28
MTMR2	1	40	0	6	639.54	1279.08	15	2	1	1	1	0.024390243902439	6	41
MTMR6	7	20	1	5	574.2	1148.4	15	2	1	0.428571428571429	1	0.0925925925925926	6	27
MTMR9	15	22	2	8	545.49	1090.98	15	2	0.289434492653183	0.633333333333333	1	0.205405405405405	10	37
MTNR1B	4	12	2	2	357.39	714.78	15	2	0.54922600619195	-2	1	-0.25	4	16
MTO1	16	19	10	6	687.06	1374.12	15	2	0.36782416326472	-0.979166666666667	1	-0.167857142857143	16	35
MTPAP	15	18	1	3	519.42	1038.84	15	2	0.618441971383148	0.6	1	0.204545454545455	4	33
MTPN	0	2	0	0	89.1	178.2	15	2	1	NA	1	NA	0	2
MTR	12	45	9	7	1197.57	2395.14	15	2	0.0109770170448687	-3.82142857142857	1	-0.351973684210526	16	57
MTRF1	14	19	1	2	428.67	857.34	15	2	1	0.321428571428571	1	0.0909090909090909	3	33
MTRF1L	13	13	1	4	392.04	784.08	15	2	0.344456803856137	0.75	1	0.3	5	26
MTRR	23	23	6	3	663.3	1326.6	15	2	0.475068106144688	-1	1	-0.166666666666667	9	46
MTSS1	12	28	5	7	693.99	1387.98	15	2	0.495936508502865	-0.666666666666667	1	-0.116666666666667	12	40
MTUS2	42	27	11	8	918.39	1836.78	15	2	1	0.116071428571429	1	0.0297482837528604	19	69
MURC	3	15	1	4	352.44	704.88	15	2	1	-0.25	1	-0.0333333333333334	5	18
MUT	9	31	1	4	741.51	1483.02	15	2	1	0.138888888888889	1	0.025	5	40
MX1	72	23	2	4	651.75	1303.5	15	2	0.0423505794720015	0.840277777777778	1	0.424561403508772	6	95
MXRA5	87	97	15	8	2868.36	5736.72	15	2	0.124148031999799	-1.09051724137931	1	-0.179347826086957	23	184
MYBL1	5	23	0	3	746.46	1492.92	15	2	1	1	1	0.178571428571429	3	28
MYBPC1	3	34	3	6	1113.75	2227.5	15	2	0.0791455455688853	-4.66666666666667	1	-0.252252252252252	9	37
MYC	3	23	2	1	414.81	829.62	15	2	0.0684181718664477	-14.3333333333333	1	-0.551282051282051	3	26
MYCBP2	13	164	5	12	4663.56	9327.12	15	2	0.0118814425856186	-4.25641025641026	1	-0.220671319375208	17	177
MYCT1	5	6	3	1	229.68	459.36	15	2	0.569230769230769	-2.6	1	-0.295454545454545	4	11
MYD88	2	14	1	3	294.03	588.06	15	2	0.508771929824561	-1.33333333333333	1	-0.125	4	16
MYF5	0	12	0	0	253.44	506.88	15	2	1	NA	1	NA	0	12
MYF6	1	9	0	1	205.92	411.84	15	2	1	1	1	0.1	1	10
MYH15	5	74	1	8	1918.62	3837.24	15	2	0.487088644213156	-0.85	1	-0.0478199718706048	9	79
MYH9	5	71	1	9	1942.38	3884.76	15	2	0.535006744168372	-0.577777777777778	1	-0.0342105263157895	10	76
MYL12A	2	22	0	1	389.07	778.14	15	2	1	1	1	0.0833333333333333	1	24
MYL3	0	7	1	1	192.06	384.12	15	2	0.222222222222222	-Inf	1	-0.5	2	7
MYLIP	4	26	1	9	441.54	883.08	15	2	1	0.277777777777778	1	0.0333333333333333	10	30
MYO16	39	56	6	4	1615.35	3230.7	15	2	0.320164979080892	-1.15384615384615	1	-0.189473684210526	10	95
MYO1G	9	13	6	22	613.8	1227.6	15	2	0.213793146348872	0.606060606060606	1	0.194805194805195	28	22
MYO3A	37	68	11	9	1730.52	3461.04	15	2	0.131822859410341	-1.24624624624625	1	-0.197619047619048	20	105
MYO6	10	48	0	4	1280.73	2561.46	15	2	1	1	1	0.172413793103448	4	58
MYO7A	11	109	4	13	2216.61	4433.22	15	2	0.0934568432424933	-2.04895104895105	1	-0.143627450980392	17	120
MYOM1	26	65	7	9	1758.24	3516.48	15	2	0.248904973337804	-0.944444444444444	1	-0.151785714285714	16	91
MYOM2	7	41	0	1	1437.48	2874.96	15	2	1	1	1	0.145833333333333	1	48
MYRFL	15	30	5	4	891	1782	15	2	0.265980687026888	-1.5	1	-0.222222222222222	9	45
MYRIP	41	8	5	1	512.49	1024.98	15	2	1	0.024390243902439	1	0.00340136054421769	6	49
MYT1L	2	22	2	1	1135.53	2271.06	15	2	0.0485470085470086	-21	1	-0.583333333333333	3	24
N4BP2L1	7	14	1	3	212.85	425.7	15	2	1	0.333333333333333	1	0.0833333333333333	4	21
N4BP2L2	82	45	21	14	1256.97	2513.94	15	2	0.692594917896275	0.176829268292683	1	0.0456692913385827	35	127
N6AMT1	4	10	2	0	213.84	427.68	15	2	0.125	-Inf	1	-0.714285714285714	2	14
NAA50	4	8	0	3	169.29	338.58	15	2	0.516483516483517	1	1	0.333333333333333	3	12
NAALAD2	16	24	4	3	733.59	1467.18	15	2	0.437989226493075	-1	1	-0.171428571428571	7	40
NAGA	17	19	6	9	430.65	861.3	15	2	0.761037533714064	0.254901960784314	1	0.0722222222222222	15	36
NAMPT	5	18	1	6	352.44	704.88	15	2	1	0.4	1	0.0745341614906832	7	23
NANOG	14	10	1	1	311.85	623.7	15	2	1	0.285714285714286	1	0.0833333333333334	2	24
NANP	9	12	1	3	259.38	518.76	15	2	0.626482213438735	0.555555555555556	1	0.178571428571429	4	21
NAP1L1	3	14	0	3	415.8	831.6	15	2	1	1	1	0.176470588235294	3	17
NAPA-NAPB	0	21	3	8	294.03	588.06	15	2	0.033266129032258	-Inf	1	-0.272727272727273	11	21
NAPEPLD	9	25	0	2	458.37	916.74	15	2	1	1	1	0.264705882352941	2	34
NAPG	2	8	0	1	305.91	611.82	15	2	1	1	1	0.2	1	10
NAPRT	22	55	7	24	661.65	1323.3	15	2	0.634463898327719	0.270833333333333	1	0.0599078341013825	31	77
NARS2	9	32	4	7	476.19	952.38	15	2	0.435048582606676	-1.03174603174603	1	-0.144124168514412	11	41
NAV3	17	78	7	4	1945.68	3891.36	15	2	0.00242809174827949	-7.02941176470588	0.978161257260591	-0.457416267942584	11	95
NBEA	8	48	5	8	1990.89	3981.78	15	2	0.0591721674649522	-2.75	1	-0.241758241758242	13	56
NBEAL2	34	81	30	47	2487.87	4975.74	15	2	0.211808033306241	-0.520650813516896	1	-0.0939582156973461	77	115
NCALD	0	4	0	5	192.06	384.12	15	2	1	NA	1	0	5	4
NCAPD2	42	64	2	10	1329.24	2658.48	15	2	0.206281526051673	0.695238095238095	1	0.229559748427673	12	106
NCAPG2	37	45	3	4	1115.73	2231.46	15	2	1	0.0878378378378378	1	0.0226480836236934	7	82
NCF4	9	17	3	5	341.55	683.1	15	2	1	-0.133333333333333	1	-0.0288461538461539	8	26
NCK2	0	7	0	3	377.19	754.38	15	2	1	NA	1	0	3	7
NCOA1	10	38	6	15	820.71	1641.42	15	2	0.541736188958214	-0.52	1	-0.0773809523809524	21	48
NCOA2	9	39	3	0	1434.18	2868.36	15	2	0.0105642256902761	-Inf	1	-0.8125	3	48
NCOA7	10	24	4	4	937.53	1875.06	15	2	0.406446240849322	-1.4	1	-0.205882352941176	8	34
NDC80	5	30	1	1	634.59	1269.18	15	2	0.301801801801802	-5	1	-0.357142857142857	2	35
NDP	1	1	1	0	132.66	265.32	15	2	1	-Inf	1	-0.5	1	2
NDRG1	3	14	0	0	380.16	760.32	15	2	1	NA	1	NA	0	17
NDUFA12	3	5	1	3	145.53	291.06	15	2	1	0.444444444444444	1	0.125	4	8
NDUFA4	0	4	0	0	82.17	164.34	15	2	1	NA	1	NA	0	4
NDUFA5	1	3	2	1	121.11	242.22	15	2	0.485714285714286	-5	1	-0.416666666666667	3	4
NDUFA6	1	10	0	2	121.77	243.54	15	2	1	1	1	0.0909090909090909	2	11
NDUFA9	5	13	3	1	377.19	754.38	15	2	0.116746411483254	-6.8	1	-0.472222222222222	4	18
NDUFAF4	10	7	0	2	172.26	344.52	15	2	0.210526315789474	1	1	0.588235294117647	2	17
NDUFAF5	6	10	1	3	195.03	390.06	15	2	1	0.444444444444444	1	0.125	4	16
NDUFAF6	9	20	5	4	324.72	649.44	15	2	0.245238487263854	-1.77777777777778	1	-0.245210727969349	9	29
NDUFB2	1	1	0	0	99.99	199.98	15	2	1	NA	1	NA	0	2
NDUFB9	8	14	0	2	173.25	346.5	15	2	0.536231884057971	1	1	0.363636363636364	2	22
NDUFC2	4	4	0	2	105.27	210.54	15	2	0.466666666666667	1	1	0.5	2	8
NDUFS6	3	5	1	1	124.74	249.48	15	2	1	-0.666666666666667	1	-0.125	2	8
NDUFV2	2	11	2	2	243.54	487.08	15	2	0.21890756302521	-4.5	1	-0.346153846153846	4	13
NDUFV3	4	6	0	1	102.63	205.26	15	2	1	1	1	0.4	1	10
NEBL	6	0	1	0	103.95	207.9	15	2	1	NA	1	0	1	6
NECAP1	2	8	1	2	272.25	544.5	15	2	1	-1	1	-0.133333333333333	3	10
NECTIN3	22	23	5	1	664.29	1328.58	15	2	0.195215958723915	-4.22727272727273	1	-0.344444444444444	6	45
NEDD1	23	27	3	5	659.34	1318.68	15	2	0.719531117393142	0.295652173913043	1	0.085	8	50
NEDD9	20	53	2	3	806.85	1613.7	15	2	0.617244775139512	-0.766666666666667	1	-0.126027397260274	5	73
NEIL2	18	16	8	3	313.83	627.66	15	2	0.309253342151811	-1.37037037037037	1	-0.197860962566845	11	34
NEK10	42	48	4	7	1169.52	2339.04	15	2	0.749983110368612	0.346938775510204	1	0.103030303030303	11	90
NEK11	25	23	5	5	594.99	1189.98	15	2	1	0.08	1	0.0208333333333334	10	48
NEK2	7	28	7	7	437.91	875.82	15	2	0.076484916096245	-3	1	-0.3	14	35
NEK3	25	24	8	9	494.01	988.02	15	2	1	0.146666666666667	1	0.0396158463385354	17	49
NEK5	45	26	8	2	809.16	1618.32	15	2	0.480924683638856	-1.31111111111111	1	-0.166197183098592	10	71
NELL2	4	26	2	4	808.83	1617.66	15	2	0.256177764360876	-2.25	1	-0.2	6	30
NENF	1	8	1	0	134.64	269.28	15	2	0.2	-Inf	1	-0.888888888888889	1	9
NEPRO	40	32	6	6	509.85	1019.7	15	2	0.762230311383052	0.2	1	0.0555555555555556	12	72
NETO1	5	10	2	1	528.66	1057.32	15	2	0.528186274509804	-3	1	-0.333333333333333	3	15
NEUROD6	0	18	0	2	334.62	669.24	15	2	1	NA	1	0	2	18
NFAM1	23	14	5	3	247.5	495	15	2	1	-0.0144927536231885	1	-0.0033783783783784	8	37
NFKBIE	16	12	1	4	353.43	706.86	15	2	0.174840732126605	0.8125	1	0.371428571428571	5	28
NFKBIZ	5	33	2	5	693.33	1386.66	15	2	0.296049129543174	-1.64	1	-0.154135338345865	7	38
NGLY1	21	23	1	0	647.46	1294.92	15	2	0.488888888888889	-Inf	1	-0.522727272727273	1	44
NHLH2	3	2	0	1	124.41	248.82	15	2	1	1	1	0.6	1	5
NHLRC1	15	23	3	5	375.21	750.42	15	2	1	0.08	1	0.0197368421052632	8	38
NHLRC3	8	16	0	1	336.6	673.2	15	2	1	1	1	0.333333333333333	1	24
NHS	34	76	11	26	1374.12	2748.24	15	2	1	0.0542986425339367	1	0.0117936117936118	37	110
NHSL1	36	73	12	16	1667.49	3334.98	15	2	0.37722298001785	-0.520833333333333	1	-0.0982961992136304	28	109
NID1	33	64	8	10	1317.69	2635.38	15	2	0.429279933850731	-0.551515151515152	1	-0.104238258877434	18	97
NINJ2	3	4	0	3	119.79	239.58	15	2	0.475	1	1	0.428571428571429	3	7
NINL	29	29	16	6	620.73	1241.46	15	2	0.0812996508253027	-1.66666666666667	1	-0.227272727272727	22	58
NIPA1	2	12	1	0	324.72	649.44	15	2	0.2	-Inf	1	-0.857142857142857	1	14
NIPA2	5	18	3	10	358.38	716.76	15	2	1	-0.0800000000000001	1	-0.0133779264214047	13	23
NIPAL2	25	15	2	2	387.09	774.18	15	2	0.633704355769018	0.4	1	0.125	4	40
NIT2	5	10	1	2	280.17	560.34	15	2	1	0	1	0	3	15
NKTR	49	70	9	9	1441.11	2882.22	15	2	0.609930712925831	-0.428571428571429	1	-0.0882352941176471	18	119
NKX2-4	1	2	0	1	177.21	354.42	15	2	1	1	1	0.333333333333333	1	3
NLGN4L	0	24	2	1	602.58	1205.16	15	2	0.00854700854700854	-Inf	1	-0.666666666666667	3	24
NMBR	4	14	0	1	385.11	770.22	15	2	1	1	1	0.222222222222222	1	18
NME6	5	5	0	1	151.8	303.6	15	2	1	1	1	0.5	1	10
NME7	5	23	3	2	377.19	754.38	15	2	0.0783951865709373	-5.9	1	-0.421428571428571	5	28
NME8	19	16	3	2	569.25	1138.5	15	2	1	-0.263157894736842	1	-0.0571428571428572	5	35
NMS	2	5	0	2	123.75	247.5	15	2	1	1	1	0.285714285714286	2	7
NMT2	0	12	1	6	494.01	988.02	15	2	0.368421052631579	-Inf	1	-0.142857142857143	7	12
NOBOX	58	34	5	3	711.81	1423.62	15	2	1	0.0229885057471264	1	0.00543478260869568	8	92
NOD1	8	47	5	13	942.48	1884.96	15	2	0.285614144275164	-1.25961538461538	1	-0.132323232323232	18	55
NOL12	9	11	7	3	213.84	427.68	15	2	0.260236548392471	-1.85185185185185	1	-0.25	10	20
NOL4	15	13	3	3	702.57	1405.14	15	2	1	0.133333333333333	1	0.0357142857142857	6	28
NOL7	11	7	4	5	217.8	435.6	15	2	0.44790236460717	0.490909090909091	1	0.166666666666667	9	18
NOM1	25	29	7	2	771.21	1542.42	15	2	0.147716470949533	-3.06	1	-0.314814814814815	9	54
NOP2	13	26	3	2	451.44	902.88	15	2	0.336358479863868	-2	1	-0.266666666666667	5	39
NOV	1	6	2	2	273.24	546.48	15	2	0.490909090909091	-5	1	-0.357142857142857	4	7
NOX3	10	15	1	0	525.69	1051.38	15	2	0.423076923076923	-Inf	1	-0.6	1	25
NOX4	7	12	0	0	375.21	750.42	15	2	1	NA	1	NA	0	19
NPAS2	2	21	3	10	668.25	1336.5	15	2	0.328227124183007	-2.15	1	-0.1438127090301	13	23
NPAS4	22	31	5	13	439.56	879.12	15	2	0.402645552079567	0.458041958041958	1	0.137316561844864	18	53
NPAT	59	90	12	19	1491.93	2983.86	15	2	1	0.0365744870651205	1	0.00887638016886771	31	149
NPC1	17	53	7	15	1271.16	2542.32	15	2	0.579079678140638	-0.454901960784314	1	-0.0753246753246753	22	70
NPHP1	16	28	4	5	673.2	1346.4	15	2	0.715086275968264	-0.4	1	-0.0808080808080808	9	44
NPHP3	9	38	5	4	1098.9	2197.8	15	2	0.034535701072882	-4.27777777777778	1	-0.364066193853428	9	47
NPSR1	8	10	0	0	278.85	557.7	15	2	1	NA	1	NA	0	18
NPTXR	2	21	4	6	475.53	951.06	15	2	0.053392658509455	-6	1	-0.31304347826087	10	23
NPVF	2	4	1	1	172.26	344.52	15	2	1	-1	1	-0.166666666666667	2	6
NPY	0	1	1	0	97.02	194.04	15	2	1	-Inf	1	-1	1	1
NR0B1	5	8	2	0	274.23	548.46	15	2	0.2	-Inf	1	-0.615384615384615	2	13
NR1D2	8	15	2	0	568.26	1136.52	15	2	0.15	-Inf	1	-0.652173913043478	2	23
NR1H4	9	18	0	2	526.68	1053.36	15	2	1	1	1	0.333333333333333	2	27
NR2E1	8	17	1	4	387.09	774.18	15	2	1	0.46875	1	0.12	5	25
NR4A3	0	14	1	7	582.45	1164.9	15	2	0.363636363636364	-Inf	1	-0.125	8	14
NRBP1	4	13	2	2	484.77	969.54	15	2	0.543859649122807	-2.25	1	-0.264705882352941	4	17
NRBP2	14	14	3	2	474.21	948.42	15	2	1	-0.5	1	-0.1	5	28
NRCAM	47	58	7	3	1809.06	3618.12	15	2	0.186032116555387	-1.87943262411348	1	-0.252380952380952	10	105
NRF1	3	20	0	8	457.38	914.76	15	2	0.54972191323693	1	1	0.130434782608696	8	23
NRIP1	21	25	4	2	1141.47	2282.94	15	2	0.410934586600598	-1.38095238095238	1	-0.210144927536232	6	46
NRP1	10	32	2	3	1049.07	2098.14	15	2	0.590387883742443	-1.13333333333333	1	-0.161904761904762	5	42
NRSN1	12	11	0	0	176.55	353.1	15	2	1	NA	1	NA	0	23
NRXN1	19	7	3	0	279.18	558.36	15	2	0.557471264367816	-Inf	1	-0.269230769230769	3	26
NSL1	11	14	1	4	253.44	506.88	15	2	0.622079070354933	0.681818181818182	1	0.24	5	25
NSMAF	4	34	0	2	907.83	1815.66	15	2	1	1	1	0.105263157894737	2	38
NSMCE2	2	2	0	0	109.89	219.78	15	2	1	NA	1	NA	0	4
NSUN2	18	26	2	1	755.37	1510.74	15	2	0.567067530064755	-1.88888888888889	1	-0.257575757575758	3	44
NSUN3	12	18	2	2	396.33	792.66	15	2	1	-0.5	1	-0.1	4	30
NSUN6	14	24	1	1	465.3	930.6	15	2	1	-0.714285714285714	1	-0.131578947368421	2	38
NT5C1B	3	14	0	1	346.17	692.34	15	2	1	1	1	0.176470588235294	1	17
NT5C3A	1	20	0	2	328.68	657.36	15	2	1	1	1	0.0476190476190476	2	21
NT5DC1	9	17	2	2	469.26	938.52	15	2	0.611056376573618	-0.888888888888889	1	-0.153846153846154	4	26
NT5DC3	0	16	0	3	495	990	15	2	1	NA	1	0	3	16
NTF3	12	12	0	0	328.68	657.36	15	2	1	NA	1	NA	0	24
NTN4	7	27	4	10	603.57	1207.14	15	2	0.707510526644425	-0.542857142857143	1	-0.0798319327731092	14	34
NTPCR	4	9	1	0	189.09	378.18	15	2	0.357142857142857	-Inf	1	-0.692307692307692	1	13
NTS	1	6	0	0	159.39	318.78	15	2	1	NA	1	NA	0	7
NUAK1	1	19	1	4	616.11	1232.22	15	2	0.366666666666667	-3.75	1	-0.15	5	20
NUB1	5	31	2	6	606.87	1213.74	15	2	0.59336886655751	-1.06666666666667	1	-0.111111111111111	8	36
NUDCD1	18	20	3	1	580.14	1160.28	15	2	0.606003752345216	-2.33333333333333	1	-0.276315789473684	4	38
NUDT15	4	5	6	2	159.39	318.78	15	2	0.334841628959276	-2.75	1	-0.305555555555556	8	9
NUDT4	2	1	0	0	70.29	140.58	15	2	1	NA	1	NA	0	3
NUDT5	1	8	1	1	218.79	437.58	15	2	0.345454545454545	-7	1	-0.388888888888889	2	9
NUFIP1	23	33	6	5	527.67	1055.34	15	2	0.511628454140487	-0.721739130434783	1	-0.13474025974026	11	56
NUGGC	111	37	10	16	856.35	1712.7	15	2	0.000401758858366781	0.791666666666667	0.42125753829487	0.365384615384615	26	148
NUMBL	7	13	2	0	222.09	444.18	15	2	0.155844155844156	-Inf	1	-0.65	2	20
NUP107	14	42	4	7	898.26	1796.52	15	2	0.469030210518883	-0.714285714285714	1	-0.113636363636364	11	56
NUP133	11	41	4	9	1142.46	2284.92	15	2	0.476524532129322	-0.656565656565657	1	-0.0961538461538462	13	52
NUP153	31	42	5	4	859.32	1718.64	15	2	0.496255586889473	-0.693548387096774	1	-0.13089802130898	9	73
NUP205	13	71	3	8	1984.62	3969.24	15	2	0.38849793922453	-1.04807692307692	1	-0.117965367965368	11	84
NUP37	10	13	0	0	323.73	647.46	15	2	1	NA	1	NA	0	23
NUP50	23	21	1	0	469.26	938.52	15	2	1	-Inf	1	-0.477272727272727	1	44
NUP58	3	15	1	4	596.97	1193.94	15	2	1	-0.25	1	-0.0333333333333334	5	18
NUP98	34	146	3	20	1736.79	3473.58	15	2	0.773876593376864	0.355882352941176	1	0.0584541062801932	23	180
NUS1	2	4	0	2	208.89	417.78	15	2	1	1	1	0.333333333333333	2	6
NVL	26	32	2	3	933.24	1866.48	15	2	1	0.17948717948718	1	0.0482758620689655	5	58
NXPE3	6	16	3	2	556.38	1112.76	15	2	0.294983277591973	-3	1	-0.327272727272727	5	22
NXPH1	1	8	0	2	261.36	522.72	15	2	1	1	1	0.111111111111111	2	9
NYX	6	25	2	9	471.24	942.48	15	2	1	0.0740740740740741	1	0.0117302052785924	11	31
OBSCN	187	323	66	88	8029.56	16059.12	15	2	0.185096808430549	-0.295454545454545	1	-0.0619047619047619	154	510
OC3	3	6	0	3	99.99	199.98	15	2	0.509090909090909	1	1	0.333333333333333	3	9
OCA2	16	23	3	3	566.94	1133.88	15	2	0.686134908766786	-0.4375	1	-0.0897435897435898	6	39
OFCC1	24	22	2	3	454.74	909.48	15	2	0.667952287297898	0.388888888888889	1	0.121739130434783	5	46
OFD1	37	33	12	2	1002.21	2004.42	15	2	0.0354163445699791	-4.35135135135135	1	-0.328571428571429	14	70
OGFRL1	6	9	3	1	488.07	976.14	15	2	0.303405572755418	-3.5	1	-0.35	4	15
OLFM4	7	9	1	2	137.94	275.88	15	2	1	0.357142857142857	1	0.104166666666667	3	16
OLFR52I1L	15	14	5	7	312.84	625.68	15	2	0.733717618847438	0.333333333333333	1	0.100574712643678	12	29
OLIG2	0	8	2	4	282.15	564.3	15	2	0.164835164835165	-Inf	1	-0.333333333333333	6	8
OPHN1	1	25	3	8	761.97	1523.94	15	2	0.0699523052464229	-8.375	1	-0.234265734265734	11	26
OPN3	5	9	2	7	392.04	784.08	15	2	0.657019787319962	0.485714285714286	1	0.134920634920635	9	14
OPN5	5	11	0	2	354.42	708.84	15	2	1	1	1	0.3125	2	16
OPN5L1	12	16	1	3	438.57	877.14	15	2	0.62908787541713	0.555555555555556	1	0.178571428571429	4	28
OPN5L2	2	14	0	2	345.51	691.02	15	2	1	1	1	0.125	2	16
OPRK1	3	14	0	0	378.18	756.36	15	2	1	NA	1	NA	0	17
OPRM1	4	20	0	3	485.1	970.2	15	2	1	1	1	0.166666666666667	3	24
OPTN	18	23	2	1	551.43	1102.86	15	2	0.583207490184234	-1.55555555555556	1	-0.227642276422764	3	41
OR10AC1	12	20	3	10	359.7	719.4	15	2	0.491747427919061	0.5	1	0.144230769230769	13	32
OR51M1L	13	16	4	7	316.8	633.6	15	2	0.729795117698344	0.296703296703297	1	0.0846394984326019	11	29
OR52B2	5	12	3	8	321.75	643.5	15	2	1	0.1	1	0.0213903743315508	11	17
OR52R1-OR52R1L1-OR52R1L2-OR52R1L3	5	5	2	0	115.17	230.34	15	2	0.46969696969697	-Inf	1	-0.5	2	10
ORC3	15	23	1	8	708.84	1417.68	15	2	0.138044078103465	0.808333333333333	1	0.283625730994152	9	38
ORC5	13	27	3	10	498.96	997.92	15	2	0.730905061697978	0.376923076923077	1	0.0942307692307692	13	40
OSBPL10	6	24	2	11	689.37	1378.74	15	2	1	0.272727272727273	1	0.0461538461538462	13	30
OSBPL1A	32	61	6	13	1236.51	2473.02	15	2	1	0.120192307692308	1	0.0282965478211659	19	93
OSBPL3	6	32	3	4	841.5	1683	15	2	0.130677603734892	-3	1	-0.270676691729323	7	38
OSBPL8	4	28	2	8	857.34	1714.68	15	2	0.616118537813018	-0.75	1	-0.075	10	32
OSR1	0	11	1	0	258.39	516.78	15	2	0.0833333333333334	-Inf	1	-1	1	11
OSR2	1	7	0	2	297.99	595.98	15	2	1	1	1	0.125	2	8
OSTM1	3	15	4	6	306.9	613.8	15	2	0.207459207459207	-2.33333333333333	1	-0.233333333333333	10	18
OTC	14	13	9	3	351.45	702.9	15	2	0.291295221151925	-1.78571428571429	1	-0.231481481481482	12	27
OTOF	20	81	16	42	2075.7	4151.4	15	2	0.325200380843832	-0.542857142857143	1	-0.0778422669853192	58	101
OTOR	3	3	0	0	131.67	263.34	15	2	1	NA	1	NA	0	6
OTUD1	3	10	5	1	348.48	696.96	15	2	0.0407636738906089	-15.6666666666667	1	-0.602564102564103	6	13
OTX1	0	4	0	2	330.66	661.32	15	2	1	NA	1	0	2	4
OVOL2	4	12	2	3	261.36	522.72	15	2	0.597523219814241	-1	1	-0.15	5	16
OVST	59	66	12	8	1586.64	3173.28	15	2	0.340102407344982	-0.677966101694915	1	-0.128	20	125
OVSTL	68	52	3	10	1428.57	2857.14	15	2	0.0371495589318041	0.770588235294118	1	0.335897435897436	13	120
OXGR1	12	23	4	2	340.56	681.12	15	2	0.186885117565477	-2.83333333333333	1	-0.323809523809524	6	35
OXGR1L	7	16	0	2	320.76	641.52	15	2	1	1	1	0.304347826086957	2	23
OXNAD1	9	11	3	3	313.83	627.66	15	2	1	-0.222222222222222	1	-0.05	6	20
OXR1	12	24	3	3	826.65	1653.3	15	2	0.648718037678243	-1	1	-0.166666666666667	6	36
OXSM	6	19	1	1	457.38	914.76	15	2	0.458689458689459	-2.16666666666667	1	-0.26	2	25
OXSR1	2	26	2	5	522.72	1045.44	15	2	0.170989304812834	-4.2	1	-0.214285714285714	7	28
P2RY10	3	13	0	2	335.61	671.22	15	2	1	1	1	0.1875	2	16
P2RY2	1	13	3	6	354.42	708.84	15	2	0.260079051383399	-5.5	1	-0.261904761904762	9	14
P2RY6	1	14	1	6	325.71	651.42	15	2	1	-1.33333333333333	1	-0.0761904761904762	7	15
P2RY8	4	18	0	2	354.42	708.84	15	2	1	1	1	0.181818181818182	2	22
P3H3	14	46	7	9	1052.04	2104.08	15	2	0.123541784676557	-1.55555555555556	1	-0.204166666666667	16	60
P4HA3	13	19	7	8	530.64	1061.28	15	2	0.758305752681876	-0.278846153846154	1	-0.0604166666666667	15	32
PAAF1	2	2	0	2	104.28	208.56	15	2	0.466666666666667	1	1	0.5	2	4
PABPC1	0	17	0	4	631.62	1263.24	15	2	1	NA	1	0	4	17
PACRG	14	7	1	1	281.49	562.98	15	2	1	0.5	1	0.166666666666667	2	21
PACSIN2	4	13	2	2	461.34	922.68	15	2	0.543859649122807	-2.25	1	-0.264705882352941	4	17
PAH	2	22	1	1	442.53	885.06	15	2	0.221538461538462	-10	1	-0.416666666666667	2	24
PAK1IP1	10	17	1	4	372.24	744.48	15	2	0.636749165739711	0.575	1	0.17037037037037	5	27
PAK5	6	33	1	10	715.77	1431.54	15	2	1	0.45	1	0.0629370629370629	11	39
PANX1	3	11	1	10	429.66	859.32	15	2	0.604347826086956	0.633333333333333	1	0.123376623376623	11	14
PANX2	30	50	9	7	928.62	1857.24	15	2	0.176546303324714	-1.14285714285714	1	-0.1875	16	80
PAPD7	1	12	3	3	652.08	1304.16	15	2	0.0709494324045408	-11	1	-0.423076923076923	6	13
PAPOLG	26	25	4	4	734.91	1469.82	15	2	1	0.0384615384615384	1	0.00980392156862742	8	51
PAQR8	5	30	3	6	349.47	698.94	15	2	0.328823129163458	-2	1	-0.19047619047619	9	35
PARD3	15	30	10	5	1295.91	2591.82	15	2	0.0345145725042561	-3	1	-0.333333333333333	15	45
PARD6G	6	17	1	2	317.79	635.58	15	2	1	-0.416666666666667	1	-0.072463768115942	3	23
PARK2	8	0	1	1	157.41	314.82	15	2	0.2	1	1	0.5	2	8
PARP12	20	19	3	1	662.31	1324.62	15	2	0.61048537395673	-1.85	1	-0.237179487179487	4	39
PARP4	38	36	17	13	1221.99	2443.98	15	2	0.669126932006973	-0.238866396761134	1	-0.0531531531531532	30	74
PARVG	15	14	0	1	319.77	639.54	15	2	1	1	1	0.517241379310345	1	29
PAWR	4	7	1	0	192.06	384.12	15	2	0.416666666666667	-Inf	1	-0.636363636363636	1	11
PAX1	0	15	1	1	209.55	419.1	15	2	0.117647058823529	-Inf	1	-0.5	2	15
PAXBP1	4	12	3	3	851.07	1702.14	15	2	0.334083872783563	-2	1	-0.25	6	16
PAXIP1	6	51	2	7	1080.75	2161.5	15	2	0.298018042646255	-1.42857142857143	1	-0.116959064327485	9	57
PBK	7	15	3	2	165	330	15	2	0.326148891366283	-2.21428571428571	1	-0.281818181818182	5	22
PCBP2	1	7	2	2	417.45	834.9	15	2	0.236363636363636	-6	1	-0.375	4	8
PCCA	4	11	2	2	392.04	784.08	15	2	0.557275541795666	-1.75	1	-0.233333333333333	4	15
PCDH17	6	47	0	4	957.66	1915.32	15	2	1	1	1	0.113207547169811	4	53
PCDH20	17	46	6	4	911.46	1822.92	15	2	0.062717726815491	-3.05882352941176	1	-0.33015873015873	10	63
PCDH8	7	64	5	9	989.01	1978.02	15	2	0.0238680317521674	-4.07936507936508	1	-0.258551307847083	14	71
PCDH9	8	35	1	1	1003.86	2007.72	15	2	0.363636363636364	-3.375	1	-0.313953488372093	2	43
PCID2	2	20	0	5	360.36	720.72	15	2	1	1	1	0.0909090909090909	5	22
PCLO	88	130	6	14	4273.17	8546.34	15	2	0.475585063024244	0.366883116883117	1	0.103669724770642	20	218
PCMT1	1	2	0	1	250.47	500.94	15	2	1	1	1	0.333333333333333	1	3
PCMTD1	0	12	0	1	355.41	710.82	15	2	1	NA	1	0	1	12
PCNP	1	4	0	1	178.2	356.4	15	2	1	1	1	0.2	1	5
PCNX2	34	74	12	14	1887.93	3775.86	15	2	0.173066504038389	-0.865546218487395	1	-0.146723646723647	26	108
PCSK2	6	30	3	7	648.78	1297.56	15	2	0.384370566604926	-1.14285714285714	1	-0.133333333333333	10	36
PCTPL	9	20	2	8	260.37	520.74	15	2	0.692696791468388	0.444444444444444	1	0.110344827586207	10	29
PCYT1B	0	14	0	3	334.29	668.58	15	2	1	NA	1	0	3	14
PDCD2	14	15	0	5	369.27	738.54	15	2	0.0629132884825484	1	1	0.482758620689655	5	29
PDCD6	1	5	1	2	154.44	308.88	15	2	1	-1.5	1	-0.166666666666667	3	6
PDCD6IP	9	31	3	6	835.89	1671.78	15	2	0.669254891293506	-0.722222222222222	1	-0.108333333333333	9	40
PDCL3	1	9	1	1	238.59	477.18	15	2	0.318181818181818	-8	1	-0.4	2	10
PDE10A	3	17	2	4	722.37	1444.74	15	2	0.558072362420189	-1.83333333333333	1	-0.183333333333333	6	20
PDE1C	21	8	2	2	528.66	1057.32	15	2	0.567204301075269	0.619047619047619	1	0.224137931034483	4	29
PDE3A	34	37	0	1	996.6	1993.2	15	2	1	1	1	0.47887323943662	1	71
PDE6H	0	3	0	3	85.14	170.28	15	2	1	NA	1	0	3	3
PDE7A	1	9	1	2	402.93	805.86	15	2	0.423076923076923	-3.5	1	-0.233333333333333	3	10
PDE7B	2	7	0	1	437.25	874.5	15	2	1	1	1	0.222222222222222	1	9
PDE9A	2	14	0	3	513.81	1027.62	15	2	1	1	1	0.125	3	16
PDGFB	2	12	1	7	249.48	498.96	15	2	1	0.142857142857143	1	0.0178571428571428	8	14
PDGFD	3	15	1	1	348.48	696.96	15	2	0.368421052631579	-4	1	-0.333333333333333	2	18
PDHA1	0	12	0	1	394.02	788.04	15	2	1	NA	1	0	1	12
PDIA4	6	25	0	1	640.2	1280.4	15	2	1	1	1	0.193548387096774	1	31
PDK3	0	10	0	1	367.95	735.9	15	2	1	NA	1	0	1	10
PDK4	1	13	0	2	417.78	835.56	15	2	1	1	1	0.0714285714285714	2	14
PDS5B	2	50	2	6	1400.85	2801.7	15	2	0.0822541450059983	-7.33333333333333	1	-0.211538461538462	8	52
PDSS1	0	9	0	3	333.63	667.26	15	2	1	NA	1	0	3	9
PDSS2	12	11	6	0	195.69	391.38	15	2	0.0575596816976127	-Inf	1	-0.478260869565217	6	23
PDX1	3	8	2	2	251.13	502.26	15	2	0.56043956043956	-1.66666666666667	1	-0.227272727272727	4	11
PDXK	2	12	0	1	334.29	668.58	15	2	1	1	1	0.142857142857143	1	14
PDXP	1	1	1	2	297.99	595.98	15	2	1	0.5	1	0.166666666666667	3	2
PDZD11	0	5	0	3	139.59	279.18	15	2	1	NA	1	0	3	5
PDZK1	16	20	2	2	514.8	1029.6	15	2	1	-0.25	1	-0.0555555555555556	4	36
PENK	1	7	2	1	265.32	530.64	15	2	0.151515151515152	-13	1	-0.541666666666667	3	8
PERP1	3	8	0	2	188.1	376.2	15	2	1	1	1	0.272727272727273	2	11
PERP2	3	6	1	2	195.03	390.06	15	2	1	0	1	0	3	9
PEX1	32	44	6	3	1215.72	2431.44	15	2	0.287549164553731	-1.75	1	-0.245614035087719	9	76
PEX13	9	11	2	0	394.02	788.04	15	2	0.476190476190476	-Inf	1	-0.55	2	20
PEX2	12	14	0	1	301.95	603.9	15	2	1	1	1	0.461538461538462	1	26
PEX26	14	17	3	0	292.71	585.42	15	2	0.227272727272727	-Inf	1	-0.548387096774194	3	31
PEX3	2	9	0	2	366.3	732.6	15	2	1	1	1	0.181818181818182	2	11
PEX5	11	19	4	6	636.24	1272.48	15	2	1	-0.151515151515152	1	-0.0333333333333334	10	30
PEX7	2	10	3	3	277.86	555.72	15	2	0.268207282913165	-4	1	-0.333333333333333	6	12
PFKFB3	3	40	2	4	513.48	1026.96	15	2	0.106889564336373	-5.66666666666667	1	-0.263565891472868	6	43
PFKP	3	26	0	3	829.62	1659.24	15	2	1	1	1	0.103448275862069	3	29
PGAP2	2	9	1	5	248.49	496.98	15	2	1	0.1	1	0.0151515151515152	6	11
PGBD5	2	20	1	3	561.99	1123.98	15	2	0.407692307692308	-2.33333333333333	1	-0.159090909090909	4	22
PGM2L1	2	24	5	4	253.44	506.88	15	2	0.00641978907044667	-14	1	-0.478632478632479	9	26
PGM3	7	34	3	6	537.57	1075.14	15	2	0.35819213655504	-1.42857142857143	1	-0.16260162601626	9	41
PGR	13	29	0	3	792.99	1585.98	15	2	0.545595489781536	1	1	0.30952380952381	3	42
PHACTR1	11	20	1	1	514.14	1028.28	15	2	1	-0.818181818181818	1	-0.145161290322581	2	31
PHACTR2	10	18	5	4	624.36	1248.72	15	2	0.438160842907948	-1.25	1	-0.198412698412698	9	28
PHB2	1	6	0	2	276.21	552.42	15	2	1	1	1	0.142857142857143	2	7
PHC1	19	30	4	6	1027.62	2055.24	15	2	1	-0.0526315789473684	1	-0.0122448979591837	10	49
PHEX	6	17	3	3	799.59	1599.18	15	2	0.339067828723001	-1.83333333333333	1	-0.239130434782609	6	23
PHF10	8	9	1	1	526.35	1052.7	15	2	1	-0.125	1	-0.0294117647058824	2	17
PHF14	0	14	0	2	535.59	1071.18	15	2	1	NA	1	0	2	14
PHF20L1	1	17	1	1	1003.86	2007.72	15	2	0.194736842105263	-16	1	-0.444444444444444	2	18
PHF3	55	63	13	8	2044.35	4088.7	15	2	0.239578983557383	-0.861363636363636	1	-0.152945924132365	21	118
PHIP	7	41	2	6	1618.65	3237.3	15	2	0.601530551262595	-0.952380952380952	1	-0.104166666666667	8	48
PHKA2	5	65	4	15	1193.94	2387.88	15	2	0.0931130796276517	-2.46666666666667	1	-0.139097744360902	19	70
PHLDA1	0	3	0	1	152.46	304.92	15	2	1	NA	1	0	1	3
PHLDB2	7	52	0	4	1320.66	2641.32	15	2	1	1	1	0.11864406779661	4	59
PHLPP1-PHLPP2	2	3	1	1	135.63	271.26	15	2	1	-0.5	1	-0.1	2	5
PHTF2	7	27	0	4	692.01	1384.02	15	2	1	1	1	0.205882352941176	4	34
PHYH	6	19	0	3	338.58	677.16	15	2	1	1	1	0.24	3	25
PI15	4	12	0	0	266.97	533.94	15	2	1	NA	1	NA	0	16
PIANP	5	12	1	6	280.5	561	15	2	0.628666527980029	0.6	1	0.151260504201681	7	17
PIBF1	13	24	2	4	581.46	1162.92	15	2	1	0.0769230769230769	1	0.0180180180180181	6	37
PICALM	3	19	0	4	699.6	1399.2	15	2	1	1	1	0.136363636363636	4	22
PICK1	3	31	2	3	405.9	811.8	15	2	0.113973429762903	-5.88888888888889	1	-0.311764705882353	5	34
PIEZO2	23	79	0	7	2608.98	5217.96	15	2	0.341384330405561	1	1	0.225490196078431	7	102
PIGA	4	17	4	5	461.34	922.68	15	2	0.195386921923654	-2.4	1	-0.253968253968254	9	21
PIGF	8	4	0	0	144.21	288.42	15	2	1	NA	1	NA	0	12
PIGM	27	29	4	4	418.77	837.54	15	2	1	-0.0740740740740742	1	-0.0178571428571428	8	56
PIGP	3	6	0	0	133.65	267.3	15	2	1	NA	1	NA	0	9
PIK3C2G	64	33	4	6	1040.49	2080.98	15	2	0.164945007863993	0.65625	1	0.25979381443299	10	97
PIK3CG	9	52	1	9	1175.13	2350.26	15	2	1	0.358024691358025	1	0.0475409836065574	10	61
PIK3R4	11	53	4	6	1350.03	2700.06	15	2	0.110015692113434	-2.21212121212121	1	-0.228125	10	64
PIM3	0	20	0	1	320.76	641.52	15	2	1	NA	1	0	1	20
PINX1	22	22	2	4	405.9	811.8	15	2	0.668837747865104	0.5	1	0.166666666666667	6	44
PIP4K2A	7	9	7	7	495.99	991.98	15	2	1	-0.285714285714286	1	-0.0625	14	16
PITRM1	14	48	2	4	1023.66	2047.32	15	2	0.620081411126187	-0.714285714285714	1	-0.10752688172043	6	62
PKDCCA	1	6	1	0	366.96	733.92	15	2	0.25	-Inf	1	-0.857142857142857	1	7
PKHD1	193	181	24	13	3725.7	7451.4	15	2	0.1666543588968	-0.731367078517338	1	-0.132605867899986	37	374
PKIB	2	3	0	0	152.46	304.92	15	2	1	NA	1	NA	0	5
PKNOX1	0	4	0	0	316.8	633.6	15	2	1	NA	1	NA	0	4
PKP2	21	42	1	3	838.53	1677.06	15	2	1	0.333333333333333	1	0.0833333333333333	4	63
PLA1A	20	14	3	1	452.43	904.86	15	2	1	-1.1	1	-0.161764705882353	4	34
PLA2G10L	5	8	7	5	156.42	312.84	15	2	0.433752668115301	-1.24	1	-0.198717948717949	12	13
PLA2G6	15	30	6	11	798.93	1597.86	15	2	1	-0.0909090909090908	1	-0.0196078431372549	17	45
PLA2G7	4	15	4	2	321.75	643.5	15	2	0.0592885375494071	-6.5	1	-0.456140350877193	6	19
PLAG1	0	2	0	1	496.98	993.96	15	2	1	NA	1	0	1	2
PLAGL1	7	18	1	2	772.2	1544.4	15	2	1	-0.285714285714286	1	-0.0533333333333333	3	25
PLBD1	4	20	4	8	540.54	1081.08	15	2	0.397421972125892	-1.5	1	-0.166666666666667	12	24
PLCB1	2	31	3	8	1137.51	2275.02	15	2	0.0906733652054129	-4.8125	1	-0.212121212121212	11	33
PLCB4	6	35	1	7	1270.17	2540.34	15	2	1	0.166666666666667	1	0.0213414634146341	8	41
PLCD1	6	15	0	4	772.2	1544.4	15	2	0.540395256916996	1	1	0.285714285714286	4	21
PLCL2	10	26	1	1	1025.64	2051.28	15	2	0.500711237553343	-1.6	1	-0.222222222222222	2	36
PLCXD1	7	14	2	2	333.63	667.26	15	2	0.601581027667984	-1	1	-0.166666666666667	4	21
PLCXD2	3	14	1	4	336.27	672.54	15	2	1	-0.166666666666667	1	-0.0235294117647059	5	17
PLCZ1	9	17	1	2	746.13	1492.26	15	2	1	0.0555555555555556	1	0.0128205128205128	3	26
PLEK	5	9	0	5	350.46	700.92	15	2	0.256535947712418	1	1	0.357142857142857	5	14
PLEKHA5	19	40	4	1	1145.43	2290.86	15	2	0.0520300840237381	-7.42105263157895	1	-0.477966101694915	5	59
PLEKHA8	5	13	3	1	412.5	825	15	2	0.116746411483254	-6.8	1	-0.472222222222222	4	18
PLEKHB1	0	3	1	2	71.94	143.88	15	2	1	-Inf	1	-0.333333333333333	3	3
PLEKHF2	2	13	0	5	247.5	495	15	2	1	1	1	0.133333333333333	5	15
PLEKHG1	30	71	11	3	1580.04	3160.08	15	2	0.000639059529553823	-7.67777777777778	0.534696192535149	-0.488684582743989	14	101
PLG	23	34	1	3	794.97	1589.94	15	2	1	0.507246376811594	1	0.153508771929825	4	57
PLGL	27	27	3	5	834.57	1669.14	15	2	0.708531476712697	0.4	1	0.125	8	54
PLXDC2	15	12	2	2	382.47	764.94	15	2	1	0.2	1	0.0555555555555556	4	27
PLXNA4	8	20	3	2	491.04	982.08	15	2	0.30408787541713	-2.75	1	-0.314285714285714	5	28
PLXNB2	29	62	2	8	1858.23	3716.46	15	2	0.71953255469326	0.46551724137931	1	0.118681318681319	10	91
PLXNC1	34	45	5	10	1484.67	2969.34	15	2	0.575326805605783	0.338235294117647	1	0.0970464135021097	15	79
PM20D2	5	10	4	0	435.6	871.2	15	2	0.0325077399380804	-Inf	1	-0.666666666666667	4	15
PMCH	11	7	1	0	244.86	489.72	15	2	1	-Inf	1	-0.388888888888889	1	18
PMM1	1	12	0	4	254.43	508.86	15	2	1	1	1	0.0769230769230769	4	13
PMPCB	6	25	3	9	483.12	966.24	15	2	0.69224121148174	-0.388888888888889	1	-0.0564516129032258	12	31
PNISR	5	16	3	3	812.13	1624.26	15	2	0.319104084321476	-2.2	1	-0.261904761904762	6	21
PNLDC1	21	21	7	1	529.65	1059.3	15	2	0.0637983779015984	-6	1	-0.375	8	42
PNO1	6	9	0	1	234.63	469.26	15	2	1	1	1	0.4	1	15
PNOC	6	7	5	8	193.05	386.1	15	2	1	0.270833333333333	1	0.0769230769230769	13	13
PNPLA3	18	24	0	0	501.93	1003.86	15	2	1	NA	1	NA	0	42
PNPLA8	16	41	3	1	796.95	1593.9	15	2	0.0854145308562723	-6.6875	1	-0.469298245614035	4	57
PNPT1	11	27	1	2	723.03	1446.06	15	2	1	-0.227272727272727	1	-0.043859649122807	3	38
PODXL	44	31	12	7	552.75	1105.5	15	2	0.797897556718123	-0.207792207792208	1	-0.0449122807017543	19	75
POGLUT1	6	11	3	8	393.03	786.06	15	2	1	0.3125	1	0.0802139037433156	11	17
POLA1	34	59	13	13	1512.39	3024.78	15	2	0.258884241362197	-0.735294117647059	1	-0.134408602150538	26	93
POLD3	9	29	9	4	460.35	920.7	15	2	0.0059187497072779	-6.25	1	-0.455465587044534	13	38
POLDIP3	1	20	1	2	413.82	827.64	15	2	0.239130434782608	-9	1	-0.285714285714286	3	21
POLH	21	30	8	7	685.08	1370.16	15	2	0.555263061321514	-0.63265306122449	1	-0.12156862745098	15	51
POLQ	17	24	5	5	485.43	970.86	15	2	0.728059973855084	-0.411764705882353	1	-0.0853658536585366	10	41
POLR1B	10	68	8	15	1114.41	2228.82	15	2	0.0270492302196526	-2.62666666666667	1	-0.219620958751394	23	78
POLR1C	3	13	0	6	343.53	687.06	15	2	0.532467532467533	1	1	0.1875	6	16
POLR2F	0	5	0	4	126.72	253.44	15	2	1	NA	1	0	4	5
POLR3B	3	50	0	11	1134.54	2269.08	15	2	1	1	1	0.0566037735849057	11	53
POLR3F	1	18	2	3	311.85	623.7	15	2	0.0988142292490118	-11	1	-0.347368421052632	5	19
POLR3H	3	6	1	2	204.93	409.86	15	2	1	0	1	0	3	9
POMC	5	6	0	4	246.18	492.36	15	2	0.230769230769231	1	1	0.454545454545455	4	11
POMGNT2	7	25	3	9	573.21	1146.42	15	2	1	-0.19047619047619	1	-0.03125	12	32
POMP	9	7	0	0	140.58	281.16	15	2	1	NA	1	NA	0	16
PON2	11	17	3	0	327.36	654.72	15	2	0.0809788654060066	-Inf	1	-0.607142857142857	3	28
POP1	25	39	7	4	970.86	1941.72	15	2	0.187869885959264	-1.73	1	-0.245738636363636	11	64
POPDC2	4	20	6	3	354.42	708.84	15	2	0.0104574883773994	-9	1	-0.5	9	24
POPDC3	3	7	2	1	302.94	605.88	15	2	0.510489510489511	-3.66666666666667	1	-0.366666666666667	3	10
POT1	38	33	5	6	809.82	1619.64	15	2	0.749326146850856	0.276315789473684	1	0.0806658130601792	11	71
POU1F1	6	7	0	0	342.21	684.42	15	2	1	NA	1	NA	0	13
POU2F1	2	6	0	4	747.45	1494.9	15	2	0.515151515151515	1	1	0.25	4	8
POU3F2	5	2	0	0	211.86	423.72	15	2	1	NA	1	NA	0	7
POU3F3	5	1	1	1	274.89	549.78	15	2	0.464285714285714	0.8	1	0.333333333333333	2	6
POU6F2	1	10	0	0	377.19	754.38	15	2	1	NA	1	NA	0	11
PP2D1	59	46	6	0	748.44	1496.88	15	2	0.0406165295081866	-Inf	1	-0.438095238095238	6	105
PPARA	5	11	0	1	464.31	928.62	15	2	1	1	1	0.3125	1	16
PPEF1	39	35	2	6	662.97	1325.94	15	2	0.263981588032221	0.700854700854701	1	0.277027027027027	8	74
PPFIA2	30	56	4	2	1123.65	2247.3	15	2	0.188787844625656	-2.73333333333333	1	-0.317829457364341	6	86
PPFIBP1	21	34	3	1	1120.02	2240.04	15	2	0.294041650004614	-3.85714285714286	1	-0.368181818181818	4	55
PPIL4	3	21	2	5	476.19	952.38	15	2	0.562229637869238	-1.8	1	-0.160714285714286	7	24
PPIL6	16	10	6	3	294.03	588.06	15	2	1	-0.25	1	-0.0512820512820512	9	26
PPM1G	0	3	0	0	28.38	56.76	15	2	1	NA	1	NA	0	3
PPM1H	7	22	1	3	463.32	926.64	15	2	1	-0.0476190476190477	1	-0.0086206896551724	4	29
PPME1	0	23	0	3	306.57	613.14	15	2	1	NA	1	0	3	23
PPP1CB	0	7	0	3	324.72	649.44	15	2	1	NA	1	0	3	7
PPP1R14C	15	2	1	3	223.74	447.48	15	2	0.0275689223057644	0.955555555555556	1	0.632352941176471	4	17
PPP1R17	1	6	0	0	157.41	314.82	15	2	1	NA	1	NA	0	7
PPP1R21	8	22	2	6	738.54	1477.08	15	2	1	0.0833333333333334	1	0.0166666666666667	8	30
PPP1R3A	68	34	5	3	1167.21	2334.42	15	2	1	0.166666666666667	1	0.0416666666666666	8	102
PPP1R3G	4	10	2	2	282.15	564.3	15	2	0.568627450980392	-1.5	1	-0.214285714285714	4	14
PPP1R42	12	11	3	0	306.9	613.8	15	2	0.238461538461538	-Inf	1	-0.478260869565217	3	23
PPP1R9A	2	20	6	4	861.63	1723.26	15	2	0.00486723139670859	-14	1	-0.509090909090909	10	22
PPP2R3B	1	10	1	2	509.85	1019.7	15	2	0.395604395604396	-4	1	-0.242424242424242	3	11
PPP2R5A	4	10	1	4	460.68	921.36	15	2	1	0.375	1	0.0857142857142857	5	14
PPP2R5D	2	18	0	8	447.15	894.3	15	2	1	1	1	0.1	8	20
PPP3R1	0	5	0	0	168.96	337.92	15	2	1	NA	1	NA	0	5
PPP4R1	10	31	4	4	939.51	1879.02	15	2	0.201697565486478	-2.1	1	-0.25609756097561	8	41
PPP4R3B	4	29	0	0	766.26	1532.52	15	2	1	NA	1	NA	0	33
PQLC1	1	6	2	1	267.96	535.92	15	2	0.183333333333333	-11	1	-0.523809523809524	3	7
PRCP	22	26	16	17	540.87	1081.74	15	2	0.824987875957715	-0.112299465240642	1	-0.0265151515151515	33	48
PRDM1	3	21	0	6	782.1	1564.2	15	2	1	1	1	0.125	6	24
PRDM13	5	22	2	3	469.26	938.52	15	2	0.296440489432703	-1.93333333333333	1	-0.214814814814815	5	27
PRDM14	9	29	0	4	505.89	1011.78	15	2	0.56129723934602	1	1	0.236842105263158	4	38
PRDM4	10	39	0	9	788.04	1576.08	15	2	0.334502576209008	1	1	0.204081632653061	9	49
PRDX4	4	8	2	3	270.27	540.54	15	2	1	-0.333333333333333	1	-0.0666666666666667	5	12
PRELID3A	0	7	0	1	191.07	382.14	15	2	1	NA	1	0	1	7
PREP	3	34	3	2	700.92	1401.84	15	2	0.0154537375333267	-16	1	-0.518918918918919	5	37
PREX2	10	38	1	4	1395.9	2791.8	15	2	1	0.05	1	0.00833333333333333	5	48
PRKAG1-PRKAG2	1	7	1	1	327.69	655.38	15	2	0.377777777777778	-6	1	-0.375	2	8
PRKAR2B	1	16	0	0	307.89	615.78	15	2	1	NA	1	NA	0	17
PRKCE	0	12	0	1	601.92	1203.84	15	2	1	NA	1	0	1	12
PRKCQ	1	25	2	2	707.85	1415.7	15	2	0.0394088669950739	-24	1	-0.461538461538462	4	26
PRKDC	109	191	31	16	4082.43	8164.86	15	2	0.000185350918599822	-2.39506880733945	0.336010323601711	-0.296241134751773	47	300
PRKX	0	9	2	1	360.36	720.72	15	2	0.0454545454545455	-Inf	1	-0.666666666666667	3	9
PRL	1	11	0	0	224.73	449.46	15	2	1	NA	1	NA	0	12
PRLL	7	9	1	1	253.44	506.88	15	2	1	-0.285714285714286	1	-0.0625	2	16
PRMT8	1	2	2	7	181.17	362.34	15	2	1	0.428571428571429	1	0.111111111111111	9	3
PROKR2	2	22	1	4	394.02	788.04	15	2	0.446086480569239	-1.75	1	-0.116666666666667	5	24
PRORSD1P	1	11	0	0	143.55	287.1	15	2	1	NA	1	NA	0	12
PROS1	9	28	1	5	647.13	1294.26	15	2	1	0.377777777777778	1	0.0765765765765766	6	37
PROSER1	2	23	1	4	930.6	1861.2	15	2	0.433497536945813	-1.875	1	-0.12	5	25
PROSER2	18	26	4	4	453.42	906.84	15	2	0.708374598683137	-0.444444444444444	1	-0.0909090909090909	8	44
PROX1	0	2	0	1	162.36	324.72	15	2	1	NA	1	0	1	2
PROZ	8	24	3	5	403.92	807.84	15	2	0.660279474520961	-0.8	1	-0.125	8	32
PRPF18	1	16	0	2	339.57	679.14	15	2	1	1	1	0.0588235294117647	2	17
PRPF4B	6	33	1	6	983.4	1966.8	15	2	1	0.0833333333333334	1	0.010989010989011	7	39
PRPH2	2	8	1	2	351.45	702.9	15	2	1	-1	1	-0.133333333333333	3	10
PRR15	6	3	0	1	116.82	233.64	15	2	0.4	1	1	0.666666666666667	1	9
PRR5	8	17	3	0	399.96	799.92	15	2	0.0503663003663004	-Inf	1	-0.68	3	25
PRRG1	2	7	0	3	258.39	516.78	15	2	1	1	1	0.222222222222222	3	9
PRSS23	1	13	1	0	369.27	738.54	15	2	0.133333333333333	-Inf	1	-0.928571428571429	1	14
PRSS55	17	11	0	3	349.47	698.94	15	2	0.0809788654060066	1	1	0.607142857142857	3	28
PRTFDC1	2	6	2	0	227.7	455.4	15	2	0.133333333333333	-Inf	1	-0.75	2	8
PSCA	18	6	1	0	119.79	239.58	15	2	1	-Inf	1	-0.25	1	24
PSEN2	4	20	0	8	454.41	908.82	15	2	0.54972191323693	1	1	0.166666666666667	8	24
PSMB1	3	11	0	2	237.6	475.2	15	2	1	1	1	0.214285714285714	2	14
PSMC2	0	21	0	2	429.66	859.32	15	2	1	NA	1	0	2	21
PSME4	2	60	2	6	1705.77	3411.54	15	2	0.0616101080276368	-9	1	-0.217741935483871	8	62
PSMG1	10	12	2	3	288.09	576.18	15	2	1	0.2	1	0.0545454545454545	5	22
PSMG2	7	13	2	3	271.26	542.52	15	2	1	-0.238095238095238	1	-0.05	5	20
PSMG4	0	2	0	3	104.61	209.22	15	2	1	NA	1	0	3	2
PSPC1	5	12	1	0	573.21	1146.42	15	2	0.333333333333333	-Inf	1	-0.705882352941176	1	17
PTCHD1	0	12	1	1	889.02	1778.04	15	2	0.142857142857143	-Inf	1	-0.5	2	12
PTCHD3-PTCHD3L	70	50	12	5	828.3	1656.6	15	2	0.431909652237951	-0.714285714285714	1	-0.122549019607843	17	120
PTCHD4	2	15	0	1	552.42	1104.84	15	2	1	1	1	0.117647058823529	1	17
PTDSS1	1	15	0	0	469.26	938.52	15	2	1	NA	1	NA	0	16
PTER	8	16	5	0	346.5	693	15	2	0.0108374384236453	-Inf	1	-0.666666666666667	5	24
PTF1A	4	3	1	0	240.57	481.14	15	2	1	-Inf	1	-0.428571428571429	1	7
PTGFRN	18	49	7	5	895.95	1791.9	15	2	0.0441493393580259	-2.81111111111111	1	-0.314676616915423	12	67
PTH1R	1	8	0	6	528.33	1056.66	15	2	1	1	1	0.111111111111111	6	9
PTHLH	5	10	1	1	176.22	352.44	15	2	1	-1	1	-0.166666666666667	2	15
PTN	0	4	0	1	164.34	328.68	15	2	1	NA	1	0	1	4
PTP4A1	1	1	1	0	172.26	344.52	15	2	1	-Inf	1	-0.5	1	2
PTP4A3	0	4	0	2	172.26	344.52	15	2	1	NA	1	0	2	4
PTPN12	13	24	6	5	817.74	1635.48	15	2	0.3037368959436	-1.21538461538462	1	-0.194103194103194	11	37
PTPN14	5	16	4	0	607.2	1214.4	15	2	0.00996047430830039	-Inf	1	-0.761904761904762	4	21
PTPN2	2	11	2	3	373.89	747.78	15	2	0.532679738562091	-2.66666666666667	1	-0.246153846153846	5	13
PTPN23	16	77	9	33	1118.37	2236.74	15	2	0.633678808886313	-0.3125	1	-0.0422427035330261	42	93
PTPN6	6	37	0	3	601.92	1203.84	15	2	1	1	1	0.13953488372093	3	43
PTPRB	32	74	4	9	1947.99	3895.98	15	2	1	-0.0277777777777777	1	-0.00580551523947753	13	106
PTPRM	0	18	0	3	443.52	887.04	15	2	1	NA	1	0	3	18
PTPRN2	9	14	0	2	365.31	730.62	15	2	0.52	1	1	0.391304347826087	2	23
PTPRO	20	39	5	5	1280.07	2560.14	15	2	0.478184171685202	-0.95	1	-0.161016949152542	10	59
PTPRQ	148	201	35	21	5497.47	10994.94	15	2	0.0058908325843278	-1.26351351351351	1	-0.200931232091691	56	349
PTPRR	4	16	4	1	517.77	1035.54	15	2	0.0234519104084322	-15	1	-0.6	5	20
PTPRZ1	37	50	5	3	2228.82	4457.64	15	2	0.459322235045136	-1.25225225225225	1	-0.199712643678161	8	87
PTRHD1	6	5	2	4	117.81	235.62	15	2	0.619909502262443	0.583333333333333	1	0.212121212121212	6	11
PTTG1IP	6	15	0	1	357.39	714.78	15	2	1	1	1	0.285714285714286	1	21
PUDP	4	5	0	3	193.38	386.76	15	2	0.490909090909091	1	1	0.444444444444444	3	9
PUF60	0	22	1	6	525.69	1051.38	15	2	0.241379310344828	-Inf	1	-0.142857142857143	7	22
PUM2	1	21	1	2	980.1	1960.2	15	2	0.23	-9.5	1	-0.287878787878788	3	22
PUS10	13	30	0	4	578.82	1157.64	15	2	0.563860622880049	1	1	0.302325581395349	4	43
PUS7L	13	22	11	6	627.66	1255.32	15	2	0.0799410129975776	-2.1025641025641	1	-0.27563025210084	17	35
PVALB	0	2	1	0	109.89	219.78	15	2	0.333333333333333	-Inf	1	-1	1	2
PWP1	6	23	2	4	482.13	964.26	15	2	0.602109465487075	-0.916666666666667	1	-0.126436781609195	6	29
PWP2	12	38	8	9	900.24	1800.48	15	2	0.122713815026858	-1.81481481481481	1	-0.230588235294118	17	50
PXDC1	0	8	0	4	208.56	417.12	15	2	1	NA	1	0	4	8
PXDN	8	44	3	10	1507.44	3014.88	15	2	0.679390212064937	-0.65	1	-0.0769230769230769	13	52
PYGB	5	38	6	23	835.56	1671.12	15	2	0.331896184060218	-0.982608695652174	1	-0.0906174819566961	29	43
PYROXD1	11	21	1	3	495	990	15	2	1	0.363636363636364	1	0.09375	4	32
QKI	0	5	0	1	291.72	583.44	15	2	1	NA	1	0	1	5
QRSL1	7	25	4	0	505.89	1011.78	15	2	0.00560224089635855	-Inf	1	-0.78125	4	32
QTRT2	16	15	1	3	415.47	830.94	15	2	0.602597402597402	0.6875	1	0.266129032258065	4	31
RAB10	0	6	0	2	198.99	397.98	15	2	1	NA	1	0	2	6
RAB10L	4	5	1	0	280.17	560.34	15	2	1	-Inf	1	-0.555555555555556	1	9
RAB12	0	1	0	3	242.22	484.44	15	2	1	NA	1	0	3	1
RAB18	0	12	1	2	204.93	409.86	15	2	0.2	-Inf	1	-0.333333333333333	3	12
RAB19	1	8	1	8	213.84	427.68	15	2	1	0	1	0	9	9
RAB1B	0	3	0	0	196.35	392.7	15	2	1	NA	1	NA	0	3
RAB20	0	6	1	3	228.69	457.38	15	2	0.4	-Inf	1	-0.25	4	6
RAB21	1	10	1	3	222.75	445.5	15	2	0.476190476190476	-2.33333333333333	1	-0.159090909090909	4	11
RAB23	1	5	0	2	235.62	471.24	15	2	1	1	1	0.166666666666667	2	6
RAB2A	0	7	0	2	210.87	421.74	15	2	1	NA	1	0	2	7
RAB30	0	9	0	6	198	396	15	2	1	NA	1	0	6	9
RAB31	1	4	0	0	194.04	388.08	15	2	1	NA	1	NA	0	5
RAB32	1	6	1	2	216.81	433.62	15	2	1	-2	1	-0.19047619047619	3	7
RAB38	7	7	2	2	260.37	520.74	15	2	1	0	1	0	4	14
RAB39A	1	7	0	0	255.42	510.84	15	2	1	NA	1	NA	0	8
RAB3GAP2	16	64	2	5	1300.86	2601.72	15	2	0.63072684397823	-0.6	1	-0.0857142857142857	7	80
RAB3IP	1	9	0	3	457.38	914.76	15	2	1	1	1	0.1	3	10
RAB41	1	13	1	0	273.24	546.48	15	2	0.133333333333333	-Inf	1	-0.928571428571429	1	14
RAB41-RAB6A	0	6	0	0	169.95	339.9	15	2	1	NA	1	NA	0	6
RAB4A	0	5	0	3	185.79	371.58	15	2	1	NA	1	0	3	5
RAB5A	0	6	0	0	213.84	427.68	15	2	1	NA	1	NA	0	6
RAB9A	2	11	0	1	199.98	399.96	15	2	1	1	1	0.153846153846154	1	13
RABL2L	5	4	3	1	178.2	356.4	15	2	1	-1.4	1	-0.194444444444444	4	9
RAC2	0	3	0	3	191.07	382.14	15	2	1	NA	1	0	3	3
RAD21	1	23	0	3	627.66	1255.32	15	2	1	1	1	0.0416666666666667	3	24
RAD51AP2	43	15	1	0	549.12	1098.24	15	2	1	-Inf	1	-0.258620689655172	1	58
RAD52	13	22	4	0	415.8	831.6	15	2	0.0289358184095026	-Inf	1	-0.628571428571429	4	35
RAI2	8	27	2	25	543.51	1087.02	15	2	0.164218795316319	0.73	1	0.154497354497354	27	35
RALA	0	4	0	1	204.93	409.86	15	2	1	NA	1	0	1	4
RALBP1	2	29	1	9	648.45	1296.9	15	2	1	-0.611111111111111	1	-0.0354838709677419	10	31
RALGAPA2	24	63	4	13	1826.55	3653.1	15	2	1	0.192307692307692	1	0.0405679513184584	17	87
RALYL	6	9	0	1	384.45	768.9	15	2	1	1	1	0.4	1	15
RAMP3	2	9	1	0	155.43	310.86	15	2	0.25	-Inf	1	-0.818181818181818	1	11
RANBP9	0	15	1	2	551.76	1103.52	15	2	0.166666666666667	-Inf	1	-0.333333333333333	3	15
RAP1B	0	2	0	0	183.15	366.3	15	2	1	NA	1	NA	0	2
RAP2A	0	2	0	0	182.16	364.32	15	2	1	NA	1	NA	0	2
RAPGEF5	3	27	2	6	668.25	1336.5	15	2	0.279307170948038	-2	1	-0.15	8	30
RARA-RARB	2	14	0	2	401.94	803.88	15	2	1	1	1	0.125	2	16
RARS2	18	26	7	5	536.25	1072.5	15	2	0.337557102327081	-1.02222222222222	1	-0.174242424242424	12	44
RASA3	11	40	4	7	879.12	1758.24	15	2	0.437000854761574	-1.07792207792208	1	-0.14795008912656	11	51
RASD2	1	11	0	1	264.33	528.66	15	2	1	1	1	0.0833333333333333	1	12
RASGRP3	2	28	1	8	667.26	1334.52	15	2	0.555750082065871	-0.75	1	-0.0444444444444444	9	30
RASL11A	1	5	1	7	234.63	469.26	15	2	1	0.285714285714286	1	0.0416666666666667	8	6
RASSF3	6	7	0	4	236.61	473.22	15	2	0.237394957983193	1	1	0.461538461538462	4	13
RASSF9	8	11	1	0	415.8	831.6	15	2	0.45	-Inf	1	-0.578947368421053	1	19
RB1	11	27	1	5	595.98	1191.96	15	2	1	0.509090909090909	1	0.12280701754386	6	38
RBBP7	3	15	3	5	420.75	841.5	15	2	0.330130738826391	-2	1	-0.208333333333333	8	18
RBFA	26	20	1	5	333.63	667.26	15	2	0.0937013103113586	0.846153846153846	1	0.398550724637681	6	46
RBFOX2	8	5	2	3	396	792	15	2	0.607843137254902	0.583333333333333	1	0.215384615384615	5	13
RBKS	3	4	4	0	306.9	613.8	15	2	0.193939393939394	-Inf	1	-0.571428571428571	4	7
RBM11	11	9	0	5	270.27	540.54	15	2	0.0463768115942029	1	1	0.55	5	20
RBM17	1	15	1	4	398.97	797.94	15	2	0.428571428571429	-2.75	1	-0.1375	5	16
RBM24	1	9	1	2	223.74	447.48	15	2	0.423076923076923	-3.5	1	-0.233333333333333	3	10
RBM33	12	55	0	5	1134.54	2269.08	15	2	0.581774534676087	1	1	0.17910447761194	5	67
RBM34	19	19	7	6	386.1	772.2	15	2	1	-0.166666666666667	1	-0.0384615384615384	13	38
RBM48	19	21	5	1	353.43	706.86	15	2	0.189638873132917	-4.52631578947368	1	-0.358333333333333	6	40
RBP5	1	10	0	0	134.64	269.28	15	2	1	NA	1	NA	0	11
RBX1	0	5	0	0	107.58	215.16	15	2	1	NA	1	NA	0	5
RCAN1	2	10	1	1	233.64	467.28	15	2	0.395604395604396	-4	1	-0.333333333333333	2	12
RCAN2	0	9	0	1	196.02	392.04	15	2	1	NA	1	0	1	9
RCBTB1	6	24	2	8	568.26	1136.52	15	2	1	0	1	0	10	30
RCBTB2	1	30	0	5	546.48	1092.96	15	2	1	1	1	0.032258064516129	5	31
RCSD1	16	21	1	5	390.06	780.12	15	2	0.376490005501559	0.7375	1	0.265765765765766	6	37
RD3	7	10	3	1	241.56	483.12	15	2	0.31077694235589	-3.28571428571429	1	-0.338235294117647	4	17
RDH10	1	17	0	2	336.6	673.2	15	2	1	1	1	0.0555555555555556	2	18
RDH14	4	14	1	0	323.73	647.46	15	2	0.263157894736842	-Inf	1	-0.777777777777778	1	18
RDX	2	18	0	5	578.16	1156.32	15	2	1	1	1	0.1	5	20
RECK	7	38	1	3	965.25	1930.5	15	2	0.522031754422398	-0.80952380952381	1	-0.0944444444444444	4	45
RECQL	19	30	1	1	655.38	1310.76	15	2	1	-0.578947368421053	1	-0.112244897959184	2	49
REL	13	34	2	6	577.17	1154.34	15	2	1	0.128205128205128	1	0.0265957446808511	8	47
RELN	22	125	9	11	2985.84	5971.68	15	2	0.00335954752503357	-3.64876033057851	1	-0.300340136054422	20	147
REPS1	26	26	1	6	902.55	1805.1	15	2	0.111955011059874	0.833333333333333	1	0.357142857142857	7	52
RERG	7	15	0	1	227.7	455.4	15	2	1	1	1	0.318181818181818	1	22
REV1	10	31	1	3	1089.99	2179.98	15	2	1	-0.0333333333333334	1	-0.00609756097560976	4	41
REV3L	72	110	20	20	3408.57	6817.14	15	2	0.287495166196571	-0.527777777777778	1	-0.104395604395604	40	182
RFC3	1	13	1	0	353.43	706.86	15	2	0.133333333333333	-Inf	1	-0.928571428571429	1	14
RFTN1	12	25	8	2	580.14	1160.28	15	2	0.0110797009306457	-7.33333333333333	1	-0.475675675675676	10	37
RFX4	8	23	2	3	763.29	1526.58	15	2	0.603439860792802	-0.916666666666667	1	-0.141935483870968	5	31
RFX6	11	21	4	1	862.29	1724.58	15	2	0.13619501854796	-6.63636363636364	1	-0.45625	5	32
RFX8	21	18	2	1	533.61	1067.22	15	2	1	-0.714285714285714	1	-0.128205128205128	3	39
RFXAP	3	11	3	5	217.47	434.94	15	2	0.624355005159959	-1.2	1	-0.160714285714286	8	14
RGN	6	19	2	2	297	594	15	2	0.300029472443266	-2.16666666666667	1	-0.26	4	25
RGNL	7	9	4	2	297.99	595.98	15	2	0.635117204776648	-1.57142857142857	1	-0.229166666666667	6	16
RGS17	1	5	0	0	188.1	376.2	15	2	1	NA	1	NA	0	6
RGS20	1	7	0	1	217.8	435.6	15	2	1	1	1	0.125	1	8
RGS22	50	47	16	2	1345.41	2690.82	15	2	0.00358449881751033	-6.52	1	-0.373424971363116	18	97
RHAG	16	12	0	2	422.73	845.46	15	2	0.209195402298851	1	1	0.571428571428571	2	28
RHNO1	23	23	7	6	263.67	527.34	15	2	1	-0.166666666666667	1	-0.0384615384615384	13	46
RHOB	0	14	0	6	195.03	390.06	15	2	1	NA	1	0	6	14
RHOG	0	6	1	1	190.08	380.16	15	2	0.25	-Inf	1	-0.5	2	6
RHOQ	1	1	0	2	202.95	405.9	15	2	1	1	1	0.5	2	2
RHOU	0	3	0	3	196.35	392.7	15	2	1	NA	1	0	3	3
RHPN1	11	25	4	15	656.7	1313.4	15	2	0.536964798182414	0.393939393939394	1	0.0950292397660819	19	36
RIBC2	19	6	1	2	379.17	758.34	15	2	0.188034188034188	0.842105263157895	1	0.426666666666667	3	25
RIDA	0	3	0	0	138.6	277.2	15	2	1	NA	1	NA	0	3
RIMKLB	3	9	1	3	338.91	677.82	15	2	1	0	1	0	4	12
RIMS1	9	14	3	2	689.04	1378.08	15	2	0.623931623931624	-1.33333333333333	1	-0.208695652173913	5	23
RIMS2	16	45	3	7	1497.87	2995.74	15	2	1	-0.205357142857143	1	-0.0377049180327869	10	61
RIN2	18	28	0	4	914.76	1829.52	15	2	0.282813721233174	1	1	0.391304347826087	4	46
RINT1	16	46	4	3	1156.32	2312.64	15	2	0.181087057513748	-2.83333333333333	1	-0.313364055299539	7	62
RIOK1	16	25	5	6	556.38	1112.76	15	2	0.739453065609782	-0.302083333333333	1	-0.0643015521064301	11	41
RIOK3	6	17	0	6	513.81	1027.62	15	2	0.295358090185676	1	1	0.260869565217391	6	23
RIPK1	19	49	6	5	685.08	1370.16	15	2	0.0927030442368021	-2.09473684210526	1	-0.266042780748663	11	68
RIPK4	3	32	4	8	782.1	1564.2	15	2	0.0595334355124846	-4.33333333333333	1	-0.247619047619048	12	35
RIPPLY3	4	3	1	0	130.68	261.36	15	2	1	-Inf	1	-0.428571428571429	1	7
RMDN1	3	13	0	0	273.24	546.48	15	2	1	NA	1	NA	0	16
RMDN2	15	14	5	2	412.83	825.66	15	2	0.426427462480594	-1.33333333333333	1	-0.197044334975369	7	29
RMND1	7	22	0	1	442.53	885.06	15	2	1	1	1	0.241379310344828	1	29
RNASEH1	15	20	1	0	348.48	696.96	15	2	0.444444444444444	-Inf	1	-0.571428571428571	1	35
RNASEH2B	6	7	2	1	281.16	562.32	15	2	1	-1.33333333333333	1	-0.205128205128205	3	13
RNF121	1	25	0	5	291.39	582.78	15	2	1	1	1	0.0384615384615385	5	26
RNF138	1	3	0	1	230.01	460.02	15	2	1	1	1	0.25	1	4
RNF139	15	43	1	8	688.05	1376.1	15	2	0.675075814572115	0.641666666666667	1	0.147509578544061	9	58
RNF144A	10	14	1	0	337.59	675.18	15	2	0.44	-Inf	1	-0.583333333333333	1	24
RNF144B	6	16	2	0	271.26	542.52	15	2	0.101449275362319	-Inf	1	-0.727272727272727	2	22
RNF149	0	15	1	5	400.95	801.9	15	2	0.285714285714286	-Inf	1	-0.166666666666667	6	15
RNF151	1	15	0	4	286.11	572.22	15	2	1	1	1	0.0625	4	16
RNF152	1	8	1	10	201.96	403.92	15	2	1	0.2	1	0.0202020202020202	11	9
RNF169	23	27	8	23	649.44	1298.88	15	2	0.0995966211208458	0.591682419659735	1	0.201935483870968	31	50
RNF17	97	73	9	10	1535.82	3071.64	15	2	0.470249137278323	0.322680412371134	1	0.0969040247678019	19	170
RNF19A	8	55	7	6	804.87	1609.74	15	2	0.00260803997097997	-7.02083333333333	0.978194853943075	-0.411477411477411	13	63
RNF217	1	11	1	1	252.45	504.9	15	2	0.274725274725275	-10	1	-0.416666666666667	2	12
RNF219	9	27	2	1	679.47	1358.94	15	2	0.186563081299924	-5	1	-0.416666666666667	3	36
RNF32	14	9	2	2	366.3	732.6	15	2	1	0.357142857142857	1	0.108695652173913	4	23
RNF6	24	39	2	11	683.1	1366.2	15	2	0.19805532675721	0.704545454545455	1	0.227106227106227	13	63
RNF8	7	18	3	3	494.01	988.02	15	2	0.357833490202789	-1.57142857142857	1	-0.22	6	25
RNGTT	0	21	0	5	592.35	1184.7	15	2	1	NA	1	0	5	21
RNMT	8	13	2	2	388.08	776.16	15	2	1	-0.625	1	-0.119047619047619	4	21
ROBO2	5	19	1	4	784.08	1568.16	15	2	1	0.05	1	0.00833333333333333	5	24
ROCK1	25	44	6	13	1449.69	2899.38	15	2	0.791272979526363	0.187692307692308	1	0.0465293668954996	19	69
ROPN1L	8	12	3	3	216.81	433.62	15	2	1	-0.5	1	-0.1	6	20
ROS1	97	82	8	8	2303.73	4607.46	15	2	0.797720262670245	0.154639175257732	1	0.0418994413407822	16	179
RP1L1	91	78	17	12	1664.19	3328.38	15	2	0.689890377434371	-0.214285714285714	1	-0.0477453580901857	29	169
RP2	4	10	3	0	358.38	716.76	15	2	0.0514705882352941	-Inf	1	-0.714285714285714	3	14
RP9	6	6	1	0	239.25	478.5	15	2	1	-Inf	1	-0.5	1	12
RPA3	4	3	0	1	121.77	243.54	15	2	1	1	1	0.571428571428571	1	7
RPAP3	20	28	3	4	663.3	1326.6	15	2	1	-0.05	1	-0.0119047619047619	7	48
RPF2	1	20	0	2	303.93	607.86	15	2	1	1	1	0.0476190476190476	2	21
RPL14	4	8	0	3	153.45	306.9	15	2	0.516483516483517	1	1	0.333333333333333	3	12
RPL15	0	7	0	2	202.95	405.9	15	2	1	NA	1	0	2	7
RPL18A	0	8	0	1	175.23	350.46	15	2	1	NA	1	0	1	8
RPL24	2	2	0	2	154.77	309.54	15	2	0.466666666666667	1	1	0.5	2	4
RPL3	0	24	1	4	399.96	799.92	15	2	0.172413793103448	-Inf	1	-0.2	5	24
RPL30	0	5	0	3	114.84	229.68	15	2	1	NA	1	0	3	5
RPL31	0	8	0	2	124.74	249.48	15	2	1	NA	1	0	2	8
RPL7	3	13	1	2	237.6	475.2	15	2	0.530443756449948	-1.16666666666667	1	-0.145833333333333	3	16
RPL8	0	15	0	3	255.42	510.84	15	2	1	NA	1	0	3	15
RPLP1	1	7	0	2	113.85	227.7	15	2	1	1	1	0.125	2	8
RPRD1A	19	18	2	3	401.94	803.88	15	2	1	0.368421052631579	1	0.113513513513513	5	37
RPS11	0	15	0	3	157.41	314.82	15	2	1	NA	1	0	3	15
RPS12	1	4	0	1	135.63	271.26	15	2	1	1	1	0.2	1	5
RPS16	1	7	0	4	145.53	291.06	15	2	1	1	1	0.125	4	8
RPS19BP1	6	5	2	0	135.63	271.26	15	2	0.487179487179487	-Inf	1	-0.454545454545455	2	11
RPS20	0	9	1	2	118.8	237.6	15	2	0.25	-Inf	1	-0.333333333333333	3	9
RPS27A	0	9	0	0	155.43	310.86	15	2	1	NA	1	NA	0	9
RPS3	3	5	0	1	241.56	483.12	15	2	1	1	1	0.375	1	8
RPS6KA2	5	21	2	3	695.97	1391.94	15	2	0.562229637869237	-1.8	1	-0.207692307692308	5	26
RPS6KA3	4	26	0	1	723.36	1446.72	15	2	1	1	1	0.133333333333333	1	30
RPS6KC1	24	46	4	4	1071.18	2142.36	15	2	0.447784027817944	-0.916666666666667	1	-0.157142857142857	8	70
RPS7	0	8	0	0	193.05	386.1	15	2	1	NA	1	NA	0	8
RPSA	1	16	0	0	294.03	588.06	15	2	1	NA	1	NA	0	17
RRAGD	1	8	2	4	404.58	809.16	15	2	0.525274725274725	-3	1	-0.222222222222222	6	9
RRBP1	13	40	5	10	990	1980	15	2	0.519062939785636	-0.538461538461539	1	-0.0880503144654088	15	53
RREB1	16	36	3	9	1504.8	3009.6	15	2	1	0.25	1	0.0576923076923077	12	52
RRM1	3	61	5	20	785.07	1570.14	15	2	0.0368492598539555	-4.08333333333333	1	-0.153125	25	64
RRM2B	10	16	1	4	332.64	665.28	15	2	0.630983279481611	0.6	1	0.184615384615385	5	26
RRP15	8	9	1	0	254.43	508.86	15	2	1	-Inf	1	-0.529411764705882	1	17
RRP1B	32	35	7	9	751.41	1502.82	15	2	1	0.149305555555556	1	0.0401119402985075	16	67
RRP36	17	13	4	1	231.33	462.66	15	2	0.627177850612386	-2.05882352941176	1	-0.233333333333333	5	30
RRP7A	8	14	4	4	273.24	546.48	15	2	0.677945642563334	-0.75	1	-0.136363636363636	8	22
RRP8	22	26	5	3	449.13	898.26	15	2	0.462026319961947	-0.96969696969697	1	-0.166666666666667	8	48
RRS1	19	21	5	2	246.51	493.02	15	2	0.415800758700313	-1.76315789473684	1	-0.239285714285714	7	40
RS1	1	10	0	5	222.75	445.5	15	2	1	1	1	0.0909090909090909	5	11
RSAD2	14	23	0	0	380.16	760.32	15	2	1	NA	1	NA	0	37
RSF1	32	64	11	11	1506.45	3012.9	15	2	0.150685308208927	-1	1	-0.166666666666667	22	96
RSPH1	24	19	4	14	343.53	687.06	15	2	0.0239181490748003	0.773809523809524	1	0.335917312661499	18	43
RSPH3	20	13	2	6	420.75	841.5	15	2	0.115247705491608	0.783333333333333	1	0.356060606060606	8	33
RSPH9	10	13	1	3	273.24	546.48	15	2	0.623931623931624	0.566666666666667	1	0.184782608695652	4	23
RSPO2	2	1	1	0	201.96	403.92	15	2	1	-Inf	1	-0.333333333333333	1	3
RSPO3	1	2	1	1	178.2	356.4	15	2	1	-1	1	-0.166666666666667	2	3
RSU1	16	13	7	4	329.01	658.02	15	2	0.729795117698344	-0.421875	1	-0.0846394984326019	11	29
RTCB	0	23	0	4	496.32	992.64	15	2	1	NA	1	0	4	23
RTN4	0	3	0	1	186.78	373.56	15	2	1	NA	1	0	1	3
RTN4IP1	4	14	0	2	353.76	707.52	15	2	1	1	1	0.222222222222222	2	18
RUBCNL	30	36	6	6	786.39	1572.78	15	2	1	-0.2	1	-0.0454545454545455	12	66
RUNDC3B	1	10	1	1	444.51	889.02	15	2	0.294871794871795	-9	1	-0.409090909090909	2	11
RUNX1	10	14	2	4	493.35	986.7	15	2	1	0.3	1	0.0833333333333334	6	24
RUNX2	9	17	1	1	542.52	1085.04	15	2	1	-0.888888888888889	1	-0.153846153846154	2	26
RWDD1	2	6	1	1	238.59	477.18	15	2	1	-2	1	-0.25	2	8
RWDD2B	7	18	2	1	287.1	574.2	15	2	0.234432234432234	-4.14285714285714	1	-0.386666666666667	3	25
RYR2	34	176	5	13	4902.48	9804.96	15	2	0.203379829351017	-0.990950226244344	1	-0.115873015873016	18	210
SACM1L	3	27	0	3	571.56	1143.12	15	2	1	1	1	0.1	3	30
SACS	25	186	5	17	4535.19	9070.38	15	2	0.174923313313793	-1.18823529411765	1	-0.108789314950452	22	211
SALL3	10	42	1	2	1250.37	2500.74	15	2	0.495178197064989	-1.1	1	-0.141025641025641	3	52
SAMD3	24	19	1	2	454.41	908.82	15	2	0.58498023715415	0.604166666666667	1	0.224806201550388	3	43
SAMD9L	73	55	2	5	1570.14	3140.28	15	2	0.241006287133858	0.698630136986301	1	0.284598214285714	7	128
SAMM50	2	15	2	2	465.3	930.6	15	2	0.147869674185464	-6.5	1	-0.382352941176471	4	17
SAP18	0	3	0	0	107.91	215.82	15	2	1	NA	1	NA	0	3
SASH1	24	60	7	6	1449.36	2898.72	15	2	0.107108063602777	-1.91666666666667	1	-0.252747252747253	13	84
SAT1	0	9	0	3	170.28	340.56	15	2	1	NA	1	0	3	9
SATB1	2	15	0	2	778.14	1556.28	15	2	1	1	1	0.117647058823529	2	17
SAYSD1	6	10	1	0	148.5	297	15	2	0.411764705882353	-Inf	1	-0.625	1	16
SBK2	3	13	0	2	314.82	629.64	15	2	1	1	1	0.1875	2	16
SCAF11	56	41	15	11	1292.94	2585.88	15	2	1	0.00162337662337664	1	0.000396510705789055	26	97
SCAF4	4	36	1	7	1051.71	2103.42	15	2	1	-0.285714285714286	1	-0.025	8	40
SCAF8	11	46	3	6	1381.71	2763.42	15	2	0.386452466220561	-1.09090909090909	1	-0.140350877192982	9	57
SCAP	15	79	9	31	1304.82	2609.64	15	2	0.460420439445723	-0.529032258064516	1	-0.0654255319148936	40	94
SCARA5	5	15	3	13	486.09	972.18	15	2	0.708598779788991	0.307692307692308	1	0.0625	16	20
SCEL	13	14	2	1	369.27	738.54	15	2	1	-1.15384615384615	1	-0.185185185185185	3	27
SCIN	22	28	2	1	761.31	1522.62	15	2	0.584051908136259	-1.54545454545455	1	-0.226666666666667	3	50
SCML2	9	29	5	1	722.7	1445.4	15	2	0.00893363584798639	-15.1111111111111	1	-0.596491228070176	6	38
SCML4	17	19	5	3	401.94	803.88	15	2	0.69808479451134	-0.862745098039216	1	-0.152777777777778	8	36
SCN11A	42	60	4	5	1690.26	3380.52	15	2	1	-0.142857142857143	1	-0.0326797385620915	9	102
SCN5A	13	59	4	5	1979.01	3958.02	15	2	0.086759377977105	-2.63076923076923	1	-0.263888888888889	9	72
SCNN1A	7	32	3	7	631.62	1263.24	15	2	0.40522931000417	-0.959183673469388	1	-0.120512820512821	10	39
SCRN1	2	19	2	0	410.85	821.7	15	2	0.0237154150197628	-Inf	1	-0.904761904761905	2	21
SCUBE1	7	16	1	0	422.73	845.46	15	2	0.333333333333333	-Inf	1	-0.695652173913043	1	23
SCX	0	4	1	4	181.17	362.34	15	2	1	-Inf	1	-0.2	5	4
SCYL2	6	26	0	4	925.65	1851.3	15	2	1	1	1	0.1875	4	32
SDC1	8	11	1	1	286.44	572.88	15	2	1	-0.375	1	-0.0789473684210527	2	19
SDC2	3	6	1	2	199.98	399.96	15	2	1	0	1	0	3	9
SDCBP	4	9	2	1	295.02	590.04	15	2	0.517857142857143	-3.5	1	-0.358974358974359	3	13
SDCCAG8	15	28	5	3	710.49	1420.98	15	2	0.2367021688837	-2.11111111111111	1	-0.276162790697674	8	43
SDHA	2	38	1	4	659.34	1318.68	15	2	0.303735024665257	-3.75	1	-0.15	5	40
SDHAF3	2	4	2	0	67.32	134.64	15	2	0.428571428571429	-Inf	1	-0.666666666666667	2	6
SDHAF4	2	4	0	1	99.99	199.98	15	2	1	1	1	0.333333333333333	1	6
SDR16C5	4	19	1	10	302.94	605.88	15	2	1	0.525	1	0.08300395256917	11	23
SEC22C	14	15	5	0	349.47	698.94	15	2	0.0525810764188373	-Inf	1	-0.517241379310345	5	29
SEC23B	1	40	3	7	760.32	1520.64	15	2	0.0205282112845138	-16.1428571428571	1	-0.275609756097561	10	41
SEC61A2	0	17	0	1	472.23	944.46	15	2	1	NA	1	0	1	17
SEC61B	2	2	0	0	95.04	190.08	15	2	1	NA	1	NA	0	4
SEC61G	0	4	0	0	68.31	136.62	15	2	1	NA	1	NA	0	4
SEC63	3	30	0	3	771.87	1543.74	15	2	1	1	1	0.0909090909090909	3	33
SEH1L	0	15	0	5	398.97	797.94	15	2	1	NA	1	0	5	15
SELENOI	4	14	2	4	371.91	743.82	15	2	0.61805700020803	-0.75	1	-0.111111111111111	6	18
SELENOO	15	27	5	6	679.47	1358.94	15	2	0.728456396738857	-0.5	1	-0.0974025974025974	11	42
SEM1	0	4	0	1	70.29	140.58	15	2	1	NA	1	0	1	4
SEMA3C	6	23	0	2	747.45	1494.9	15	2	1	1	1	0.206896551724138	2	29
SEMA3D	6	26	2	4	759	1518	15	2	0.587041023573531	-1.16666666666667	1	-0.145833333333333	6	32
SENP6	12	33	4	5	1178.1	2356.2	15	2	0.424511327256863	-1.2	1	-0.177777777777778	9	45
SENP7	46	34	5	2	1045.44	2090.88	15	2	0.694647046469499	-0.847826086956522	1	-0.139285714285714	7	80
SEPHS1	0	9	0	3	389.07	778.14	15	2	1	NA	1	0	3	9
SEPT10	20	25	3	3	465.3	930.6	15	2	1	-0.25	1	-0.0555555555555556	6	45
SEPT3	11	27	3	13	465.3	930.6	15	2	0.51549164237779	0.433566433566434	1	0.101973684210526	16	38
SEPT7	2	11	2	2	412.5	825	15	2	0.21890756302521	-4.5	1	-0.346153846153846	4	13
SERAC1	10	34	1	5	696.96	1393.92	15	2	1	0.32	1	0.0606060606060606	6	44
SERHL2	15	16	3	6	338.58	677.16	15	2	0.476091476091476	0.466666666666667	1	0.150537634408602	9	31
SERINC1	0	13	0	3	457.38	914.76	15	2	1	NA	1	0	3	13
SERPINE3	27	23	6	6	396	792	15	2	1	0.148148148148148	1	0.04	12	50
SERPINH1	2	14	1	9	372.57	745.14	15	2	1	0.222222222222222	1	0.025	10	16
SERTAD2	3	7	1	5	313.83	627.66	15	2	1	0.533333333333333	1	0.133333333333333	6	10
SERTAD4	6	5	1	1	282.81	565.62	15	2	1	0.166666666666667	1	0.0454545454545454	2	11
SERTM1	1	5	1	0	106.92	213.84	15	2	0.285714285714286	-Inf	1	-0.833333333333333	1	6
SESN1	2	18	1	3	470.25	940.5	15	2	0.436758893280632	-2	1	-0.15	4	20
SESN3	1	17	0	2	485.1	970.2	15	2	1	1	1	0.0555555555555556	2	18
SETD2	57	125	13	35	2114.64	4229.28	15	2	0.602531517798189	0.18546365914787	1	0.0423534798534799	48	182
SETD4	16	23	6	3	435.6	871.2	15	2	0.266934987509202	-1.875	1	-0.256410256410256	9	39
SETDB2	61	45	3	7	836.55	1673.1	15	2	0.10942389314967	0.68384074941452	1	0.275471698113208	10	106
SF3B5	0	1	0	1	86.13	172.26	15	2	1	NA	1	0	1	1
SF3B6	0	8	0	2	124.74	249.48	15	2	1	NA	1	0	2	8
SFMBT2	21	28	1	5	960.3	1920.6	15	2	0.38409933881632	0.733333333333333	1	0.261904761904762	6	49
SFRP4	13	22	1	0	343.53	687.06	15	2	0.388888888888889	-Inf	1	-0.628571428571429	1	35
SFT2D1	4	9	0	1	176.22	352.44	15	2	1	1	1	0.307692307692308	1	13
SFT2D2	6	4	0	0	159.39	318.78	15	2	1	NA	1	NA	0	10
SGCE	6	19	1	2	469.92	939.84	15	2	1	-0.583333333333333	1	-0.0933333333333333	3	25
SGCG	10	16	0	0	325.38	650.76	15	2	1	NA	1	NA	0	26
SGK1	0	10	0	4	428.67	857.34	15	2	1	NA	1	0	4	10
SGK3	4	18	1	5	486.09	972.18	15	2	1	0.1	1	0.0151515151515152	6	22
SGO1	34	13	7	3	588.39	1176.78	15	2	1	0.107843137254902	1	0.023404255319149	10	47
SGSM3	12	45	5	15	803.88	1607.76	15	2	0.758183999180479	-0.25	1	-0.0394736842105263	20	57
SH2D1B	5	5	0	2	133.65	267.3	15	2	0.46969696969697	1	1	0.5	2	10
SH3BGR	4	7	0	1	182.16	364.32	15	2	1	1	1	0.363636363636364	1	11
SH3BGRL2	1	0	1	1	105.93	211.86	15	2	1	1	1	0.5	2	1
SH3BP1	13	39	9	8	633.93	1267.86	15	2	0.0404979467949039	-2.375	1	-0.279411764705882	17	52
SH3BP5	1	18	0	5	426.03	852.06	15	2	1	1	1	0.0526315789473684	5	19
SH3KBP1	4	13	1	4	639.54	1279.08	15	2	1	0.1875	1	0.0352941176470588	5	17
SH3RF3	9	42	7	9	673.2	1346.4	15	2	0.0459634130686112	-2.62962962962963	1	-0.261029411764706	16	51
SHH	8	22	0	2	421.74	843.48	15	2	1	1	1	0.266666666666667	2	30
SHISA2	1	17	0	4	270.6	541.2	15	2	1	1	1	0.0555555555555556	4	18
SHISA8	6	22	9	15	357.72	715.44	15	2	0.233722791200694	-1.2	1	-0.160714285714286	24	28
SHOX	1	5	0	1	289.08	578.16	15	2	1	1	1	0.166666666666667	1	6
SHPRH	31	65	3	9	1616.01	3232.02	15	2	0.749355495144353	0.301075268817204	1	0.0729166666666667	12	96
SHROOM2	29	68	9	12	1709.4	3418.8	15	2	0.304487712787685	-0.758620689655172	1	-0.12960235640648	21	97
SIAH3	5	6	2	1	207.9	415.8	15	2	1	-1.4	1	-0.212121212121212	3	11
SIDT1	3	34	3	10	767.25	1534.5	15	2	0.172915290075327	-2.4	1	-0.14968814968815	13	37
SIIL	23	54	1	12	879.12	1758.24	15	2	0.171887246259021	0.804347826086957	1	0.221778221778222	13	77
SIK1	8	36	2	4	791.01	1582.02	15	2	0.585916290660575	-1.25	1	-0.151515151515151	6	44
SIM1	6	35	2	2	685.41	1370.82	15	2	0.13953488372093	-4.83333333333333	1	-0.353658536585366	4	41
SIM2	13	25	1	3	823.68	1647.36	15	2	1	0.358974358974359	1	0.0921052631578947	4	38
SINHCAF	4	10	2	2	257.4	514.8	15	2	0.568627450980392	-1.5	1	-0.214285714285714	4	14
SIPA1L2	8	64	1	6	1694.88	3389.76	15	2	0.586451683081327	-0.333333333333333	1	-0.0317460317460317	7	72
SIRT5	2	10	1	3	307.89	615.78	15	2	1	-0.666666666666667	1	-0.0833333333333333	4	12
SIX2	1	9	0	2	285.12	570.24	15	2	1	1	1	0.1	2	10
SKA3	28	20	7	6	474.21	948.42	15	2	1	0.166666666666667	1	0.0448717948717949	13	48
SKAP2	3	9	0	0	334.62	669.24	15	2	1	NA	1	NA	0	12
SLA	8	6	1	5	275.22	550.44	15	2	0.157120743034056	0.85	1	0.404761904761905	6	14
SLAIN1	8	19	0	1	517.77	1035.54	15	2	1	1	1	0.296296296296296	1	27
SLC10A2	4	11	0	1	362.34	724.68	15	2	1	1	1	0.266666666666667	1	15
SLC12A7	10	29	1	5	1046.43	2092.86	15	2	1	0.42	1	0.0897435897435897	6	39
SLC13A1	4	17	0	4	598.95	1197.9	15	2	1	1	1	0.19047619047619	4	21
SLC13A4	21	25	4	4	627.66	1255.32	15	2	1	-0.19047619047619	1	-0.0434782608695652	8	46
SLC15A1	36	34	2	5	685.08	1370.16	15	2	0.430946450809464	0.622222222222222	1	0.228571428571429	7	70
SLC15A5	11	16	0	2	577.17	1154.34	15	2	0.512315270935961	1	1	0.407407407407407	2	27
SLC16A7	0	11	0	1	476.19	952.38	15	2	1	NA	1	0	1	11
SLC16A8	7	27	4	9	537.57	1075.14	15	2	0.466968990641579	-0.714285714285714	1	-0.101809954751131	13	34
SLC17A5	6	28	2	1	480.48	960.96	15	2	0.111711711711712	-8.33333333333333	1	-0.490196078431372	3	34
SLC17A8	10	18	1	3	612.81	1225.62	15	2	1	0.4	1	0.107142857142857	4	28
SLC18B1	7	25	0	0	439.23	878.46	15	2	1	NA	1	NA	0	32
SLC19A2	11	21	4	4	477.18	954.36	15	2	0.44386158008449	-0.909090909090909	1	-0.15625	8	32
SLC1A4	5	19	3	3	521.4	1042.8	15	2	0.300253463012084	-2.8	1	-0.291666666666667	6	24
SLC22A15	3	17	2	3	540.54	1081.08	15	2	0.252230378317335	-2.77777777777778	1	-0.25	5	20
SLC22A16	13	14	1	5	559.68	1119.36	15	2	0.208533471534028	0.784615384615385	1	0.314814814814815	6	27
SLC22A2	40	36	3	12	539.22	1078.44	15	2	0.0249168308967923	0.775	1	0.326315789473684	15	76
SLC22A23	4	20	1	7	368.28	736.56	15	2	1	0.285714285714286	1	0.0416666666666667	8	24
SLC22A3	15	27	3	4	544.5	1089	15	2	0.697366632571439	-0.35	1	-0.0714285714285714	7	42
SLC22A7	11	21	5	7	537.57	1075.14	15	2	0.731789093610784	-0.363636363636364	1	-0.0729166666666667	12	32
SLC24A3	6	11	0	0	560.34	1120.68	15	2	1	NA	1	NA	0	17
SLC25A13	18	34	8	9	848.43	1696.86	15	2	0.397375766813499	-0.679012345679012	1	-0.124434389140271	17	52
SLC25A15	8	21	1	9	298.98	597.96	15	2	0.399582753722372	0.708333333333333	1	0.175862068965517	10	29
SLC25A17	4	9	0	6	287.1	574.2	15	2	0.255417956656347	1	1	0.307692307692308	6	13
SLC25A3	2	11	1	1	355.41	710.82	15	2	0.371428571428571	-4.5	1	-0.346153846153846	2	13
SLC25A30	1	10	0	2	257.4	514.8	15	2	1	1	1	0.0909090909090909	2	11
SLC25A32	2	9	4	2	320.1	640.2	15	2	0.109405300581771	-8	1	-0.484848484848485	6	11
SLC25A38	14	11	1	1	286.11	572.22	15	2	1	0.214285714285714	1	0.0600000000000001	2	25
SLC25A40	12	10	5	1	333.63	667.26	15	2	0.354727398205659	-3.16666666666667	1	-0.287878787878788	6	22
SLC25A6	0	10	0	3	296.01	592.02	15	2	1	NA	1	0	3	10
SLC26A3	14	40	2	1	747.45	1494.9	15	2	0.187286397812714	-4.71428571428571	1	-0.407407407407407	3	54
SLC26A4	12	21	4	5	772.2	1544.4	15	2	0.710851831972424	-0.4	1	-0.0808080808080808	9	33
SLC26A5	10	28	6	2	724.68	1449.36	15	2	0.0147147073088527	-7.4	1	-0.486842105263158	8	38
SLC29A1	5	13	3	8	444.51	889.02	15	2	1	0.025	1	0.00505050505050508	11	18
SLC2A12	4	20	3	4	592.02	1184.04	15	2	0.302261392050046	-2.75	1	-0.261904761904762	7	24
SLC2A13	8	15	1	3	397.65	795.3	15	2	1	0.375	1	0.0978260869565217	4	23
SLC2A14	10	22	0	1	494.01	988.02	15	2	1	1	1	0.3125	1	32
SLC30A10	6	19	0	2	433.62	867.24	15	2	1	1	1	0.24	2	25
SLC30A8	8	8	1	2	247.5	495	15	2	1	0.5	1	0.166666666666667	3	16
SLC35A1	6	25	3	5	335.61	671.22	15	2	0.354751599333643	-1.5	1	-0.181451612903226	8	31
SLC35A5	6	22	3	4	427.68	855.36	15	2	0.33970751815743	-1.75	1	-0.214285714285714	7	28
SLC35B2	8	16	3	12	414.81	829.62	15	2	0.476972293893055	0.5	1	0.133333333333333	15	24
SLC35B3	1	10	1	0	366.3	732.6	15	2	0.166666666666667	-Inf	1	-0.909090909090909	1	11
SLC35D3	8	6	3	2	374.88	749.76	15	2	1	-0.125	1	-0.0285714285714286	5	14
SLC35E3	1	18	1	8	306.9	613.8	15	2	1	-1.25	1	-0.0584795321637427	9	19
SLC35F2	1	16	2	4	380.82	761.64	15	2	0.15527950310559	-7	1	-0.274509803921569	6	17
SLC35F3	3	7	0	1	231.33	462.66	15	2	1	1	1	0.3	1	10
SLC36A4	11	21	5	2	488.07	976.14	15	2	0.100506555614915	-3.77272727272727	1	-0.370535714285714	7	32
SLC37A1	6	29	2	1	523.71	1047.42	15	2	0.106211474632527	-8.66666666666667	1	-0.495238095238095	3	35
SLC37A3	6	20	4	3	496.98	993.96	15	2	0.160525583982202	-3.44444444444444	1	-0.340659340659341	7	26
SLC38A1	0	14	0	1	485.1	970.2	15	2	1	NA	1	0	1	14
SLC38A2	2	22	1	1	496.98	993.96	15	2	0.221538461538462	-10	1	-0.416666666666667	2	24
SLC38A4	4	15	0	4	543.51	1087.02	15	2	1	1	1	0.210526315789474	4	19
SLC39A12	16	20	2	4	660.33	1320.66	15	2	0.685159859742658	0.375	1	0.111111111111111	6	36
SLC39A6	8	34	1	5	711.81	1423.62	15	2	1	0.15	1	0.0238095238095238	6	42
SLC41A2	2	19	0	4	568.26	1136.52	15	2	1	1	1	0.0952380952380952	4	21
SLC45A4	5	46	4	13	780.12	1560.24	15	2	0.21232209909872	-1.83076923076923	1	-0.137254901960784	17	51
SLC46A3	13	17	1	2	460.35	920.7	15	2	1	0.346153846153846	1	0.1	3	30
SLC4A1AP	12	28	4	3	675.18	1350.36	15	2	0.208315642150619	-2.11111111111111	1	-0.271428571428571	7	40
SLC4A2	13	50	8	24	1221.66	2443.32	15	2	0.613051152273293	-0.282051282051282	1	-0.0436507936507937	32	63
SLC4A7	5	30	2	7	1012.77	2025.54	15	2	0.618783312397666	-0.714285714285714	1	-0.0793650793650794	9	35
SLC51AL	5	15	1	1	335.61	671.22	15	2	0.48051948051948	-2	1	-0.25	2	20
SLC5A3	0	22	0	7	706.86	1413.72	15	2	1	NA	1	0	7	22
SLC5A7	0	20	0	1	572.88	1145.76	15	2	1	NA	1	0	1	20
SLC5A8	4	18	2	6	601.92	1203.84	15	2	0.645198938992042	-0.5	1	-0.0681818181818182	8	22
SLC6A12	10	27	4	5	601.92	1203.84	15	2	0.422585681379525	-1.16	1	-0.174174174174174	9	37
SLC6A13	9	24	1	5	598.95	1197.9	15	2	1	0.466666666666667	1	0.106060606060606	6	33
SLC6A15	3	18	0	1	722.7	1445.4	15	2	1	1	1	0.142857142857143	1	21
SLC6A19	13	50	6	4	1096.92	2193.84	15	2	0.0160038397267525	-4.76923076923077	1	-0.393650793650794	10	63
SLC6A20	10	35	3	13	587.07	1174.14	15	2	1	0.192307692307692	1	0.0347222222222222	16	45
SLC7A1	9	35	4	14	618.75	1237.5	15	2	1	-0.111111111111111	1	-0.0176767676767677	18	44
SLC7A13	4	23	3	1	484.11	968.22	15	2	0.0278086763070078	-16.25	1	-0.601851851851852	4	27
SLC9A3	23	26	0	2	792	1584	15	2	0.494901960784314	1	1	0.469387755102041	2	49
SLC9A7	2	17	1	9	573.21	1146.42	15	2	1	0.0555555555555556	1	0.00526315789473683	10	19
SLCO1A2	23	9	3	1	236.94	473.88	15	2	1	-0.173913043478261	1	-0.03125	4	32
SLCO1B1	16	21	1	1	696.96	1393.92	15	2	1	-0.3125	1	-0.0675675675675675	2	37
SLCO1B3	13	24	4	1	700.92	1401.84	15	2	0.139676113360324	-6.38461538461539	1	-0.448648648648649	5	37
SLCO1C1	21	25	0	0	564.63	1129.26	15	2	1	NA	1	NA	0	46
SLCO2B1	21	40	5	22	785.07	1570.14	15	2	0.204657778511155	0.567099567099567	1	0.159077109896782	27	61
SLCO5A1	6	34	4	1	772.86	1545.72	15	2	0.00622217638666873	-21.6666666666667	1	-0.65	5	40
SLITRK1	2	33	0	0	686.07	1372.14	15	2	1	NA	1	NA	0	35
SLX4IP	23	13	6	2	520.74	1041.48	15	2	0.695126535589861	-0.695652173913043	1	-0.111111111111111	8	36
SMAD9	0	10	0	0	463.32	926.64	15	2	1	NA	1	NA	0	10
SMAP1	4	17	1	2	467.28	934.56	15	2	0.521245059288538	-1.125	1	-0.142857142857143	3	21
SMARCC1	4	43	1	12	1024.65	2049.3	15	2	1	0.104166666666667	1	0.00818330605564647	13	47
SMC1B	35	36	4	3	907.17	1814.34	15	2	1	-0.371428571428571	1	-0.0784708249496981	7	71
SMC6	22	37	2	3	1086.03	2172.06	15	2	1	-0.121212121212121	1	-0.0271186440677966	5	59
SMCHD1	41	74	10	11	2005.08	4010.16	15	2	0.332426743000974	-0.64079822616408	1	-0.119668737060041	21	115
SMCO3	4	5	0	1	223.74	447.48	15	2	1	1	1	0.444444444444444	1	9
SMDT1	3	5	0	1	73.26	146.52	15	2	1	1	1	0.375	1	8
SMIM28	7	10	3	2	175.23	350.46	15	2	0.62406015037594	-1.14285714285714	1	-0.188235294117647	5	17
SMIM8	4	3	1	4	126.72	253.44	15	2	0.292929292929293	0.8125	1	0.371428571428571	5	7
SMOC2	4	6	0	0	239.58	479.16	15	2	1	NA	1	NA	0	10
SMPD1	15	44	8	10	578.16	1156.32	15	2	0.147183832112024	-1.34666666666667	1	-0.190207156308851	18	59
SMPDL3A	12	14	1	1	451.44	902.88	15	2	1	-0.166666666666667	1	-0.0384615384615384	2	26
SMPX	4	4	1	0	116.82	233.64	15	2	1	-Inf	1	-0.5	1	8
SMS	2	9	1	2	223.74	447.48	15	2	1	-1.25	1	-0.151515151515151	3	11
SMYD2	5	13	2	1	323.07	646.14	15	2	0.247368421052632	-4.2	1	-0.388888888888889	3	18
SMYD3	9	8	1	1	307.23	614.46	15	2	1	0.111111111111111	1	0.0294117647058824	2	17
SNAI2	0	8	0	0	266.31	532.62	15	2	1	NA	1	NA	0	8
SNAP25	0	5	0	1	204.93	409.86	15	2	1	NA	1	0	1	5
SNAP47	3	17	5	4	415.8	831.6	15	2	0.0667030121302985	-6.08333333333333	1	-0.405555555555556	9	20
SNRK	1	37	1	6	758.34	1516.68	15	2	0.28989898989899	-5.16666666666667	1	-0.116541353383459	7	38
SNRNP48	3	9	0	2	302.94	605.88	15	2	1	1	1	0.25	2	12
SNRPB2	0	11	0	0	203.94	407.88	15	2	1	NA	1	NA	0	11
SNRPD1	0	7	0	0	118.8	237.6	15	2	1	NA	1	NA	0	7
SNRPF	0	4	0	1	76.23	152.46	15	2	1	NA	1	0	1	4
SNTB1	5	16	2	0	375.21	750.42	15	2	0.08300395256917	-Inf	1	-0.761904761904762	2	21
SNTG1	2	2	0	2	124.08	248.16	15	2	0.466666666666667	1	1	0.5	2	4
SNTG2	10	16	0	3	427.68	855.36	15	2	0.532019704433498	1	1	0.384615384615385	3	26
SNU13	0	11	0	0	126.72	253.44	15	2	1	NA	1	NA	0	11
SNX10	7	12	5	3	233.64	467.28	15	2	0.398067632850241	-1.85714285714286	1	-0.256578947368421	8	19
SNX13	3	20	5	2	887.7	1775.4	15	2	0.00666077217801357	-15.6666666666667	1	-0.583850931677019	7	23
SNX3	1	4	0	3	157.41	314.82	15	2	1	1	1	0.2	3	5
SNX5	3	15	1	3	394.02	788.04	15	2	1	-0.666666666666667	1	-0.0833333333333333	4	18
SNX9	3	16	0	3	591.03	1182.06	15	2	1	1	1	0.157894736842105	3	19
SOBP	2	23	1	11	858.99	1717.98	15	2	1	-0.0454545454545454	1	-0.00333333333333333	12	25
SOCS1L	8	8	3	3	213.18	426.36	15	2	1	0	1	0	6	16
SOCS2	1	10	1	3	198.99	397.98	15	2	0.476190476190476	-2.33333333333333	1	-0.159090909090909	4	11
SOCS5	4	21	0	4	531.63	1063.26	15	2	1	1	1	0.16	4	25
SOD1	2	10	1	4	153.45	306.9	15	2	1	-0.25	1	-0.0333333333333334	5	12
SOD2	2	8	1	4	222.75	445.5	15	2	1	0	1	0	5	10
SON	193	170	22	22	3876.84	7753.68	15	2	0.750155056973891	0.119170984455959	1	0.0316804407713499	44	363
SOS1	1	37	62	68	1278.09	2556.18	15	2	3.09965416756468e-08	-32.7352941176471	0.00033714938380601	-0.450607287449393	130	38
SOSTDC1	0	6	0	1	204.93	409.86	15	2	1	NA	1	0	1	6
SOT3A1L	10	15	1	2	339.57	679.14	15	2	1	0.25	1	0.0666666666666667	3	25
SOWAHC	8	14	2	7	444.18	888.36	15	2	0.677001201632434	0.5	1	0.141414141414141	9	22
SOX1	0	14	0	2	347.82	695.64	15	2	1	NA	1	0	2	14
SOX10	1	18	3	4	459.36	918.72	15	2	0.0468227424749164	-12.5	1	-0.37593984962406	7	19
SOX11	2	12	0	1	387.09	774.18	15	2	1	1	1	0.142857142857143	1	14
SOX17	4	25	1	4	408.87	817.74	15	2	1	-0.5625	1	-0.0620689655172414	5	29
SOX5	3	17	0	0	469.92	939.84	15	2	1	NA	1	NA	0	20
SOX7	3	22	0	10	373.23	746.46	15	2	0.541634835752483	1	1	0.12	10	25
SP4	7	30	4	2	771.87	1543.74	15	2	0.0293491921697433	-7.57142857142857	1	-0.477477477477477	6	37
SP8	2	18	2	1	330.99	661.98	15	2	0.0666290231507622	-17	1	-0.566666666666667	3	20
SPACA1	15	12	0	1	252.12	504.24	15	2	0.464285714285714	1	1	0.555555555555556	1	27
SPAG1	35	38	15	5	782.76	1565.52	15	2	0.0427778797962273	-2.25714285714286	1	-0.270547945205479	20	73
SPAG17	111	84	13	9	2105.73	4211.46	15	2	1	-0.0930930930930931	1	-0.0216783216783217	22	195
SPAG6	1	5	1	3	429	858	15	2	1	-0.666666666666667	1	-0.0833333333333333	4	6
SPAM1	20	21	4	2	567.27	1134.54	15	2	0.666171862114465	-1.1	1	-0.178861788617886	6	41
SPATA13	15	33	4	4	841.5	1683	15	2	0.422790794111549	-1.2	1	-0.1875	8	48
SPATA17	18	17	3	0	343.53	687.06	15	2	0.238264580369844	-Inf	1	-0.485714285714286	3	35
SPCS2	7	18	1	6	239.91	479.82	15	2	0.646416245971307	0.571428571428571	1	0.137142857142857	7	25
SPDYA	4	10	1	0	308.88	617.76	15	2	0.333333333333333	-Inf	1	-0.714285714285714	1	14
SPERT	21	16	3	3	322.74	645.48	15	2	1	0.238095238095238	1	0.0675675675675675	6	37
SPG20	13	43	2	6	625.68	1251.36	15	2	1	-0.102564102564103	1	-0.0178571428571428	8	56
SPIC	0	9	0	2	253.44	506.88	15	2	1	NA	1	0	2	9
SPICE1	37	28	7	5	818.73	1637.46	15	2	1	-0.0594594594594595	1	-0.0141025641025642	12	65
SPIRE1	15	22	2	7	585.09	1170.18	15	2	0.450266385721994	0.580952380952381	1	0.183183183183183	9	37
SPIRE1L	33	28	9	9	589.71	1179.42	15	2	0.793638377407123	0.151515151515151	1	0.0409836065573771	18	61
SPRED2	0	7	1	2	412.83	825.66	15	2	0.3	-Inf	1	-0.333333333333333	3	7
SPRTN	23	24	2	8	494.01	988.02	15	2	0.160030480017462	0.739130434782609	1	0.28936170212766	10	47
SPRY2	5	17	2	1	310.86	621.72	15	2	0.179565217391304	-5.8	1	-0.439393939393939	3	22
SPRYD7	0	6	2	0	195.03	390.06	15	2	0.0357142857142857	-Inf	1	-1	2	6
SPTBB4L	95	95	41	44	1977.03	3954.06	15	2	0.795668038725047	0.0681818181818182	1	0.0176470588235294	85	190
SPTBN1	2	70	1	10	2310.33	4620.66	15	2	0.350899533091716	-2.5	1	-0.0631313131313131	11	72
SPTLC3	0	15	0	2	549.45	1098.9	15	2	1	NA	1	0	2	15
SPX	5	2	0	0	116.82	233.64	15	2	1	NA	1	NA	0	7
SQLE	8	33	1	4	567.27	1134.54	15	2	1	-0.03125	1	-0.00487804878048781	5	41
SRBD1	32	27	2	6	1065.24	2130.48	15	2	0.14966403794395	0.71875	1	0.292372881355932	8	59
SRD5A1	3	9	0	2	181.83	363.66	15	2	1	1	1	0.25	2	12
SREBF2	12	55	6	18	1089.33	2178.66	15	2	0.551597841891616	-0.527777777777778	1	-0.0708955223880597	24	67
SRGAP1	18	31	2	9	1114.74	2229.48	15	2	0.306946175137567	0.617283950617284	1	0.185528756957328	11	49
SRI	2	4	0	1	194.7	389.4	15	2	1	1	1	0.333333333333333	1	6
SRP9	1	4	0	1	86.13	172.26	15	2	1	1	1	0.2	1	5
SRPX	0	26	4	8	450.45	900.9	15	2	0.00670595407437513	-Inf	1	-0.333333333333333	12	26
SS18	0	11	0	1	414.81	829.62	15	2	1	NA	1	0	1	11
SSBP1	2	12	0	2	147.51	295.02	15	2	1	1	1	0.142857142857143	2	14
SSNA1	2	8	2	4	113.85	227.7	15	2	0.604395604395604	-1	1	-0.133333333333333	6	10
SSPO	93	116	74	80	2763.75	5527.5	15	2	0.523843492374588	-0.153763440860215	1	-0.0355434039644566	154	209
SSR1	4	15	1	0	285.12	570.24	15	2	0.25	-Inf	1	-0.789473684210526	1	19
SSTR3	4	22	3	5	397.98	795.96	15	2	0.315252241052149	-2.3	1	-0.221153846153846	8	26
SSTR4	8	25	2	5	369.6	739.2	15	2	1	-0.25	1	-0.0432900432900433	7	33
ST13	4	12	0	3	358.38	716.76	15	2	1	1	1	0.25	3	16
ST18	15	32	2	2	1034.22	2068.44	15	2	0.592925170068027	-1.13333333333333	1	-0.180851063829787	4	47
ST3GAL1	4	17	1	1	367.29	734.58	15	2	0.395256916996047	-3.25	1	-0.30952380952381	2	21
ST3GAL6	6	17	1	0	349.47	698.94	15	2	0.291666666666667	-Inf	1	-0.739130434782609	1	23
ST6GAL2	6	14	4	4	524.7	1049.4	15	2	0.400425661295227	-1.33333333333333	1	-0.2	8	20
ST7	5	7	0	2	506.22	1012.44	15	2	0.505494505494505	1	1	0.416666666666667	2	12
ST8SIA6	4	13	3	1	395.01	790.02	15	2	0.087719298245614	-8.75	1	-0.514705882352941	4	17
STAB2	65	122	14	21	2418.57	4837.14	15	2	0.568060901200749	-0.251282051282051	1	-0.0524064171122995	35	187
STAC	5	13	0	0	359.37	718.74	15	2	1	NA	1	NA	0	18
STAGL	31	37	7	2	1206.81	2413.62	15	2	0.086607075448522	-3.17741935483871	1	-0.321895424836601	9	68
STAM	1	17	0	3	539.55	1079.1	15	2	1	1	1	0.0555555555555556	3	18
STARD13	4	30	3	5	1074.15	2148.3	15	2	0.11299113866508	-3.5	1	-0.257352941176471	8	34
STARD3NL	8	4	0	1	232.65	465.3	15	2	0.384615384615385	1	1	0.666666666666667	1	12
STAU2	6	11	1	2	550.11	1100.22	15	2	1	0.0833333333333334	1	0.0196078431372549	3	17
STEAP1	8	19	5	0	339.57	679.14	15	2	0.00639102971555697	-Inf	1	-0.703703703703704	5	27
STEAP4	15	18	2	3	468.27	936.54	15	2	1	0.2	1	0.0545454545454545	5	33
STIM1	10	31	5	10	722.04	1444.08	15	2	0.513540133892513	-0.55	1	-0.0894308943089431	15	41
STK24	1	13	0	4	427.68	855.36	15	2	1	1	1	0.0714285714285714	4	14
STK31	43	53	8	5	926.31	1852.62	15	2	0.375419290359865	-0.972093023255814	1	-0.167467948717949	13	96
STK38L	1	13	0	0	463.98	927.96	15	2	1	NA	1	NA	0	14
STMND1	18	7	7	3	228.69	457.38	15	2	1	0.0925925925925926	1	0.02	10	25
STOML3	4	16	5	2	281.16	562.32	15	2	0.0234519104084321	-9	1	-0.514285714285714	7	20
STON1	10	3	0	0	144.54	289.08	15	2	1	NA	1	NA	0	13
STRA8	4	16	0	2	346.5	693	15	2	1	1	1	0.2	2	20
STRAP	0	14	0	1	347.49	694.98	15	2	1	NA	1	0	1	14
STRIP2	5	28	10	20	805.86	1611.72	15	2	0.138584522408826	-1.8	1	-0.181818181818182	30	33
STRN	1	28	0	4	791.01	1582.02	15	2	1	1	1	0.0344827586206897	4	29
STS	8	13	4	3	471.9	943.8	15	2	0.418357487922705	-1.16666666666667	1	-0.19047619047619	7	21
STT3B	1	22	0	5	807.84	1615.68	15	2	1	1	1	0.0434782608695652	5	23
STX11	1	12	2	5	286.11	572.22	15	2	0.270175438596491	-3.8	1	-0.208791208791209	7	13
STX17	5	7	3	1	298.98	597.96	15	2	0.569230769230769	-3.2	1	-0.333333333333333	4	12
STX19	5	10	2	3	289.08	578.16	15	2	1	-0.333333333333333	1	-0.0666666666666667	5	15
STX7	10	6	3	0	255.42	510.84	15	2	0.51702786377709	-Inf	1	-0.375	3	16
STYK1	2	17	3	5	421.74	843.48	15	2	0.135785953177258	-4.1	1	-0.269736842105263	8	19
SUCLA2	3	15	2	3	459.36	918.72	15	2	0.290677286100627	-2.33333333333333	1	-0.233333333333333	5	18
SUGCT	14	12	0	1	275.22	550.44	15	2	0.481481481481481	1	1	0.538461538461538	1	26
SUGT1	6	14	4	3	337.59	675.18	15	2	0.364818756123104	-2.11111111111111	1	-0.271428571428571	7	20
SULT	13	10	2	1	309.87	619.74	15	2	1	-0.538461538461539	1	-0.101449275362319	3	23
SULT1C3	10	16	1	1	304.92	609.84	15	2	1	-0.6	1	-0.115384615384615	2	26
SULT4A1	2	5	0	0	241.56	483.12	15	2	1	NA	1	NA	0	7
SULT6B1L	9	14	1	0	312.84	625.68	15	2	0.416666666666667	-Inf	1	-0.608695652173913	1	23
SUN2	12	29	8	19	663.3	1326.6	15	2	1	-0.0175438596491229	1	-0.003613369467028	27	41
SUPT20H	1	19	2	0	763.29	1526.58	15	2	0.012987012987013	-Inf	1	-0.95	2	20
SUPT3H	4	6	0	0	343.86	687.72	15	2	1	NA	1	NA	0	10
SUPT7L	2	22	1	4	408.87	817.74	15	2	0.446086480569239	-1.75	1	-0.116666666666667	5	24
SUSD4	7	12	1	5	418.44	836.88	15	2	0.623715415019763	0.657142857142857	1	0.201754385964912	6	19
SUSD5	33	26	1	2	614.79	1229.58	15	2	0.584664198836594	0.606060606060606	1	0.225988700564972	3	59
SUV39H2	13	9	1	1	469.26	938.52	15	2	1	0.307692307692308	1	0.0909090909090909	2	22
SVIL	11	51	2	9	1546.38	3092.76	15	2	1	-0.0303030303030303	1	-0.00439882697947214	11	62
SVOPL	26	36	7	9	575.85	1151.7	15	2	1	-0.0769230769230769	1	-0.0181451612903226	16	62
SYAP1	0	19	0	3	356.4	712.8	15	2	1	NA	1	0	3	19
SYCE3	0	4	0	1	92.07	184.14	15	2	1	NA	1	0	1	4
SYCP2L	86	32	11	10	794.97	1589.94	15	2	0.0729370809681246	0.590697674418605	1	0.20500403551251	21	118
SYN2	1	9	1	4	387.75	775.5	15	2	1	-1.25	1	-0.1	5	10
SYN3	6	18	2	4	711.81	1423.62	15	2	0.645198938992042	-0.5	1	-0.0833333333333333	6	24
SYNE1	159	207	28	14	6035.04	12070.08	15	2	0.0051624693827745	-1.60377358490566	1	-0.23224043715847	42	366
SYNGR1	7	8	0	1	198.99	397.98	15	2	1	1	1	0.466666666666667	1	15
SYNJ1	25	63	5	14	1594.89	3189.78	15	2	1	0.1	1	0.020933014354067	19	88
SYNJ2	24	61	7	10	1492.26	2984.52	15	2	0.386268464018458	-0.779166666666667	1	-0.129411764705882	17	85
SYPL1	13	16	3	0	234.63	469.26	15	2	0.225806451612903	-Inf	1	-0.551724137931034	3	29
SYT1	0	12	0	3	420.75	841.5	15	2	1	NA	1	0	3	12
SYT10	2	12	0	1	506.55	1013.1	15	2	1	1	1	0.142857142857143	1	14
SYT14	17	23	6	3	804.87	1609.74	15	2	0.273154525565189	-1.70588235294118	1	-0.241666666666667	9	40
SYTL2	119	114	15	10	1942.71	3885.42	15	2	0.410101286121388	-0.436974789915966	1	-0.0892703862660944	25	233
SYTL3	16	33	5	3	543.51	1087.02	15	2	0.129585211213811	-2.4375	1	-0.298469387755102	8	49
SYTL5	15	22	3	5	760.32	1520.64	15	2	1	0.12	1	0.0304054054054054	8	37
T	2	14	0	3	431.64	863.28	15	2	1	1	1	0.125	3	16
TAB1	2	27	0	4	497.97	995.94	15	2	1	1	1	0.0689655172413793	4	29
TAB2	4	9	3	3	730.62	1461.24	15	2	0.61687306501548	-1.25	1	-0.192307692307692	6	13
TAB3	6	21	0	3	704.22	1408.44	15	2	1	1	1	0.222222222222222	3	27
TAC1	2	5	1	2	73.26	146.52	15	2	1	-0.25	1	-0.0476190476190476	3	7
TAF10	0	9	0	1	126.06	252.12	15	2	1	NA	1	0	1	9
TAF13	0	3	0	3	88.77	177.54	15	2	1	NA	1	0	3	3
TAF1B	13	22	3	1	575.19	1150.38	15	2	0.286379496905813	-4.07692307692308	1	-0.378571428571429	4	35
TAF1D	17	23	3	4	342.87	685.74	15	2	1	-0.0147058823529411	1	-0.00357142857142856	7	40
TAF2	11	55	4	8	1537.14	3074.28	15	2	0.230382471131701	-1.5	1	-0.166666666666667	12	66
TAF3	7	36	0	3	908.82	1817.64	15	2	1	1	1	0.162790697674419	3	43
TAF4B	31	30	6	8	753.39	1506.78	15	2	0.768252136627468	0.274193548387097	1	0.0796252927400469	14	61
TAF5L	0	15	1	6	584.1	1168.2	15	2	0.318181818181818	-Inf	1	-0.142857142857143	7	15
TAF9	4	11	1	3	208.89	417.78	15	2	1	0.0833333333333334	1	0.0166666666666667	4	15
TAGAP	12	25	5	4	689.04	1378.08	15	2	0.257597842813131	-1.60416666666667	1	-0.231231231231231	9	37
TAGLN3	0	4	0	1	198	396	15	2	1	NA	1	0	1	4
TAPBPL	32	28	3	6	452.43	904.86	15	2	0.30587317810858	0.5625	1	0.2	9	60
TARBP1	34	48	6	11	1289.64	2579.28	15	2	0.787785039556487	0.229946524064171	1	0.0616929698708751	17	82
TARP	22	8	1	3	170.28	340.56	15	2	0.0889468690702087	0.878787878787879	1	0.483333333333333	4	30
TATDN1	6	17	3	3	295.02	590.04	15	2	0.339067828723001	-1.83333333333333	1	-0.239130434782609	6	23
TATDN3	3	7	3	2	268.29	536.58	15	2	0.328671328671329	-2.5	1	-0.3	5	10
TBC1D15	10	23	5	4	699.93	1399.86	15	2	0.241690153492615	-1.875	1	-0.252525252525253	9	33
TBC1D22A	15	23	5	3	507.54	1015.08	15	2	0.26737597185697	-1.55555555555556	1	-0.230263157894737	8	38
TBC1D23	12	77	3	8	1638.45	3276.9	15	2	0.363345215150909	-1.40625	1	-0.137895812053115	11	89
TBC1D30	11	54	3	6	831.6	1663.2	15	2	0.357918399316214	-1.45454545454545	1	-0.164102564102564	9	65
TBC1D31	26	46	2	7	1065.24	2130.48	15	2	0.486501525880753	0.494505494505495	1	0.138888888888889	9	72
TBC1D32	24	28	4	2	1057.32	2114.64	15	2	0.415455448226054	-1.33333333333333	1	-0.205128205128205	6	52
TBC1D4	6	40	3	0	1103.52	2207.04	15	2	0.00455927051671732	-Inf	1	-0.869565217391304	3	46
TBC1D7	9	8	0	0	271.26	542.52	15	2	1	NA	1	NA	0	17
TBC1D8	13	71	4	17	1141.14	2282.28	15	2	0.742481193337623	-0.285067873303168	1	-0.0357142857142857	21	84
TBCC	11	13	2	4	336.27	672.54	15	2	0.672468527640941	0.409090909090909	1	0.125	6	24
TBCE	7	18	5	4	495.99	991.98	15	2	0.223925276450959	-2.21428571428571	1	-0.275555555555556	9	25
TBK1	0	19	4	3	689.04	1378.08	15	2	0.00234113712374582	-Inf	0.978161257260591	-0.571428571428571	7	19
TBL1X	0	11	0	3	518.76	1037.52	15	2	1	NA	1	0	3	11
TBP	0	15	0	2	299.97	599.94	15	2	1	NA	1	0	2	15
TBPL1	0	3	0	0	182.16	364.32	15	2	1	NA	1	NA	0	3
TBX15	0	16	0	1	524.7	1049.4	15	2	1	NA	1	0	1	16
TBX19	6	12	3	2	360.36	720.72	15	2	0.342833368004993	-2	1	-0.266666666666667	5	18
TBX20	0	26	0	1	436.59	873.18	15	2	1	NA	1	0	1	26
TBX22	3	6	1	4	430.32	860.64	15	2	1	0.5	1	0.133333333333333	5	9
TBXAS1	14	12	1	1	350.46	700.92	15	2	1	0.142857142857143	1	0.0384615384615384	2	26
TCAIM	7	15	2	3	485.1	970.2	15	2	1	-0.428571428571429	1	-0.0818181818181818	5	22
TCEA1	0	7	0	0	284.13	568.26	15	2	1	NA	1	NA	0	7
TCEANC	13	16	2	0	356.4	712.8	15	2	0.225806451612903	-Inf	1	-0.551724137931034	2	29
TCF20	18	118	9	20	1922.91	3845.82	15	2	0.0268854649296046	-1.95	1	-0.177991886409736	29	136
TCF21	0	7	0	0	178.2	356.4	15	2	1	NA	1	NA	0	7
TCF24	1	10	2	6	153.45	306.9	15	2	0.545923632610939	-2.33333333333333	1	-0.159090909090909	8	11
TCP1	1	30	2	9	553.41	1106.82	15	2	0.162891986062718	-5.66666666666667	1	-0.149560117302053	11	31
TCP11L2	5	21	1	2	505.23	1010.46	15	2	0.515325670498084	-1.1	1	-0.141025641025641	3	26
TCTE1	22	20	7	4	452.43	904.86	15	2	0.735118656987316	-0.590909090909091	1	-0.112554112554113	11	42
TDG	6	18	1	4	414.81	829.62	15	2	1	0.25	1	0.05	5	24
TDH	5	17	0	2	370.26	740.52	15	2	1	1	1	0.227272727272727	2	22
TDP2	7	10	2	0	342.54	685.08	15	2	0.210526315789474	-Inf	1	-0.588235294117647	2	17
TDRD3	18	28	5	3	788.04	1576.08	15	2	0.263969986942098	-1.59259259259259	1	-0.233695652173913	8	46
TDRD6	144	165	19	14	2259.84	4519.68	15	2	0.272651674991444	-0.555059523809524	1	-0.109738158281848	33	309
TEAD4	21	16	3	1	552.75	1105.5	15	2	0.629347289424311	-1.28571428571429	1	-0.182432432432432	4	37
TEF	0	3	1	1	286.11	572.22	15	2	0.4	-Inf	1	-0.5	2	3
TENM4	5	120	4	29	2511.63	5023.26	15	2	0.0916144300090474	-2.31034482758621	1	-0.0812121212121212	33	125
TERF1	31	15	2	1	281.16	562.32	15	2	1	0.032258064516129	1	0.00724637681159424	3	46
TERT	48	47	6	4	1287.99	2575.98	15	2	0.742484482659056	-0.46875	1	-0.0947368421052631	10	95
TES	2	17	0	3	418.77	837.54	15	2	1	1	1	0.105263157894737	3	19
TEX10	8	44	2	5	918.72	1837.44	15	2	0.338299543948256	-1.2	1	-0.131868131868132	7	52
TEX30	2	7	2	1	223.74	447.48	15	2	0.236363636363636	-6	1	-0.444444444444444	3	9
TEX33	17	13	2	3	355.41	710.82	15	2	0.641809803100126	0.490196078431373	1	0.166666666666667	5	30
TFAP2A	0	17	0	2	475.53	951.06	15	2	1	NA	1	0	2	17
TFAP2B	0	9	0	0	440.55	881.1	15	2	1	NA	1	NA	0	9
TFAP2D	0	5	0	0	424.71	849.42	15	2	1	NA	1	NA	0	5
TFB1M	5	20	2	1	345.51	691.02	15	2	0.145299145299145	-7	1	-0.466666666666667	3	25
TFB2M	10	9	1	1	325.38	650.76	15	2	1	0.1	1	0.0263157894736842	2	19
TFDP1	1	7	0	1	411.84	823.68	15	2	1	1	1	0.125	1	8
TFEC	20	9	1	1	431.64	863.28	15	2	1	0.55	1	0.189655172413793	2	29
TFF2	3	7	0	0	127.71	255.42	15	2	1	NA	1	NA	0	10
TFG	0	17	0	3	339.57	679.14	15	2	1	NA	1	0	3	17
TFPI2	3	9	2	2	235.95	471.9	15	2	0.546703296703297	-2	1	-0.25	4	12
TGDS	7	22	2	2	354.42	708.84	15	2	0.295161290322581	-2.14285714285714	1	-0.258620689655172	4	29
TGFB2	4	10	1	0	352.11	704.22	15	2	0.333333333333333	-Inf	1	-0.714285714285714	1	14
TGFBR1	1	18	1	3	498.96	997.92	15	2	0.324110671936759	-5	1	-0.197368421052632	4	19
TGFBR2	2	20	0	5	559.35	1118.7	15	2	1	1	1	0.0909090909090909	5	22
TGFBRAP1	11	55	3	8	854.37	1708.74	15	2	0.409874023680316	-0.875	1	-0.106060606060606	11	66
TGIF1	2	5	0	2	267.3	534.6	15	2	1	1	1	0.285714285714286	2	7
TGM4	34	33	0	13	702.9	1405.8	15	2	0.000405914855350006	1	0.42125753829487	0.507462686567164	13	67
TGS1	30	37	5	3	847.11	1694.22	15	2	0.461098108737129	-1.05555555555556	1	-0.177238805970149	8	67
THAP12	9	36	2	9	790.02	1580.04	15	2	1	0.111111111111111	1	0.0181818181818182	11	45
THAP5	14	22	2	2	409.86	819.72	15	2	1	-0.571428571428571	1	-0.111111111111111	4	36
THBD	14	23	2	8	426.69	853.38	15	2	0.45682557694784	0.589285714285714	1	0.178378378378378	10	37
THBS2	5	36	1	3	1171.17	2342.34	15	2	0.447961340984597	-1.4	1	-0.128048780487805	4	41
THEMIS	13	24	2	1	605.88	1211.76	15	2	0.544534412955466	-2.69230769230769	1	-0.315315315315315	3	37
THL	17	21	3	0	455.4	910.8	15	2	0.106941838649156	-Inf	1	-0.552631578947368	3	38
THOC1	6	33	2	7	658.35	1316.7	15	2	0.633155420575999	-0.571428571428571	1	-0.0683760683760684	9	39
THRB	1	13	1	15	472.23	944.46	15	2	1	0.133333333333333	1	0.00892857142857142	16	14
THSD1	27	41	8	10	841.5	1683	15	2	0.790104499869611	-0.214814814814815	1	-0.0473856209150327	18	68
THSD7A	11	36	2	1	972.84	1945.68	15	2	0.161836734693878	-5.54545454545455	1	-0.432624113475177	3	47
THUMPD2	28	26	10	9	489.06	978.12	15	2	1	-0.0317460317460319	1	-0.00779727095516569	19	54
TIAM1	17	82	13	14	1688.61	3377.22	15	2	0.00175476512384429	-3.47899159663866	0.867571829638832	-0.30976430976431	27	99
TIAM2	14	83	3	7	1709.73	3419.46	15	2	0.195470606776465	-1.54081632653061	1	-0.155670103092784	10	97
TIGAR	0	2	0	0	23.1	46.2	15	2	1	NA	1	NA	0	2
TIMM21	2	5	2	0	226.71	453.42	15	2	0.166666666666667	-Inf	1	-0.714285714285714	2	7
TIMMDC1	9	10	2	2	226.38	452.76	15	2	1	-0.111111111111111	1	-0.0263157894736842	4	19
TIMP3	0	7	0	1	210.87	421.74	15	2	1	NA	1	0	1	7
TINAG	16	21	2	2	463.32	926.64	15	2	1	-0.3125	1	-0.0675675675675675	4	37
TIPRL	3	7	1	0	271.26	542.52	15	2	0.363636363636364	-Inf	1	-0.7	1	10
TJAP1	34	37	15	13	1063.26	2126.52	15	2	0.65982489317682	-0.255656108597285	1	-0.056841046277666	28	71
TLR7	23	56	5	6	1348.38	2696.76	15	2	0.307425833751713	-1.02898550724638	1	-0.163406214039125	11	79
TM4SF1a	10	19	4	2	194.04	388.08	15	2	0.190689149560117	-2.8	1	-0.32183908045977	6	29
TM7SF3	15	20	1	1	558.36	1116.72	15	2	1	-0.333333333333333	1	-0.0714285714285715	2	35
TM9SF2	2	26	3	5	638.55	1277.1	15	2	0.0614973262032085	-6.8	1	-0.303571428571429	8	28
TMBIM4	2	7	0	1	235.62	471.24	15	2	1	1	1	0.222222222222222	1	9
TMC2	40	38	5	2	1002.21	2004.42	15	2	0.439023429922464	-1.375	1	-0.201465201465202	7	78
TMCC3	5	27	0	2	495.99	991.98	15	2	1	1	1	0.15625	2	32
TMCO3	2	32	2	1	672.21	1344.42	15	2	0.025997425997426	-31	1	-0.607843137254902	3	34
TMEFF1	4	10	2	4	251.46	502.92	15	2	1	-0.25	1	-0.0476190476190476	6	14
TMEM106B	0	14	0	0	273.24	546.48	15	2	1	NA	1	NA	0	14
TMEM108	10	19	10	11	463.32	926.64	15	2	0.392718444965776	-0.727272727272727	1	-0.13136288998358	21	29
TMEM117	8	5	2	2	136.29	272.58	15	2	1	0.375	1	0.115384615384615	4	13
TMEM121L	9	22	6	8	371.58	743.16	15	2	0.496763078301438	-0.833333333333333	1	-0.138248847926267	14	31
TMEM123	20	8	5	1	184.14	368.28	15	2	1	-1	1	-0.119047619047619	6	28
TMEM126A	17	16	1	1	286.44	572.88	15	2	1	0.0588235294117647	1	0.0151515151515151	2	33
TMEM131	16	50	5	10	1854.93	3709.86	15	2	0.519622185356748	-0.5625	1	-0.0909090909090909	15	66
TMEM135	5	7	0	3	305.91	611.82	15	2	0.505494505494505	1	1	0.416666666666667	3	12
TMEM139	4	4	0	2	213.84	427.68	15	2	0.466666666666667	1	1	0.5	2	8
TMEM14A	2	3	0	1	108.9	217.8	15	2	1	1	1	0.4	1	5
TMEM14C	1	5	0	2	106.92	213.84	15	2	1	1	1	0.166666666666667	2	6
TMEM14CL	0	5	1	0	105.93	211.86	15	2	0.166666666666667	-Inf	1	-1	1	5
TMEM151B	0	28	0	12	482.46	964.92	15	2	1	NA	1	0	12	28
TMEM158	2	5	1	3	302.61	605.22	15	2	1	0.166666666666667	1	0.0357142857142857	4	7
TMEM168	2	25	1	4	693.99	1387.98	15	2	0.410282258064516	-2.125	1	-0.125925925925926	5	27
TMEM17	2	3	2	2	191.73	383.46	15	2	1	-0.5	1	-0.1	4	5
TMEM178B	2	7	1	3	143.55	287.1	15	2	1	-0.166666666666667	1	-0.0277777777777778	4	9
TMEM18	2	6	1	0	108.57	217.14	15	2	0.333333333333333	-Inf	1	-0.75	1	8
TMEM181	6	14	1	2	470.25	940.5	15	2	1	-0.166666666666667	1	-0.0333333333333333	3	20
TMEM184B	4	27	1	4	406.89	813.78	15	2	0.549298128342246	-0.6875	1	-0.0709677419354839	5	31
TMEM19	11	15	0	0	342.54	685.08	15	2	1	NA	1	NA	0	26
TMEM200A	8	21	1	1	487.08	974.16	15	2	0.503225806451613	-1.625	1	-0.224137931034483	2	29
TMEM200C	21	27	5	1	544.5	1089	15	2	0.0948152846044079	-5.42857142857143	1	-0.395833333333333	6	48
TMEM206	7	13	2	1	347.49	694.98	15	2	0.537549407114625	-2.71428571428571	1	-0.316666666666667	3	20
TMEM209	17	47	1	6	515.13	1030.26	15	2	0.669851211570051	0.53921568627451	1	0.122767857142857	7	64
TMEM213	6	11	2	2	105.93	211.86	15	2	0.617710944026733	-0.833333333333333	1	-0.147058823529412	4	17
TMEM243	0	2	1	2	75.24	150.48	15	2	1	-Inf	1	-0.333333333333333	3	2
TMEM255B	2	14	2	2	327.03	654.06	15	2	0.16202270381837	-6	1	-0.375	4	16
TMEM263	0	5	0	0	115.83	231.66	15	2	1	NA	1	NA	0	5
TMEM27	7	10	0	1	291.06	582.12	15	2	1	1	1	0.411764705882353	1	17
TMEM272	0	11	1	2	186.12	372.24	15	2	0.214285714285714	-Inf	1	-0.333333333333333	3	11
TMEM30A	2	12	1	7	381.15	762.3	15	2	1	0.142857142857143	1	0.0178571428571428	8	14
TMEM30CP	15	17	2	1	537.57	1075.14	15	2	0.602597402597403	-1.26666666666667	1	-0.197916666666667	3	32
TMEM39A	0	17	1	1	480.15	960.3	15	2	0.105263157894737	-Inf	1	-0.5	2	17
TMEM42	3	9	3	4	96.03	192.06	15	2	0.61687306501548	-1.25	1	-0.178571428571429	7	12
TMEM45A	1	13	0	3	273.24	546.48	15	2	1	1	1	0.0714285714285714	3	14
TMEM47	1	2	0	0	180.18	360.36	15	2	1	NA	1	NA	0	3
TMEM5	7	21	3	3	406.89	813.78	15	2	0.328420467185762	-2	1	-0.25	6	28
TMEM50B	1	3	0	1	157.41	314.82	15	2	1	1	1	0.25	1	4
TMEM52B	9	11	2	3	181.17	362.34	15	2	1	0.185185185185185	1	0.05	5	20
TMEM60	0	3	1	0	133.65	267.3	15	2	0.25	-Inf	1	-1	1	3
TMEM65	2	4	0	0	175.23	350.46	15	2	1	NA	1	NA	0	6
TMEM68	11	7	0	1	328.68	657.36	15	2	0.421052631578948	1	1	0.611111111111111	1	18
TMEM68L	14	14	0	1	331.65	663.3	15	2	1	1	1	0.5	1	28
TMEM70	7	10	0	4	202.62	405.24	15	2	0.254970760233918	1	1	0.411764705882353	4	17
TMEM74	8	18	0	1	312.84	625.68	15	2	1	1	1	0.307692307692308	1	26
TMIE	4	8	2	3	263.34	526.68	15	2	1	-0.333333333333333	1	-0.0666666666666667	5	12
TMPO	6	7	1	2	438.24	876.48	15	2	1	0.416666666666667	1	0.128205128205128	3	13
TMPRSS15	35	38	2	3	939.18	1878.36	15	2	1	0.276190476190476	1	0.0794520547945205	5	73
TMPRSS2	13	21	2	6	486.42	972.84	15	2	0.688790202269021	0.461538461538462	1	0.132352941176471	8	34
TMPRSS3	5	30	2	7	472.23	944.46	15	2	0.618783312397666	-0.714285714285714	1	-0.0793650793650794	9	35
TMPRSS6	10	28	4	11	762.96	1525.92	15	2	1	-0.0181818181818181	1	-0.00350877192982457	15	38
TMPRSS7	19	36	3	3	774.18	1548.36	15	2	0.657814431211735	-0.894736842105263	1	-0.154545454545455	6	55
TMTC1	8	2	6	2	300.96	601.92	15	2	1	0.25	1	0.05	8	10
TMTC2	4	11	0	0	471.57	943.14	15	2	1	NA	1	NA	0	15
TMTC4	5	21	1	1	733.59	1467.18	15	2	0.388888888888889	-3.2	1	-0.307692307692308	2	26
TMX3	9	14	0	0	479.16	958.32	15	2	1	NA	1	NA	0	23
TMX4	10	21	2	5	327.69	655.38	15	2	1	0.16	1	0.0368663594470046	7	31
TNFAIP3	18	44	5	5	852.39	1704.78	15	2	0.272574793326719	-1.44444444444444	1	-0.209677419354839	10	62
TNFRSF11A	17	40	3	7	642.18	1284.36	15	2	1	-0.00840336134453779	1	-0.00175438596491229	10	57
TNFRSF11B	15	13	4	4	398.97	797.94	15	2	1	0.133333333333333	1	0.0357142857142857	8	28
TNFRSF13C	13	11	4	3	198.66	397.32	15	2	1	-0.128205128205128	1	-0.0297619047619048	7	24
TNFRSF14	10	14	3	5	339.24	678.48	15	2	1	0.16	1	0.0416666666666667	8	24
TNFRSF19	1	12	3	2	404.91	809.82	15	2	0.0441176470588235	-17	1	-0.523076923076923	5	13
TNFRSF1A	27	18	4	4	419.76	839.52	15	2	0.704776897796063	0.333333333333333	1	0.1	8	45
TNFRSF21	10	40	6	7	635.58	1271.16	15	2	0.0753758134338077	-2.42857142857143	1	-0.261538461538462	13	50
TNFSF13B	12	15	0	0	364.65	729.3	15	2	1	NA	1	NA	0	27
TNRC6B	11	18	7	7	1719.63	3439.26	15	2	0.520501829478464	-0.636363636363636	1	-0.120689655172414	14	29
TNS3	41	56	12	3	1547.04	3094.08	15	2	0.0105641610715051	-4.46341463414634	1	-0.377319587628866	15	97
TOB2	3	10	3	7	337.59	675.18	15	2	1	-0.428571428571429	1	-0.0692307692307692	10	13
TOM1	8	28	3	11	554.4	1108.8	15	2	1	0.0454545454545454	1	0.00793650793650794	14	36
TOMM20	0	2	1	1	124.74	249.48	15	2	1	-Inf	1	-0.5	2	2
TOMM70	13	16	1	2	628.32	1256.64	15	2	1	0.384615384615385	1	0.114942528735632	3	29
TOP1MT	40	62	16	19	949.74	1899.48	15	2	0.552618787404823	-0.305263157894737	1	-0.0649859943977591	35	102
TOPAZ1	171	113	30	20	1930.17	3860.34	15	2	1	0.00877192982456143	1	0.00211267605633803	50	284
TOPBP1	49	84	20	14	1507.44	3014.88	15	2	0.0308358940215266	-1.44897959183673	1	-0.219814241486068	34	133
TOX	7	9	1	6	450.45	900.9	15	2	0.345219593974473	0.785714285714286	1	0.294642857142857	7	16
TP53BP2	17	46	6	10	1124.64	2249.28	15	2	0.538410992517589	-0.623529411764706	1	-0.10515873015873	16	63
TP53I3	9	17	2	6	441.54	883.08	15	2	1	0.37037037037037	1	0.0961538461538461	8	26
TP53INP1	6	17	4	12	235.62	471.24	15	2	1	0.0555555555555556	1	0.0108695652173913	16	23
TPBG	3	19	1	5	397.98	795.96	15	2	1	-0.266666666666667	1	-0.0303030303030303	6	22
TPBGL	4	12	5	7	337.26	674.52	15	2	0.431884057971015	-1.14285714285714	1	-0.166666666666667	12	16
TPCN3	10	23	4	5	693	1386	15	2	0.450806239298273	-0.84	1	-0.141414141414141	9	33
TPD52	4	13	1	4	239.58	479.16	15	2	1	0.1875	1	0.0352941176470588	5	17
TPD52L1	0	5	3	2	203.94	407.88	15	2	0.166666666666667	-Inf	1	-0.6	5	5
TPH2	2	12	3	2	333.63	667.26	15	2	0.0843653250773993	-8	1	-0.457142857142857	5	14
TPI1	0	9	1	6	246.51	493.02	15	2	0.4375	-Inf	1	-0.142857142857143	7	9
TPK1	23	16	4	1	301.29	602.58	15	2	0.633704355769018	-1.78260869565217	1	-0.21025641025641	5	39
TPMT	6	11	0	2	242.55	485.1	15	2	1	1	1	0.352941176470588	2	17
TPO	21	37	0	4	851.73	1703.46	15	2	0.290017836495801	1	1	0.362068965517241	4	58
TPP1	20	37	0	6	556.71	1113.42	15	2	0.164498275022426	1	1	0.350877192982456	6	57
TPP2	5	51	0	2	1249.38	2498.76	15	2	1	1	1	0.0892857142857143	2	56
TPRKB	5	10	0	7	181.17	362.34	15	2	0.134768740031898	1	1	0.333333333333333	7	15
TPTE2	13	22	2	11	506.88	1013.76	15	2	0.181897487879851	0.692307692307692	1	0.217582417582418	13	35
TRA2A	0	6	1	2	275.22	550.44	15	2	0.333333333333333	-Inf	1	-0.333333333333333	3	6
TRABD	1	15	1	2	371.25	742.5	15	2	0.298245614035088	-6.5	1	-0.270833333333333	3	16
TRAF3IP2	12	19	6	8	535.59	1071.18	15	2	1	-0.1875	1	-0.0414746543778802	14	31
TRAF5	0	24	0	7	552.42	1104.84	15	2	1	NA	1	0	7	24
TRAM1	0	6	0	2	353.43	706.86	15	2	1	NA	1	0	2	6
TRAM2	0	17	2	4	375.21	750.42	15	2	0.0592885375494071	-Inf	1	-0.333333333333333	6	17
TRANK1	199	139	6	4	2932.05	5864.1	15	2	1	-0.0477386934673367	1	-0.0112426035502958	10	338
TRAPPC10	10	33	1	13	1256.31	2512.62	15	2	0.260978373685885	0.746153846153846	1	0.161129568106312	14	43
TRAPPC12	32	34	1	1	868.23	1736.46	15	2	1	-0.0625	1	-0.0151515151515151	2	66
TRAPPC2	1	4	0	0	116.82	233.64	15	2	1	NA	1	NA	0	5
TRAPPC8	20	56	5	10	1432.2	2864.4	15	2	0.545726434344263	-0.4	1	-0.0701754385964912	15	76
TRAPPC9	6	62	4	15	861.63	1723.26	15	2	0.215210840391935	-1.75555555555556	1	-0.122291021671827	19	68
TRAT1	5	8	2	1	173.25	346.5	15	2	0.55	-2.2	1	-0.282051282051282	3	13
TRDMT1	15	10	1	3	400.95	801.9	15	2	0.299397920087575	0.777777777777778	1	0.35	4	25
TRDNL	16	4	4	0	280.17	560.34	15	2	1	-Inf	1	-0.2	4	20
TRERF1	15	39	5	8	1154.34	2308.68	15	2	0.507128023927292	-0.625	1	-0.106837606837607	13	54
TRHDE	6	16	2	0	636.57	1273.14	15	2	0.101449275362319	-Inf	1	-0.727272727272727	2	22
TRHR	3	16	2	0	398.97	797.94	15	2	0.0476190476190476	-Inf	1	-0.842105263157895	2	19
TRIB1	0	11	1	3	361.35	722.7	15	2	0.266666666666667	-Inf	1	-0.25	4	11
TRIL	15	89	2	6	750.75	1501.5	15	2	0.349299291710303	-0.977777777777778	1	-0.105769230769231	8	104
TRIM13	9	27	4	6	412.83	825.66	15	2	0.434599664413885	-1	1	-0.15	10	36
TRIM24	12	32	2	3	1167.87	2335.74	15	2	0.615582279782095	-0.777777777777778	1	-0.127272727272727	5	44
TRIM3	1	36	3	14	721.38	1442.76	15	2	0.0870827285921626	-6.71428571428571	1	-0.149443561208267	17	37
TRIM35	11	18	5	11	515.46	1030.92	15	2	0.751942830694622	0.256198347107438	1	0.0668103448275862	16	29
TRIM45	11	26	8	6	527.67	1055.34	15	2	0.105591897108838	-2.15151515151515	1	-0.274131274131274	14	37
TRIM67	5	19	1	4	728.64	1457.28	15	2	1	0.05	1	0.00833333333333333	5	24
TRIM71	0	29	2	10	886.05	1772.1	15	2	0.0804878048780488	-Inf	1	-0.166666666666667	12	29
TRIO	4	40	1	13	1724.58	3449.16	15	2	1	0.230769230769231	1	0.0194805194805195	14	44
TRMT10C	23	16	3	3	410.85	821.7	15	2	0.686134908766786	0.304347826086957	1	0.0897435897435898	6	39
TRMT11	4	17	1	1	456.39	912.78	15	2	0.395256916996047	-3.25	1	-0.30952380952381	2	21
TRMT6	14	22	1	5	478.17	956.34	15	2	0.395014398223641	0.685714285714286	1	0.222222222222222	6	36
TRMT61B	10	7	1	1	239.58	479.16	15	2	1	0.3	1	0.0882352941176471	2	17
TRMU	2	17	1	1	422.73	845.46	15	2	0.271428571428572	-7.5	1	-0.394736842105263	2	19
TRPA1	7	30	1	5	1094.94	2189.88	15	2	1	0.142857142857143	1	0.0225225225225225	6	37
TRPC6	9	35	1	3	810.81	1621.62	15	2	1	-0.296296296296296	1	-0.0454545454545454	4	44
TRPS1	5	17	3	1	918.72	1837.44	15	2	0.0721070234113713	-9.2	1	-0.522727272727273	4	22
TRPV6	6	23	1	3	717.75	1435.5	15	2	1	-0.277777777777778	1	-0.0431034482758621	4	29
TSC22D1	15	44	11	12	1073.16	2146.32	15	2	0.0659720976230626	-1.68888888888889	1	-0.224023581429624	23	59
TSGA10	22	19	4	4	648.78	1297.56	15	2	1	0.136363636363636	1	0.0365853658536586	8	41
TSHZ1	7	33	2	1	1056.33	2112.66	15	2	0.105988169516247	-8.42857142857143	1	-0.491666666666667	3	40
TSKU	7	22	1	9	349.47	698.94	15	2	0.652558553487346	0.650793650793651	1	0.141379310344828	10	29
TSNARE1	36	18	9	1	483.78	967.56	15	2	0.257936785579288	-3.5	1	-0.233333333333333	10	54
TSNAX	4	7	2	4	288.09	576.18	15	2	1	0.125	1	0.0303030303030303	6	11
TSPAN12	1	6	0	1	302.94	605.88	15	2	1	1	1	0.142857142857143	1	7
TSPAN13	4	12	0	0	198	396	15	2	1	NA	1	NA	0	16
TSPAN19	13	7	0	0	201.96	403.92	15	2	1	NA	1	NA	0	20
TSPAN7	3	12	1	2	264.33	528.66	15	2	1	-1	1	-0.133333333333333	3	15
TSPAN8	23	4	1	1	230.67	461.34	15	2	0.320197044334975	0.826086956521739	1	0.351851851851852	2	27
TSSC1	9	10	0	0	335.61	671.22	15	2	1	NA	1	NA	0	19
TST	5	14	4	7	292.05	584.1	15	2	0.687094914081421	-0.6	1	-0.100478468899522	11	19
TSTA3	5	17	8	6	319.44	638.88	15	2	0.0731776047460141	-3.53333333333333	1	-0.344155844155844	14	22
TSTD3	1	7	2	0	142.23	284.46	15	2	0.0666666666666666	-Inf	1	-0.875	2	8
TTBK1	22	55	5	9	1305.81	2611.62	15	2	0.751137090119031	-0.388888888888889	1	-0.0714285714285715	14	77
TTC13	4	28	3	5	829.62	1659.24	15	2	0.128175091023388	-3.2	1	-0.25	8	32
TTC26	4	17	2	3	548.46	1096.92	15	2	0.558072362420189	-1.83333333333333	1	-0.20952380952381	5	21
TTC27	3	3	1	0	130.68	261.36	15	2	1	-Inf	1	-0.5	1	6
TTC3	80	73	6	9	1992.87	3985.74	15	2	0.42433655873276	0.391666666666667	1	0.122875816993464	15	153
TTC32	1	2	2	0	139.59	279.18	15	2	0.4	-Inf	1	-0.666666666666667	2	3
TTC38-TTC38L	3	13	0	0	344.52	689.04	15	2	1	NA	1	NA	0	16
TTC39C	1	19	1	0	572.22	1144.44	15	2	0.0952380952380952	-Inf	1	-0.95	1	20
TTC7A	19	35	8	12	949.41	1898.82	15	2	0.787899132007399	-0.228070175438597	1	-0.0481481481481482	20	54
TTF2	61	53	11	4	1170.18	2340.36	15	2	0.175033276982788	-1.38934426229508	1	-0.198245614035088	15	114
TTK	30	37	7	9	911.79	1823.58	15	2	1	0.0407407407407407	1	0.0102611940298508	16	67
TTL	1	7	1	2	375.21	750.42	15	2	0.490909090909091	-2.5	1	-0.208333333333333	3	8
TTLL2	15	24	4	3	544.5	1089	15	2	0.424363116229747	-1.13333333333333	1	-0.186813186813187	7	39
TTPA	5	9	0	4	270.27	540.54	15	2	0.277777777777778	1	1	0.357142857142857	4	14
TTR	0	2	0	3	149.49	298.98	15	2	1	NA	1	0	3	2
TUBA8A	1	26	1	2	443.52	887.04	15	2	0.193103448275862	-12	1	-0.296296296296296	3	27
TUBA8B	4	11	0	5	501.93	1003.86	15	2	0.530443756449948	1	1	0.266666666666667	5	15
TUBB6	1	20	0	7	442.53	885.06	15	2	1	1	1	0.0476190476190476	7	21
TUBE1	4	20	5	4	471.24	942.48	15	2	0.073289124668435	-5.25	1	-0.388888888888889	9	24
TUBGCP3	3	31	0	3	897.93	1795.86	15	2	1	1	1	0.0882352941176471	3	34
TUBGCP5	7	36	6	8	1028.61	2057.22	15	2	0.064297505146187	-2.85714285714286	1	-0.26578073089701	14	43
TUBGCP6	59	111	17	11	2425.5	4851	15	2	0.0116059674576373	-1.9075500770416	1	-0.260084033613445	28	170
TULP3	2	15	2	8	441.21	882.42	15	2	0.612535612535613	-0.875	1	-0.0823529411764706	10	17
TULP4	7	85	1	19	1484.01	2968.02	15	2	1	0.360902255639098	1	0.0260869565217391	20	92
TWF1	3	23	2	1	347.49	694.98	15	2	0.0684181718664477	-14.3333333333333	1	-0.551282051282051	3	26
TWIST1	0	4	0	2	185.46	370.92	15	2	1	NA	1	0	2	4
TWISTNB	10	9	0	0	313.83	627.66	15	2	1	NA	1	NA	0	19
TWSG1	0	16	1	5	223.74	447.48	15	2	0.272727272727273	-Inf	1	-0.166666666666667	6	16
TXLNB	20	26	3	4	668.25	1336.5	15	2	1	0.025	1	0.00621118012422361	7	46
TXLNG	12	26	1	2	552.42	1104.84	15	2	1	-0.0833333333333333	1	-0.0175438596491228	3	38
TXN2	2	5	0	3	132.66	265.32	15	2	1	1	1	0.285714285714286	3	7
TXNDC5	4	25	3	5	409.86	819.72	15	2	0.156320370741623	-2.75	1	-0.237068965517241	8	29
TXNDC9	0	17	3	1	224.73	449.46	15	2	0.00300751879699248	-Inf	0.991296422875371	-0.75	4	17
TXNL4A	1	7	0	1	141.57	283.14	15	2	1	1	1	0.125	1	8
TXNL4B	1	5	4	1	148.5	297	15	2	0.0800865800865801	-19	1	-0.633333333333333	5	6
TXNRD1	7	27	2	6	554.4	1108.8	15	2	1	-0.285714285714286	1	-0.0441176470588235	8	34
TYMS	8	15	1	2	299.97	599.94	15	2	1	0.0625	1	0.0144927536231884	3	23
TYR	7	19	1	0	524.7	1049.4	15	2	0.296296296296296	-Inf	1	-0.730769230769231	1	26
U2AF1	0	6	0	2	227.04	454.08	15	2	1	NA	1	0	2	6
UBA5	4	17	7	6	485.43	970.86	15	2	0.0596866889136077	-3.95833333333333	1	-0.347985347985348	13	21
UBAC2	17	15	4	1	342.54	685.08	15	2	0.364069952305246	-2.52941176470588	1	-0.26875	5	32
UBASH3A	6	25	4	5	620.73	1241.46	15	2	0.190337343394619	-2.33333333333333	1	-0.25089605734767	9	31
UBE2E2	6	4	1	2	414.15	828.3	15	2	0.559440559440559	0.666666666666667	1	0.266666666666667	3	10
UBE2H	14	18	6	3	251.79	503.58	15	2	0.277157252767009	-1.57142857142857	1	-0.229166666666667	9	32
UBE2J1	7	21	1	5	316.8	633.6	15	2	1	0.4	1	0.0833333333333333	6	28
UBE2V2	1	2	0	0	151.47	302.94	15	2	1	NA	1	NA	0	3
UBE3A	0	22	0	6	872.19	1744.38	15	2	1	NA	1	0	6	22
UBE3C	4	48	1	3	1074.15	2148.3	15	2	0.319611206403659	-3	1	-0.173076923076923	4	52
UBE3D	24	17	5	3	437.25	874.5	15	2	1	-0.180555555555556	1	-0.0396341463414634	8	41
UBL3	1	7	0	0	112.53	225.06	15	2	1	NA	1	NA	0	8
UBN2	8	32	1	3	1189.65	2379.3	15	2	1	-0.333333333333333	1	-0.05	4	40
UBP1	5	21	0	0	532.62	1065.24	15	2	1	NA	1	NA	0	26
UBR2	16	56	3	7	1752.63	3505.26	15	2	0.690426256323476	-0.5	1	-0.0777777777777778	10	72
UBR5	0	98	1	20	2772	5544	15	2	0.176470588235294	-Inf	1	-0.0476190476190476	21	98
UBXN2A	13	18	0	1	289.08	578.16	15	2	1	1	1	0.419354838709677	1	31
UBXN2B	1	12	0	2	365.31	730.62	15	2	1	1	1	0.0769230769230769	2	13
UCP3	4	12	8	9	301.95	603.9	15	2	0.281752672051071	-1.66666666666667	1	-0.220588235294118	17	16
UFL1	21	25	6	3	782.1	1564.2	15	2	0.295463669209153	-1.38095238095238	1	-0.210144927536232	9	46
UFM1	9	3	0	0	134.64	269.28	15	2	1	NA	1	NA	0	12
UGGT2	34	62	11	7	1506.78	3013.56	15	2	0.0639194032930582	-1.86554621848739	1	-0.256944444444444	18	96
UGP2	0	21	0	4	502.92	1005.84	15	2	1	NA	1	0	4	21
UHRF1BP1L	18	43	3	4	1451.34	2902.68	15	2	0.66771961877229	-0.791666666666667	1	-0.133489461358314	7	61
ULK4	7	7	2	1	176.22	352.44	15	2	1	-1	1	-0.166666666666667	3	14
UMAD1	8	6	0	0	143.55	287.1	15	2	1	NA	1	NA	0	14
UMODL1	67	63	21	8	1309.77	2619.54	15	2	0.0617746787477607	-1.46828358208955	1	-0.208753315649867	29	130
UNC50	3	12	12	7	345.84	691.68	15	2	0.0170819648826612	-5.85714285714286	1	-0.431578947368421	19	15
UNC93A	6	12	0	1	454.41	908.82	15	2	1	1	1	0.333333333333333	1	18
UPF2	1	44	2	6	1280.07	2560.14	15	2	0.0561768974643558	-13.6666666666667	1	-0.227777777777778	8	45
UPK1B	7	13	0	2	256.41	512.82	15	2	1	1	1	0.35	2	20
UPK3A	20	17	1	1	195.03	390.06	15	2	1	0.15	1	0.0405405405405406	2	37
UPP1	3	11	2	3	310.86	621.72	15	2	0.569573443412453	-1.44444444444444	1	-0.185714285714286	5	14
UQCRB	1	8	0	1	110.88	221.76	15	2	1	1	1	0.111111111111111	1	9
URB1	83	99	23	16	2258.19	4516.38	15	2	0.158178717560189	-0.71460843373494	1	-0.133699633699634	39	182
URB2	57	61	26	25	1512.72	3025.44	15	2	0.86702423183553	-0.112982456140351	1	-0.0267530741110003	51	118
USF3	46	102	15	29	2236.41	4472.82	15	2	0.715230542570543	-0.146926536731634	1	-0.0300982800982801	44	148
USH2A	118	151	13	11	4291.98	8583.96	15	2	0.393518851110608	-0.512326656394453	1	-0.103004956629492	24	269
USP12-USP12-like	1	4	0	1	263.34	526.68	15	2	1	1	1	0.2	1	5
USP14	0	19	2	5	477.18	954.36	15	2	0.0646153846153846	-Inf	1	-0.285714285714286	7	19
USP15	4	29	0	3	972.18	1944.36	15	2	1	1	1	0.121212121212121	3	33
USP16	19	32	6	4	816.75	1633.5	15	2	0.291740718854524	-1.52631578947368	1	-0.227450980392157	10	51
USP18	23	11	1	0	434.61	869.22	15	2	1	-Inf	1	-0.323529411764706	1	34
USP25	3	38	1	0	1106.82	2213.64	15	2	0.0952380952380953	-Inf	1	-0.926829268292683	1	41
USP34	8	89	4	10	3530.67	7061.34	15	2	0.0440154710737764	-3.45	1	-0.203240058910162	14	97
USP35	20	57	6	9	1013.76	2027.52	15	2	0.347714606063055	-0.9	1	-0.14025974025974	15	77
USP44	7	13	1	3	707.85	1415.7	15	2	1	0.380952380952381	1	0.1	4	20
USP45	6	33	2	2	803.55	1607.1	15	2	0.151446398184912	-4.5	1	-0.346153846153846	4	39
USP5	0	60	1	10	846.45	1692.9	15	2	0.154929577464789	-Inf	1	-0.0909090909090909	11	60
USP6NL	22	37	3	2	851.4	1702.8	15	2	0.370717102943769	-1.52272727272727	1	-0.227118644067797	5	59
USP9X	20	69	3	23	2634.72	5269.44	15	2	0.275117652402308	0.55	1	0.10933448573898	26	89
USPL1	83	65	14	14	1076.13	2152.26	15	2	0.679213258273831	0.216867469879518	1	0.0608108108108109	28	148
UST	0	3	1	1	324.72	649.44	15	2	0.4	-Inf	1	-0.5	2	3
UTP20	60	99	17	11	2771.01	5542.02	15	2	0.035870239401779	-1.55	1	-0.229784366576819	28	159
UTP23	7	8	3	0	245.52	491.04	15	2	0.215686274509804	-Inf	1	-0.533333333333333	3	15
UTRN	53	146	20	17	3428.37	6856.74	15	2	0.00166357955681892	-2.24084350721421	0.861654992358069	-0.274208882249083	37	199
UTS2RL	15	23	6	9	365.31	730.62	15	2	1	-0.0222222222222221	1	-0.00526315789473686	15	38
UVRAG	21	38	6	14	819.06	1638.12	15	2	0.787322710370591	0.224489795918367	1	0.0559322033898305	20	59
UXS1	3	17	0	4	417.78	835.56	15	2	1	1	1	0.15	4	20
VAMP1	21	7	2	1	169.29	338.58	15	2	1	0.333333333333333	1	0.0833333333333334	3	28
VAPA	0	6	0	0	222.42	444.84	15	2	1	NA	1	NA	0	6
VCPIP1	8	50	4	19	1202.85	2405.7	15	2	0.733342707060338	-0.315789473684211	1	-0.0359820089955022	23	58
VEGFD	2	14	3	0	350.46	700.92	15	2	0.0103199174406605	-Inf	1	-0.875	3	16
VEZT	16	22	6	4	827.64	1655.28	15	2	0.477674458832664	-1.0625	1	-0.178947368421053	10	38
VGLL2	3	23	2	3	305.58	611.16	15	2	0.172919940439407	-4.11111111111111	1	-0.284615384615385	5	26
VGLL3	2	5	0	0	288.09	576.18	15	2	1	NA	1	NA	0	7
VILL	23	47	8	13	953.37	1906.74	15	2	0.793531343585277	-0.25752508361204	1	-0.0523809523809524	21	70
VIM	4	8	0	12	456.39	912.78	15	2	0.093167701863354	1	1	0.333333333333333	12	12
VIP	2	9	0	0	164.34	328.68	15	2	1	NA	1	NA	0	11
VIPR1	8	16	3	2	384.12	768.24	15	2	0.338638373121132	-2	1	-0.266666666666667	5	24
VIPR2	2	14	0	1	434.61	869.22	15	2	1	1	1	0.125	1	16
VIT	22	46	5	7	787.71	1575.42	15	2	0.526655233930517	-0.493506493506493	1	-0.0931372549019608	12	68
VMO1	2	9	1	1	182.16	364.32	15	2	0.423076923076923	-3.5	1	-0.318181818181818	2	11
VNN1	31	18	9	0	491.04	982.08	15	2	0.0454013130655941	-Inf	1	-0.36734693877551	9	49
VPS13B	44	103	13	17	2879.25	5758.5	15	2	0.197714877387057	-0.790106951871658	1	-0.134013605442177	30	147
VPS36	3	15	1	6	383.13	766.26	15	2	1	0.166666666666667	1	0.0238095238095238	7	18
VPS41	3	35	0	4	846.45	1692.9	15	2	1	1	1	0.0789473684210526	4	38
VPS50	3	36	0	6	958.32	1916.64	15	2	1	1	1	0.0769230769230769	6	39
VPS54	3	22	2	5	967.23	1934.46	15	2	0.296440489432703	-1.93333333333333	1	-0.165714285714286	7	25
VRK2	27	21	0	0	534.6	1069.2	15	2	1	NA	1	NA	0	48
VSIG4	26	18	4	5	687.06	1374.12	15	2	0.477963019812501	0.446153846153846	1	0.146464646464647	9	44
VSNL1	1	6	3	0	158.4	316.8	15	2	0.0333333333333333	-Inf	1	-0.857142857142857	3	7
VSTM2A	7	7	0	0	239.58	479.16	15	2	1	NA	1	NA	0	14
VSTM5	2	11	0	0	197.01	394.02	15	2	1	NA	1	NA	0	13
VSX1	2	17	1	4	265.65	531.3	15	2	0.521245059288538	-1.125	1	-0.0947368421052632	5	19
VTA1	4	10	0	2	304.92	609.84	15	2	1	1	1	0.285714285714286	2	14
VTCN1	7	15	6	5	304.92	609.84	15	2	0.269707887991488	-1.57142857142857	1	-0.227272727272727	11	22
VTCN1L	10	12	1	1	156.42	312.84	15	2	1	-0.2	1	-0.0454545454545455	2	22
VWA3B	87	46	17	6	1437.48	2874.96	15	2	0.481957289021551	-0.498084291187739	1	-0.084995096436744	23	133
VWDE	62	55	15	12	1810.71	3621.42	15	2	0.834013843603722	-0.108870967741935	1	-0.0256410256410257	27	117
VWF	17	23	0	2	889.02	1778.04	15	2	0.506387921022067	1	1	0.425	2	40
WAC	0	7	1	1	600.93	1201.86	15	2	0.222222222222222	-Inf	1	-0.5	2	7
WASF1	1	19	3	2	550.11	1100.22	15	2	0.0162055335968379	-27.5	1	-0.55	5	20
WASF3	2	22	2	8	495	990	15	2	0.563567362428843	-1.75	1	-0.116666666666667	10	24
WASHC1	9	22	1	5	472.23	944.46	15	2	1	0.511111111111111	1	0.123655913978495	6	31
WASHC3	2	6	0	0	241.56	483.12	15	2	1	NA	1	NA	0	8
WASHC4	4	47	1	7	1162.26	2324.52	15	2	0.530787278487915	-0.678571428571429	1	-0.0465686274509804	8	51
WASHC5	2	48	0	6	1148.4	2296.8	15	2	1	1	1	0.04	6	50
WASL	3	16	0	3	500.94	1001.88	15	2	1	1	1	0.157894736842105	3	19
WBP11	1	38	2	5	641.52	1283.04	15	2	0.0562582345191041	-14.2	1	-0.26007326007326	7	39
WBP2NL	8	19	1	9	296.01	592.02	15	2	0.393244746414936	0.736111111111111	1	0.196296296296296	10	27
WBP4	17	29	4	0	405.9	811.8	15	2	0.0259878419452887	-Inf	1	-0.630434782608696	4	46
WDCP	12	44	8	8	742.5	1485	15	2	0.0538085140821019	-2.66666666666667	1	-0.285714285714286	16	56
WDCPL	23	38	6	0	726.66	1453.32	15	2	0.00475992471659299	-Inf	1	-0.622950819672131	6	61
WDFY2	1	15	3	5	396.99	793.98	15	2	0.0909090909090908	-8	1	-0.3125	8	16
WDPCP	25	29	6	3	745.47	1490.94	15	2	0.302017705609347	-1.32	1	-0.203703703703704	9	54
WDR26	1	16	0	2	618.75	1237.5	15	2	1	1	1	0.0588235294117647	2	17
WDR27	60	45	6	7	990	1980	15	2	0.557512494366972	0.357142857142857	1	0.10989010989011	13	105
WDR3	11	42	7	5	931.59	1863.18	15	2	0.0142653584650252	-4.34545454545455	1	-0.375786163522013	12	53
WDR35	8	50	3	1	1158.3	2316.6	15	2	0.015676397565632	-17.75	1	-0.612068965517241	4	58
WDR37	4	17	0	0	491.04	982.08	15	2	1	NA	1	NA	0	21
WDR4	18	21	5	5	375.54	751.08	15	2	1	-0.166666666666667	1	-0.0384615384615384	10	39
WDR43	11	17	0	2	622.71	1245.42	15	2	0.519540229885057	1	1	0.392857142857143	2	28
WDR48	6	37	2	1	716.43	1432.86	15	2	0.0737812911725955	-11.3333333333333	1	-0.527131782945736	3	43
WDR60	42	37	8	8	1154.34	2308.68	15	2	1	0.119047619047619	1	0.0316455696202531	16	79
WDR64	69	37	2	1	1040.49	2080.98	15	2	1	-0.0724637681159421	1	-0.0157232704402516	3	106
WDR73	8	8	3	6	202.95	405.9	15	2	0.676618656615964	0.5	1	0.166666666666667	9	16
WDR86	0	20	1	7	395.01	790.02	15	2	0.285714285714286	-Inf	1	-0.125	8	20
WDR91	6	23	3	5	689.04	1378.08	15	2	0.372695103245388	-1.3	1	-0.168103448275862	8	29
WDR92	3	14	2	1	357.39	714.78	15	2	0.140350877192982	-8.33333333333333	1	-0.490196078431372	3	17
WDYHV1	9	13	3	4	209.88	419.76	15	2	1	-0.0833333333333333	1	-0.0194805194805194	7	22
WEE2	21	33	3	2	555.39	1110.78	15	2	0.388169430003999	-1.35714285714286	1	-0.211111111111111	5	54
WIF1	9	16	0	1	414.81	829.62	15	2	1	1	1	0.36	1	25
WIPF3	5	15	1	2	233.97	467.94	15	2	1	-0.5	1	-0.0833333333333333	3	20
WISP1	9	19	0	1	392.37	784.74	15	2	1	1	1	0.321428571428571	1	28
WISP3	11	12	3	2	349.47	698.94	15	2	1	-0.636363636363636	1	-0.121739130434783	5	23
WNK1	28	84	7	13	2871.33	5742.66	15	2	0.410815651058821	-0.615384615384615	1	-0.1	20	112
WNT11	2	7	3	2	323.73	647.46	15	2	0.265734265734266	-4.25	1	-0.377777777777778	5	9
WNT11B	11	12	3	6	347.49	694.98	15	2	0.694226918798665	0.454545454545455	1	0.144927536231884	9	23
WNT16	4	19	1	2	350.46	700.92	15	2	0.488461538461538	-1.375	1	-0.159420289855072	3	23
WNT2	1	11	0	0	320.1	640.2	15	2	1	NA	1	NA	0	12
WNT3A	1	9	0	5	355.41	710.82	15	2	1	1	1	0.1	5	10
WNT5B	0	8	0	7	356.4	712.8	15	2	1	NA	1	0	7	8
WNT9A	0	10	0	3	350.79	701.58	15	2	1	NA	1	0	3	10
WRB	1	10	0	0	169.29	338.58	15	2	1	NA	1	NA	0	11
WTAP	1	6	2	2	393.03	786.06	15	2	0.490909090909091	-5	1	-0.357142857142857	4	7
WWC3	8	38	3	1	1120.35	2240.7	15	2	0.0293747286148502	-13.25	1	-0.576086956521739	4	46
WWP1	7	20	0	3	901.89	1803.78	15	2	1	1	1	0.259259259259259	3	27
XCL1	2	5	0	0	97.02	194.04	15	2	1	NA	1	NA	0	7
XCR1	8	12	0	0	335.61	671.22	15	2	1	NA	1	NA	0	20
XDH	25	54	7	4	1346.4	2692.8	15	2	0.0488048790158771	-2.78	1	-0.319907940161105	11	79
XG	0	7	1	2	163.35	326.7	15	2	0.3	-Inf	1	-0.333333333333333	3	7
XIRP1	75	112	29	21	2825.46	5650.92	15	2	0.0256877069157385	-1.06222222222222	1	-0.178930481283422	50	187
XK	5	10	1	10	440.55	881.1	15	2	0.197324414715719	0.8	1	0.242424242424242	11	15
XKR4	1	11	1	2	339.9	679.8	15	2	0.371428571428571	-4.5	1	-0.25	3	12
XKR5	47	36	20	15	650.43	1300.86	15	2	1	-0.0212765957446808	1	-0.00516351118760749	35	83
XKR6	1	8	1	2	418.77	837.54	15	2	0.454545454545454	-3	1	-0.222222222222222	3	9
XKR9	10	13	2	0	375.21	750.42	15	2	0.22	-Inf	1	-0.565217391304348	2	23
XPNPEP3	3	29	11	3	497.97	995.94	15	2	7.71654140314786e-06	-34.4444444444444	0.0279776069473464	-0.691964285714286	14	32
XPO1	0	26	3	1	995.94	1991.88	15	2	0.000985221674876848	-Inf	0.673656619712625	-0.75	4	26
XPO4	3	29	2	2	1040.49	2080.98	15	2	0.084288260758849	-8.66666666666667	1	-0.40625	4	32
XPO5	3	45	2	3	1188	2376	15	2	0.0642861498735924	-9	1	-0.3375	5	48
XPOT	5	27	1	2	969.21	1938.42	15	2	0.441711229946524	-1.7	1	-0.177083333333333	3	32
XRCC2	6	12	2	1	276.21	552.42	15	2	0.530827067669173	-3	1	-0.333333333333333	3	18
XRCC6	11	24	8	9	611.82	1223.64	15	2	0.360198526517396	-0.939393939393939	1	-0.156302521008403	17	35
XRN2	5	34	0	6	940.5	1881	15	2	1	1	1	0.128205128205128	6	39
XRRA1	58	40	26	12	771.21	1542.42	15	2	0.431794200485725	-0.494252873563218	1	-0.0923737916219119	38	98
XYLB	9	14	6	3	435.93	871.86	15	2	0.243288839451242	-2.11111111111111	1	-0.27536231884058	9	23
YAE1D1	10	7	2	0	220.77	441.54	15	2	0.508771929824561	-Inf	1	-0.411764705882353	2	17
YARS2	4	9	2	1	281.16	562.32	15	2	0.517857142857143	-3.5	1	-0.358974358974359	3	13
YBX3	14	18	4	3	330	660	15	2	0.682479682479682	-0.714285714285714	1	-0.133928571428571	7	32
YEATS4	6	18	7	6	326.7	653.4	15	2	0.147711414221262	-2.5	1	-0.288461538461538	13	24
YES1	1	6	0	8	536.58	1073.16	15	2	0.466666666666667	1	1	0.142857142857143	8	7
YIPF3	2	22	1	10	335.61	671.22	15	2	1	-0.1	1	-0.00757575757575758	11	24
YIPF4	0	8	0	3	244.53	489.06	15	2	1	NA	1	0	3	8
YIPF6	1	17	1	1	159.39	318.78	15	2	0.194736842105263	-16	1	-0.444444444444444	2	18
YME1L1	6	31	4	5	715.77	1431.54	15	2	0.0867637225636839	-3.13333333333333	1	-0.282282282282282	9	37
YPEL5	0	3	0	1	120.78	241.56	15	2	1	NA	1	0	1	3
YTHDF3	2	10	0	2	578.16	1156.32	15	2	1	1	1	0.166666666666667	2	12
YWHAQ	0	3	0	0	196.02	392.04	15	2	1	NA	1	NA	0	3
YWHAZ	0	4	0	0	243.54	487.08	15	2	1	NA	1	NA	0	4
ZAR1L	15	21	5	3	300.96	601.92	15	2	0.4361222778693	-1.33333333333333	1	-0.208333333333333	8	36
ZBED1	0	33	1	6	689.04	1378.08	15	2	0.175	-Inf	1	-0.142857142857143	7	33
ZBED4	4	25	2	3	1161.27	2322.54	15	2	0.205300155252717	-3.16666666666667	1	-0.262068965517241	5	29
ZBTB10	2	14	0	3	856.02	1712.04	15	2	1	1	1	0.125	3	16
ZBTB14	2	12	0	2	444.51	889.02	15	2	1	1	1	0.142857142857143	2	14
ZBTB18-ZBTB42	0	1	1	2	517.77	1035.54	15	2	1	-Inf	1	-0.333333333333333	3	1
ZBTB2	1	11	1	1	508.86	1017.72	15	2	0.274725274725275	-10	1	-0.416666666666667	2	12
ZBTB20	0	14	1	3	662.31	1324.62	15	2	0.222222222222222	-Inf	1	-0.25	4	14
ZBTB21	8	56	2	14	1047.42	2094.84	15	2	1	0	1	0	16	64
ZBTB47	7	24	1	16	731.94	1463.88	15	2	0.229995572745584	0.785714285714286	1	0.166982922201139	17	31
ZC2HC1A	4	11	3	1	322.74	645.48	15	2	0.117389060887513	-7.25	1	-0.483333333333333	4	15
ZC3H12B	4	19	2	1	829.62	1659.24	15	2	0.123076923076923	-8.5	1	-0.492753623188406	3	23
ZC3H12C	4	22	6	8	882.09	1764.18	15	2	0.122575617912929	-3.125	1	-0.274725274725275	14	26
ZC3H12D	31	34	11	10	601.92	1203.84	15	2	0.803720838463961	-0.206451612903226	1	-0.0468864468864469	21	65
ZC3H13	4	57	5	14	1628.55	3257.1	15	2	0.0307956635943457	-4.08928571428571	1	-0.197584124245039	19	61
ZC3H3	12	24	9	11	422.73	845.46	15	2	0.405100095572974	-0.636363636363636	1	-0.116666666666667	20	36
ZC3H6	5	31	3	2	1125.63	2251.26	15	2	0.0426128705974662	-8.3	1	-0.461111111111111	5	36
ZC3H7B	4	40	1	10	982.08	1964.16	15	2	1	0	1	0	11	44
ZC3HAV1	29	25	3	0	686.07	1372.14	15	2	0.24812030075188	-Inf	1	-0.462962962962963	3	54
ZC3HC1	18	29	10	17	403.26	806.52	15	2	1	0.0522875816993464	1	0.012608353033885	27	47
ZC4H2	0	9	0	0	222.75	445.5	15	2	1	NA	1	NA	0	9
ZCCHC2	7	31	3	9	1025.64	2051.28	15	2	0.68579214672883	-0.476190476190476	1	-0.0657894736842105	12	38
ZDHHC14	1	6	0	3	331.32	662.64	15	2	1	1	1	0.142857142857143	3	7
ZDHHC17	3	18	3	6	600.93	1201.86	15	2	0.328700265251989	-2	1	-0.19047619047619	9	21
ZDHHC20	0	10	0	4	359.37	718.74	15	2	1	NA	1	0	4	10
ZDHHC23	9	18	2	8	409.86	819.72	15	2	0.688407666226157	0.5	1	0.133333333333333	10	27
ZDHHC3	4	8	1	3	323.73	647.46	15	2	1	0.333333333333333	1	0.0833333333333333	4	12
ZEB1	12	16	3	4	967.56	1935.12	15	2	1	0	1	0	7	28
ZFAND3	2	6	0	2	213.51	427.02	15	2	1	1	1	0.25	2	8
ZFAT	17	68	5	10	1233.54	2467.08	15	2	0.310332790807777	-1	1	-0.133333333333333	15	85
ZFC3H1	18	67	8	5	1883.64	3767.28	15	2	0.00472852947049038	-4.95555555555556	1	-0.403619909502262	13	85
ZFHX4	34	54	5	3	2489.52	4979.04	15	2	0.263614060652229	-1.64705882352941	1	-0.238636363636364	8	88
ZFP2	9	40	4	5	467.28	934.56	15	2	0.102491753130386	-2.55555555555556	1	-0.260770975056689	9	49
ZFP92	9	17	7	3	323.73	647.46	15	2	0.0731580865062511	-3.40740740740741	1	-0.353846153846154	10	26
ZFPM2	13	30	3	1	1016.73	2033.46	15	2	0.107532307347293	-5.92307692307692	1	-0.447674418604651	4	43
ZFX	0	21	2	3	787.05	1574.1	15	2	0.0307692307692308	-Inf	1	-0.4	5	21
ZHX1	15	47	9	1	867.24	1734.48	15	2	0.000120701245359643	-27.2	0.262573489155368	-0.658064516129032	10	62
ZHX2	10	32	3	8	824.67	1649.34	15	2	1	-0.2	1	-0.0346320346320346	11	42
ZMYM2	5	27	2	6	580.14	1160.28	15	2	0.611150660067069	-0.8	1	-0.09375	8	32
ZNF236	13	74	3	4	1877.37	3754.74	15	2	0.0929095114053331	-3.26923076923077	1	-0.279146141215107	7	87
ZNF277	14	10	7	0	472.23	944.46	15	2	0.0660677105615927	-Inf	1	-0.416666666666667	7	24
ZNF292	73	137	13	21	2706.66	5413.32	15	2	0.70219552935924	-0.1617742987606	1	-0.034733893557423	34	210
ZNF318	79	74	19	20	2123.55	4247.1	15	2	0.857875585197831	0.110126582278481	1	0.0291603821015586	39	153
ZNF384	1	16	0	1	532.62	1065.24	15	2	1	1	1	0.0588235294117647	1	17
ZNF385D	1	12	0	0	255.42	510.84	15	2	1	NA	1	NA	0	13
ZNF395	10	27	3	10	479.16	958.32	15	2	1	0.19	1	0.0395010395010395	13	37
ZNF398L	9	23	15	12	609.18	1218.36	15	2	0.0383614212800072	-2.19444444444444	1	-0.274305555555556	27	32
ZNF407	84	62	9	7	1699.83	3399.66	15	2	1	0.0510204081632653	1	0.0128424657534246	16	146
ZNF438	47	42	5	6	840.18	1680.36	15	2	0.753865541805961	0.25531914893617	1	0.0735444330949949	11	89
ZNF451	30	40	4	5	1059.3	2118.6	15	2	1	-0.0666666666666667	1	-0.0158730158730159	9	70
ZNF512	5	21	1	2	560.01	1120.02	15	2	0.515325670498084	-1.1	1	-0.141025641025641	3	26
ZNF516	28	64	11	9	1196.91	2393.82	15	2	0.0675014652487282	-1.79365079365079	1	-0.245652173913044	20	92
ZNF521	5	38	1	3	1251.36	2502.72	15	2	0.432231659798727	-1.53333333333333	1	-0.133720930232558	4	43
ZNF622	14	25	0	6	465.3	930.6	15	2	0.155531205417762	1	1	0.358974358974359	6	39
ZNF654	11	33	1	7	1078.11	2156.22	15	2	0.663361810959351	0.571428571428571	1	0.125	8	44
ZNF746	47	40	8	15	464.31	928.62	15	2	0.158610740575531	0.546099290780142	1	0.19240379810095	23	87
ZNF767	65	65	11	16	791.01	1582.02	15	2	0.40567091313817	0.3125	1	0.0925925925925926	27	130
ZNF800	8	15	2	1	674.19	1348.38	15	2	0.538461538461538	-2.75	1	-0.318840579710145	3	23
ZNF830	10	12	7	2	333.63	667.26	15	2	0.131657397107898	-3.2	1	-0.323232323232323	9	22
ZNF91L	28	38	4	2	619.74	1239.48	15	2	0.396218002240517	-1.71428571428571	1	-0.242424242424242	6	66
ZPAX	53	35	2	1	838.53	1677.06	15	2	1	-0.320754716981132	1	-0.0643939393939393	3	88
ZPLD1	3	14	1	4	411.84	823.68	15	2	1	-0.166666666666667	1	-0.0235294117647059	5	17
ZRSR2	0	13	1	4	474.21	948.42	15	2	0.277777777777778	-Inf	1	-0.2	5	13
ZUFSP	14	25	5	3	485.1	970.2	15	2	0.239906938774031	-1.97619047619048	1	-0.266025641025641	8	39
ZYX	24	28	6	3	575.19	1150.38	15	2	0.300551924750746	-1.33333333333333	1	-0.205128205128205	9	52
xcc-b100_1894L	22	17	6	4	574.2	1148.4	15	2	1	-0.159090909090909	1	-0.0358974358974359	10	39
44G24.1	0	0	1	4	130.02	260.04	15	2	1	NA	1	NA	5	0
A1CF	0	0	0	2	584.1	1168.2	15	2	1	NA	1	NA	2	0
A2ML4	0	0	9	8	1469.82	2939.64	15	2	1	NA	1	NA	17	0
A4GNT	0	0	1	6	385.11	770.22	15	2	1	NA	1	NA	7	0
AAAS	0	0	5	6	465.3	930.6	15	2	1	NA	1	NA	11	0
AACS	0	0	0	2	634.59	1269.18	15	2	1	NA	1	NA	2	0
AADAC	0	0	6	9	399.96	799.92	15	2	1	NA	1	NA	15	0
AADACL4L1	0	0	10	4	406.89	813.78	15	2	1	NA	1	NA	14	0
AADACL4L2	0	0	8	8	394.35	788.7	15	2	1	NA	1	NA	16	0
AADACL4L3	0	0	6	8	404.91	809.82	15	2	1	NA	1	NA	14	0
AADACL4L5	0	0	5	2	403.92	807.84	15	2	1	NA	1	NA	7	0
AAGAB	0	0	2	4	299.97	599.94	15	2	1	NA	1	NA	6	0
AAK1	0	0	5	4	1350.03	2700.06	15	2	1	NA	1	NA	9	0
AAMP	0	0	5	9	419.76	839.52	15	2	1	NA	1	NA	14	0
AANAT	0	0	3	2	203.94	407.88	15	2	1	NA	1	NA	5	0
AAREL	0	0	15	8	287.76	575.52	15	2	1	NA	1	NA	23	0
AARS	0	0	7	19	959.31	1918.62	15	2	1	NA	1	NA	26	0
AARSD1	0	0	6	12	535.59	1071.18	15	2	1	NA	1	NA	18	0
AATF	0	0	8	6	623.7	1247.4	15	2	1	NA	1	NA	14	0
AATK	0	0	23	37	1510.08	3020.16	15	2	1	NA	1	NA	60	0
ABCA1	0	0	5	13	2281.62	4563.24	15	2	1	NA	1	NA	18	0
ABCA12	0	0	29	14	3943.17	7886.34	15	2	1	NA	1	NA	43	0
ABCA2	0	0	2	2	2689.5	5379	15	2	1	NA	1	NA	4	0
ABCA3	0	0	3	35	1691.91	3383.82	15	2	1	NA	1	NA	38	0
ABCA4	0	0	23	23	2408.01	4816.02	15	2	1	NA	1	NA	46	0
ABCA5	0	0	7	25	1632.51	3265.02	15	2	1	NA	1	NA	32	0
ABCA7	0	0	61	63	2149.29	4298.58	15	2	1	NA	1	NA	124	0
ABCA8	0	0	13	21	1587.96	3175.92	15	2	1	NA	1	NA	34	0
ABCA9	0	0	18	17	1589.94	3179.88	15	2	1	NA	1	NA	35	0
ABCB11	0	0	2	6	1336.5	2673	15	2	1	NA	1	NA	8	0
ABCB6	0	0	6	22	800.91	1601.82	15	2	1	NA	1	NA	28	0
ABCB9	0	0	6	10	784.08	1568.16	15	2	1	NA	1	NA	16	0
ABCC1	0	0	8	2	1509.75	3019.5	15	2	1	NA	1	NA	10	0
ABCC2	0	0	3	9	675.18	1350.36	15	2	1	NA	1	NA	12	0
ABCC3	0	0	4	10	1514.7	3029.4	15	2	1	NA	1	NA	14	0
ABCC5	0	0	5	7	1438.47	2876.94	15	2	1	NA	1	NA	12	0
ABCC6	0	0	5	3	1375.11	2750.22	15	2	1	NA	1	NA	8	0
ABCC8	0	0	4	6	1524.6	3049.2	15	2	1	NA	1	NA	10	0
ABCD3	0	0	2	3	655.38	1310.76	15	2	1	NA	1	NA	5	0
ABCD4	0	0	1	8	603.9	1207.8	15	2	1	NA	1	NA	9	0
ABCE1	0	0	4	3	594	1188	15	2	1	NA	1	NA	7	0
ABCF3	0	0	4	9	698.61	1397.22	15	2	1	NA	1	NA	13	0
ABCG2	0	0	1	3	744.48	1488.96	15	2	1	NA	1	NA	4	0
ABCG4	0	0	4	10	636.57	1273.14	15	2	1	NA	1	NA	14	0
ABHD11	0	0	3	0	264.66	529.32	15	2	1	NA	1	NA	3	0
ABHD12B	0	0	4	7	361.35	722.7	15	2	1	NA	1	NA	11	0
ABHD14A	0	0	2	5	213.84	427.68	15	2	1	NA	1	NA	7	0
ABHD17A	0	0	0	6	301.95	603.9	15	2	1	NA	1	NA	6	0
ABHD17C	0	0	0	2	301.95	603.9	15	2	1	NA	1	NA	2	0
ABHD18	0	0	2	0	376.2	752.4	15	2	1	NA	1	NA	2	0
ABHD2	0	0	0	2	421.74	843.48	15	2	1	NA	1	NA	2	0
ABHD6	0	0	0	9	334.62	669.24	15	2	1	NA	1	NA	9	0
ABHD8	0	0	2	7	430.65	861.3	15	2	1	NA	1	NA	9	0
ABI2	0	0	1	1	520.74	1041.48	15	2	1	NA	1	NA	2	0
ABL2	0	0	5	8	1123.65	2247.3	15	2	1	NA	1	NA	13	0
ABLIM1	0	0	1	5	638.55	1277.1	15	2	1	NA	1	NA	6	0
ABR	0	0	2	21	994.95	1989.9	15	2	1	NA	1	NA	23	0
ABTB1	0	0	0	7	473.22	946.44	15	2	1	NA	1	NA	7	0
ACAA2	0	0	1	13	383.13	766.26	15	2	1	NA	1	NA	14	0
ACACA	0	0	3	18	2276.01	4552.02	15	2	1	NA	1	NA	21	0
ACACB	0	0	9	43	2362.14	4724.28	15	2	1	NA	1	NA	52	0
ACAD8	0	0	1	5	402.93	805.86	15	2	1	NA	1	NA	6	0
ACAD9	0	0	0	5	542.19	1084.38	15	2	1	NA	1	NA	5	0
ACAN	0	0	23	24	2080.98	4161.96	15	2	1	NA	1	NA	47	0
ACAP2	0	0	3	1	808.83	1617.66	15	2	1	NA	1	NA	4	0
ACAP3	0	0	3	16	856.35	1712.7	15	2	1	NA	1	NA	19	0
ACBD4	0	0	5	8	366.96	733.92	15	2	1	NA	1	NA	13	0
ACCS	0	0	2	13	881.1	1762.2	15	2	1	NA	1	NA	15	0
ACD	0	0	13	8	622.71	1245.42	15	2	1	NA	1	NA	21	0
ACE	0	0	10	23	1266.21	2532.42	15	2	1	NA	1	NA	33	0
ACKR1	0	0	1	4	310.86	621.72	15	2	1	NA	1	NA	5	0
ACLY	0	0	1	17	1072.17	2144.34	15	2	1	NA	1	NA	18	0
ACMSD	0	0	1	3	333.63	667.26	15	2	1	NA	1	NA	4	0
ACO1	0	0	0	6	874.83	1749.66	15	2	1	NA	1	NA	6	0
ACOT11	0	0	6	10	552.42	1104.84	15	2	1	NA	1	NA	16	0
ACOT12	0	0	4	0	502.92	1005.84	15	2	1	NA	1	NA	4	0
ACOT4	0	0	7	11	704.22	1408.44	15	2	1	NA	1	NA	18	0
ACOT7	0	0	1	1	330	660	15	2	1	NA	1	NA	2	0
ACOT8	0	0	4	3	265.98	531.96	15	2	1	NA	1	NA	7	0
ACOX1	0	0	13	32	1759.89	3519.78	15	2	1	NA	1	NA	45	0
ACOX2	0	0	2	2	716.43	1432.86	15	2	1	NA	1	NA	4	0
ACOX3	0	0	1	4	699.93	1399.86	15	2	1	NA	1	NA	5	0
ACSBG1	0	0	2	3	690.03	1380.06	15	2	1	NA	1	NA	5	0
ACSF2	0	0	4	4	411.84	823.68	15	2	1	NA	1	NA	8	0
ACSF3	0	0	13	18	626.01	1252.02	15	2	1	NA	1	NA	31	0
ACSL3	0	0	2	8	728.64	1457.28	15	2	1	NA	1	NA	10	0
ACSL4	0	0	1	3	664.29	1328.58	15	2	1	NA	1	NA	4	0
ACSL5	0	0	0	4	677.16	1354.32	15	2	1	NA	1	NA	4	0
ACSL6	0	0	2	6	716.76	1433.52	15	2	1	NA	1	NA	8	0
ACT85CL	0	0	0	5	374.22	748.44	15	2	1	NA	1	NA	5	0
ACTB	0	0	0	3	372.24	744.48	15	2	1	NA	1	NA	3	0
ACTC2L	0	0	0	17	372.24	744.48	15	2	1	NA	1	NA	17	0
ACTG1	0	0	0	18	342.87	685.74	15	2	1	NA	1	NA	18	0
ACTL6A	0	0	0	3	397.98	795.96	15	2	1	NA	1	NA	3	0
ACTN1	0	0	1	1	879.12	1758.24	15	2	1	NA	1	NA	2	0
ACTR10-ACTR10L	0	0	2	4	405.9	811.8	15	2	1	NA	1	NA	6	0
ACTR1A	0	0	1	9	373.23	746.46	15	2	1	NA	1	NA	10	0
ACTR3	0	0	0	2	414.81	829.62	15	2	1	NA	1	NA	2	0
ACTR5	0	0	1	9	605.88	1211.76	15	2	1	NA	1	NA	10	0
ACTR8	0	0	2	2	562.32	1124.64	15	2	1	NA	1	NA	4	0
ACTRT2	0	0	2	4	373.23	746.46	15	2	1	NA	1	NA	6	0
ACVR1	0	0	2	0	521.07	1042.14	15	2	1	NA	1	NA	2	0
ACVR1B	0	0	0	6	449.46	898.92	15	2	1	NA	1	NA	6	0
ACVR1C	0	0	4	9	488.4	976.8	15	2	1	NA	1	NA	13	0
ACVR2A	0	0	1	5	499.95	999.9	15	2	1	NA	1	NA	6	0
ACVRL1	0	0	5	12	461.67	923.34	15	2	1	NA	1	NA	17	0
ACY1	0	0	3	11	408.87	817.74	15	2	1	NA	1	NA	14	0
ACYP1	0	0	3	3	99	198	15	2	1	NA	1	NA	6	0
ADA	0	0	6	8	356.4	712.8	15	2	1	NA	1	NA	14	0
ADAD1	0	0	7	4	576.18	1152.36	15	2	1	NA	1	NA	11	0
ADAL	0	0	0	3	325.71	651.42	15	2	1	NA	1	NA	3	0
ADAM10	0	0	1	3	740.19	1480.38	15	2	1	NA	1	NA	4	0
ADAM12	0	0	4	6	859.32	1718.64	15	2	1	NA	1	NA	10	0
ADAM19	0	0	7	4	892.98	1785.96	15	2	1	NA	1	NA	11	0
ADAM20	0	0	6	17	771.21	1542.42	15	2	1	NA	1	NA	23	0
ADAM28	0	0	4	6	768.24	1536.48	15	2	1	NA	1	NA	10	0
ADAM33	0	0	11	27	936.21	1872.42	15	2	1	NA	1	NA	38	0
ADAM5P	0	0	5	7	791.01	1582.02	15	2	1	NA	1	NA	12	0
ADAM8	0	0	3	1	740.52	1481.04	15	2	1	NA	1	NA	4	0
ADAM9	0	0	10	4	881.76	1763.52	15	2	1	NA	1	NA	14	0
ADAM9L-LOC100857794	0	0	1	1	251.46	502.92	15	2	1	NA	1	NA	2	0
ADAMTS12	0	0	6	2	1597.2	3194.4	15	2	1	NA	1	NA	8	0
ADAMTS13	0	0	11	5	1441.44	2882.88	15	2	1	NA	1	NA	16	0
ADAMTS15	0	0	4	27	921.03	1842.06	15	2	1	NA	1	NA	31	0
ADAMTS17	0	0	4	5	1112.76	2225.52	15	2	1	NA	1	NA	9	0
ADAMTS18	0	0	2	0	1226.94	2453.88	15	2	1	NA	1	NA	2	0
ADAMTS19	0	0	2	0	807.51	1615.02	15	2	1	NA	1	NA	2	0
ADAMTS6	0	0	4	0	1245.75	2491.5	15	2	1	NA	1	NA	4	0
ADAMTS7	0	0	17	38	1769.79	3539.58	15	2	1	NA	1	NA	55	0
ADAMTS8	0	0	2	22	702.57	1405.14	15	2	1	NA	1	NA	24	0
ADAMTS9	0	0	6	25	1915.65	3831.3	15	2	1	NA	1	NA	31	0
ADAMTSL2	0	0	5	17	865.26	1730.52	15	2	1	NA	1	NA	22	0
ADAMTSL2L	0	0	8	7	988.02	1976.04	15	2	1	NA	1	NA	15	0
ADAMTSL3	0	0	6	4	1702.8	3405.6	15	2	1	NA	1	NA	10	0
ADAMTSL5	0	0	8	14	514.8	1029.6	15	2	1	NA	1	NA	22	0
ADAP1	0	0	0	2	372.24	744.48	15	2	1	NA	1	NA	2	0
ADAP2	0	0	1	1	361.35	722.7	15	2	1	NA	1	NA	2	0
ADAR	0	0	10	13	1147.74	2295.48	15	2	1	NA	1	NA	23	0
ADARB1	0	0	4	4	644.82	1289.64	15	2	1	NA	1	NA	8	0
ADAT1	0	0	7	3	496.98	993.96	15	2	1	NA	1	NA	10	0
ADCY7	0	0	6	6	1038.18	2076.36	15	2	1	NA	1	NA	12	0
ADD3	0	0	4	1	703.89	1407.78	15	2	1	NA	1	NA	5	0
ADGRA1L	0	0	0	3	706.86	1413.72	15	2	1	NA	1	NA	3	0
ADGRA2	0	0	12	28	1025.31	2050.62	15	2	1	NA	1	NA	40	0
ADGRA3L	0	0	5	4	1244.1	2488.2	15	2	1	NA	1	NA	9	0
ADGRB2	0	0	5	27	1439.46	2878.92	15	2	1	NA	1	NA	32	0
ADGRD1	0	0	2	6	898.92	1797.84	15	2	1	NA	1	NA	8	0
ADGRD2	0	0	10	9	1087.02	2174.04	15	2	1	NA	1	NA	19	0
ADGRG1	0	0	3	2	664.29	1328.58	15	2	1	NA	1	NA	5	0
ADGRG3	0	0	1	2	549.45	1098.9	15	2	1	NA	1	NA	3	0
ADGRG4	0	0	7	5	1086.03	2172.06	15	2	1	NA	1	NA	12	0
ADGRG5	0	0	3	0	475.86	951.72	15	2	1	NA	1	NA	3	0
ADGRL2	0	0	4	4	1482.03	2964.06	15	2	1	NA	1	NA	8	0
ADGRL3	0	0	2	4	1063.26	2126.52	15	2	1	NA	1	NA	6	0
ADGRV1	0	0	40	29	5664.45	11328.9	15	2	1	NA	1	NA	69	0
ADH1C	0	0	1	3	373.23	746.46	15	2	1	NA	1	NA	4	0
ADH5	0	0	3	5	371.25	742.5	15	2	1	NA	1	NA	8	0
ADIPOQ	0	0	1	12	243.54	487.08	15	2	1	NA	1	NA	13	0
ADIPOR1	0	0	1	5	333.63	667.26	15	2	1	NA	1	NA	6	0
ADM	0	0	1	2	168.3	336.6	15	2	1	NA	1	NA	3	0
ADMP	0	0	4	10	622.38	1244.76	15	2	1	NA	1	NA	14	0
ADNP	0	0	8	4	1285.02	2570.04	15	2	1	NA	1	NA	12	0
ADORA1	0	0	1	9	321.75	643.5	15	2	1	NA	1	NA	10	0
ADORA2B	0	0	1	7	337.59	675.18	15	2	1	NA	1	NA	8	0
ADPGK	0	0	1	3	484.44	968.88	15	2	1	NA	1	NA	4	0
ADPRHL2	0	0	1	8	375.21	750.42	15	2	1	NA	1	NA	9	0
ADRA1A	0	0	0	4	472.23	944.46	15	2	1	NA	1	NA	4	0
ADRA1D	0	0	2	4	340.56	681.12	15	2	1	NA	1	NA	6	0
ADRA2A	0	0	3	6	440.55	881.1	15	2	1	NA	1	NA	9	0
ADRA2BL2	0	0	8	10	342.54	685.08	15	2	1	NA	1	NA	18	0
ADRB2	0	0	1	6	394.02	788.04	15	2	1	NA	1	NA	7	0
ADRB3	0	0	5	13	399.3	798.6	15	2	1	NA	1	NA	18	0
ADRM1	0	0	0	3	401.94	803.88	15	2	1	NA	1	NA	3	0
AEN	0	0	6	4	305.91	611.82	15	2	1	NA	1	NA	10	0
AFAP1	0	0	4	1	807.84	1615.68	15	2	1	NA	1	NA	5	0
AFAP1L1	0	0	1	3	762.3	1524.6	15	2	1	NA	1	NA	4	0
AFAP1L2	0	0	10	11	813.78	1627.56	15	2	1	NA	1	NA	21	0
AFF1	0	0	10	10	1172.16	2344.32	15	2	1	NA	1	NA	20	0
AFF4	0	0	6	9	1156.32	2312.64	15	2	1	NA	1	NA	15	0
AFMID	0	0	0	6	257.73	515.46	15	2	1	NA	1	NA	6	0
AFP	0	0	3	2	609.84	1219.68	15	2	1	NA	1	NA	5	0
AGA	0	0	4	0	353.43	706.86	15	2	1	NA	1	NA	4	0
AGBL1	0	0	8	1	860.31	1720.62	15	2	1	NA	1	NA	9	0
AGBL2	0	0	20	10	573.21	1146.42	15	2	1	NA	1	NA	30	0
AGBL4	0	0	0	2	549.45	1098.9	15	2	1	NA	1	NA	2	0
AGFG1	0	0	1	4	506.88	1013.76	15	2	1	NA	1	NA	5	0
AGGF1	0	0	6	3	720.72	1441.44	15	2	1	NA	1	NA	9	0
AGL	0	0	5	12	1515.69	3031.38	15	2	1	NA	1	NA	17	0
AGMAT	0	0	5	5	292.05	584.1	15	2	1	NA	1	NA	10	0
AGO1	0	0	0	11	841.17	1682.34	15	2	1	NA	1	NA	11	0
AGO3	0	0	0	3	850.41	1700.82	15	2	1	NA	1	NA	3	0
AGPAT2	0	0	3	6	270.27	540.54	15	2	1	NA	1	NA	9	0
AGPAT9L	0	0	1	1	409.2	818.4	15	2	1	NA	1	NA	2	0
AGPS	0	0	2	2	620.07	1240.14	15	2	1	NA	1	NA	4	0
AGRN	0	0	13	47	1866.48	3732.96	15	2	1	NA	1	NA	60	0
AGTR2	0	0	0	5	369.27	738.54	15	2	1	NA	1	NA	5	0
AGXT	0	0	7	6	414.81	829.62	15	2	1	NA	1	NA	13	0
AGXT2	0	0	2	3	493.35	986.7	15	2	1	NA	1	NA	5	0
AHCYL1	0	0	0	6	486.09	972.18	15	2	1	NA	1	NA	6	0
AHDC1-LOC107055013-LOC112530227	0	0	8	14	1039.5	2079	15	2	1	NA	1	NA	22	0
AHNAK2	0	0	12	4	2241.03	4482.06	15	2	1	NA	1	NA	16	0
AHR1B	0	0	20	14	960.96	1921.92	15	2	1	NA	1	NA	34	0
AHR2	0	0	16	17	886.05	1772.1	15	2	1	NA	1	NA	33	0
AHSA1	0	0	0	4	337.59	675.18	15	2	1	NA	1	NA	4	0
AHSG	0	0	3	4	342.54	685.08	15	2	1	NA	1	NA	7	0
AIFM1	0	0	5	4	561	1122	15	2	1	NA	1	NA	9	0
AIFM2	0	0	2	7	371.25	742.5	15	2	1	NA	1	NA	9	0
AIFM3	0	0	1	8	593.01	1186.02	15	2	1	NA	1	NA	9	0
AIM1L	0	0	22	35	1302.84	2605.68	15	2	1	NA	1	NA	57	0
AIMP1	0	0	2	2	306.9	613.8	15	2	1	NA	1	NA	4	0
AIMP2	0	0	0	2	312.84	625.68	15	2	1	NA	1	NA	2	0
AIPL1	0	0	7	7	602.58	1205.16	15	2	1	NA	1	NA	14	0
AJAP1	0	0	3	4	310.53	621.06	15	2	1	NA	1	NA	7	0
AK1	0	0	2	4	193.05	386.1	15	2	1	NA	1	NA	6	0
AK3	0	0	0	4	304.92	609.84	15	2	1	NA	1	NA	4	0
AK4	0	0	0	4	220.44	440.88	15	2	1	NA	1	NA	4	0
AK5	0	0	1	1	568.26	1136.52	15	2	1	NA	1	NA	2	0
AK7	0	0	2	2	719.73	1439.46	15	2	1	NA	1	NA	4	0
AK8	0	0	0	3	476.19	952.38	15	2	1	NA	1	NA	3	0
AKAP1	0	0	6	8	870.21	1740.42	15	2	1	NA	1	NA	14	0
AKAP10	0	0	3	14	1123.98	2247.96	15	2	1	NA	1	NA	17	0
AKAP13	0	0	6	7	1456.29	2912.58	15	2	1	NA	1	NA	13	0
AKAP14	0	0	2	1	167.31	334.62	15	2	1	NA	1	NA	3	0
AKAP2	0	0	4	1	895.29	1790.58	15	2	1	NA	1	NA	5	0
AKAP5	0	0	4	4	508.53	1017.06	15	2	1	NA	1	NA	8	0
AKAP6	0	0	11	5	2417.25	4834.5	15	2	1	NA	1	NA	16	0
AKIP1	0	0	1	1	107.25	214.5	15	2	1	NA	1	NA	2	0
AKNA	0	0	24	18	693	1386	15	2	1	NA	1	NA	42	0
AKNAD1	0	0	23	8	717.42	1434.84	15	2	1	NA	1	NA	31	0
AKR1A1	0	0	1	1	324.72	649.44	15	2	1	NA	1	NA	2	0
AKR7A2	0	0	2	9	317.79	635.58	15	2	1	NA	1	NA	11	0
AKT1	0	0	0	4	491.04	982.08	15	2	1	NA	1	NA	4	0
AKTIP	0	0	2	0	291.06	582.12	15	2	1	NA	1	NA	2	0
ALAD	0	0	3	4	307.23	614.46	15	2	1	NA	1	NA	7	0
ALAS1	0	0	2	6	617.43	1234.86	15	2	1	NA	1	NA	8	0
ALB	0	0	2	6	609.84	1219.68	15	2	1	NA	1	NA	8	0
ALDH18A1	0	0	1	2	910.14	1820.28	15	2	1	NA	1	NA	3	0
ALDH1A1	0	0	3	0	450.12	900.24	15	2	1	NA	1	NA	3	0
ALDH1A3	0	0	0	4	507.87	1015.74	15	2	1	NA	1	NA	4	0
ALDH3A2	0	0	15	30	1193.94	2387.88	15	2	1	NA	1	NA	45	0
ALDH4A1	0	0	7	15	545.49	1090.98	15	2	1	NA	1	NA	22	0
ALDH6A1	0	0	2	1	494.01	988.02	15	2	1	NA	1	NA	3	0
ALDH7A1	0	0	6	2	476.19	952.38	15	2	1	NA	1	NA	8	0
ALDH9A1	0	0	5	10	513.81	1027.62	15	2	1	NA	1	NA	15	0
ALDOB	0	0	0	2	361.35	722.7	15	2	1	NA	1	NA	2	0
ALDOC	0	0	1	12	361.35	722.7	15	2	1	NA	1	NA	13	0
ALG1	0	0	6	4	389.07	778.14	15	2	1	NA	1	NA	10	0
ALG13	0	0	3	1	899.91	1799.82	15	2	1	NA	1	NA	4	0
ALG14	0	0	1	1	214.83	429.66	15	2	1	NA	1	NA	2	0
ALG3	0	0	3	7	356.73	713.46	15	2	1	NA	1	NA	10	0
ALG6	0	0	5	1	441.54	883.08	15	2	1	NA	1	NA	6	0
ALG9	0	0	7	11	790.02	1580.04	15	2	1	NA	1	NA	18	0
ALKBH1	0	0	3	4	322.74	645.48	15	2	1	NA	1	NA	7	0
ALKBH2	0	0	2	0	239.58	479.16	15	2	1	NA	1	NA	2	0
ALKBH3-HSD17B12	0	0	2	6	447.15	894.3	15	2	1	NA	1	NA	8	0
ALKBH5	0	0	1	10	376.2	752.4	15	2	1	NA	1	NA	11	0
ALMS1	0	0	75	35	3076.92	6153.84	15	2	1	NA	1	NA	110	0
ALOX5	0	0	1	5	668.25	1336.5	15	2	1	NA	1	NA	6	0
ALPI	0	0	11	13	540.54	1081.08	15	2	1	NA	1	NA	24	0
ALPK1	0	0	19	9	1134.54	2269.08	15	2	1	NA	1	NA	28	0
ALPK2	0	0	11	7	1804.77	3609.54	15	2	1	NA	1	NA	18	0
ALPK3	0	0	9	8	1549.35	3098.7	15	2	1	NA	1	NA	17	0
ALPL	0	0	2	10	515.13	1030.26	15	2	1	NA	1	NA	12	0
ALPP	0	0	2	12	514.8	1029.6	15	2	1	NA	1	NA	14	0
ALS2	0	0	7	5	1612.71	3225.42	15	2	1	NA	1	NA	12	0
ALX3	0	0	3	5	301.29	602.58	15	2	1	NA	1	NA	8	0
ALX4	0	0	3	7	382.14	764.28	15	2	1	NA	1	NA	10	0
AMBRA1	0	0	1	14	1288.98	2577.96	15	2	1	NA	1	NA	15	0
AMDHD2	0	0	1	2	407.88	815.76	15	2	1	NA	1	NA	3	0
AMER1	0	0	21	23	1125.63	2251.26	15	2	1	NA	1	NA	44	0
AMER3	0	0	6	8	982.08	1964.16	15	2	1	NA	1	NA	14	0
AMFR	0	0	4	5	593.67	1187.34	15	2	1	NA	1	NA	9	0
AMH	0	0	3	1	506.88	1013.76	15	2	1	NA	1	NA	4	0
AMHR2	0	0	2	8	588.06	1176.12	15	2	1	NA	1	NA	10	0
AMMECR1	0	0	1	2	258.72	517.44	15	2	1	NA	1	NA	3	0
AMN	0	0	8	4	416.79	833.58	15	2	1	NA	1	NA	12	0
AMOTL2	0	0	7	14	701.91	1403.82	15	2	1	NA	1	NA	21	0
AMPD1	0	0	2	3	736.56	1473.12	15	2	1	NA	1	NA	5	0
AMPD2	0	0	0	6	789.69	1579.38	15	2	1	NA	1	NA	6	0
AMPD3	0	0	0	3	767.25	1534.5	15	2	1	NA	1	NA	3	0
AMY1A	0	0	1	1	198.99	397.98	15	2	1	NA	1	NA	2	0
AMZ1	0	0	0	10	498.96	997.92	15	2	1	NA	1	NA	10	0
AN1ZNF5L	0	0	3	4	205.92	411.84	15	2	1	NA	1	NA	7	0
ANAPC11	0	0	3	3	104.28	208.56	15	2	1	NA	1	NA	6	0
ANAPC2	0	0	3	5	803.88	1607.76	15	2	1	NA	1	NA	8	0
ANAPC4	0	0	5	4	755.37	1510.74	15	2	1	NA	1	NA	9	0
ANAPC5	0	0	2	10	749.43	1498.86	15	2	1	NA	1	NA	12	0
ANAPC7	0	0	0	2	560.34	1120.68	15	2	1	NA	1	NA	2	0
ANGEL1	0	0	2	8	670.23	1340.46	15	2	1	NA	1	NA	10	0
ANGPT4	0	0	5	17	489.06	978.12	15	2	1	NA	1	NA	22	0
ANGPTL1	0	0	2	0	488.07	976.14	15	2	1	NA	1	NA	2	0
ANGPTL2	0	0	1	1	572.55	1145.1	15	2	1	NA	1	NA	2	0
ANGPTL3	0	0	2	2	459.36	918.72	15	2	1	NA	1	NA	4	0
ANGPTL4	0	0	5	8	478.17	956.34	15	2	1	NA	1	NA	13	0
ANGPTL7	0	0	1	1	345.51	691.02	15	2	1	NA	1	NA	2	0
ANK1	0	0	4	6	2034.45	4068.9	15	2	1	NA	1	NA	10	0
ANK2	0	0	24	37	3866.94	7733.88	15	2	1	NA	1	NA	61	0
ANK3	0	0	12	21	4591.29	9182.58	15	2	1	NA	1	NA	33	0
ANKDD1A	0	0	3	4	501.27	1002.54	15	2	1	NA	1	NA	7	0
ANKDD1B	0	0	3	5	530.97	1061.94	15	2	1	NA	1	NA	8	0
ANKFN1	0	0	4	2	1068.21	2136.42	15	2	1	NA	1	NA	6	0
ANKFN1L	0	0	8	20	1216.05	2432.1	15	2	1	NA	1	NA	28	0
ANKFY1	0	0	0	8	1156.32	2312.64	15	2	1	NA	1	NA	8	0
ANKHD1	0	0	1	7	2022.57	4045.14	15	2	1	NA	1	NA	8	0
ANKK1	0	0	9	7	776.82	1553.64	15	2	1	NA	1	NA	16	0
ANKLE1	0	0	11	16	316.47	632.94	15	2	1	NA	1	NA	27	0
ANKLE2	0	0	5	6	914.76	1829.52	15	2	1	NA	1	NA	11	0
ANKRD11	0	0	10	31	2687.85	5375.7	15	2	1	NA	1	NA	41	0
ANKRD13A	0	0	4	5	581.13	1162.26	15	2	1	NA	1	NA	9	0
ANKRD13C	0	0	0	2	381.15	762.3	15	2	1	NA	1	NA	2	0
ANKRD17	0	0	4	13	2424.51	4849.02	15	2	1	NA	1	NA	17	0
ANKRD2	0	0	8	8	315.81	631.62	15	2	1	NA	1	NA	16	0
ANKRD22	0	0	2	2	190.08	380.16	15	2	1	NA	1	NA	4	0
ANKRD24	0	0	11	14	648.12	1296.24	15	2	1	NA	1	NA	25	0
ANKRD27	0	0	2	0	1080.75	2161.5	15	2	1	NA	1	NA	2	0
ANKRD31	0	0	13	6	1363.23	2726.46	15	2	1	NA	1	NA	19	0
ANKRD33	0	0	9	9	437.58	875.16	15	2	1	NA	1	NA	18	0
ANKRD34C	0	0	6	4	521.07	1042.14	15	2	1	NA	1	NA	10	0
ANKRD40	0	0	2	4	350.13	700.26	15	2	1	NA	1	NA	6	0
ANKRD40L	0	0	6	3	320.76	641.52	15	2	1	NA	1	NA	9	0
ANKRD50	0	0	2	11	1403.82	2807.64	15	2	1	NA	1	NA	13	0
ANKRD52	0	0	2	8	1089	2178	15	2	1	NA	1	NA	10	0
ANKRD55	0	0	2	2	657.36	1314.72	15	2	1	NA	1	NA	4	0
ANKRD9	0	0	5	3	290.07	580.14	15	2	1	NA	1	NA	8	0
ANKS1A	0	0	6	14	1099.89	2199.78	15	2	1	NA	1	NA	20	0
ANKS4B	0	0	2	0	400.95	801.9	15	2	1	NA	1	NA	2	0
ANKZF1	0	0	10	5	695.97	1391.94	15	2	1	NA	1	NA	15	0
ANO1	0	0	1	6	986.04	1972.08	15	2	1	NA	1	NA	7	0
ANO8	0	0	5	16	847.44	1694.88	15	2	1	NA	1	NA	21	0
ANO9	0	0	4	7	757.35	1514.7	15	2	1	NA	1	NA	11	0
ANP32A	0	0	0	3	251.13	502.26	15	2	1	NA	1	NA	3	0
ANP32E	0	0	0	2	239.58	479.16	15	2	1	NA	1	NA	2	0
ANPEP	0	0	5	15	935.22	1870.44	15	2	1	NA	1	NA	20	0
ANTXR2	0	0	0	3	422.07	844.14	15	2	1	NA	1	NA	3	0
ANXA10	0	0	1	2	311.85	623.7	15	2	1	NA	1	NA	3	0
ANXA11	0	0	3	0	552.75	1105.5	15	2	1	NA	1	NA	3	0
ANXA6	0	0	8	20	665.28	1330.56	15	2	1	NA	1	NA	28	0
ANXA7	0	0	0	5	448.47	896.94	15	2	1	NA	1	NA	5	0
ANXA8	0	0	2	5	323.73	647.46	15	2	1	NA	1	NA	7	0
AOC3	0	0	25	47	1357.62	2715.24	15	2	1	NA	1	NA	72	0
AOX2	0	0	16	14	1535.82	3071.64	15	2	1	NA	1	NA	30	0
AP1AR	0	0	1	2	297.99	595.98	15	2	1	NA	1	NA	3	0
AP1B1	0	0	4	32	916.41	1832.82	15	2	1	NA	1	NA	36	0
AP1M1	0	0	0	6	412.83	825.66	15	2	1	NA	1	NA	6	0
AP2A2	0	0	0	2	875.16	1750.32	15	2	1	NA	1	NA	2	0
AP2B1	0	0	0	12	927.3	1854.6	15	2	1	NA	1	NA	12	0
AP2M1	0	0	0	4	429.66	859.32	15	2	1	NA	1	NA	4	0
AP3D1	0	0	2	2	1246.41	2492.82	15	2	1	NA	1	NA	4	0
AP3M1	0	0	1	3	414.81	829.62	15	2	1	NA	1	NA	4	0
AP3S1	0	0	1	2	192.06	384.12	15	2	1	NA	1	NA	3	0
AP3S2	0	0	0	4	184.47	368.94	15	2	1	NA	1	NA	4	0
AP4E1	0	0	14	11	1064.58	2129.16	15	2	1	NA	1	NA	25	0
AP5M1	0	0	7	5	483.12	966.24	15	2	1	NA	1	NA	12	0
AP5Z1	0	0	6	7	801.9	1603.8	15	2	1	NA	1	NA	13	0
APBA1	0	0	5	1	751.74	1503.48	15	2	1	NA	1	NA	6	0
APBA2	0	0	0	5	736.56	1473.12	15	2	1	NA	1	NA	5	0
APBA3	0	0	11	14	685.08	1370.16	15	2	1	NA	1	NA	25	0
APBB2	0	0	5	8	828.63	1657.26	15	2	1	NA	1	NA	13	0
APBB3	0	0	0	10	456.39	912.78	15	2	1	NA	1	NA	10	0
APC	0	0	2	6	2739	5478	15	2	1	NA	1	NA	8	0
APC2	0	0	33	53	2366.1	4732.2	15	2	1	NA	1	NA	86	0
APCDD1L	0	0	1	2	251.79	503.58	15	2	1	NA	1	NA	3	0
APEH	0	0	2	4	146.19	292.38	15	2	1	NA	1	NA	6	0
APH1AL	0	0	0	2	205.92	411.84	15	2	1	NA	1	NA	2	0
API5	0	0	0	2	495.99	991.98	15	2	1	NA	1	NA	2	0
APOA1	0	0	0	2	251.79	503.58	15	2	1	NA	1	NA	2	0
APOA1BP	0	0	11	15	650.76	1301.52	15	2	1	NA	1	NA	26	0
APOA4	0	0	3	6	364.32	728.64	15	2	1	NA	1	NA	9	0
APOBEC2	0	0	8	1	264.33	528.66	15	2	1	NA	1	NA	9	0
APOC3	0	0	1	2	93.06	186.12	15	2	1	NA	1	NA	3	0
APOD	0	0	4	2	188.1	376.2	15	2	1	NA	1	NA	6	0
APOH	0	0	3	4	347.49	694.98	15	2	1	NA	1	NA	7	0
APOOL	0	0	4	1	271.26	542.52	15	2	1	NA	1	NA	5	0
APPBP2	0	0	0	4	581.13	1162.26	15	2	1	NA	1	NA	4	0
APRT	0	0	0	4	178.2	356.4	15	2	1	NA	1	NA	4	0
AQP10	0	0	6	8	297.99	595.98	15	2	1	NA	1	NA	14	0
AQP12A	0	0	7	3	297.99	595.98	15	2	1	NA	1	NA	10	0
AQP2	0	0	2	0	273.24	546.48	15	2	1	NA	1	NA	2	0
AQP5	0	0	0	4	263.34	526.68	15	2	1	NA	1	NA	4	0
AQP7	0	0	2	0	281.16	562.32	15	2	1	NA	1	NA	2	0
AQP8	0	0	4	9	256.41	512.82	15	2	1	NA	1	NA	13	0
AQR	0	0	5	3	2170.08	4340.16	15	2	1	NA	1	NA	8	0
ARAP2	0	0	9	6	1648.35	3296.7	15	2	1	NA	1	NA	15	0
AREL1	0	0	2	1	815.76	1631.52	15	2	1	NA	1	NA	3	0
ARF6	0	0	2	4	174.24	348.48	15	2	1	NA	1	NA	6	0
ARFGAP1	0	0	2	2	418.77	837.54	15	2	1	NA	1	NA	4	0
ARFGAP2	0	0	1	4	519.75	1039.5	15	2	1	NA	1	NA	5	0
ARFGEF2	0	0	0	6	1770.78	3541.56	15	2	1	NA	1	NA	6	0
ARFIP1	0	0	0	2	399.96	799.92	15	2	1	NA	1	NA	2	0
ARFRP1	0	0	3	6	269.94	539.88	15	2	1	NA	1	NA	9	0
ARHGAP1	0	0	1	4	433.62	867.24	15	2	1	NA	1	NA	5	0
ARHGAP10	0	0	3	2	807.84	1615.68	15	2	1	NA	1	NA	5	0
ARHGAP11A	0	0	1	2	993.96	1987.92	15	2	1	NA	1	NA	3	0
ARHGAP17	0	0	5	3	847.44	1694.88	15	2	1	NA	1	NA	8	0
ARHGAP19	0	0	1	6	476.52	953.04	15	2	1	NA	1	NA	7	0
ARHGAP22	0	0	5	4	589.05	1178.1	15	2	1	NA	1	NA	9	0
ARHGAP23	0	0	23	25	1394.58	2789.16	15	2	1	NA	1	NA	48	0
ARHGAP24	0	0	0	4	648.45	1296.9	15	2	1	NA	1	NA	4	0
ARHGAP25	0	0	2	2	1057.32	2114.64	15	2	1	NA	1	NA	4	0
ARHGAP26	0	0	2	10	665.94	1331.88	15	2	1	NA	1	NA	12	0
ARHGAP27	0	0	1	4	764.28	1528.56	15	2	1	NA	1	NA	5	0
ARHGAP29	0	0	11	17	1440.78	2881.56	15	2	1	NA	1	NA	28	0
ARHGAP32	0	0	10	13	1951.29	3902.58	15	2	1	NA	1	NA	23	0
ARHGAP36	0	0	0	4	472.89	945.78	15	2	1	NA	1	NA	4	0
ARHGAP39	0	0	5	9	996.6	1993.2	15	2	1	NA	1	NA	14	0
ARHGAP40	0	0	2	8	666.27	1332.54	15	2	1	NA	1	NA	10	0
ARHGAP44	0	0	4	8	691.35	1382.7	15	2	1	NA	1	NA	12	0
ARHGAP45	0	0	2	8	476.85	953.7	15	2	1	NA	1	NA	10	0
ARHGAP5	0	0	0	9	1490.94	2981.88	15	2	1	NA	1	NA	9	0
ARHGEF1	0	0	6	15	1154.34	2308.68	15	2	1	NA	1	NA	21	0
ARHGEF10L	0	0	12	30	1269.84	2539.68	15	2	1	NA	1	NA	42	0
ARHGEF11	0	0	8	16	914.43	1828.86	15	2	1	NA	1	NA	24	0
ARHGEF12	0	0	10	7	1547.37	3094.74	15	2	1	NA	1	NA	17	0
ARHGEF16	0	0	8	9	696.96	1393.92	15	2	1	NA	1	NA	17	0
ARHGEF18	0	0	11	24	1558.26	3116.52	15	2	1	NA	1	NA	35	0
ARHGEF26	0	0	10	10	995.28	1990.56	15	2	1	NA	1	NA	20	0
ARHGEF28	0	0	8	9	1722.6	3445.2	15	2	1	NA	1	NA	17	0
ARHGEF3	0	0	3	1	506.88	1013.76	15	2	1	NA	1	NA	4	0
ARHGEF37	0	0	2	0	680.13	1360.26	15	2	1	NA	1	NA	2	0
ARHGEF38	0	0	0	4	792.99	1585.98	15	2	1	NA	1	NA	4	0
ARHGEF39	0	0	2	0	314.49	628.98	15	2	1	NA	1	NA	2	0
ARHGEF4	0	0	9	12	1620.63	3241.26	15	2	1	NA	1	NA	21	0
ARHGEF6	0	0	1	4	745.47	1490.94	15	2	1	NA	1	NA	5	0
ARHGEF9	0	0	0	2	522.72	1045.44	15	2	1	NA	1	NA	2	0
ARID1A	0	0	8	12	2003.43	4006.86	15	2	1	NA	1	NA	20	0
ARID3A	0	0	3	9	581.79	1163.58	15	2	1	NA	1	NA	12	0
ARID3B	0	0	3	8	539.88	1079.76	15	2	1	NA	1	NA	11	0
ARID3C	0	0	2	0	345.51	691.02	15	2	1	NA	1	NA	2	0
ARID4A	0	0	1	3	1285.02	2570.04	15	2	1	NA	1	NA	4	0
ARID5A	0	0	13	15	634.92	1269.84	15	2	1	NA	1	NA	28	0
ARID5B	0	0	12	11	1443.75	2887.5	15	2	1	NA	1	NA	23	0
ARIH1	0	0	0	5	428.67	857.34	15	2	1	NA	1	NA	5	0
ARL10	0	0	0	6	231.66	463.32	15	2	1	NA	1	NA	6	0
ARL13A	0	0	2	1	287.1	574.2	15	2	1	NA	1	NA	3	0
ARL14	0	0	2	1	193.05	386.1	15	2	1	NA	1	NA	3	0
ARL14EP	0	0	0	5	284.13	568.26	15	2	1	NA	1	NA	5	0
ARL15	0	0	6	1	196.68	393.36	15	2	1	NA	1	NA	7	0
ARL16	0	0	3	3	110.88	221.76	15	2	1	NA	1	NA	6	0
ARL2	0	0	1	2	200.97	401.94	15	2	1	NA	1	NA	3	0
ARL4C	0	0	0	3	191.07	382.14	15	2	1	NA	1	NA	3	0
ARL5A	0	0	1	1	168.96	337.92	15	2	1	NA	1	NA	2	0
ARL6IP1	0	0	1	1	294.03	588.06	15	2	1	NA	1	NA	2	0
ARL6IP4	0	0	2	3	236.94	473.88	15	2	1	NA	1	NA	5	0
ARMC6	0	0	4	6	463.32	926.64	15	2	1	NA	1	NA	10	0
ARMC7	0	0	2	2	181.17	362.34	15	2	1	NA	1	NA	4	0
ARMC8	0	0	0	3	652.41	1304.82	15	2	1	NA	1	NA	3	0
ARMC9	0	0	10	8	858.33	1716.66	15	2	1	NA	1	NA	18	0
ARNT	0	0	6	0	778.14	1556.28	15	2	1	NA	1	NA	6	0
ARNT2	0	0	1	1	724.68	1449.36	15	2	1	NA	1	NA	2	0
ARNTL	0	0	2	4	668.91	1337.82	15	2	1	NA	1	NA	6	0
ARPC1A	0	0	0	2	367.29	734.58	15	2	1	NA	1	NA	2	0
ARPC1B	0	0	0	5	357.39	714.78	15	2	1	NA	1	NA	5	0
ARPC2	0	0	0	2	297.99	595.98	15	2	1	NA	1	NA	2	0
ARPC5	0	0	1	1	119.13	238.26	15	2	1	NA	1	NA	2	0
ARPC5L	0	0	1	3	149.49	298.98	15	2	1	NA	1	NA	4	0
ARRDC1	0	0	0	3	397.32	794.64	15	2	1	NA	1	NA	3	0
ARRDC2	0	0	2	5	392.04	784.08	15	2	1	NA	1	NA	7	0
ARRDC3	0	0	1	1	354.42	708.84	15	2	1	NA	1	NA	2	0
ARSB	0	0	3	4	553.74	1107.48	15	2	1	NA	1	NA	7	0
ARSG	0	0	9	21	520.08	1040.16	15	2	1	NA	1	NA	30	0
ARSI	0	0	3	16	541.86	1083.72	15	2	1	NA	1	NA	19	0
ARSJ	0	0	3	8	587.07	1174.14	15	2	1	NA	1	NA	11	0
ARTN	0	0	2	4	212.52	425.04	15	2	1	NA	1	NA	6	0
ARVCF	0	0	3	11	936.54	1873.08	15	2	1	NA	1	NA	14	0
AS3MT	0	0	2	8	543.51	1087.02	15	2	1	NA	1	NA	10	0
ASAH1	0	0	2	3	392.04	784.08	15	2	1	NA	1	NA	5	0
ASAH2	0	0	2	1	732.6	1465.2	15	2	1	NA	1	NA	3	0
ASAP3	0	0	3	10	604.56	1209.12	15	2	1	NA	1	NA	13	0
ASB1	0	0	5	6	348.48	696.96	15	2	1	NA	1	NA	11	0
ASB12	0	0	4	7	315.81	631.62	15	2	1	NA	1	NA	11	0
ASB14	0	0	1	1	275.55	551.1	15	2	1	NA	1	NA	2	0
ASB2	0	0	0	3	606.87	1213.74	15	2	1	NA	1	NA	3	0
ASB6	0	0	5	6	419.76	839.52	15	2	1	NA	1	NA	11	0
ASCC2	0	0	7	2	685.41	1370.82	15	2	1	NA	1	NA	9	0
ASH1L	0	0	7	12	2960.1	5920.2	15	2	1	NA	1	NA	19	0
ASH2L	0	0	2	5	560.67	1121.34	15	2	1	NA	1	NA	7	0
ASIC1	0	0	1	13	668.25	1336.5	15	2	1	NA	1	NA	14	0
ASIC4	0	0	5	11	505.89	1011.78	15	2	1	NA	1	NA	16	0
ASL2	0	0	4	2	899.91	1799.82	15	2	1	NA	1	NA	6	0
ASNSD1	0	0	8	1	667.59	1335.18	15	2	1	NA	1	NA	9	0
ASPG	0	0	5	6	597.63	1195.26	15	2	1	NA	1	NA	11	0
ASPHD2	0	0	0	4	340.56	681.12	15	2	1	NA	1	NA	4	0
ASPM	0	0	30	30	3342.57	6685.14	15	2	1	NA	1	NA	60	0
ASPN	0	0	0	2	368.28	736.56	15	2	1	NA	1	NA	2	0
ASS1	0	0	2	13	406.23	812.46	15	2	1	NA	1	NA	15	0
ASTL	0	0	4	1	405.9	811.8	15	2	1	NA	1	NA	5	0
ASTN1	0	0	2	18	1259.61	2519.22	15	2	1	NA	1	NA	20	0
ASTN2	0	0	1	3	599.28	1198.56	15	2	1	NA	1	NA	4	0
ASXL1	0	0	6	20	2237.73	4475.46	15	2	1	NA	1	NA	26	0
ATAD3A	0	0	2	17	594.99	1189.98	15	2	1	NA	1	NA	19	0
ATAD5	0	0	8	7	1772.43	3544.86	15	2	1	NA	1	NA	15	0
ATE1	0	0	3	4	554.4	1108.8	15	2	1	NA	1	NA	7	0
ATF6	0	0	2	5	567.6	1135.2	15	2	1	NA	1	NA	7	0
ATF7	0	0	6	10	509.52	1019.04	15	2	1	NA	1	NA	16	0
ATG14	0	0	1	6	463.32	926.64	15	2	1	NA	1	NA	7	0
ATG2B	0	0	2	6	2057.22	4114.44	15	2	1	NA	1	NA	8	0
ATG4A	0	0	2	2	128.7	257.4	15	2	1	NA	1	NA	4	0
ATG4B	0	0	0	3	390.06	780.12	15	2	1	NA	1	NA	3	0
ATG4C	0	0	1	2	455.4	910.8	15	2	1	NA	1	NA	3	0
ATG7	0	0	6	6	715.77	1431.54	15	2	1	NA	1	NA	12	0
ATG9A	0	0	1	16	838.2	1676.4	15	2	1	NA	1	NA	17	0
ATIC	0	0	2	3	617.1	1234.2	15	2	1	NA	1	NA	5	0
ATL1	0	0	2	11	553.41	1106.82	15	2	1	NA	1	NA	13	0
ATMIN	0	0	0	3	781.11	1562.22	15	2	1	NA	1	NA	3	0
ATOH7	0	0	1	1	150.48	300.96	15	2	1	NA	1	NA	2	0
ATP10B	0	0	7	10	1549.35	3098.7	15	2	1	NA	1	NA	17	0
ATP10D	0	0	2	3	1445.4	2890.8	15	2	1	NA	1	NA	5	0
ATP11C	0	0	2	4	1009.8	2019.6	15	2	1	NA	1	NA	6	0
ATP12A	0	0	5	11	1024.65	2049.3	15	2	1	NA	1	NA	16	0
ATP13A2	0	0	15	19	1462.23	2924.46	15	2	1	NA	1	NA	34	0
ATP13A3	0	0	4	6	1291.95	2583.9	15	2	1	NA	1	NA	10	0
ATP13A4	0	0	5	8	1192.95	2385.9	15	2	1	NA	1	NA	13	0
ATP13A5	0	0	16	8	1177.77	2355.54	15	2	1	NA	1	NA	24	0
ATP2A2	0	0	0	14	998.91	1997.82	15	2	1	NA	1	NA	14	0
ATP2A3	0	0	10	37	920.04	1840.08	15	2	1	NA	1	NA	47	0
ATP2B4	0	0	4	23	1196.91	2393.82	15	2	1	NA	1	NA	27	0
ATP2C2	0	0	9	9	934.56	1869.12	15	2	1	NA	1	NA	18	0
ATP5A1Z	0	0	0	4	548.46	1096.92	15	2	1	NA	1	NA	4	0
ATP5D	0	0	1	2	152.79	305.58	15	2	1	NA	1	NA	3	0
ATP5F1	0	0	3	1	250.47	500.94	15	2	1	NA	1	NA	4	0
ATP5F1B	0	0	0	7	545.16	1090.32	15	2	1	NA	1	NA	7	0
ATP5H	0	0	2	5	160.38	320.76	15	2	1	NA	1	NA	7	0
ATP5I	0	0	1	1	71.28	142.56	15	2	1	NA	1	NA	2	0
ATP5J2	0	0	1	1	89.1	178.2	15	2	1	NA	1	NA	2	0
ATP5SL	0	0	2	7	125.4	250.8	15	2	1	NA	1	NA	9	0
ATP6V0A1	0	0	3	14	856.35	1712.7	15	2	1	NA	1	NA	17	0
ATP6V0A2	0	0	2	2	797.94	1595.88	15	2	1	NA	1	NA	4	0
ATP6V0B	0	0	0	2	190.08	380.16	15	2	1	NA	1	NA	2	0
ATP6V0C	0	0	0	3	128.37	256.74	15	2	1	NA	1	NA	3	0
ATP6V1B2	0	0	4	10	990.99	1981.98	15	2	1	NA	1	NA	14	0
ATP6V1G1	0	0	1	2	117.81	235.62	15	2	1	NA	1	NA	3	0
ATP6V1G3	0	0	1	2	117.81	235.62	15	2	1	NA	1	NA	3	0
ATP8A1	0	0	1	2	1134.54	2269.08	15	2	1	NA	1	NA	3	0
ATP8B1	0	0	1	5	1240.47	2480.94	15	2	1	NA	1	NA	6	0
ATP8B3	0	0	11	3	1188	2376	15	2	1	NA	1	NA	14	0
ATP8B4	0	0	0	3	1195.92	2391.84	15	2	1	NA	1	NA	3	0
ATP9A	0	0	0	3	1073.16	2146.32	15	2	1	NA	1	NA	3	0
ATPAF1	0	0	4	0	306.9	613.8	15	2	1	NA	1	NA	4	0
ATPAF2	0	0	2	1	249.15	498.3	15	2	1	NA	1	NA	3	0
ATR	0	0	15	26	2633.4	5266.8	15	2	1	NA	1	NA	41	0
ATRAID	0	0	2	0	32.01	64.02	15	2	1	NA	1	NA	2	0
ATRIP	0	0	6	9	798.93	1597.86	15	2	1	NA	1	NA	15	0
ATRN	0	0	6	12	1280.07	2560.14	15	2	1	NA	1	NA	18	0
ATRNL1	0	0	4	13	1060.62	2121.24	15	2	1	NA	1	NA	17	0
ATXN1L	0	0	0	3	687.06	1374.12	15	2	1	NA	1	NA	3	0
ATXN2	0	0	3	2	939.51	1879.02	15	2	1	NA	1	NA	5	0
ATXN7	0	0	1	4	793.32	1586.64	15	2	1	NA	1	NA	5	0
AUP1	0	0	3	5	416.13	832.26	15	2	1	NA	1	NA	8	0
AURKA	0	0	1	3	422.73	845.46	15	2	1	NA	1	NA	4	0
AUTS2	0	0	0	9	1021.35	2042.7	15	2	1	NA	1	NA	9	0
AVD-AVR2-LOC427416-LOC769899	0	0	3	3	146.52	293.04	15	2	1	NA	1	NA	6	0
AVPR1B	0	0	11	11	413.82	827.64	15	2	1	NA	1	NA	22	0
AXDND1	0	0	10	4	1037.52	2075.04	15	2	1	NA	1	NA	14	0
AXIN2	0	0	6	15	810.15	1620.3	15	2	1	NA	1	NA	21	0
AZIN2	0	0	2	6	453.42	906.84	15	2	1	NA	1	NA	8	0
B3GALNT1	0	0	2	3	316.8	633.6	15	2	1	NA	1	NA	5	0
B3GALT1	0	0	1	2	323.73	647.46	15	2	1	NA	1	NA	3	0
B3GALT2	0	0	1	4	412.5	825	15	2	1	NA	1	NA	5	0
B3GALT6	0	0	4	8	345.51	691.02	15	2	1	NA	1	NA	12	0
B3GNT4	0	0	5	9	366.3	732.6	15	2	1	NA	1	NA	14	0
B3GNT7	0	0	4	10	402.93	805.86	15	2	1	NA	1	NA	14	0
B3GNT9	0	0	3	4	411.84	823.68	15	2	1	NA	1	NA	7	0
B3GNTL	0	0	8	1	367.29	734.58	15	2	1	NA	1	NA	9	0
B3GNTL1	0	0	1	3	227.7	455.4	15	2	1	NA	1	NA	4	0
B4GALNT4	0	0	8	25	1114.08	2228.16	15	2	1	NA	1	NA	33	0
B4GALT1	0	0	1	2	253.11	506.22	15	2	1	NA	1	NA	3	0
B4GALT2	0	0	1	5	361.35	722.7	15	2	1	NA	1	NA	6	0
B4GALT5	0	0	0	3	313.5	627	15	2	1	NA	1	NA	3	0
B9D1	0	0	1	1	207.9	415.8	15	2	1	NA	1	NA	2	0
BAAT	0	0	5	12	413.82	827.64	15	2	1	NA	1	NA	17	0
BABAM1	0	0	0	2	85.14	170.28	15	2	1	NA	1	NA	2	0
BACE1	0	0	1	7	421.41	842.82	15	2	1	NA	1	NA	8	0
BAG3	0	0	6	5	555.39	1110.78	15	2	1	NA	1	NA	11	0
BAG4	0	0	11	6	326.7	653.4	15	2	1	NA	1	NA	17	0
BAG5	0	0	1	3	446.49	892.98	15	2	1	NA	1	NA	4	0
BAHCC1	0	0	12	20	921.03	1842.06	15	2	1	NA	1	NA	32	0
BAHD1	0	0	5	8	830.61	1661.22	15	2	1	NA	1	NA	13	0
BAIAP2	0	0	2	15	571.23	1142.46	15	2	1	NA	1	NA	17	0
BAK1	0	0	1	4	215.82	431.64	15	2	1	NA	1	NA	5	0
BANK1	0	0	5	5	725.67	1451.34	15	2	1	NA	1	NA	10	0
BANP	0	0	2	4	466.29	932.58	15	2	1	NA	1	NA	6	0
BAP1	0	0	1	7	708.84	1417.68	15	2	1	NA	1	NA	8	0
BARD1	0	0	2	1	782.1	1564.2	15	2	1	NA	1	NA	3	0
BARHL2	0	0	1	1	360.36	720.72	15	2	1	NA	1	NA	2	0
BARX1	0	0	0	2	242.88	485.76	15	2	1	NA	1	NA	2	0
BARX2	0	0	0	3	271.26	542.52	15	2	1	NA	1	NA	3	0
BAZ1A	0	0	9	11	1553.31	3106.62	15	2	1	NA	1	NA	20	0
BAZ1B	0	0	1	2	1514.7	3029.4	15	2	1	NA	1	NA	3	0
BAZ2A	0	0	9	22	1739.1	3478.2	15	2	1	NA	1	NA	31	0
BAZ2B	0	0	3	9	2132.46	4264.92	15	2	1	NA	1	NA	12	0
BBOF1	0	0	7	2	503.91	1007.82	15	2	1	NA	1	NA	9	0
BBS12	0	0	17	17	753.06	1506.12	15	2	1	NA	1	NA	34	0
BBS2	0	0	3	5	714.78	1429.56	15	2	1	NA	1	NA	8	0
BBS4	0	0	2	7	531.63	1063.26	15	2	1	NA	1	NA	9	0
BBS7	0	0	3	6	687.39	1374.78	15	2	1	NA	1	NA	9	0
BCAN	0	0	9	11	671.55	1343.1	15	2	1	NA	1	NA	20	0
BCAR3	0	0	4	4	811.8	1623.6	15	2	1	NA	1	NA	8	0
BCAS1	0	0	7	2	602.91	1205.82	15	2	1	NA	1	NA	9	0
BCAS3	0	0	8	9	879.78	1759.56	15	2	1	NA	1	NA	17	0
BCCIP	0	0	6	0	302.94	605.88	15	2	1	NA	1	NA	6	0
BCDIN3D	0	0	1	5	259.71	519.42	15	2	1	NA	1	NA	6	0
BCHE	0	0	1	4	629.64	1259.28	15	2	1	NA	1	NA	5	0
BCL10	0	0	1	1	215.82	431.64	15	2	1	NA	1	NA	2	0
BCL2L1	0	0	0	3	227.7	455.4	15	2	1	NA	1	NA	3	0
BCL6	0	0	0	8	697.95	1395.9	15	2	1	NA	1	NA	8	0
BCL9L	0	0	1	1	1480.05	2960.1	15	2	1	NA	1	NA	2	0
BCO1	0	0	0	2	521.73	1043.46	15	2	1	NA	1	NA	2	0
BCO2	0	0	4	7	573.21	1146.42	15	2	1	NA	1	NA	11	0
BCORL1	0	0	12	23	1543.41	3086.82	15	2	1	NA	1	NA	35	0
BCS1L	0	0	6	4	390.06	780.12	15	2	1	NA	1	NA	10	0
BDH1A	0	0	2	4	340.56	681.12	15	2	1	NA	1	NA	6	0
BDH1B	0	0	2	3	293.04	586.08	15	2	1	NA	1	NA	5	0
BDH2	0	0	3	2	243.54	487.08	15	2	1	NA	1	NA	5	0
BDKRB2	0	0	2	0	371.25	742.5	15	2	1	NA	1	NA	2	0
BDP1L	0	0	6	3	2244.66	4489.32	15	2	1	NA	1	NA	9	0
BEAN1	0	0	0	2	310.86	621.72	15	2	1	NA	1	NA	2	0
BEND4	0	0	1	2	424.38	848.76	15	2	1	NA	1	NA	3	0
BEST1	0	0	3	2	714.45	1428.9	15	2	1	NA	1	NA	5	0
BEST2-BEST4	0	0	13	13	499.95	999.9	15	2	1	NA	1	NA	26	0
BF1-BF2-HLA-F10AL1-HLA-F10AL3-HLA-F10AL4-LOC101751283-LOC107049114-LOC107049124-LOC107050538-LOC107050833-LOC107054704-LOC112529954-LOC417056-MHCIA2-MHCIA3-MHCIA6-MHCIA7-MHCIA9-MHCIY-MICA-MR1-YF5-YF6	0	0	29	14	308.55	617.1	15	2	1	NA	1	NA	43	0
BFAR	0	0	5	3	445.5	891	15	2	1	NA	1	NA	8	0
BGLAP	0	0	1	2	102.96	205.92	15	2	1	NA	1	NA	3	0
BHLHA9	0	0	10	7	246.18	492.36	15	2	1	NA	1	NA	17	0
BHLHE23	0	0	1	5	219.78	439.56	15	2	1	NA	1	NA	6	0
BHLHE40	0	0	1	3	395.01	790.02	15	2	1	NA	1	NA	4	0
BHMT	0	0	1	2	386.76	773.52	15	2	1	NA	1	NA	3	0
BICC1	0	0	1	1	195.03	390.06	15	2	1	NA	1	NA	2	0
BICD2	0	0	2	3	834.57	1669.14	15	2	1	NA	1	NA	5	0
BIN1	0	0	0	2	532.29	1064.58	15	2	1	NA	1	NA	2	0
BIN2-CELA1	0	0	25	22	1386.99	2773.98	15	2	1	NA	1	NA	47	0
BIN3	0	0	3	3	325.38	650.76	15	2	1	NA	1	NA	6	0
BIRC7	0	0	4	5	384.12	768.24	15	2	1	NA	1	NA	9	0
BLEC1	0	0	2	2	194.04	388.08	15	2	1	NA	1	NA	4	0
BLEC3-LOC107054697	0	0	3	4	169.95	339.9	15	2	1	NA	1	NA	7	0
BLM	0	0	20	11	1415.7	2831.4	15	2	1	NA	1	NA	31	0
BLMH	0	0	1	4	451.44	902.88	15	2	1	NA	1	NA	5	0
BLNK	0	0	3	0	551.43	1102.86	15	2	1	NA	1	NA	3	0
BLOC1S2	0	0	0	2	123.42	246.84	15	2	1	NA	1	NA	2	0
BMP10	0	0	2	2	421.74	843.48	15	2	1	NA	1	NA	4	0
BMP2K	0	0	10	12	1064.58	2129.16	15	2	1	NA	1	NA	22	0
BMP3	0	0	0	2	478.17	956.34	15	2	1	NA	1	NA	2	0
BMP4	0	0	1	4	399.96	799.92	15	2	1	NA	1	NA	5	0
BMP7	0	0	0	3	432.63	865.26	15	2	1	NA	1	NA	3	0
BMPR1B	0	0	0	7	496.98	993.96	15	2	1	NA	1	NA	7	0
BMPR2	0	0	1	1	1013.76	2027.52	15	2	1	NA	1	NA	2	0
BMS1	0	0	8	8	1291.95	2583.9	15	2	1	NA	1	NA	16	0
BNC1	0	0	1	3	976.14	1952.28	15	2	1	NA	1	NA	4	0
BNC2	0	0	1	1	876.15	1752.3	15	2	1	NA	1	NA	2	0
BNIP2	0	0	1	2	306.9	613.8	15	2	1	NA	1	NA	3	0
BNIP3	0	0	1	4	225.39	450.78	15	2	1	NA	1	NA	5	0
BNIP3L	0	0	3	3	256.08	512.16	15	2	1	NA	1	NA	6	0
BOD1	0	0	0	2	132	264	15	2	1	NA	1	NA	2	0
BOD1L1	0	0	15	7	2947.23	5894.46	15	2	1	NA	1	NA	22	0
BOK	0	0	1	4	211.86	423.72	15	2	1	NA	1	NA	5	0
BORCS8	0	0	0	8	110.55	221.1	15	2	1	NA	1	NA	8	0
BORL1-BORL4	0	0	4	2	270.27	540.54	15	2	1	NA	1	NA	6	0
BPIFB2	0	0	4	7	423.72	847.44	15	2	1	NA	1	NA	11	0
BPIFB3	0	0	2	8	455.4	910.8	15	2	1	NA	1	NA	10	0
BPIFB4	0	0	7	5	410.52	821.04	15	2	1	NA	1	NA	12	0
BPIFB6	0	0	7	3	453.42	906.84	15	2	1	NA	1	NA	10	0
BPIL3	0	0	16	11	567.6	1135.2	15	2	1	NA	1	NA	27	0
BPTF	0	0	12	5	3006.63	6013.26	15	2	1	NA	1	NA	17	0
BRAP	0	0	2	6	582.12	1164.24	15	2	1	NA	1	NA	8	0
BRAT1	0	0	5	7	843.48	1686.96	15	2	1	NA	1	NA	12	0
BRCA1	0	0	20	26	1816.65	3633.3	15	2	1	NA	1	NA	46	0
BRCC3	0	0	1	5	228.36	456.72	15	2	1	NA	1	NA	6	0
BRD3	0	0	5	14	715.77	1431.54	15	2	1	NA	1	NA	19	0
BRD7	0	0	4	5	600.27	1200.54	15	2	1	NA	1	NA	9	0
BRD8	0	0	3	4	1214.07	2428.14	15	2	1	NA	1	NA	7	0
BRDT	0	0	2	4	921.36	1842.72	15	2	1	NA	1	NA	6	0
BRF1	0	0	1	2	511.83	1023.66	15	2	1	NA	1	NA	3	0
BRF2	0	0	7	5	361.02	722.04	15	2	1	NA	1	NA	12	0
BRINP1	0	0	2	6	770.88	1541.76	15	2	1	NA	1	NA	8	0
BRINP2	0	0	6	13	772.53	1545.06	15	2	1	NA	1	NA	19	0
BRINP3	0	0	3	0	438.57	877.14	15	2	1	NA	1	NA	3	0
BRPF1	0	0	2	18	1209.12	2418.24	15	2	1	NA	1	NA	20	0
BRPF3	0	0	3	13	1151.37	2302.74	15	2	1	NA	1	NA	16	0
BRS3	0	0	2	2	393.03	786.06	15	2	1	NA	1	NA	4	0
BRSK2	0	0	3	7	781.11	1562.22	15	2	1	NA	1	NA	10	0
BRWD3	0	0	3	10	1636.8	3273.6	15	2	1	NA	1	NA	13	0
BSDC1	0	0	2	4	445.83	891.66	15	2	1	NA	1	NA	6	0
BSG	0	0	1	1	383.13	766.26	15	2	1	NA	1	NA	2	0
BSND	0	0	2	5	228.69	457.38	15	2	1	NA	1	NA	7	0
BSPRY	0	0	2	2	332.64	665.28	15	2	1	NA	1	NA	4	0
BST1	0	0	1	1	325.71	651.42	15	2	1	NA	1	NA	2	0
BSX	0	0	1	2	234.63	469.26	15	2	1	NA	1	NA	3	0
BTAF1	0	0	1	5	1821.93	3643.86	15	2	1	NA	1	NA	6	0
BTBD1	0	0	0	3	359.37	718.74	15	2	1	NA	1	NA	3	0
BTBD10	0	0	0	3	470.25	940.5	15	2	1	NA	1	NA	3	0
BTBD17	0	0	4	11	479.16	958.32	15	2	1	NA	1	NA	15	0
BTBD18	0	0	3	2	242.88	485.76	15	2	1	NA	1	NA	5	0
BTBD19	0	0	1	6	294.03	588.06	15	2	1	NA	1	NA	7	0
BTBD2	0	0	1	1	408.87	817.74	15	2	1	NA	1	NA	2	0
BTBD6	0	0	2	6	477.18	954.36	15	2	1	NA	1	NA	8	0
BTBD7	0	0	2	2	1104.18	2208.36	15	2	1	NA	1	NA	4	0
BTC	0	0	2	7	170.28	340.56	15	2	1	NA	1	NA	9	0
BTG2	0	0	1	7	162.36	324.72	15	2	1	NA	1	NA	8	0
BTG4	0	0	1	2	225.72	451.44	15	2	1	NA	1	NA	3	0
BTK	0	0	4	11	627.66	1255.32	15	2	1	NA	1	NA	15	0
BTN1	0	0	2	7	444.51	889.02	15	2	1	NA	1	NA	9	0
BTN1A1	0	0	3	4	480.15	960.3	15	2	1	NA	1	NA	7	0
BTN3A2-BTN3A3-LOC107049000-LOC107055478-LOC426827	0	0	3	2	372.24	744.48	15	2	1	NA	1	NA	5	0
BUB1B	0	0	8	5	1149.72	2299.44	15	2	1	NA	1	NA	13	0
BUB3	0	0	0	3	326.7	653.4	15	2	1	NA	1	NA	3	0
BUD13-LOC770165	0	0	11	16	574.2	1148.4	15	2	1	NA	1	NA	27	0
BUD31	0	0	0	3	143.55	287.1	15	2	1	NA	1	NA	3	0
BYSL	0	0	4	4	430.32	860.64	15	2	1	NA	1	NA	8	0
BZFP1-LOC112533547	0	0	9	9	441.87	883.74	15	2	1	NA	1	NA	18	0
BZW1	0	0	1	5	414.81	829.62	15	2	1	NA	1	NA	6	0
C10H15ORF58	0	0	1	3	594	1188	15	2	1	NA	1	NA	4	0
C10H15ORF59	0	0	1	7	271.59	543.18	15	2	1	NA	1	NA	8	0
C10orf10	0	0	3	2	330.66	661.32	15	2	1	NA	1	NA	5	0
C10orf128	0	0	2	0	103.95	207.9	15	2	1	NA	1	NA	2	0
C11H16orf70	0	0	1	1	419.76	839.52	15	2	1	NA	1	NA	2	0
C11ORF52	0	0	1	2	117.81	235.62	15	2	1	NA	1	NA	3	0
C11orf24	0	0	10	0	474.21	948.42	15	2	1	NA	1	NA	10	0
C11orf63	0	0	13	5	767.25	1534.5	15	2	1	NA	1	NA	18	0
C11orf91	0	0	1	1	144.54	289.08	15	2	1	NA	1	NA	2	0
C12H3ORF67	0	0	5	2	803.55	1607.1	15	2	1	NA	1	NA	7	0
C12H3orf18	0	0	1	1	155.43	310.86	15	2	1	NA	1	NA	2	0
C13H5orf15	0	0	4	0	289.08	578.16	15	2	1	NA	1	NA	4	0
C14H16orf62	0	0	4	1	953.37	1906.74	15	2	1	NA	1	NA	5	0
C14ORF166B	0	0	4	1	379.17	758.34	15	2	1	NA	1	NA	5	0
C14ORF39	0	0	3	1	583.11	1166.22	15	2	1	NA	1	NA	4	0
C14orf180	0	0	3	0	135.63	271.26	15	2	1	NA	1	NA	3	0
C15H12ORF65	0	0	4	1	161.37	322.74	15	2	1	NA	1	NA	5	0
C15H12orf49	0	0	2	1	203.94	407.88	15	2	1	NA	1	NA	3	0
C15orf39-MUC1	0	0	38	31	1656.6	3313.2	15	2	1	NA	1	NA	69	0
C17H9orf16	0	0	1	1	89.1	178.2	15	2	1	NA	1	NA	2	0
C17H9orf78	0	0	1	2	287.1	574.2	15	2	1	NA	1	NA	3	0
C17ORF80	0	0	10	6	337.26	674.52	15	2	1	NA	1	NA	16	0
C18H17orf58	0	0	2	0	380.16	760.32	15	2	1	NA	1	NA	2	0
C18H17orf75	0	0	1	3	359.37	718.74	15	2	1	NA	1	NA	4	0
C19H17ORF64	0	0	3	1	174.24	348.48	15	2	1	NA	1	NA	4	0
C19H17orf78	0	0	3	3	268.29	536.58	15	2	1	NA	1	NA	6	0
C19orf24	0	0	4	1	139.59	279.18	15	2	1	NA	1	NA	5	0
C19orf35	0	0	3	0	502.92	1005.84	15	2	1	NA	1	NA	3	0
C19orf45	0	0	4	1	473.22	946.44	15	2	1	NA	1	NA	5	0
C19orf70	0	0	2	0	108.24	216.48	15	2	1	NA	1	NA	2	0
C19orf71	0	0	9	7	202.62	405.24	15	2	1	NA	1	NA	16	0
C1GALT1C1	0	0	1	2	307.89	615.78	15	2	1	NA	1	NA	3	0
C1QA	0	0	5	9	241.56	483.12	15	2	1	NA	1	NA	14	0
C1QB	0	0	2	7	242.55	485.1	15	2	1	NA	1	NA	9	0
C1QBP	0	0	1	1	200.64	401.28	15	2	1	NA	1	NA	2	0
C1QC	0	0	4	7	241.56	483.12	15	2	1	NA	1	NA	11	0
C1QL1	0	0	0	2	136.29	272.58	15	2	1	NA	1	NA	2	0
C1QL4	0	0	0	5	231.66	463.32	15	2	1	NA	1	NA	5	0
C1QTNF1	0	0	2	5	274.23	548.46	15	2	1	NA	1	NA	7	0
C1QTNF2	0	0	1	1	282.15	564.3	15	2	1	NA	1	NA	2	0
C1QTNF4	0	0	2	4	364.32	728.64	15	2	1	NA	1	NA	6	0
C1QTNF5	0	0	0	8	231	462	15	2	1	NA	1	NA	8	0
C1QTNF8	0	0	6	4	255.42	510.84	15	2	1	NA	1	NA	10	0
C1orf158	0	0	3	1	215.82	431.64	15	2	1	NA	1	NA	4	0
C1orf167	0	0	15	9	1583.01	3166.02	15	2	1	NA	1	NA	24	0
C1orf186	0	0	2	2	161.37	322.74	15	2	1	NA	1	NA	4	0
C1orf210	0	0	6	3	366.96	733.92	15	2	1	NA	1	NA	9	0
C1orf228	0	0	7	5	445.5	891	15	2	1	NA	1	NA	12	0
C20H20ORF112	0	0	2	15	592.02	1184.04	15	2	1	NA	1	NA	17	0
C20H20ORF195	0	0	5	3	481.8	963.6	15	2	1	NA	1	NA	8	0
C20H20orf204	0	0	2	5	161.37	322.74	15	2	1	NA	1	NA	7	0
C20H20orf96	0	0	7	5	351.45	702.9	15	2	1	NA	1	NA	12	0
C20orf27	0	0	4	4	173.25	346.5	15	2	1	NA	1	NA	8	0
C21H1orf159	0	0	1	3	200.97	401.94	15	2	1	NA	1	NA	4	0
C22H2ORF42	0	0	5	10	544.17	1088.34	15	2	1	NA	1	NA	15	0
C22H8ORF4	0	0	0	2	105.93	211.86	15	2	1	NA	1	NA	2	0
C22orf39	0	0	2	1	104.94	209.88	15	2	1	NA	1	NA	3	0
C23H1ORF109	0	0	2	2	199.98	399.96	15	2	1	NA	1	NA	4	0
C23H1ORF94	0	0	5	2	374.22	748.44	15	2	1	NA	1	NA	7	0
C23H1orf216	0	0	3	3	248.49	496.98	15	2	1	NA	1	NA	6	0
C24H11orf1	0	0	3	1	164.34	328.68	15	2	1	NA	1	NA	4	0
C24H11orf34	0	0	2	1	179.19	358.38	15	2	1	NA	1	NA	3	0
C24H11orf57	0	0	2	4	304.26	608.52	15	2	1	NA	1	NA	6	0
C25H1ORF43	0	0	1	1	248.82	497.64	15	2	1	NA	1	NA	2	0
C26H1orf116	0	0	5	8	498.96	997.92	15	2	1	NA	1	NA	13	0
C26H1orf74	0	0	4	2	246.18	492.36	15	2	1	NA	1	NA	6	0
C26H6ORF125	0	0	1	3	119.46	238.92	15	2	1	NA	1	NA	4	0
C26H6orf106	0	0	0	4	241.89	483.78	15	2	1	NA	1	NA	4	0
C28H19ORF44	0	0	11	12	624.03	1248.06	15	2	1	NA	1	NA	23	0
C2CD2L	0	0	1	6	633.6	1267.2	15	2	1	NA	1	NA	7	0
C2CD4C	0	0	1	6	412.83	825.66	15	2	1	NA	1	NA	7	0
C2orf72	0	0	0	2	241.56	483.12	15	2	1	NA	1	NA	2	0
C33H12orf10	0	0	4	15	359.37	718.74	15	2	1	NA	1	NA	19	0
C3orf33	0	0	2	5	220.44	440.88	15	2	1	NA	1	NA	7	0
C3orf70	0	0	3	3	240.57	481.14	15	2	1	NA	1	NA	6	0
C4BPA	0	0	28	29	2238.72	4477.44	15	2	1	NA	1	NA	57	0
C4H20ORF194	0	0	8	8	1140.81	2281.62	15	2	1	NA	1	NA	16	0
C4H2orf81	0	0	13	7	407.88	815.76	15	2	1	NA	1	NA	20	0
C4H4ORF47	0	0	4	4	370.26	740.52	15	2	1	NA	1	NA	8	0
C4H4ORF50	0	0	7	5	2023.56	4047.12	15	2	1	NA	1	NA	12	0
C4H4orf17	0	0	6	3	336.6	673.2	15	2	1	NA	1	NA	9	0
C4HCXorf57	0	0	4	3	873.18	1746.36	15	2	1	NA	1	NA	7	0
C4ORF19	0	0	5	6	325.71	651.42	15	2	1	NA	1	NA	11	0
C5	0	0	4	16	1662.21	3324.42	15	2	1	NA	1	NA	20	0
C5H11ORF9	0	0	3	12	1086.03	2172.06	15	2	1	NA	1	NA	15	0
C5H11orf16	0	0	13	7	406.56	813.12	15	2	1	NA	1	NA	20	0
C5H11orf58	0	0	0	2	161.7	323.4	15	2	1	NA	1	NA	2	0
C5H11orf74	0	0	2	1	255.42	510.84	15	2	1	NA	1	NA	3	0
C5H14ORF105	0	0	5	3	280.17	560.34	15	2	1	NA	1	NA	8	0
C5H14ORF169	0	0	4	8	503.25	1006.5	15	2	1	NA	1	NA	12	0
C5H14orf1	0	0	3	1	138.6	277.2	15	2	1	NA	1	NA	4	0
C5H14orf159	0	0	7	2	611.82	1223.64	15	2	1	NA	1	NA	9	0
C5H14orf166	0	0	0	5	242.55	485.1	15	2	1	NA	1	NA	5	0
C5H14orf37	0	0	8	4	741.51	1483.02	15	2	1	NA	1	NA	12	0
C5H14orf4	0	0	2	14	736.56	1473.12	15	2	1	NA	1	NA	16	0
C5H14orf79	0	0	2	3	289.08	578.16	15	2	1	NA	1	NA	5	0
C5H15ORF62	0	0	0	3	175.23	350.46	15	2	1	NA	1	NA	3	0
C5H15orf52	0	0	5	3	636.57	1273.14	15	2	1	NA	1	NA	8	0
C5H15orf57	0	0	0	3	176.22	352.44	15	2	1	NA	1	NA	3	0
C5NT1AL	0	0	4	5	361.35	722.7	15	2	1	NA	1	NA	9	0
C6	0	0	3	7	872.85	1745.7	15	2	1	NA	1	NA	10	0
C6H10ORF71	0	0	12	6	1503.81	3007.62	15	2	1	NA	1	NA	18	0
C6H10ORF88	0	0	7	1	443.52	887.04	15	2	1	NA	1	NA	8	0
C6H10ORF90	0	0	6	7	729.96	1459.92	15	2	1	NA	1	NA	13	0
C6H10orf54	0	0	1	3	306.9	613.8	15	2	1	NA	1	NA	4	0
C6orf132	0	0	14	14	1071.18	2142.36	15	2	1	NA	1	NA	28	0
C7	0	0	2	1	787.38	1574.76	15	2	1	NA	1	NA	3	0
C7H2ORF47	0	0	2	3	255.42	510.84	15	2	1	NA	1	NA	5	0
C7H2ORF69	0	0	6	4	377.19	754.38	15	2	1	NA	1	NA	10	0
C7H2ORF76	0	0	1	2	125.73	251.46	15	2	1	NA	1	NA	3	0
C8A	0	0	1	4	594	1188	15	2	1	NA	1	NA	5	0
C8B	0	0	7	11	1149.39	2298.78	15	2	1	NA	1	NA	18	0
C8G	0	0	2	0	192.39	384.78	15	2	1	NA	1	NA	2	0
C8H14ORF80	0	0	10	6	429.66	859.32	15	2	1	NA	1	NA	16	0
C8H1ORF112	0	0	5	5	819.72	1639.44	15	2	1	NA	1	NA	10	0
C8H1ORF146	0	0	1	2	175.23	350.46	15	2	1	NA	1	NA	3	0
C8H1ORF21	0	0	0	2	120.78	241.56	15	2	1	NA	1	NA	2	0
C8H1orf123	0	0	1	2	159.39	318.78	15	2	1	NA	1	NA	3	0
C8H1orf168	0	0	13	7	591.03	1182.06	15	2	1	NA	1	NA	20	0
C8H1orf27	0	0	1	2	419.76	839.52	15	2	1	NA	1	NA	3	0
C8H1orf52	0	0	3	0	183.15	366.3	15	2	1	NA	1	NA	3	0
C9H21orf2	0	0	0	3	252.45	504.9	15	2	1	NA	1	NA	3	0
C9H2ORF82	0	0	0	3	121.77	243.54	15	2	1	NA	1	NA	3	0
C9H2orf54	0	0	9	6	424.71	849.42	15	2	1	NA	1	NA	15	0
C9H3orf58	0	0	3	1	425.7	851.4	15	2	1	NA	1	NA	4	0
C9ORF58	0	0	1	2	144.54	289.08	15	2	1	NA	1	NA	3	0
C9orf116	0	0	3	1	106.26	212.52	15	2	1	NA	1	NA	4	0
C9orf69	0	0	0	3	138.6	277.2	15	2	1	NA	1	NA	3	0
C9orf84	0	0	12	9	1474.11	2948.22	15	2	1	NA	1	NA	21	0
C9orf85	0	0	2	0	139.59	279.18	15	2	1	NA	1	NA	2	0
CA12	0	0	2	2	340.23	680.46	15	2	1	NA	1	NA	4	0
CA15L	0	0	5	9	319.77	639.54	15	2	1	NA	1	NA	14	0
CA4	0	0	3	4	313.83	627.66	15	2	1	NA	1	NA	7	0
CA5A	0	0	0	5	301.95	603.9	15	2	1	NA	1	NA	5	0
CA6	0	0	6	6	517.77	1035.54	15	2	1	NA	1	NA	12	0
CA9	0	0	2	6	328.68	657.36	15	2	1	NA	1	NA	8	0
CAAP1	0	0	0	2	298.32	596.64	15	2	1	NA	1	NA	2	0
CABIN1	0	0	4	13	2029.83	4059.66	15	2	1	NA	1	NA	17	0
CABLES2	0	0	7	2	572.22	1144.44	15	2	1	NA	1	NA	9	0
CABP7	0	0	0	2	208.89	417.78	15	2	1	NA	1	NA	2	0
CACFD1	0	0	1	2	173.25	346.5	15	2	1	NA	1	NA	3	0
CACNA1B	0	0	9	38	2166.12	4332.24	15	2	1	NA	1	NA	47	0
CACNA1D	0	0	10	10	2197.8	4395.6	15	2	1	NA	1	NA	20	0
CACNA1E	0	0	22	63	2164.14	4328.28	15	2	1	NA	1	NA	85	0
CACNA1G	0	0	12	43	2332.11	4664.22	15	2	1	NA	1	NA	55	0
CACNA1H	0	0	12	30	2365.11	4730.22	15	2	1	NA	1	NA	42	0
CACNA1S	0	0	15	37	1845.36	3690.72	15	2	1	NA	1	NA	52	0
CACNA2D2	0	0	3	23	1018.05	2036.1	15	2	1	NA	1	NA	26	0
CACNG3	0	0	1	4	256.41	512.82	15	2	1	NA	1	NA	5	0
CACNG5	0	0	0	4	277.2	554.4	15	2	1	NA	1	NA	4	0
CACTIN	0	0	2	6	688.38	1376.76	15	2	1	NA	1	NA	8	0
CACYBP	0	0	0	3	219.78	439.56	15	2	1	NA	1	NA	3	0
CAD	0	0	2	0	1088.01	2176.02	15	2	1	NA	1	NA	2	0
CADM1	0	0	1	2	427.68	855.36	15	2	1	NA	1	NA	3	0
CADM3	0	0	5	7	499.95	999.9	15	2	1	NA	1	NA	12	0
CADNL	0	0	5	1	997.92	1995.84	15	2	1	NA	1	NA	6	0
CADPS	0	0	1	4	582.78	1165.56	15	2	1	NA	1	NA	5	0
CALCOCO2	0	0	1	2	442.53	885.06	15	2	1	NA	1	NA	3	0
CALHM1	0	0	2	2	326.7	653.4	15	2	1	NA	1	NA	4	0
CALHM3	0	0	6	1	326.7	653.4	15	2	1	NA	1	NA	7	0
CALML3	0	0	0	2	148.5	297	15	2	1	NA	1	NA	2	0
CALN1	0	0	3	2	264.33	528.66	15	2	1	NA	1	NA	5	0
CAMK1	0	0	2	8	279.51	559.02	15	2	1	NA	1	NA	10	0
CAMK1G	0	0	1	5	472.23	944.46	15	2	1	NA	1	NA	6	0
CAMK2A	0	0	14	18	470.91	941.82	15	2	1	NA	1	NA	32	0
CAMK2D	0	0	1	1	469.26	938.52	15	2	1	NA	1	NA	2	0
CAMK2G	0	0	0	3	531.63	1063.26	15	2	1	NA	1	NA	3	0
CAMK4	0	0	1	1	181.5	363	15	2	1	NA	1	NA	2	0
CAMK4L	0	0	1	5	360.03	720.06	15	2	1	NA	1	NA	6	0
CAMKK1	0	0	5	6	508.53	1017.06	15	2	1	NA	1	NA	11	0
CAMKK2	0	0	2	13	549.45	1098.9	15	2	1	NA	1	NA	15	0
CAMLG	0	0	3	4	290.07	580.14	15	2	1	NA	1	NA	7	0
CAMSAP1	0	0	8	9	1578.06	3156.12	15	2	1	NA	1	NA	17	0
CAMSAP2	0	0	4	6	1383.03	2766.06	15	2	1	NA	1	NA	10	0
CAND2	0	0	8	15	1213.74	2427.48	15	2	1	NA	1	NA	23	0
CANT1	0	0	3	6	394.02	788.04	15	2	1	NA	1	NA	9	0
CANX	0	0	3	4	599.94	1199.88	15	2	1	NA	1	NA	7	0
CAPG	0	0	6	7	256.08	512.16	15	2	1	NA	1	NA	13	0
CAPN10	0	0	4	6	666.27	1332.54	15	2	1	NA	1	NA	10	0
CAPN15	0	0	3	25	1149.39	2298.78	15	2	1	NA	1	NA	28	0
CAPN3	0	0	3	4	797.94	1595.88	15	2	1	NA	1	NA	7	0
CAPN6	0	0	0	2	637.56	1275.12	15	2	1	NA	1	NA	2	0
CARD11	0	0	2	4	1123.65	2247.3	15	2	1	NA	1	NA	6	0
CARD19	0	0	1	1	181.17	362.34	15	2	1	NA	1	NA	2	0
CARD9	0	0	8	1	654.72	1309.44	15	2	1	NA	1	NA	9	0
CARHSP1	0	0	1	1	214.17	428.34	15	2	1	NA	1	NA	2	0
CARNMT1	0	0	1	1	278.19	556.38	15	2	1	NA	1	NA	2	0
CARS	0	0	10	6	1244.76	2489.52	15	2	1	NA	1	NA	16	0
CASC3	0	0	3	13	601.59	1203.18	15	2	1	NA	1	NA	16	0
CASC4	0	0	2	0	415.47	830.94	15	2	1	NA	1	NA	2	0
CASKIN1	0	0	15	42	1514.7	3029.4	15	2	1	NA	1	NA	57	0
CASKIN2	0	0	21	26	1471.14	2942.28	15	2	1	NA	1	NA	47	0
CASP1	0	0	2	3	364.65	729.3	15	2	1	NA	1	NA	5	0
CASP10	0	0	3	4	521.73	1043.46	15	2	1	NA	1	NA	7	0
CASP18	0	0	1	1	461.34	922.68	15	2	1	NA	1	NA	2	0
CASP6	0	0	2	5	300.96	601.92	15	2	1	NA	1	NA	7	0
CASP8	0	0	2	1	478.17	956.34	15	2	1	NA	1	NA	3	0
CASP9	0	0	3	7	400.95	801.9	15	2	1	NA	1	NA	10	0
CAST	0	0	12	6	605.55	1211.1	15	2	1	NA	1	NA	18	0
CASZ1	0	0	5	20	1933.47	3866.94	15	2	1	NA	1	NA	25	0
CAT	0	0	1	2	510.51	1021.02	15	2	1	NA	1	NA	3	0
CATIP	0	0	5	16	392.7	785.4	15	2	1	NA	1	NA	21	0
CAV3	0	0	1	2	144.21	288.42	15	2	1	NA	1	NA	3	0
CBARP	0	0	7	14	606.21	1212.42	15	2	1	NA	1	NA	21	0
CBFA2T2	0	0	3	8	565.29	1130.58	15	2	1	NA	1	NA	11	0
CBFA2T3	0	0	3	18	505.89	1011.78	15	2	1	NA	1	NA	21	0
CBL	0	0	3	10	863.28	1726.56	15	2	1	NA	1	NA	13	0
CBLN1	0	0	0	3	169.62	339.24	15	2	1	NA	1	NA	3	0
CBR4	0	0	3	1	235.62	471.24	15	2	1	NA	1	NA	4	0
CBWD1	0	0	3	0	365.31	730.62	15	2	1	NA	1	NA	3	0
CBX4	0	0	4	9	461.67	923.34	15	2	1	NA	1	NA	13	0
CBX8	0	0	1	7	323.07	646.14	15	2	1	NA	1	NA	8	0
CC2D1B-LOC101748080	0	0	7	3	873.18	1746.36	15	2	1	NA	1	NA	10	0
CC2D2A	0	0	8	9	1527.57	3055.14	15	2	1	NA	1	NA	17	0
CCAH221-CCL26-CCLI7-CCLI8	0	0	4	2	89.76	179.52	15	2	1	NA	1	NA	6	0
CCBL1	0	0	6	15	791.01	1582.02	15	2	1	NA	1	NA	21	0
CCDC102A	0	0	4	2	484.44	968.88	15	2	1	NA	1	NA	6	0
CCDC110	0	0	9	1	622.71	1245.42	15	2	1	NA	1	NA	10	0
CCDC113	0	0	1	3	351.45	702.9	15	2	1	NA	1	NA	4	0
CCDC124	0	0	1	3	167.31	334.62	15	2	1	NA	1	NA	4	0
CCDC125	0	0	3	2	214.83	429.66	15	2	1	NA	1	NA	5	0
CCDC137	0	0	7	2	190.08	380.16	15	2	1	NA	1	NA	9	0
CCDC14	0	0	11	6	922.68	1845.36	15	2	1	NA	1	NA	17	0
CCDC148	0	0	4	2	612.48	1224.96	15	2	1	NA	1	NA	6	0
CCDC149	0	0	3	4	553.41	1106.82	15	2	1	NA	1	NA	7	0
CCDC15	0	0	1	2	424.38	848.76	15	2	1	NA	1	NA	3	0
CCDC153	0	0	3	2	196.68	393.36	15	2	1	NA	1	NA	5	0
CCDC17	0	0	14	10	276.87	553.74	15	2	1	NA	1	NA	24	0
CCDC173	0	0	2	0	295.02	590.04	15	2	1	NA	1	NA	2	0
CCDC173L	0	0	5	2	415.14	830.28	15	2	1	NA	1	NA	7	0
CCDC174	0	0	8	5	670.56	1341.12	15	2	1	NA	1	NA	13	0
CCDC175-LOC112532521	0	0	11	2	743.16	1486.32	15	2	1	NA	1	NA	13	0
CCDC177	0	0	6	10	535.59	1071.18	15	2	1	NA	1	NA	16	0
CCDC180-LOC112529956	0	0	14	5	1503.15	3006.3	15	2	1	NA	1	NA	19	0
CCDC183	0	0	6	4	533.61	1067.22	15	2	1	NA	1	NA	10	0
CCDC186	0	0	2	4	907.83	1815.66	15	2	1	NA	1	NA	6	0
CCDC27	0	0	3	1	425.37	850.74	15	2	1	NA	1	NA	4	0
CCDC28B	0	0	1	4	176.22	352.44	15	2	1	NA	1	NA	5	0
CCDC30	0	0	13	5	1076.13	2152.26	15	2	1	NA	1	NA	18	0
CCDC33-LOC107052135	0	0	24	8	616.77	1233.54	15	2	1	NA	1	NA	32	0
CCDC39	0	0	5	4	947.43	1894.86	15	2	1	NA	1	NA	9	0
CCDC40	0	0	8	6	942.48	1884.96	15	2	1	NA	1	NA	14	0
CCDC42	0	0	2	4	309.87	619.74	15	2	1	NA	1	NA	6	0
CCDC43	0	0	0	2	211.86	423.72	15	2	1	NA	1	NA	2	0
CCDC47	0	0	1	1	478.17	956.34	15	2	1	NA	1	NA	2	0
CCDC50	0	0	3	2	515.46	1030.92	15	2	1	NA	1	NA	5	0
CCDC51	0	0	4	3	415.8	831.6	15	2	1	NA	1	NA	7	0
CCDC57	0	0	2	1	502.92	1005.84	15	2	1	NA	1	NA	3	0
CCDC60	0	0	1	1	134.64	269.28	15	2	1	NA	1	NA	2	0
CCDC63	0	0	8	3	546.48	1092.96	15	2	1	NA	1	NA	11	0
CCDC65	0	0	5	9	413.16	826.32	15	2	1	NA	1	NA	14	0
CCDC66	0	0	6	2	929.61	1859.22	15	2	1	NA	1	NA	8	0
CCDC69	0	0	4	6	299.64	599.28	15	2	1	NA	1	NA	10	0
CCDC71	0	0	3	11	390.06	780.12	15	2	1	NA	1	NA	14	0
CCDC73	0	0	11	7	1008.48	2016.96	15	2	1	NA	1	NA	18	0
CCDC84	0	0	0	2	176.22	352.44	15	2	1	NA	1	NA	2	0
CCDC85C	0	0	2	2	415.14	830.28	15	2	1	NA	1	NA	4	0
CCDC88C	0	0	11	9	1992.54	3985.08	15	2	1	NA	1	NA	20	0
CCDC93	0	0	0	4	611.82	1223.64	15	2	1	NA	1	NA	4	0
CCDC96	0	0	4	3	498.63	997.26	15	2	1	NA	1	NA	7	0
CCL1	0	0	3	1	93.06	186.12	15	2	1	NA	1	NA	4	0
CCL17	0	0	2	1	94.05	188.1	15	2	1	NA	1	NA	3	0
CCL19	0	0	2	1	219.12	438.24	15	2	1	NA	1	NA	3	0
CCL5	0	0	1	1	90.09	180.18	15	2	1	NA	1	NA	2	0
CCLI5	0	0	4	0	97.02	194.04	15	2	1	NA	1	NA	4	0
CCM2L	0	0	2	8	498.63	997.26	15	2	1	NA	1	NA	10	0
CCNB2	0	0	1	6	413.82	827.64	15	2	1	NA	1	NA	7	0
CCNB3	0	0	2	3	394.02	788.04	15	2	1	NA	1	NA	5	0
CCNE1	0	0	0	3	403.92	807.84	15	2	1	NA	1	NA	3	0
CCNF	0	0	3	8	690.03	1380.06	15	2	1	NA	1	NA	11	0
CCNG1	0	0	1	2	293.04	586.08	15	2	1	NA	1	NA	3	0
CCNI	0	0	2	1	381.15	762.3	15	2	1	NA	1	NA	3	0
CCNI2	0	0	2	5	364.32	728.64	15	2	1	NA	1	NA	7	0
CCNJ	0	0	1	1	374.55	749.1	15	2	1	NA	1	NA	2	0
CCNJL	0	0	3	7	392.04	784.08	15	2	1	NA	1	NA	10	0
CCNL1	0	0	1	7	502.26	1004.52	15	2	1	NA	1	NA	8	0
CCNL2	0	0	1	9	531.3	1062.6	15	2	1	NA	1	NA	10	0
CCNT2	0	0	3	4	740.52	1481.04	15	2	1	NA	1	NA	7	0
CCP110	0	0	1	2	1004.85	2009.7	15	2	1	NA	1	NA	3	0
CCPG1	0	0	6	3	800.91	1601.82	15	2	1	NA	1	NA	9	0
CCR7	0	0	1	6	371.25	742.5	15	2	1	NA	1	NA	7	0
CCSER1	0	0	8	8	507.87	1015.74	15	2	1	NA	1	NA	16	0
CCT6A	0	0	2	9	525.69	1051.38	15	2	1	NA	1	NA	11	0
CCT7	0	0	3	13	572.22	1144.44	15	2	1	NA	1	NA	16	0
CD14	0	0	8	4	468.27	936.54	15	2	1	NA	1	NA	12	0
CD151	0	0	0	2	250.47	500.94	15	2	1	NA	1	NA	2	0
CD164L2	0	0	1	4	110.88	221.76	15	2	1	NA	1	NA	5	0
CD180	0	0	6	6	654.39	1308.78	15	2	1	NA	1	NA	12	0
CD1B	0	0	6	3	376.86	753.72	15	2	1	NA	1	NA	9	0
CD1C	0	0	3	6	378.84	757.68	15	2	1	NA	1	NA	9	0
CD244	0	0	14	4	342.54	685.08	15	2	1	NA	1	NA	18	0
CD274	0	0	1	1	407.22	814.44	15	2	1	NA	1	NA	2	0
CD276	0	0	2	9	293.7	587.4	15	2	1	NA	1	NA	11	0
CD300LF	0	0	2	6	310.2	620.4	15	2	1	NA	1	NA	8	0
CD300LG	0	0	29	12	491.37	982.74	15	2	1	NA	1	NA	41	0
CD320	0	0	2	1	191.07	382.14	15	2	1	NA	1	NA	3	0
CD34	0	0	5	1	358.05	716.1	15	2	1	NA	1	NA	6	0
CD38	0	0	3	2	302.94	605.88	15	2	1	NA	1	NA	5	0
CD3E	0	0	2	1	155.76	311.52	15	2	1	NA	1	NA	3	0
CD40LG	0	0	0	3	270.27	540.54	15	2	1	NA	1	NA	3	0
CD44	0	0	2	5	564.3	1128.6	15	2	1	NA	1	NA	7	0
CD5-CD6	0	0	19	14	951.39	1902.78	15	2	1	NA	1	NA	33	0
CD7	0	0	2	1	543.18	1086.36	15	2	1	NA	1	NA	3	0
CD72	0	0	3	2	247.5	495	15	2	1	NA	1	NA	5	0
CD74	0	0	2	4	283.14	566.28	15	2	1	NA	1	NA	6	0
CD81	0	0	0	5	212.85	425.7	15	2	1	NA	1	NA	5	0
CD82	0	0	1	1	260.37	520.74	15	2	1	NA	1	NA	2	0
CD8A-LOC100857817-LOC100857839-LOC100858172-LOC101752184-LOC107049163-LOC107049196-LOC107049200-LOC107053306-LOC107053324-LOC107056303-LOC112529934-LOC422924-LOC771798-LOC771804-LOC771880-LOC777408-TCD8AL1-TCD8AL4	0	0	6	3	234.63	469.26	15	2	1	NA	1	NA	9	0
CD8B	0	0	4	5	202.95	405.9	15	2	1	NA	1	NA	9	0
CD99L2	0	0	2	7	252.45	504.9	15	2	1	NA	1	NA	9	0
CDA	0	0	2	0	141.57	283.14	15	2	1	NA	1	NA	2	0
CDAN1	0	0	3	3	1298.55	2597.1	15	2	1	NA	1	NA	6	0
CDC14A	0	0	5	6	609.51	1219.02	15	2	1	NA	1	NA	11	0
CDC14B	0	0	3	4	404.91	809.82	15	2	1	NA	1	NA	7	0
CDC20	0	0	3	8	500.94	1001.88	15	2	1	NA	1	NA	11	0
CDC20B	0	0	5	1	322.74	645.48	15	2	1	NA	1	NA	6	0
CDC23	0	0	1	2	571.89	1143.78	15	2	1	NA	1	NA	3	0
CDC27	0	0	0	8	826.65	1653.3	15	2	1	NA	1	NA	8	0
CDC34	0	0	0	3	233.64	467.28	15	2	1	NA	1	NA	3	0
CDC42BPB	0	0	1	14	1702.8	3405.6	15	2	1	NA	1	NA	15	0
CDC42EP4	0	0	3	12	302.94	605.88	15	2	1	NA	1	NA	15	0
CDC45	0	0	0	5	561.33	1122.66	15	2	1	NA	1	NA	5	0
CDC7	0	0	1	2	551.43	1102.86	15	2	1	NA	1	NA	3	0
CDCA2	0	0	12	7	1035.87	2071.74	15	2	1	NA	1	NA	19	0
CDCA4	0	0	2	3	342.54	685.08	15	2	1	NA	1	NA	5	0
CDCA4L	0	0	0	2	281.16	562.32	15	2	1	NA	1	NA	2	0
CDCA7	0	0	0	3	407.88	815.76	15	2	1	NA	1	NA	3	0
CDCA9	0	0	0	4	285.12	570.24	15	2	1	NA	1	NA	4	0
CDCP2	0	0	12	15	528	1056	15	2	1	NA	1	NA	27	0
CDH11	0	0	0	3	785.07	1570.14	15	2	1	NA	1	NA	3	0
CDH13	0	0	4	0	432.96	865.92	15	2	1	NA	1	NA	4	0
CDH22	0	0	4	5	763.29	1526.58	15	2	1	NA	1	NA	9	0
CDH23	0	0	28	67	3407.25	6814.5	15	2	1	NA	1	NA	95	0
CDH4	0	0	3	5	770.22	1540.44	15	2	1	NA	1	NA	8	0
CDH5	0	0	1	1	762.63	1525.26	15	2	1	NA	1	NA	2	0
CDH8	0	0	2	1	747.45	1494.9	15	2	1	NA	1	NA	3	0
CDHR1	0	0	4	3	803.88	1607.76	15	2	1	NA	1	NA	7	0
CDHR2	0	0	11	33	1278.42	2556.84	15	2	1	NA	1	NA	44	0
CDK11A	0	0	2	5	760.98	1521.96	15	2	1	NA	1	NA	7	0
CDK12	0	0	11	16	1473.78	2947.56	15	2	1	NA	1	NA	27	0
CDK15	0	0	3	3	269.28	538.56	15	2	1	NA	1	NA	6	0
CDK18	0	0	4	4	473.88	947.76	15	2	1	NA	1	NA	8	0
CDK3	0	0	3	5	306.9	613.8	15	2	1	NA	1	NA	8	0
CDK5RAP1	0	0	7	17	915.75	1831.5	15	2	1	NA	1	NA	24	0
CDK5RAP2	0	0	10	6	1943.37	3886.74	15	2	1	NA	1	NA	16	0
CDK5RAP3	0	0	6	7	482.46	964.92	15	2	1	NA	1	NA	13	0
CDK7	0	0	0	4	333.63	667.26	15	2	1	NA	1	NA	4	0
CDKL1	0	0	2	7	349.47	698.94	15	2	1	NA	1	NA	9	0
CDKL2	0	0	5	6	526.68	1053.36	15	2	1	NA	1	NA	11	0
CDKN3	0	0	2	5	204.93	409.86	15	2	1	NA	1	NA	7	0
CDO1	0	0	1	1	192.72	385.44	15	2	1	NA	1	NA	2	0
CDON	0	0	6	1	1245.42	2490.84	15	2	1	NA	1	NA	7	0
CDR2	0	0	0	3	453.42	906.84	15	2	1	NA	1	NA	3	0
CDR2L	0	0	1	4	458.04	916.08	15	2	1	NA	1	NA	5	0
CDRT1	0	0	14	15	1040.82	2081.64	15	2	1	NA	1	NA	29	0
CDT1	0	0	14	10	560.34	1120.68	15	2	1	NA	1	NA	24	0
CEBPA	0	0	2	0	314.49	628.98	15	2	1	NA	1	NA	2	0
CECR5L	0	0	3	1	400.95	801.9	15	2	1	NA	1	NA	4	0
CEL	0	0	0	3	551.43	1102.86	15	2	1	NA	1	NA	3	0
CELA3B	0	0	0	6	195.36	390.72	15	2	1	NA	1	NA	6	0
CELF1	0	0	0	4	481.14	962.28	15	2	1	NA	1	NA	4	0
CELF6	0	0	2	12	353.43	706.86	15	2	1	NA	1	NA	14	0
CEMIP	0	0	6	9	1347.39	2694.78	15	2	1	NA	1	NA	15	0
CENPC	0	0	4	3	918.72	1837.44	15	2	1	NA	1	NA	7	0
CENPE	0	0	15	8	2119.59	4239.18	15	2	1	NA	1	NA	23	0
CENPI	0	0	6	7	693.66	1387.32	15	2	1	NA	1	NA	13	0
CENPL	0	0	4	3	341.55	683.1	15	2	1	NA	1	NA	7	0
CENPS	0	0	1	3	139.59	279.18	15	2	1	NA	1	NA	4	0
CENPT	0	0	5	4	688.05	1376.1	15	2	1	NA	1	NA	9	0
CENPV	0	0	0	3	217.8	435.6	15	2	1	NA	1	NA	3	0
CEP104	0	0	9	6	942.48	1884.96	15	2	1	NA	1	NA	15	0
CEP112	0	0	11	5	941.49	1882.98	15	2	1	NA	1	NA	16	0
CEP120	0	0	5	3	957.33	1914.66	15	2	1	NA	1	NA	8	0
CEP128	0	0	6	1	1089	2178	15	2	1	NA	1	NA	7	0
CEP135	0	0	7	6	1139.49	2278.98	15	2	1	NA	1	NA	13	0
CEP152	0	0	7	1	2162.16	4324.32	15	2	1	NA	1	NA	8	0
CEP164	0	0	19	14	1918.29	3836.58	15	2	1	NA	1	NA	33	0
CEP170B	0	0	4	11	1480.05	2960.1	15	2	1	NA	1	NA	15	0
CEP19	0	0	1	2	162.36	324.72	15	2	1	NA	1	NA	3	0
CEP250	0	0	16	11	2374.02	4748.04	15	2	1	NA	1	NA	27	0
CEP350	0	0	18	10	3186.81	6373.62	15	2	1	NA	1	NA	28	0
CEP350L	0	0	54	29	2800.71	5601.42	15	2	1	NA	1	NA	83	0
CEP44	0	0	1	2	381.15	762.3	15	2	1	NA	1	NA	3	0
CEP55	0	0	4	1	456.39	912.78	15	2	1	NA	1	NA	5	0
CEP63	0	0	2	1	712.8	1425.6	15	2	1	NA	1	NA	3	0
CEP70	0	0	3	2	579.15	1158.3	15	2	1	NA	1	NA	5	0
CEP85	0	0	10	6	776.16	1552.32	15	2	1	NA	1	NA	16	0
CEP95	0	0	8	2	867.24	1734.48	15	2	1	NA	1	NA	10	0
CEPT1	0	0	2	6	430.65	861.3	15	2	1	NA	1	NA	8	0
CERKL	0	0	3	3	493.02	986.04	15	2	1	NA	1	NA	6	0
CERS1	0	0	2	4	354.42	708.84	15	2	1	NA	1	NA	6	0
CERS3	0	0	11	4	769.23	1538.46	15	2	1	NA	1	NA	15	0
CERS4	0	0	2	3	511.83	1023.66	15	2	1	NA	1	NA	5	0
CERS4L	0	0	3	1	351.45	702.9	15	2	1	NA	1	NA	4	0
CERS5	0	0	2	5	391.05	782.1	15	2	1	NA	1	NA	7	0
CERS6	0	0	1	1	528.66	1057.32	15	2	1	NA	1	NA	2	0
CETN1	0	0	0	2	170.28	340.56	15	2	1	NA	1	NA	2	0
CFAP161	0	0	3	2	302.94	605.88	15	2	1	NA	1	NA	5	0
CFAP221	0	0	7	3	849.09	1698.18	15	2	1	NA	1	NA	10	0
CFAP43	0	0	14	6	1672.11	3344.22	15	2	1	NA	1	NA	20	0
CFAP52	0	0	5	2	569.25	1138.5	15	2	1	NA	1	NA	7	0
CFAP57	0	0	7	6	1228.59	2457.18	15	2	1	NA	1	NA	13	0
CFAP58	0	0	4	2	957.66	1915.32	15	2	1	NA	1	NA	6	0
CFAP65	0	0	26	18	1753.62	3507.24	15	2	1	NA	1	NA	44	0
CFAP73	0	0	8	10	322.41	644.82	15	2	1	NA	1	NA	18	0
CFAP74	0	0	19	7	1582.68	3165.36	15	2	1	NA	1	NA	26	0
CFAP77	0	0	1	3	252.78	505.56	15	2	1	NA	1	NA	4	0
CFAP99	0	0	4	4	653.4	1306.8	15	2	1	NA	1	NA	8	0
CFC1	0	0	0	2	170.61	341.22	15	2	1	NA	1	NA	2	0
CFD	0	0	5	7	260.04	520.08	15	2	1	NA	1	NA	12	0
CFDP1	0	0	1	2	281.16	562.32	15	2	1	NA	1	NA	3	0
CFH	0	0	3	12	937.53	1875.06	15	2	1	NA	1	NA	15	0
CFI	0	0	5	3	512.82	1025.64	15	2	1	NA	1	NA	8	0
CFLAR	0	0	0	3	485.1	970.2	15	2	1	NA	1	NA	3	0
CG-16	0	0	1	3	133.65	267.3	15	2	1	NA	1	NA	4	0
CGN	0	0	8	5	1259.28	2518.56	15	2	1	NA	1	NA	13	0
CGNL1	0	0	11	7	1302.84	2605.68	15	2	1	NA	1	NA	18	0
CGNRHRL	0	0	9	11	367.29	734.58	15	2	1	NA	1	NA	20	0
CGRRF1	0	0	3	0	339.57	679.14	15	2	1	NA	1	NA	3	0
CH25H	0	0	0	4	272.25	544.5	15	2	1	NA	1	NA	4	0
CHAC1	0	0	1	6	232.65	465.3	15	2	1	NA	1	NA	7	0
CHAD	0	0	4	6	356.4	712.8	15	2	1	NA	1	NA	10	0
CHAF1A	0	0	8	17	879.45	1758.9	15	2	1	NA	1	NA	25	0
CHAT	0	0	3	0	629.64	1259.28	15	2	1	NA	1	NA	3	0
CHCHD1	0	0	2	0	123.75	247.5	15	2	1	NA	1	NA	2	0
CHCHD10	0	0	1	5	134.64	269.28	15	2	1	NA	1	NA	6	0
CHCHD2	0	0	0	2	98.01	196.02	15	2	1	NA	1	NA	2	0
CHCHD6	0	0	1	4	312.18	624.36	15	2	1	NA	1	NA	5	0
CHD1Z-CHDB1	0	0	16	37	1536.81	3073.62	15	2	1	NA	1	NA	53	0
CHD2	0	0	2	4	1846.02	3692.04	15	2	1	NA	1	NA	6	0
CHD5	0	0	4	12	1898.82	3797.64	15	2	1	NA	1	NA	16	0
CHD9	0	0	6	17	2861.1	5722.2	15	2	1	NA	1	NA	23	0
CHDH	0	0	1	2	604.89	1209.78	15	2	1	NA	1	NA	3	0
CHERP	0	0	1	6	901.89	1803.78	15	2	1	NA	1	NA	7	0
CHFR	0	0	0	3	671.22	1342.44	15	2	1	NA	1	NA	3	0
CHGA	0	0	6	4	454.41	908.82	15	2	1	NA	1	NA	10	0
CHIA-CHIA-M31-LOC768786	0	0	15	15	1007.82	2015.64	15	2	1	NA	1	NA	30	0
CHIC2	0	0	2	2	164.34	328.68	15	2	1	NA	1	NA	4	0
CHID1	0	0	1	1	313.83	627.66	15	2	1	NA	1	NA	2	0
CHKA	0	0	3	2	424.05	848.1	15	2	1	NA	1	NA	5	0
CHL1	0	0	3	6	1197.9	2395.8	15	2	1	NA	1	NA	9	0
CHM	0	0	4	3	649.44	1298.88	15	2	1	NA	1	NA	7	0
CHMP1A	0	0	0	4	170.61	341.22	15	2	1	NA	1	NA	4	0
CHMP7	0	0	3	4	440.22	880.44	15	2	1	NA	1	NA	7	0
CHN1	0	0	0	3	455.4	910.8	15	2	1	NA	1	NA	3	0
CHP1	0	0	0	2	194.04	388.08	15	2	1	NA	1	NA	2	0
CHPF	0	0	7	11	661.65	1323.3	15	2	1	NA	1	NA	18	0
CHRD	0	0	6	19	894.3	1788.6	15	2	1	NA	1	NA	25	0
CHRDL1	0	0	1	3	452.43	904.86	15	2	1	NA	1	NA	4	0
CHRM4	0	0	2	7	519.75	1039.5	15	2	1	NA	1	NA	9	0
CHRNA1	0	0	3	3	452.43	904.86	15	2	1	NA	1	NA	6	0
CHRNA3	0	0	0	2	477.18	954.36	15	2	1	NA	1	NA	2	0
CHRNA4	0	0	2	9	618.75	1237.5	15	2	1	NA	1	NA	11	0
CHRNA6	0	0	0	3	486.09	972.18	15	2	1	NA	1	NA	3	0
CHRNA7	0	0	0	3	497.97	995.94	15	2	1	NA	1	NA	3	0
CHRNA7L	0	0	4	6	542.85	1085.7	15	2	1	NA	1	NA	10	0
CHRNA9	0	0	3	6	482.13	964.26	15	2	1	NA	1	NA	9	0
CHRNB2	0	0	2	11	418.77	837.54	15	2	1	NA	1	NA	13	0
CHRNB3	0	0	3	8	450.45	900.9	15	2	1	NA	1	NA	11	0
CHRNB4	0	0	1	2	485.1	970.2	15	2	1	NA	1	NA	3	0
CHRND	0	0	3	14	511.83	1023.66	15	2	1	NA	1	NA	17	0
CHRNG	0	0	1	11	498.3	996.6	15	2	1	NA	1	NA	12	0
CHST1	0	0	2	11	415.8	831.6	15	2	1	NA	1	NA	13	0
CHST12	0	0	2	2	415.8	831.6	15	2	1	NA	1	NA	4	0
CHST13	0	0	3	4	338.58	677.16	15	2	1	NA	1	NA	7	0
CHST15	0	0	2	0	555.39	1110.78	15	2	1	NA	1	NA	2	0
CHST2	0	0	1	1	354.75	709.5	15	2	1	NA	1	NA	2	0
CHST3	0	0	3	5	457.38	914.76	15	2	1	NA	1	NA	8	0
CHST8	0	0	2	1	400.95	801.9	15	2	1	NA	1	NA	3	0
CHSY1	0	0	1	8	525.69	1051.38	15	2	1	NA	1	NA	9	0
CHSY3	0	0	2	0	516.12	1032.24	15	2	1	NA	1	NA	2	0
CHTF18	0	0	15	19	970.86	1941.72	15	2	1	NA	1	NA	34	0
CHTOP	0	0	1	4	214.83	429.66	15	2	1	NA	1	NA	5	0
CHUK	0	0	1	1	781.77	1563.54	15	2	1	NA	1	NA	2	0
CIAPIN1	0	0	2	0	305.91	611.82	15	2	1	NA	1	NA	2	0
CIB1	0	0	2	1	172.26	344.52	15	2	1	NA	1	NA	3	0
CIB2	0	0	0	3	240.57	481.14	15	2	1	NA	1	NA	3	0
CIDEC	0	0	3	4	243.21	486.42	15	2	1	NA	1	NA	7	0
CIITA	0	0	5	5	1251.69	2503.38	15	2	1	NA	1	NA	10	0
CILP	0	0	16	25	1094.94	2189.88	15	2	1	NA	1	NA	41	0
CINP	0	0	3	1	209.88	419.76	15	2	1	NA	1	NA	4	0
CIPC	0	0	1	1	369.27	738.54	15	2	1	NA	1	NA	2	0
CIR1	0	0	2	3	460.35	920.7	15	2	1	NA	1	NA	5	0
CISD2	0	0	0	3	132.33	264.66	15	2	1	NA	1	NA	3	0
CISH	0	0	0	4	256.41	512.82	15	2	1	NA	1	NA	4	0
CITED4	0	0	0	2	202.95	405.9	15	2	1	NA	1	NA	2	0
CIZ1	0	0	4	6	737.55	1475.1	15	2	1	NA	1	NA	10	0
CKAP5	0	0	2	9	2044.68	4089.36	15	2	1	NA	1	NA	11	0
CKLF	0	0	4	4	99.99	199.98	15	2	1	NA	1	NA	8	0
CKMT1A	0	0	2	3	397.32	794.64	15	2	1	NA	1	NA	5	0
CLASP1	0	0	2	3	1442.43	2884.86	15	2	1	NA	1	NA	5	0
CLCA1	0	0	10	10	1645.71	3291.42	15	2	1	NA	1	NA	20	0
CLCC1	0	0	2	7	510.84	1021.68	15	2	1	NA	1	NA	9	0
CLCN2	0	0	6	18	854.04	1708.08	15	2	1	NA	1	NA	24	0
CLCN3	0	0	0	8	758.01	1516.02	15	2	1	NA	1	NA	8	0
CLCN5	0	0	1	2	812.79	1625.58	15	2	1	NA	1	NA	3	0
CLCN6	0	0	1	7	861.3	1722.6	15	2	1	NA	1	NA	8	0
CLCNKB	0	0	7	8	580.47	1160.94	15	2	1	NA	1	NA	15	0
CLDN1	0	0	0	2	209.88	419.76	15	2	1	NA	1	NA	2	0
CLDN11	0	0	2	6	205.92	411.84	15	2	1	NA	1	NA	8	0
CLDN16	0	0	1	1	245.52	491.04	15	2	1	NA	1	NA	2	0
CLDN16L	0	0	5	1	228.69	457.38	15	2	1	NA	1	NA	6	0
CLDN18	0	0	0	5	257.4	514.8	15	2	1	NA	1	NA	5	0
CLDN19	0	0	2	1	209.88	419.76	15	2	1	NA	1	NA	3	0
CLDN2	0	0	4	4	229.68	459.36	15	2	1	NA	1	NA	8	0
CLDN3	0	0	0	2	212.52	425.04	15	2	1	NA	1	NA	2	0
CLDN4	0	0	0	3	187.77	375.54	15	2	1	NA	1	NA	3	0
CLDN5	0	0	0	3	214.83	429.66	15	2	1	NA	1	NA	3	0
CLDN9	0	0	0	2	212.85	425.7	15	2	1	NA	1	NA	2	0
CLEC16A	0	0	1	5	1026.63	2053.26	15	2	1	NA	1	NA	6	0
CLEC18B	0	0	6	10	396.33	792.66	15	2	1	NA	1	NA	16	0
CLEC3A	0	0	1	1	192.06	384.12	15	2	1	NA	1	NA	2	0
CLEC5A	0	0	2	2	176.55	353.1	15	2	1	NA	1	NA	4	0
CLGN	0	0	0	3	633.27	1266.54	15	2	1	NA	1	NA	3	0
CLIC2	0	0	1	3	242.55	485.1	15	2	1	NA	1	NA	4	0
CLINT1	0	0	1	2	643.5	1287	15	2	1	NA	1	NA	3	0
CLIP1	0	0	10	14	2253.24	4506.48	15	2	1	NA	1	NA	24	0
CLIP2	0	0	5	24	1030.59	2061.18	15	2	1	NA	1	NA	29	0
CLK1	0	0	1	7	456.39	912.78	15	2	1	NA	1	NA	8	0
CLK3	0	0	1	8	491.04	982.08	15	2	1	NA	1	NA	9	0
CLMN	0	0	5	2	858.33	1716.66	15	2	1	NA	1	NA	7	0
CLMP	0	0	1	5	382.14	764.28	15	2	1	NA	1	NA	6	0
CLN6	0	0	0	4	287.43	574.86	15	2	1	NA	1	NA	4	0
CLNK	0	0	0	5	522.06	1044.12	15	2	1	NA	1	NA	5	0
CLOCK	0	0	4	1	894.96	1789.92	15	2	1	NA	1	NA	5	0
CLP1	0	0	0	11	421.74	843.48	15	2	1	NA	1	NA	11	0
CLPS	0	0	3	4	117.81	235.62	15	2	1	NA	1	NA	7	0
CLPX	0	0	2	6	615.78	1231.56	15	2	1	NA	1	NA	8	0
CLRN1	0	0	2	6	230.67	461.34	15	2	1	NA	1	NA	8	0
CLRN3	0	0	3	5	225.72	451.44	15	2	1	NA	1	NA	8	0
CLSPN	0	0	13	16	1306.8	2613.6	15	2	1	NA	1	NA	29	0
CLSTN1	0	0	0	7	990.99	1981.98	15	2	1	NA	1	NA	7	0
CLSTN2	0	0	6	5	892.98	1785.96	15	2	1	NA	1	NA	11	0
CLTB	0	0	1	6	208.89	417.78	15	2	1	NA	1	NA	7	0
CLTC	0	0	0	11	1659.24	3318.48	15	2	1	NA	1	NA	11	0
CLTCL1	0	0	2	18	1654.29	3308.58	15	2	1	NA	1	NA	20	0
CLUH	0	0	4	18	1540.11	3080.22	15	2	1	NA	1	NA	22	0
CMIP	0	0	0	6	704.88	1409.76	15	2	1	NA	1	NA	6	0
CMPK1	0	0	0	2	195.03	390.06	15	2	1	NA	1	NA	2	0
CMYA5	0	0	39	17	4373.82	8747.64	15	2	1	NA	1	NA	56	0
CNBP	0	0	0	2	170.28	340.56	15	2	1	NA	1	NA	2	0
CNGA1	0	0	3	6	638.55	1277.1	15	2	1	NA	1	NA	9	0
CNGA2	0	0	14	9	653.07	1306.14	15	2	1	NA	1	NA	23	0
CNGB1	0	0	12	18	1162.59	2325.18	15	2	1	NA	1	NA	30	0
CNKSR1	0	0	14	19	590.7	1181.4	15	2	1	NA	1	NA	33	0
CNKSR2L	0	0	2	3	992.64	1985.28	15	2	1	NA	1	NA	5	0
CNN2	0	0	0	11	239.58	479.16	15	2	1	NA	1	NA	11	0
CNN3	0	0	0	3	328.68	657.36	15	2	1	NA	1	NA	3	0
CNOT6	0	0	0	4	552.42	1104.84	15	2	1	NA	1	NA	4	0
CNOT7	0	0	0	2	283.14	566.28	15	2	1	NA	1	NA	2	0
CNOT8	0	0	1	2	290.07	580.14	15	2	1	NA	1	NA	3	0
CNOT9	0	0	0	3	289.08	578.16	15	2	1	NA	1	NA	3	0
CNP	0	0	1	6	399.96	799.92	15	2	1	NA	1	NA	7	0
CNPPD1	0	0	5	10	417.78	835.56	15	2	1	NA	1	NA	15	0
CNTF	0	0	2	3	195.03	390.06	15	2	1	NA	1	NA	5	0
CNTFR	0	0	0	3	377.85	755.7	15	2	1	NA	1	NA	3	0
CNTLN	0	0	6	0	737.55	1475.1	15	2	1	NA	1	NA	6	0
CNTN2	0	0	2	13	1016.73	2033.46	15	2	1	NA	1	NA	15	0
CNTN3	0	0	5	11	892.98	1785.96	15	2	1	NA	1	NA	16	0
CNTN4	0	0	3	9	1019.7	2039.4	15	2	1	NA	1	NA	12	0
CNTN6	0	0	7	3	1032.9	2065.8	15	2	1	NA	1	NA	10	0
CNTNAP1	0	0	3	36	1312.74	2625.48	15	2	1	NA	1	NA	39	0
CNTNAP5	0	0	3	8	1265.88	2531.76	15	2	1	NA	1	NA	11	0
CNTRL	0	0	21	16	2311.65	4623.3	15	2	1	NA	1	NA	37	0
COA7	0	0	2	1	229.68	459.36	15	2	1	NA	1	NA	3	0
COBLL1	0	0	5	4	1148.4	2296.8	15	2	1	NA	1	NA	9	0
COCH	0	0	2	1	532.62	1065.24	15	2	1	NA	1	NA	3	0
COG1	0	0	19	18	924.99	1849.98	15	2	1	NA	1	NA	37	0
COG7	0	0	6	6	760.98	1521.96	15	2	1	NA	1	NA	12	0
COG8	0	0	0	5	187.11	374.22	15	2	1	NA	1	NA	5	0
COIL	0	0	2	1	605.55	1211.1	15	2	1	NA	1	NA	3	0
COL11A1	0	0	11	5	1902.78	3805.56	15	2	1	NA	1	NA	16	0
COL13A1	0	0	8	7	724.68	1449.36	15	2	1	NA	1	NA	15	0
COL16A1	0	0	15	38	1522.62	3045.24	15	2	1	NA	1	NA	53	0
COL17A1	0	0	10	13	1480.05	2960.1	15	2	1	NA	1	NA	23	0
COL18A1	0	0	21	30	1432.53	2865.06	15	2	1	NA	1	NA	51	0
COL1A1	0	0	6	10	879.78	1759.56	15	2	1	NA	1	NA	16	0
COL20A1	0	0	18	24	1458.27	2916.54	15	2	1	NA	1	NA	42	0
COL24A1	0	0	4	6	1650.33	3300.66	15	2	1	NA	1	NA	10	0
COL26A1	0	0	7	9	557.37	1114.74	15	2	1	NA	1	NA	16	0
COL2A1L	0	0	37	29	1612.05	3224.1	15	2	1	NA	1	NA	66	0
COL3A1	0	0	0	5	1445.4	2890.8	15	2	1	NA	1	NA	5	0
COL4A3	0	0	17	15	1664.19	3328.38	15	2	1	NA	1	NA	32	0
COL4A3BP	0	0	0	2	613.47	1226.94	15	2	1	NA	1	NA	2	0
COL4A4	0	0	11	9	1662.21	3324.42	15	2	1	NA	1	NA	20	0
COL4A5	0	0	2	6	1672.77	3345.54	15	2	1	NA	1	NA	8	0
COL4A6	0	0	7	14	1690.26	3380.52	15	2	1	NA	1	NA	21	0
COL5A1	0	0	1	20	1781.01	3562.02	15	2	1	NA	1	NA	21	0
COL5A2	0	0	0	7	1450.02	2900.04	15	2	1	NA	1	NA	7	0
COL6A1	0	0	9	22	1009.47	2018.94	15	2	1	NA	1	NA	31	0
COL6A2	0	0	0	5	902.88	1805.76	15	2	1	NA	1	NA	5	0
COL6A3	0	0	7	11	3145.89	6291.78	15	2	1	NA	1	NA	18	0
COL8A2	0	0	3	15	688.05	1376.1	15	2	1	NA	1	NA	18	0
COL9A2	0	0	5	18	449.46	898.92	15	2	1	NA	1	NA	23	0
COL9A3	0	0	1	7	669.24	1338.48	15	2	1	NA	1	NA	8	0
COLCA2	0	0	1	5	236.61	473.22	15	2	1	NA	1	NA	6	0
COLGALT2	0	0	2	2	569.58	1139.16	15	2	1	NA	1	NA	4	0
COMMD4	0	0	1	6	197.01	394.02	15	2	1	NA	1	NA	7	0
COMMD7	0	0	1	1	171.27	342.54	15	2	1	NA	1	NA	2	0
COMMD9	0	0	3	4	197.01	394.02	15	2	1	NA	1	NA	7	0
COMT	0	0	2	2	281.16	562.32	15	2	1	NA	1	NA	4	0
COMTD1	0	0	2	1	258.39	516.78	15	2	1	NA	1	NA	3	0
COPA	0	0	3	9	1212.75	2425.5	15	2	1	NA	1	NA	12	0
COPB1	0	0	13	15	1093.95	2187.9	15	2	1	NA	1	NA	28	0
COPB2	0	0	1	15	904.2	1808.4	15	2	1	NA	1	NA	16	0
COPE	0	0	3	4	303.93	607.86	15	2	1	NA	1	NA	7	0
COPRS	0	0	2	1	181.17	362.34	15	2	1	NA	1	NA	3	0
COPS4	0	0	0	3	402.93	805.86	15	2	1	NA	1	NA	3	0
COPS7B	0	0	1	2	286.77	573.54	15	2	1	NA	1	NA	3	0
COPZ1	0	0	0	4	91.08	182.16	15	2	1	NA	1	NA	4	0
COQ10A	0	0	1	4	211.2	422.4	15	2	1	NA	1	NA	5	0
COQ2	0	0	3	3	451.44	902.88	15	2	1	NA	1	NA	6	0
COQ6	0	0	4	5	479.49	958.98	15	2	1	NA	1	NA	9	0
COQ9	0	0	2	0	292.71	585.42	15	2	1	NA	1	NA	2	0
COR8	0	0	3	5	319.77	639.54	15	2	1	NA	1	NA	8	0
CORIN	0	0	11	8	1432.53	2865.06	15	2	1	NA	1	NA	19	0
CORO1C	0	0	6	15	836.22	1672.44	15	2	1	NA	1	NA	21	0
CORO2A	0	0	2	1	515.79	1031.58	15	2	1	NA	1	NA	3	0
CORO2B	0	0	1	15	468.6	937.2	15	2	1	NA	1	NA	16	0
CORO6	0	0	0	8	488.73	977.46	15	2	1	NA	1	NA	8	0
COTL1	0	0	4	1	172.92	345.84	15	2	1	NA	1	NA	5	0
COX10	0	0	0	2	209.88	419.76	15	2	1	NA	1	NA	2	0
COX18	0	0	4	3	300.96	601.92	15	2	1	NA	1	NA	7	0
COX5A	0	0	0	2	116.49	232.98	15	2	1	NA	1	NA	2	0
CP	0	0	5	4	1069.2	2138.4	15	2	1	NA	1	NA	9	0
CPAMD8	0	0	4	9	1845.36	3690.72	15	2	1	NA	1	NA	13	0
CPD	0	0	4	15	1268.52	2537.04	15	2	1	NA	1	NA	19	0
CPE	0	0	1	2	429.33	858.66	15	2	1	NA	1	NA	3	0
CPEB1	0	0	1	7	555.72	1111.44	15	2	1	NA	1	NA	8	0
CPEB2	0	0	3	6	831.6	1663.2	15	2	1	NA	1	NA	9	0
CPEB3	0	0	0	2	667.26	1334.52	15	2	1	NA	1	NA	2	0
CPEB4	0	0	1	2	696.96	1393.92	15	2	1	NA	1	NA	3	0
CPLX2	0	0	0	4	133.65	267.3	15	2	1	NA	1	NA	4	0
CPN1	0	0	0	2	449.46	898.92	15	2	1	NA	1	NA	2	0
CPNE1	0	0	7	5	509.19	1018.38	15	2	1	NA	1	NA	12	0
CPNE2	0	0	2	3	539.55	1079.1	15	2	1	NA	1	NA	5	0
CPNE7	0	0	5	13	505.89	1011.78	15	2	1	NA	1	NA	18	0
CPNE9	0	0	1	11	488.07	976.14	15	2	1	NA	1	NA	12	0
CPPED1	0	0	3	1	309.87	619.74	15	2	1	NA	1	NA	4	0
CPS1	0	0	6	5	1585.32	3170.64	15	2	1	NA	1	NA	11	0
CPSF4L	0	0	5	5	236.94	473.88	15	2	1	NA	1	NA	10	0
CPSF7	0	0	1	5	353.76	707.52	15	2	1	NA	1	NA	6	0
CPT2	0	0	5	7	639.54	1279.08	15	2	1	NA	1	NA	12	0
CPTP	0	0	0	3	212.85	425.7	15	2	1	NA	1	NA	3	0
CPXM2	0	0	4	4	841.17	1682.34	15	2	1	NA	1	NA	8	0
CPZ	0	0	6	2	643.5	1287	15	2	1	NA	1	NA	8	0
CR1L	0	0	11	11	893.31	1786.62	15	2	1	NA	1	NA	22	0
CRACR2B	0	0	14	4	700.92	1401.84	15	2	1	NA	1	NA	18	0
CRAMP1	0	0	2	14	1345.41	2690.82	15	2	1	NA	1	NA	16	0
CRAT	0	0	1	8	620.4	1240.8	15	2	1	NA	1	NA	9	0
CRB1	0	0	7	3	1310.76	2621.52	15	2	1	NA	1	NA	10	0
CRB2	0	0	13	19	1458.93	2917.86	15	2	1	NA	1	NA	32	0
CRBN	0	0	0	3	442.53	885.06	15	2	1	NA	1	NA	3	0
CREB3	0	0	4	3	323.73	647.46	15	2	1	NA	1	NA	7	0
CREB3L1	0	0	1	3	482.13	964.26	15	2	1	NA	1	NA	4	0
CREB3L3	0	0	5	19	445.5	891	15	2	1	NA	1	NA	24	0
CREBRF	0	0	2	8	630.63	1261.26	15	2	1	NA	1	NA	10	0
CRHR1	0	0	1	1	415.8	831.6	15	2	1	NA	1	NA	2	0
CRIP2	0	0	0	3	198.33	396.66	15	2	1	NA	1	NA	3	0
CRISPLD2	0	0	2	4	498.96	997.92	15	2	1	NA	1	NA	6	0
CRLF3	0	0	1	3	422.4	844.8	15	2	1	NA	1	NA	4	0
CRMP1	0	0	1	1	567.27	1134.54	15	2	1	NA	1	NA	2	0
CROCC	0	0	40	49	1646.7	3293.4	15	2	1	NA	1	NA	89	0
CRP	0	0	1	2	225.72	451.44	15	2	1	NA	1	NA	3	0
CRTAC1	0	0	12	19	623.7	1247.4	15	2	1	NA	1	NA	31	0
CRTAM	0	0	11	7	472.23	944.46	15	2	1	NA	1	NA	18	0
CRY2	0	0	3	3	541.53	1083.06	15	2	1	NA	1	NA	6	0
CRY4	0	0	7	9	524.7	1049.4	15	2	1	NA	1	NA	16	0
CRYAB	0	0	0	2	173.25	346.5	15	2	1	NA	1	NA	2	0
CRYBA1	0	0	1	1	213.84	427.68	15	2	1	NA	1	NA	2	0
CRYBA2	0	0	2	2	195.03	390.06	15	2	1	NA	1	NA	4	0
CRYBA4	0	0	7	8	195.03	390.06	15	2	1	NA	1	NA	15	0
CRYBB1	0	0	10	12	232.65	465.3	15	2	1	NA	1	NA	22	0
CRYBB2	0	0	0	7	199.98	399.96	15	2	1	NA	1	NA	7	0
CRYBB3	0	0	1	4	209.88	419.76	15	2	1	NA	1	NA	5	0
CRYGS	0	0	2	2	177.21	354.42	15	2	1	NA	1	NA	4	0
CRYZ	0	0	3	2	328.68	657.36	15	2	1	NA	1	NA	5	0
CS	0	0	1	5	459.36	918.72	15	2	1	NA	1	NA	6	0
CSE1L	0	0	1	7	1581.03	3162.06	15	2	1	NA	1	NA	8	0
CSF1	0	0	4	6	523.71	1047.42	15	2	1	NA	1	NA	10	0
CSF1R	0	0	10	13	979.11	1958.22	15	2	1	NA	1	NA	23	0
CSF2	0	0	2	2	121.11	242.22	15	2	1	NA	1	NA	4	0
CSF3	0	0	1	4	201.96	403.92	15	2	1	NA	1	NA	5	0
CSF3R	0	0	20	21	814.44	1628.88	15	2	1	NA	1	NA	41	0
CSGALNACT1	0	0	2	5	501.93	1003.86	15	2	1	NA	1	NA	7	0
CSGALNACT2	0	0	0	3	536.58	1073.16	15	2	1	NA	1	NA	3	0
CSK	0	0	1	4	446.49	892.98	15	2	1	NA	1	NA	5	0
CSMD2	0	0	9	31	3231.03	6462.06	15	2	1	NA	1	NA	40	0
CSNK1G1	0	0	0	8	460.35	920.7	15	2	1	NA	1	NA	8	0
CSNK2A1	0	0	0	5	388.08	776.16	15	2	1	NA	1	NA	5	0
CSNK2A2	0	0	1	1	313.17	626.34	15	2	1	NA	1	NA	2	0
CSPG4	0	0	46	40	2296.8	4593.6	15	2	1	NA	1	NA	86	0
CSRNP2	0	0	8	13	548.46	1096.92	15	2	1	NA	1	NA	21	0
CSRNP3	0	0	2	2	745.8	1491.6	15	2	1	NA	1	NA	4	0
CSRP1	0	0	0	5	191.07	382.14	15	2	1	NA	1	NA	5	0
CSTF2	0	0	0	9	568.26	1136.52	15	2	1	NA	1	NA	9	0
CSTF3	0	0	1	3	703.89	1407.78	15	2	1	NA	1	NA	4	0
CTBP2	0	0	17	26	950.73	1901.46	15	2	1	NA	1	NA	43	0
CTCF	0	0	1	2	734.58	1469.16	15	2	1	NA	1	NA	3	0
CTGFL	0	0	3	5	345.51	691.02	15	2	1	NA	1	NA	8	0
CTH	0	0	3	5	399.96	799.92	15	2	1	NA	1	NA	8	0
CTIF	0	0	1	4	430.65	861.3	15	2	1	NA	1	NA	5	0
CTNNA3	0	0	9	2	1020.03	2040.06	15	2	1	NA	1	NA	11	0
CTNNBL1	0	0	1	5	602.91	1205.82	15	2	1	NA	1	NA	6	0
CTNND1	0	0	1	13	949.41	1898.82	15	2	1	NA	1	NA	14	0
CTNS	0	0	5	2	379.17	758.34	15	2	1	NA	1	NA	7	0
CTPS1	0	0	2	5	586.08	1172.16	15	2	1	NA	1	NA	7	0
CTR9	0	0	3	7	1170.18	2340.36	15	2	1	NA	1	NA	10	0
CTRC	0	0	1	10	265.32	530.64	15	2	1	NA	1	NA	11	0
CTRL	0	0	0	2	253.44	506.88	15	2	1	NA	1	NA	2	0
CTSA	0	0	1	2	773.85	1547.7	15	2	1	NA	1	NA	3	0
CTSD	0	0	1	10	390.06	780.12	15	2	1	NA	1	NA	11	0
CTSE	0	0	7	7	390.06	780.12	15	2	1	NA	1	NA	14	0
CTSH	0	0	2	5	327.69	655.38	15	2	1	NA	1	NA	7	0
CTSK	0	0	0	3	331.65	663.3	15	2	1	NA	1	NA	3	0
CTSS	0	0	2	1	326.04	652.08	15	2	1	NA	1	NA	3	0
CTSV	0	0	2	1	396.66	793.32	15	2	1	NA	1	NA	3	0
CTTNBP2NL	0	0	3	2	633.6	1267.2	15	2	1	NA	1	NA	5	0
CTU2	0	0	7	12	452.76	905.52	15	2	1	NA	1	NA	19	0
CUEDC1	0	0	2	7	345.18	690.36	15	2	1	NA	1	NA	9	0
CUEDC2	0	0	0	5	282.15	564.3	15	2	1	NA	1	NA	5	0
CUL3	0	0	0	3	744.48	1488.96	15	2	1	NA	1	NA	3	0
CUL4B	0	0	0	2	821.7	1643.4	15	2	1	NA	1	NA	2	0
CUTA	0	0	1	1	160.38	320.76	15	2	1	NA	1	NA	2	0
CUX1	0	0	4	5	263.01	526.02	15	2	1	NA	1	NA	9	0
CUX2	0	0	24	25	1325.28	2650.56	15	2	1	NA	1	NA	49	0
CUZD1	0	0	11	9	593.01	1186.02	15	2	1	NA	1	NA	20	0
CWC22	0	0	3	2	861.96	1723.92	15	2	1	NA	1	NA	5	0
CWC25	0	0	2	5	426.36	852.72	15	2	1	NA	1	NA	7	0
CWH43	0	0	6	2	731.61	1463.22	15	2	1	NA	1	NA	8	0
CX3CL1	0	0	10	7	600.6	1201.2	15	2	1	NA	1	NA	17	0
CXCL13	0	0	5	0	116.82	233.64	15	2	1	NA	1	NA	5	0
CXCL13L3	0	0	1	1	104.94	209.88	15	2	1	NA	1	NA	2	0
CXCR1	0	0	2	8	352.44	704.88	15	2	1	NA	1	NA	10	0
CXCR4	0	0	0	4	363.33	726.66	15	2	1	NA	1	NA	4	0
CXorf65	0	0	1	3	178.2	356.4	15	2	1	NA	1	NA	4	0
CYB561	0	0	2	5	231.66	463.32	15	2	1	NA	1	NA	7	0
CYB561A3	0	0	2	2	233.64	467.28	15	2	1	NA	1	NA	4	0
CYB561D2	0	0	1	5	166.32	332.64	15	2	1	NA	1	NA	6	0
CYB5B	0	0	3	2	142.56	285.12	15	2	1	NA	1	NA	5	0
CYB5D2	0	0	2	6	253.44	506.88	15	2	1	NA	1	NA	8	0
CYB5R2	0	0	2	1	283.14	566.28	15	2	1	NA	1	NA	3	0
CYBA	0	0	5	7	152.13	304.26	15	2	1	NA	1	NA	12	0
CYBRD1	0	0	1	2	281.16	562.32	15	2	1	NA	1	NA	3	0
CYFIP2	0	0	0	4	1241.46	2482.92	15	2	1	NA	1	NA	4	0
CYGB	0	0	0	2	178.2	356.4	15	2	1	NA	1	NA	2	0
CYLD	0	0	2	10	945.45	1890.9	15	2	1	NA	1	NA	12	0
CYP11A1	0	0	5	13	502.59	1005.18	15	2	1	NA	1	NA	18	0
CYP19A1	0	0	1	2	498.96	997.92	15	2	1	NA	1	NA	3	0
CYP1A1	0	0	8	17	515.79	1031.58	15	2	1	NA	1	NA	25	0
CYP1A2	0	0	10	14	505.56	1011.12	15	2	1	NA	1	NA	24	0
CYP1C1	0	0	7	6	509.85	1019.7	15	2	1	NA	1	NA	13	0
CYP20A1	0	0	2	0	453.09	906.18	15	2	1	NA	1	NA	2	0
CYP21A1	0	0	5	7	264.33	528.66	15	2	1	NA	1	NA	12	0
CYP24A1	0	0	1	1	418.44	836.88	15	2	1	NA	1	NA	2	0
CYP26A1	0	0	1	3	487.08	974.16	15	2	1	NA	1	NA	4	0
CYP26B1	0	0	1	8	469.92	939.84	15	2	1	NA	1	NA	9	0
CYP26C1	0	0	1	2	562.32	1124.64	15	2	1	NA	1	NA	3	0
CYP27C1	0	0	5	3	551.43	1102.86	15	2	1	NA	1	NA	8	0
CYP2AB1	0	0	3	4	485.1	970.2	15	2	1	NA	1	NA	7	0
CYP2AB2	0	0	0	4	480.81	961.62	15	2	1	NA	1	NA	4	0
CYP2AB3	0	0	4	3	485.43	970.86	15	2	1	NA	1	NA	7	0
CYP2AB4	0	0	2	1	486.09	972.18	15	2	1	NA	1	NA	3	0
CYP2AB5	0	0	3	6	441.54	883.08	15	2	1	NA	1	NA	9	0
CYP2AC7	0	0	2	5	919.71	1839.42	15	2	1	NA	1	NA	7	0
CYP2C23a-CYP2C23b	0	0	0	4	490.05	980.1	15	2	1	NA	1	NA	4	0
CYP2C45-RP11-400G3.5	0	0	0	3	490.05	980.1	15	2	1	NA	1	NA	3	0
CYP2J19	0	0	6	8	494.01	988.02	15	2	1	NA	1	NA	14	0
CYP2J21-CYP2J22-CYP2J23	0	0	1	12	487.08	974.16	15	2	1	NA	1	NA	13	0
CYP2R1	0	0	3	3	424.05	848.1	15	2	1	NA	1	NA	6	0
CYP2U1	0	0	2	5	471.57	943.14	15	2	1	NA	1	NA	7	0
CYP2W2	0	0	2	0	488.07	976.14	15	2	1	NA	1	NA	2	0
CYP3A4	0	0	2	8	505.89	1011.78	15	2	1	NA	1	NA	10	0
CYP3A5	0	0	0	9	505.89	1011.78	15	2	1	NA	1	NA	9	0
CYP46A1	0	0	3	2	499.95	999.9	15	2	1	NA	1	NA	5	0
CYP4A22	0	0	3	6	462.33	924.66	15	2	1	NA	1	NA	9	0
CYP4V2	0	0	5	2	1045.44	2090.88	15	2	1	NA	1	NA	7	0
CYR61	0	0	2	2	372.24	744.48	15	2	1	NA	1	NA	4	0
CYTIP	0	0	1	4	322.74	645.48	15	2	1	NA	1	NA	5	0
CYTL1	0	0	2	0	129.69	259.38	15	2	1	NA	1	NA	2	0
CZH18ORF25	0	0	2	3	332.31	664.62	15	2	1	NA	1	NA	5	0
CZH18ORF32	0	0	1	3	99.99	199.98	15	2	1	NA	1	NA	4	0
CZH5ORF34	0	0	4	0	573.87	1147.74	15	2	1	NA	1	NA	4	0
CZH5ORF42	0	0	10	6	2235.75	4471.5	15	2	1	NA	1	NA	16	0
CZH9ORF3	0	0	4	1	644.16	1288.32	15	2	1	NA	1	NA	5	0
CZH9orf24	0	0	1	1	246.84	493.68	15	2	1	NA	1	NA	2	0
CZH9orf64	0	0	1	1	318.78	637.56	15	2	1	NA	1	NA	2	0
CZH9orf72	0	0	0	3	477.18	954.36	15	2	1	NA	1	NA	3	0
D2HGDH	0	0	6	10	515.13	1030.26	15	2	1	NA	1	NA	16	0
DAAM1	0	0	4	10	1022.01	2044.02	15	2	1	NA	1	NA	14	0
DAB2	0	0	4	3	1152.69	2305.38	15	2	1	NA	1	NA	7	0
DAB2IP	0	0	5	12	1090.32	2180.64	15	2	1	NA	1	NA	17	0
DACT1	0	0	2	5	723.36	1446.72	15	2	1	NA	1	NA	7	0
DAD1	0	0	0	2	125.73	251.46	15	2	1	NA	1	NA	2	0
DAGLA	0	0	2	9	998.91	1997.82	15	2	1	NA	1	NA	11	0
DALRD3	0	0	4	8	528	1056	15	2	1	NA	1	NA	12	0
DAO	0	0	1	9	338.91	677.82	15	2	1	NA	1	NA	10	0
DAPK1	0	0	3	4	1290.3	2580.6	15	2	1	NA	1	NA	7	0
DAPK2	0	0	2	11	491.04	982.08	15	2	1	NA	1	NA	13	0
DAPP1	0	0	2	3	259.38	518.76	15	2	1	NA	1	NA	5	0
DARS	0	0	1	2	500.94	1001.88	15	2	1	NA	1	NA	3	0
DARS2	0	0	6	5	632.61	1265.22	15	2	1	NA	1	NA	11	0
DAW1	0	0	3	5	411.84	823.68	15	2	1	NA	1	NA	8	0
DAZAP1	0	0	1	1	405.9	811.8	15	2	1	NA	1	NA	2	0
DAZAP2	0	0	0	4	167.31	334.62	15	2	1	NA	1	NA	4	0
DBF4B	0	0	14	7	774.18	1548.36	15	2	1	NA	1	NA	21	0
DBH	0	0	6	18	626.67	1253.34	15	2	1	NA	1	NA	24	0
DBN1	0	0	7	15	518.1	1036.2	15	2	1	NA	1	NA	22	0
DBNDD1	0	0	3	1	148.17	296.34	15	2	1	NA	1	NA	4	0
DBNDD2	0	0	1	2	167.97	335.94	15	2	1	NA	1	NA	3	0
DBNL	0	0	5	14	390.72	781.44	15	2	1	NA	1	NA	19	0
DBR1	0	0	2	3	556.71	1113.42	15	2	1	NA	1	NA	5	0
DBT	0	0	3	5	489.06	978.12	15	2	1	NA	1	NA	8	0
DCAF1	0	0	5	5	1711.05	3422.1	15	2	1	NA	1	NA	10	0
DCAF10	0	0	0	3	413.49	826.98	15	2	1	NA	1	NA	3	0
DCAF17	0	0	2	4	540.54	1081.08	15	2	1	NA	1	NA	6	0
DCAF5	0	0	4	8	950.4	1900.8	15	2	1	NA	1	NA	12	0
DCAF8	0	0	6	9	511.83	1023.66	15	2	1	NA	1	NA	15	0
DCAKD	0	0	5	6	227.7	455.4	15	2	1	NA	1	NA	11	0
DCDC2B	0	0	6	2	247.5	495	15	2	1	NA	1	NA	8	0
DCHS2	0	0	8	2	2008.38	4016.76	15	2	1	NA	1	NA	10	0
DCLK2	0	0	2	0	754.38	1508.76	15	2	1	NA	1	NA	2	0
DCLRE1A	0	0	4	0	989.01	1978.02	15	2	1	NA	1	NA	4	0
DCLRE1B	0	0	1	1	453.09	906.18	15	2	1	NA	1	NA	2	0
DCP1A	0	0	2	3	582.12	1164.24	15	2	1	NA	1	NA	5	0
DCP2	0	0	1	2	365.64	731.28	15	2	1	NA	1	NA	3	0
DCTN1	0	0	4	17	1087.02	2174.04	15	2	1	NA	1	NA	21	0
DCTN3	0	0	0	2	154.77	309.54	15	2	1	NA	1	NA	2	0
DCTN4	0	0	3	5	423.39	846.78	15	2	1	NA	1	NA	8	0
DD1CR	0	0	3	0	452.43	904.86	15	2	1	NA	1	NA	3	0
DDB1	0	0	1	16	1119.69	2239.38	15	2	1	NA	1	NA	17	0
DDB2	0	0	4	4	600.93	1201.86	15	2	1	NA	1	NA	8	0
DDEFL1	0	0	6	8	932.58	1865.16	15	2	1	NA	1	NA	14	0
DDHD1	0	0	2	8	604.89	1209.78	15	2	1	NA	1	NA	10	0
DDHD2	0	0	7	10	669.57	1339.14	15	2	1	NA	1	NA	17	0
DDI2	0	0	8	8	958.65	1917.3	15	2	1	NA	1	NA	16	0
DDIT3	0	0	8	5	183.15	366.3	15	2	1	NA	1	NA	13	0
DDOST	0	0	1	7	429.66	859.32	15	2	1	NA	1	NA	8	0
DDR1	0	0	0	6	865.26	1730.52	15	2	1	NA	1	NA	6	0
DDRGK1	0	0	1	2	305.91	611.82	15	2	1	NA	1	NA	3	0
DDTNFR23	0	0	2	5	403.59	807.18	15	2	1	NA	1	NA	7	0
DDX18	0	0	11	6	638.55	1277.1	15	2	1	NA	1	NA	17	0
DDX19B	0	0	0	2	475.53	951.06	15	2	1	NA	1	NA	2	0
DDX20	0	0	6	3	764.28	1528.56	15	2	1	NA	1	NA	9	0
DDX21	0	0	1	6	697.95	1395.9	15	2	1	NA	1	NA	7	0
DDX23	0	0	0	12	667.26	1334.52	15	2	1	NA	1	NA	12	0
DDX24	0	0	5	3	718.74	1437.48	15	2	1	NA	1	NA	8	0
DDX27	0	0	5	4	749.43	1498.86	15	2	1	NA	1	NA	9	0
DDX28	0	0	8	5	521.73	1043.46	15	2	1	NA	1	NA	13	0
DDX31	0	0	5	9	697.95	1395.9	15	2	1	NA	1	NA	14	0
DDX4	0	0	4	6	690.03	1380.06	15	2	1	NA	1	NA	10	0
DDX41	0	0	0	15	612.81	1225.62	15	2	1	NA	1	NA	15	0
DDX42	0	0	5	13	934.56	1869.12	15	2	1	NA	1	NA	18	0
DDX49	0	0	3	8	475.2	950.4	15	2	1	NA	1	NA	11	0
DDX5	0	0	2	3	597.96	1195.92	15	2	1	NA	1	NA	5	0
DDX51	0	0	6	3	674.85	1349.7	15	2	1	NA	1	NA	9	0
DDX54	0	0	6	12	830.94	1661.88	15	2	1	NA	1	NA	18	0
DDX55	0	0	4	1	589.05	1178.1	15	2	1	NA	1	NA	5	0
DDX59	0	0	5	2	619.74	1239.48	15	2	1	NA	1	NA	7	0
DDX6	0	0	0	2	471.24	942.48	15	2	1	NA	1	NA	2	0
DDX60	0	0	7	12	1832.49	3664.98	15	2	1	NA	1	NA	19	0
DEAF1	0	0	0	3	580.14	1160.28	15	2	1	NA	1	NA	3	0
DECR2	0	0	4	5	292.38	584.76	15	2	1	NA	1	NA	9	0
DEF6	0	0	1	10	589.71	1179.42	15	2	1	NA	1	NA	11	0
DEF8	0	0	1	7	439.23	878.46	15	2	1	NA	1	NA	8	0
DEGS2	0	0	0	4	319.77	639.54	15	2	1	NA	1	NA	4	0
DELE	0	0	3	3	470.58	941.16	15	2	1	NA	1	NA	6	0
DENND1A	0	0	3	2	1077.45	2154.9	15	2	1	NA	1	NA	5	0
DENND1B	0	0	3	3	734.58	1469.16	15	2	1	NA	1	NA	6	0
DENND2C	0	0	2	2	1029.93	2059.86	15	2	1	NA	1	NA	4	0
DENND2D	0	0	2	9	461.01	922.02	15	2	1	NA	1	NA	11	0
DENND4A	0	0	7	21	1799.82	3599.64	15	2	1	NA	1	NA	28	0
DENND5A	0	0	2	14	1251.03	2502.06	15	2	1	NA	1	NA	16	0
DENND6A	0	0	0	4	558.36	1116.72	15	2	1	NA	1	NA	4	0
DENR	0	0	0	4	169.29	338.58	15	2	1	NA	1	NA	4	0
DEPDC1	0	0	11	8	804.87	1609.74	15	2	1	NA	1	NA	19	0
DEPDC1B	0	0	2	2	618.09	1236.18	15	2	1	NA	1	NA	4	0
DEPDC7	0	0	3	3	514.8	1029.6	15	2	1	NA	1	NA	6	0
DEPTOR	0	0	4	3	388.74	777.48	15	2	1	NA	1	NA	7	0
DES	0	0	0	5	384.12	768.24	15	2	1	NA	1	NA	5	0
DET1	0	0	0	5	546.48	1092.96	15	2	1	NA	1	NA	5	0
DFFA	0	0	1	1	308.88	617.76	15	2	1	NA	1	NA	2	0
DFNB59	0	0	1	1	354.42	708.84	15	2	1	NA	1	NA	2	0
DGCR2	0	0	0	2	537.57	1075.14	15	2	1	NA	1	NA	2	0
DGKD	0	0	0	4	1205.82	2411.64	15	2	1	NA	1	NA	4	0
DGKE	0	0	1	2	566.28	1132.56	15	2	1	NA	1	NA	3	0
DGKG	0	0	9	13	858.99	1717.98	15	2	1	NA	1	NA	22	0
DGKK	0	0	3	31	1024.65	2049.3	15	2	1	NA	1	NA	34	0
DGKQ	0	0	9	5	771.87	1543.74	15	2	1	NA	1	NA	14	0
DGKZ	0	0	7	10	1071.18	2142.36	15	2	1	NA	1	NA	17	0
DGUOK	0	0	0	2	493.68	987.36	15	2	1	NA	1	NA	2	0
DHCR24	0	0	2	0	464.64	929.28	15	2	1	NA	1	NA	2	0
DHCR7	0	0	2	3	470.25	940.5	15	2	1	NA	1	NA	5	0
DHODH	0	0	3	2	401.61	803.22	15	2	1	NA	1	NA	5	0
DHRS11	0	0	4	9	524.04	1048.08	15	2	1	NA	1	NA	13	0
DHRS13	0	0	3	2	197.01	394.02	15	2	1	NA	1	NA	5	0
DHRS7	0	0	0	2	332.31	664.62	15	2	1	NA	1	NA	2	0
DHRS7B	0	0	1	5	321.75	643.5	15	2	1	NA	1	NA	6	0
DHX15	0	0	0	3	755.37	1510.74	15	2	1	NA	1	NA	3	0
DHX29	0	0	2	5	1374.45	2748.9	15	2	1	NA	1	NA	7	0
DHX32	0	0	9	5	732.93	1465.86	15	2	1	NA	1	NA	14	0
DHX33	0	0	4	12	771.87	1543.74	15	2	1	NA	1	NA	16	0
DHX34	0	0	20	25	1083.72	2167.44	15	2	1	NA	1	NA	45	0
DHX35	0	0	5	6	696.96	1393.92	15	2	1	NA	1	NA	11	0
DHX36	0	0	1	19	929.94	1859.88	15	2	1	NA	1	NA	20	0
DHX38	0	0	0	4	1225.62	2451.24	15	2	1	NA	1	NA	4	0
DHX40	0	0	3	4	702.9	1405.8	15	2	1	NA	1	NA	7	0
DHX58	0	0	7	13	633.93	1267.86	15	2	1	NA	1	NA	20	0
DHX8	0	0	2	9	1181.07	2362.14	15	2	1	NA	1	NA	11	0
DIABLO	0	0	2	4	239.58	479.16	15	2	1	NA	1	NA	6	0
DIAPH2	0	0	1	1	514.14	1028.28	15	2	1	NA	1	NA	2	0
DICER1	0	0	2	0	1934.79	3869.58	15	2	1	NA	1	NA	2	0
DIMT1	0	0	0	2	340.56	681.12	15	2	1	NA	1	NA	2	0
DIO1	0	0	1	5	197.01	394.02	15	2	1	NA	1	NA	6	0
DIP2A	0	0	5	4	1407.78	2815.56	15	2	1	NA	1	NA	9	0
DIP2B	0	0	6	20	1617.33	3234.66	15	2	1	NA	1	NA	26	0
DIRAS1	0	0	0	2	196.35	392.7	15	2	1	NA	1	NA	2	0
DIRC2	0	0	2	1	487.08	974.16	15	2	1	NA	1	NA	3	0
DIS3L	0	0	12	6	1041.48	2082.96	15	2	1	NA	1	NA	18	0
DIS3L2	0	0	7	20	1205.82	2411.64	15	2	1	NA	1	NA	27	0
DISP2	0	0	5	14	1468.17	2936.34	15	2	1	NA	1	NA	19	0
DISP3	0	0	1	6	1284.03	2568.06	15	2	1	NA	1	NA	7	0
DIXDC1	0	0	2	3	683.1	1366.2	15	2	1	NA	1	NA	5	0
DKC1	0	0	0	6	490.05	980.1	15	2	1	NA	1	NA	6	0
DKK1	0	0	1	2	232.65	465.3	15	2	1	NA	1	NA	3	0
DKK3	0	0	2	4	328.02	656.04	15	2	1	NA	1	NA	6	0
DLAT	0	0	4	4	546.48	1092.96	15	2	1	NA	1	NA	8	0
DLC1	0	0	3	6	1421.64	2843.28	15	2	1	NA	1	NA	9	0
DLG1	0	0	3	4	832.59	1665.18	15	2	1	NA	1	NA	7	0
DLG3	0	0	8	24	806.52	1613.04	15	2	1	NA	1	NA	32	0
DLG5	0	0	4	3	1895.19	3790.38	15	2	1	NA	1	NA	7	0
DLGAP3	0	0	8	13	934.23	1868.46	15	2	1	NA	1	NA	21	0
DLGAP4	0	0	2	0	1025.31	2050.62	15	2	1	NA	1	NA	2	0
DLGAP5	0	0	13	4	778.14	1556.28	15	2	1	NA	1	NA	17	0
DLK1	0	0	1	3	384.12	768.24	15	2	1	NA	1	NA	4	0
DLL4	0	0	0	2	677.16	1354.32	15	2	1	NA	1	NA	2	0
DLST	0	0	1	7	433.62	867.24	15	2	1	NA	1	NA	8	0
DLX3	0	0	0	5	281.16	562.32	15	2	1	NA	1	NA	5	0
DLX4	0	0	2	1	243.54	487.08	15	2	1	NA	1	NA	3	0
DMAP1	0	0	1	2	460.35	920.7	15	2	1	NA	1	NA	3	0
DMBT1	0	0	1	2	254.43	508.86	15	2	1	NA	1	NA	3	0
DMBT1L-DMBT1L3	0	0	19	12	860.97	1721.94	15	2	1	NA	1	NA	31	0
DMBX1	0	0	2	7	359.37	718.74	15	2	1	NA	1	NA	9	0
DMGDH	0	0	3	5	881.76	1763.52	15	2	1	NA	1	NA	8	0
DMP1	0	0	6	4	426.69	853.38	15	2	1	NA	1	NA	10	0
DMRT1	0	0	0	3	203.28	406.56	15	2	1	NA	1	NA	3	0
DMRT2	0	0	0	3	456.39	912.78	15	2	1	NA	1	NA	3	0
DMRTA2	0	0	0	2	437.25	874.5	15	2	1	NA	1	NA	2	0
DMXL1	0	0	10	12	2957.13	5914.26	15	2	1	NA	1	NA	22	0
DMXL2	0	0	10	24	3042.27	6084.54	15	2	1	NA	1	NA	34	0
DNA2	0	0	10	12	1642.74	3285.48	15	2	1	NA	1	NA	22	0
DNAAF2	0	0	16	8	778.14	1556.28	15	2	1	NA	1	NA	24	0
DNAAF5	0	0	5	0	826.65	1653.3	15	2	1	NA	1	NA	5	0
DNAH1	0	0	27	29	4339.17	8678.34	15	2	1	NA	1	NA	56	0
DNAH10	0	0	16	21	4540.8	9081.6	15	2	1	NA	1	NA	37	0
DNAH12	0	0	10	20	3897.3	7794.6	15	2	1	NA	1	NA	30	0
DNAH17	0	0	20	83	4416.39	8832.78	15	2	1	NA	1	NA	103	0
DNAH3	0	0	9	7	4031.28	8062.56	15	2	1	NA	1	NA	16	0
DNAH7	0	0	16	23	3963.96	7927.92	15	2	1	NA	1	NA	39	0
DNAH9	0	0	15	23	3601.62	7203.24	15	2	1	NA	1	NA	38	0
DNAI1	0	0	1	3	725.01	1450.02	15	2	1	NA	1	NA	4	0
DNAI2	0	0	6	12	642.51	1285.02	15	2	1	NA	1	NA	18	0
DNAJA1	0	0	0	2	390.72	781.44	15	2	1	NA	1	NA	2	0
DNAJA2	0	0	0	4	387.42	774.84	15	2	1	NA	1	NA	4	0
DNAJA4	0	0	1	3	392.7	785.4	15	2	1	NA	1	NA	4	0
DNAJB11	0	0	0	2	358.38	716.76	15	2	1	NA	1	NA	2	0
DNAJB14	0	0	1	2	377.19	754.38	15	2	1	NA	1	NA	3	0
DNAJB2	0	0	3	5	276.54	553.08	15	2	1	NA	1	NA	8	0
DNAJB5	0	0	1	5	355.08	710.16	15	2	1	NA	1	NA	6	0
DNAJB8	0	0	2	2	222.75	445.5	15	2	1	NA	1	NA	4	0
DNAJC11	0	0	4	1	533.28	1066.56	15	2	1	NA	1	NA	5	0
DNAJC12	0	0	2	1	195.69	391.38	15	2	1	NA	1	NA	3	0
DNAJC16	0	0	5	11	712.47	1424.94	15	2	1	NA	1	NA	16	0
DNAJC17	0	0	2	0	283.14	566.28	15	2	1	NA	1	NA	2	0
DNAJC18	0	0	0	2	355.41	710.82	15	2	1	NA	1	NA	2	0
DNAJC21	0	0	1	1	515.13	1030.26	15	2	1	NA	1	NA	2	0
DNAJC22	0	0	5	8	317.79	635.58	15	2	1	NA	1	NA	13	0
DNAJC24	0	0	0	5	145.53	291.06	15	2	1	NA	1	NA	5	0
DNAJC25	0	0	1	1	338.91	677.82	15	2	1	NA	1	NA	2	0
DNAJC5	0	0	0	3	197.01	394.02	15	2	1	NA	1	NA	3	0
DNAJC6	0	0	2	7	976.14	1952.28	15	2	1	NA	1	NA	9	0
DNAJC7	0	0	1	3	491.04	982.08	15	2	1	NA	1	NA	4	0
DNAJC9	0	0	1	3	272.25	544.5	15	2	1	NA	1	NA	4	0
DNAL1	0	0	0	3	208.89	417.78	15	2	1	NA	1	NA	3	0
DNALI1	0	0	1	2	254.43	508.86	15	2	1	NA	1	NA	3	0
DNASE1L3	0	0	1	7	304.92	609.84	15	2	1	NA	1	NA	8	0
DNASE2B	0	0	2	1	357.39	714.78	15	2	1	NA	1	NA	3	0
DND1	0	0	1	4	325.71	651.42	15	2	1	NA	1	NA	5	0
DNER	0	0	4	8	638.55	1277.1	15	2	1	NA	1	NA	12	0
DNLZ	0	0	1	2	168.3	336.6	15	2	1	NA	1	NA	3	0
DNM1	0	0	3	14	926.64	1853.28	15	2	1	NA	1	NA	17	0
DNMBP	0	0	7	2	741.51	1483.02	15	2	1	NA	1	NA	9	0
DNMT3B	0	0	4	13	748.44	1496.88	15	2	1	NA	1	NA	17	0
DNPEP	0	0	3	9	468.93	937.86	15	2	1	NA	1	NA	12	0
DNTTIP2	0	0	11	6	805.86	1611.72	15	2	1	NA	1	NA	17	0
DOC2B	0	0	0	10	395.01	790.02	15	2	1	NA	1	NA	10	0
DOCK1	0	0	5	11	994.29	1988.58	15	2	1	NA	1	NA	16	0
DOCK10	0	0	13	16	2169.75	4339.5	15	2	1	NA	1	NA	29	0
DOCK11	0	0	4	7	1932.48	3864.96	15	2	1	NA	1	NA	11	0
DOCK2	0	0	3	4	1597.2	3194.4	15	2	1	NA	1	NA	7	0
DOCK2L	0	0	8	29	1786.95	3573.9	15	2	1	NA	1	NA	37	0
DOCK5	0	0	3	14	1829.52	3659.04	15	2	1	NA	1	NA	17	0
DOCK7	0	0	1	8	1496.88	2993.76	15	2	1	NA	1	NA	9	0
DOCK8	0	0	2	8	2027.19	4054.38	15	2	1	NA	1	NA	10	0
DOHH	0	0	3	2	206.58	413.16	15	2	1	NA	1	NA	5	0
DOK1	0	0	1	4	564.96	1129.92	15	2	1	NA	1	NA	5	0
DOK2	0	0	8	12	481.14	962.28	15	2	1	NA	1	NA	20	0
DOK4	0	0	1	1	350.13	700.26	15	2	1	NA	1	NA	2	0
DOK5	0	0	2	1	311.85	623.7	15	2	1	NA	1	NA	3	0
DOLK	0	0	4	6	518.76	1037.52	15	2	1	NA	1	NA	10	0
DOLPP1	0	0	2	3	261.69	523.38	15	2	1	NA	1	NA	5	0
DOT1L	0	0	0	5	1571.46	3142.92	15	2	1	NA	1	NA	5	0
DPAGT1	0	0	2	0	402.93	805.86	15	2	1	NA	1	NA	2	0
DPCD	0	0	2	2	197.67	395.34	15	2	1	NA	1	NA	4	0
DPEP1	0	0	4	9	410.85	821.7	15	2	1	NA	1	NA	13	0
DPEP2	0	0	1	2	418.77	837.54	15	2	1	NA	1	NA	3	0
DPF3	0	0	2	3	401.61	803.22	15	2	1	NA	1	NA	5	0
DPH1	0	0	7	11	411.51	823.02	15	2	1	NA	1	NA	18	0
DPH2	0	0	11	17	429.66	859.32	15	2	1	NA	1	NA	28	0
DPH5	0	0	0	2	283.14	566.28	15	2	1	NA	1	NA	2	0
DPH7	0	0	3	7	510.84	1021.68	15	2	1	NA	1	NA	10	0
DPM1	0	0	1	1	240.57	481.14	15	2	1	NA	1	NA	2	0
DPP10	0	0	2	1	622.71	1245.42	15	2	1	NA	1	NA	3	0
DPP4	0	0	1	1	749.43	1498.86	15	2	1	NA	1	NA	2	0
DPP7	0	0	0	2	305.91	611.82	15	2	1	NA	1	NA	2	0
DPP8	0	0	1	9	874.17	1748.34	15	2	1	NA	1	NA	10	0
DPP9	0	0	4	12	926.97	1853.94	15	2	1	NA	1	NA	16	0
DPYD	0	0	10	7	915.75	1831.5	15	2	1	NA	1	NA	17	0
DPYSL2	0	0	4	12	700.92	1401.84	15	2	1	NA	1	NA	16	0
DPYSL4	0	0	7	10	564.3	1128.6	15	2	1	NA	1	NA	17	0
DRAM2	0	0	3	3	264.33	528.66	15	2	1	NA	1	NA	6	0
DRAXIN	0	0	3	5	346.5	693	15	2	1	NA	1	NA	8	0
DRC3	0	0	10	4	545.16	1090.32	15	2	1	NA	1	NA	14	0
DRC7	0	0	6	2	791.01	1582.02	15	2	1	NA	1	NA	8	0
DRCC1	0	0	2	1	417.78	835.56	15	2	1	NA	1	NA	3	0
DRD1	0	0	0	2	447.48	894.96	15	2	1	NA	1	NA	2	0
DRD2	0	0	1	4	442.53	885.06	15	2	1	NA	1	NA	5	0
DRD4	0	0	2	1	369.27	738.54	15	2	1	NA	1	NA	3	0
DRD5	0	0	1	3	481.47	962.94	15	2	1	NA	1	NA	4	0
DRG2	0	0	0	6	349.14	698.28	15	2	1	NA	1	NA	6	0
DRGX	0	0	2	1	258.39	516.78	15	2	1	NA	1	NA	3	0
DRP2	0	0	9	24	929.61	1859.22	15	2	1	NA	1	NA	33	0
DSCAML1	0	0	2	35	1862.19	3724.38	15	2	1	NA	1	NA	37	0
DSTYK	0	0	1	11	909.15	1818.3	15	2	1	NA	1	NA	12	0
DTHD1	0	0	5	1	845.46	1690.92	15	2	1	NA	1	NA	6	0
DTX1	0	0	5	8	523.71	1047.42	15	2	1	NA	1	NA	13	0
DTX2	0	0	6	19	545.49	1090.98	15	2	1	NA	1	NA	25	0
DTX3L	0	0	9	10	733.59	1467.18	15	2	1	NA	1	NA	19	0
DTX4	0	0	4	4	551.76	1103.52	15	2	1	NA	1	NA	8	0
DTYMK	0	0	1	6	210.87	421.74	15	2	1	NA	1	NA	7	0
DUOX2	0	0	6	9	1514.37	3028.74	15	2	1	NA	1	NA	15	0
DUOXA1L	0	0	3	5	319.77	639.54	15	2	1	NA	1	NA	8	0
DUOXA2	0	0	2	4	324.72	649.44	15	2	1	NA	1	NA	6	0
DUPD1	0	0	1	1	215.82	431.64	15	2	1	NA	1	NA	2	0
DUS1L	0	0	3	1	529.65	1059.3	15	2	1	NA	1	NA	4	0
DUSP1	0	0	0	3	366.3	732.6	15	2	1	NA	1	NA	3	0
DUSP11RC1I	0	0	3	2	659.34	1318.68	15	2	1	NA	1	NA	5	0
DUSP13	0	0	7	1	219.78	439.56	15	2	1	NA	1	NA	8	0
DUSP13L	0	0	2	3	188.1	376.2	15	2	1	NA	1	NA	5	0
DUSP14	0	0	1	1	197.01	394.02	15	2	1	NA	1	NA	2	0
DUSP15	0	0	1	1	212.85	425.7	15	2	1	NA	1	NA	2	0
DUSP19	0	0	0	2	211.86	423.72	15	2	1	NA	1	NA	2	0
DUSP26	0	0	0	2	194.04	388.08	15	2	1	NA	1	NA	2	0
DUSP28	0	0	2	4	152.46	304.92	15	2	1	NA	1	NA	6	0
DUSP5	0	0	0	2	326.04	652.08	15	2	1	NA	1	NA	2	0
DUSP7	0	0	0	3	376.53	753.06	15	2	1	NA	1	NA	3	0
DUSP8	0	0	3	6	549.45	1098.9	15	2	1	NA	1	NA	9	0
DVL3	0	0	1	11	667.59	1335.18	15	2	1	NA	1	NA	12	0
DYDC1	0	0	1	1	137.61	275.22	15	2	1	NA	1	NA	2	0
DYM	0	0	5	2	531.63	1063.26	15	2	1	NA	1	NA	7	0
DYNC1H1	0	0	3	17	4539.48	9078.96	15	2	1	NA	1	NA	20	0
DYNLRB2	0	0	1	1	96.03	192.06	15	2	1	NA	1	NA	2	0
DYRK3	0	0	2	3	557.04	1114.08	15	2	1	NA	1	NA	5	0
DYSF	0	0	18	37	2019.93	4039.86	15	2	1	NA	1	NA	55	0
DYX1C1	0	0	10	9	424.71	849.42	15	2	1	NA	1	NA	19	0
DZIP1L	0	0	8	7	491.04	982.08	15	2	1	NA	1	NA	15	0
E2F1	0	0	7	12	362.67	725.34	15	2	1	NA	1	NA	19	0
E2F2	0	0	4	8	326.37	652.74	15	2	1	NA	1	NA	12	0
E2F4	0	0	0	4	350.13	700.26	15	2	1	NA	1	NA	4	0
E2F8	0	0	3	5	889.68	1779.36	15	2	1	NA	1	NA	8	0
E4F1	0	0	1	6	660	1320	15	2	1	NA	1	NA	7	0
EAAT5L	0	0	3	10	540.54	1081.08	15	2	1	NA	1	NA	13	0
EAF2	0	0	2	1	228.36	456.72	15	2	1	NA	1	NA	3	0
EAPP	0	0	3	5	285.12	570.24	15	2	1	NA	1	NA	8	0
EBF2	0	0	2	14	356.4	712.8	15	2	1	NA	1	NA	16	0
ECD	0	0	13	2	663.3	1326.6	15	2	1	NA	1	NA	15	0
ECEL1	0	0	1	12	754.38	1508.76	15	2	1	NA	1	NA	13	0
ECHS1	0	0	1	1	278.85	557.7	15	2	1	NA	1	NA	2	0
ECM2	0	0	3	4	703.89	1407.78	15	2	1	NA	1	NA	7	0
ECSCR	0	0	4	3	241.56	483.12	15	2	1	NA	1	NA	7	0
ECT2	0	0	4	7	876.15	1752.3	15	2	1	NA	1	NA	11	0
EDBETA	0	0	0	2	106.92	213.84	15	2	1	NA	1	NA	2	0
EDC3	0	0	0	9	501.93	1003.86	15	2	1	NA	1	NA	9	0
EDC4	0	0	4	10	1383.69	2767.38	15	2	1	NA	1	NA	14	0
EDCH5	0	0	6	8	197.01	394.02	15	2	1	NA	1	NA	14	0
EDEM1	0	0	0	5	510.84	1021.68	15	2	1	NA	1	NA	5	0
EDEM2	0	0	2	8	534.6	1069.2	15	2	1	NA	1	NA	10	0
EDEM3	0	0	1	4	881.76	1763.52	15	2	1	NA	1	NA	5	0
EDGH	0	0	5	8	295.02	590.04	15	2	1	NA	1	NA	13	0
EDIL3	0	0	1	1	315.81	631.62	15	2	1	NA	1	NA	2	0
EDMTF1-EDMTF2-EDMTF3-LOC110231148	0	0	4	3	179.19	358.38	15	2	1	NA	1	NA	7	0
EDN2	0	0	1	2	180.18	360.36	15	2	1	NA	1	NA	3	0
EDNRB2	0	0	14	13	643.5	1287	15	2	1	NA	1	NA	27	0
EDPE	0	0	1	5	296.01	592.02	15	2	1	NA	1	NA	6	0
EDQCM	0	0	1	2	174.24	348.48	15	2	1	NA	1	NA	3	0
EDQM1	0	0	4	1	204.6	409.2	15	2	1	NA	1	NA	5	0
EDQREP	0	0	4	7	331.32	662.64	15	2	1	NA	1	NA	11	0
EDRF1	0	0	6	7	1215.72	2431.44	15	2	1	NA	1	NA	13	0
EDWM	0	0	4	4	219.78	439.56	15	2	1	NA	1	NA	8	0
EDYM1	0	0	2	1	152.46	304.92	15	2	1	NA	1	NA	3	0
EDYM2	0	0	5	5	319.77	639.54	15	2	1	NA	1	NA	10	0
EEF1A2	0	0	0	10	459.36	918.72	15	2	1	NA	1	NA	10	0
EEF2KMT	0	0	4	3	335.61	671.22	15	2	1	NA	1	NA	7	0
EEFSEC	0	0	1	4	554.4	1108.8	15	2	1	NA	1	NA	5	0
EFCAB14	0	0	7	3	475.2	950.4	15	2	1	NA	1	NA	10	0
EFCAB5	0	0	12	5	1233.54	2467.08	15	2	1	NA	1	NA	17	0
EFCAB7	0	0	5	4	624.69	1249.38	15	2	1	NA	1	NA	9	0
EFCC1	0	0	10	8	621.72	1243.44	15	2	1	NA	1	NA	18	0
EFHD2	0	0	2	8	220.77	441.54	15	2	1	NA	1	NA	10	0
EFL1	0	0	7	1	1088.01	2176.02	15	2	1	NA	1	NA	8	0
EFNA2	0	0	1	4	168.3	336.6	15	2	1	NA	1	NA	5	0
EFNA5	0	0	2	0	214.5	429	15	2	1	NA	1	NA	2	0
EFTUD2	0	0	1	12	963.27	1926.54	15	2	1	NA	1	NA	13	0
EGF	0	0	12	9	1236.18	2472.36	15	2	1	NA	1	NA	21	0
EGFL7	0	0	3	5	273.24	546.48	15	2	1	NA	1	NA	8	0
EGFLAM	0	0	5	1	963.27	1926.54	15	2	1	NA	1	NA	6	0
EGLN3	0	0	0	3	239.58	479.16	15	2	1	NA	1	NA	3	0
EGR1	0	0	1	1	505.89	1011.78	15	2	1	NA	1	NA	2	0
EGR4	0	0	5	7	486.09	972.18	15	2	1	NA	1	NA	12	0
EHHADH	0	0	5	3	719.73	1439.46	15	2	1	NA	1	NA	8	0
EHMT1	0	0	4	5	1317.69	2635.38	15	2	1	NA	1	NA	9	0
EIF2A	0	0	1	4	682.11	1364.22	15	2	1	NA	1	NA	5	0
EIF2AK1	0	0	2	1	634.59	1269.18	15	2	1	NA	1	NA	3	0
EIF2AK3	0	0	6	10	1054.35	2108.7	15	2	1	NA	1	NA	16	0
EIF2B1	0	0	0	4	299.97	599.94	15	2	1	NA	1	NA	4	0
EIF2B2	0	0	1	5	348.48	696.96	15	2	1	NA	1	NA	6	0
EIF2B3	0	0	1	2	448.47	896.94	15	2	1	NA	1	NA	3	0
EIF2B5	0	0	6	12	697.29	1394.58	15	2	1	NA	1	NA	18	0
EIF2D	0	0	11	6	594	1188	15	2	1	NA	1	NA	17	0
EIF2S2	0	0	0	2	331.32	662.64	15	2	1	NA	1	NA	2	0
EIF3A	0	0	2	8	1371.15	2742.3	15	2	1	NA	1	NA	10	0
EIF3B	0	0	0	5	815.76	1631.52	15	2	1	NA	1	NA	5	0
EIF3F	0	0	1	3	276.21	552.42	15	2	1	NA	1	NA	4	0
EIF3I	0	0	0	7	321.75	643.5	15	2	1	NA	1	NA	7	0
EIF3J	0	0	0	2	336.93	673.86	15	2	1	NA	1	NA	2	0
EIF3M	0	0	0	4	370.92	741.84	15	2	1	NA	1	NA	4	0
EIF4A2	0	0	0	2	403.92	807.84	15	2	1	NA	1	NA	2	0
EIF4B	0	0	2	3	419.76	839.52	15	2	1	NA	1	NA	5	0
EIF4E1B	0	0	1	9	209.88	419.76	15	2	1	NA	1	NA	10	0
EIF4G1	0	0	12	26	1555.95	3111.9	15	2	1	NA	1	NA	38	0
EIF4G2	0	0	4	7	967.89	1935.78	15	2	1	NA	1	NA	11	0
EIF4G3	0	0	7	10	1681.35	3362.7	15	2	1	NA	1	NA	17	0
EIF5	0	0	0	2	426.69	853.38	15	2	1	NA	1	NA	2	0
EIF5A2-LOC107050352-RPL22L1	0	0	0	3	251.46	502.92	15	2	1	NA	1	NA	3	0
EIF6	0	0	0	3	242.88	485.76	15	2	1	NA	1	NA	3	0
ELAC2	0	0	3	4	818.73	1637.46	15	2	1	NA	1	NA	7	0
ELAVL2	0	0	2	0	407.88	815.76	15	2	1	NA	1	NA	2	0
ELAVL4	0	0	5	8	429.99	859.98	15	2	1	NA	1	NA	13	0
ELF2	0	0	1	7	589.05	1178.1	15	2	1	NA	1	NA	8	0
ELF3	0	0	2	5	368.28	736.56	15	2	1	NA	1	NA	7	0
ELFN1	0	0	1	7	789.03	1578.06	15	2	1	NA	1	NA	8	0
ELK4	0	0	2	3	444.51	889.02	15	2	1	NA	1	NA	5	0
ELL	0	0	3	5	561.33	1122.66	15	2	1	NA	1	NA	8	0
ELL2	0	0	3	7	531.63	1063.26	15	2	1	NA	1	NA	10	0
ELMO2	0	0	1	2	725.67	1451.34	15	2	1	NA	1	NA	3	0
ELMO3	0	0	3	9	712.8	1425.6	15	2	1	NA	1	NA	12	0
ELMOD2	0	0	2	1	295.02	590.04	15	2	1	NA	1	NA	3	0
ELMSAN1	0	0	2	8	1103.85	2207.7	15	2	1	NA	1	NA	10	0
ELOVL1	0	0	0	3	308.88	617.76	15	2	1	NA	1	NA	3	0
ELOVL3	0	0	3	4	267.3	534.6	15	2	1	NA	1	NA	7	0
ELP4	0	0	1	3	373.23	746.46	15	2	1	NA	1	NA	4	0
EMC1	0	0	6	11	976.14	1952.28	15	2	1	NA	1	NA	17	0
EMC3	0	0	0	3	259.38	518.76	15	2	1	NA	1	NA	3	0
EME1	0	0	7	7	521.73	1043.46	15	2	1	NA	1	NA	14	0
EMID1	0	0	5	13	765.27	1530.54	15	2	1	NA	1	NA	18	0
EMILIN3	0	0	4	9	743.49	1486.98	15	2	1	NA	1	NA	13	0
EML1	0	0	0	5	858.33	1716.66	15	2	1	NA	1	NA	5	0
EML5	0	0	4	15	1913.67	3827.34	15	2	1	NA	1	NA	19	0
ENC1	0	0	0	6	584.1	1168.2	15	2	1	NA	1	NA	6	0
ENDOG	0	0	10	10	298.98	597.96	15	2	1	NA	1	NA	20	0
ENDOU	0	0	2	5	358.38	716.76	15	2	1	NA	1	NA	7	0
ENDOV	0	0	3	4	265.32	530.64	15	2	1	NA	1	NA	7	0
ENG	0	0	6	20	632.28	1264.56	15	2	1	NA	1	NA	26	0
ENGASE	0	0	10	17	675.18	1350.36	15	2	1	NA	1	NA	27	0
ENO1	0	0	0	4	430.65	861.3	15	2	1	NA	1	NA	4	0
ENO4	0	0	7	3	620.73	1241.46	15	2	1	NA	1	NA	10	0
ENOPH1	0	0	0	2	205.26	410.52	15	2	1	NA	1	NA	2	0
ENOX2	0	0	1	2	654.06	1308.12	15	2	1	NA	1	NA	3	0
ENPEP	0	0	4	8	939.51	1879.02	15	2	1	NA	1	NA	12	0
ENPP7	0	0	1	8	424.71	849.42	15	2	1	NA	1	NA	9	0
ENSA	0	0	2	6	116.82	233.64	15	2	1	NA	1	NA	8	0
ENTPD1	0	0	2	2	495.99	991.98	15	2	1	NA	1	NA	4	0
ENTPD2L	0	0	11	4	488.07	976.14	15	2	1	NA	1	NA	15	0
ENTPD4	0	0	1	16	602.91	1205.82	15	2	1	NA	1	NA	17	0
ENTPD8	0	0	4	2	492.69	985.38	15	2	1	NA	1	NA	6	0
ENTPD8-ENTPD8L	0	0	3	5	458.37	916.74	15	2	1	NA	1	NA	8	0
EOGT	0	0	6	8	522.72	1045.44	15	2	1	NA	1	NA	14	0
EP400	0	0	7	12	1878.03	3756.06	15	2	1	NA	1	NA	19	0
EPB41	0	0	16	15	1125.63	2251.26	15	2	1	NA	1	NA	31	0
EPB41L1	0	0	4	1	1725.57	3451.14	15	2	1	NA	1	NA	5	0
EPB41L4A	0	0	4	3	662.97	1325.94	15	2	1	NA	1	NA	7	0
EPB41L5	0	0	5	1	743.16	1486.32	15	2	1	NA	1	NA	6	0
EPC2	0	0	3	6	839.19	1678.38	15	2	1	NA	1	NA	9	0
EPFIP1L	0	0	1	7	557.37	1114.74	15	2	1	NA	1	NA	8	0
EPG5	0	0	8	4	2508.66	5017.32	15	2	1	NA	1	NA	12	0
EPHA10	0	0	5	17	1004.85	2009.7	15	2	1	NA	1	NA	22	0
EPHA2	0	0	2	6	781.11	1562.22	15	2	1	NA	1	NA	8	0
EPHA4	0	0	0	3	1298.22	2596.44	15	2	1	NA	1	NA	3	0
EPHA5	0	0	3	3	596.97	1193.94	15	2	1	NA	1	NA	6	0
EPHA8	0	0	5	12	1001.88	2003.76	15	2	1	NA	1	NA	17	0
EPHB1	0	0	4	14	1018.38	2036.76	15	2	1	NA	1	NA	18	0
EPHB2	0	0	2	13	944.79	1889.58	15	2	1	NA	1	NA	15	0
EPHB3	0	0	2	20	935.55	1871.1	15	2	1	NA	1	NA	22	0
EPN3	0	0	6	7	614.46	1228.92	15	2	1	NA	1	NA	13	0
EPS15	0	0	3	3	909.81	1819.62	15	2	1	NA	1	NA	6	0
EPS15L1	0	0	9	14	1241.46	2482.92	15	2	1	NA	1	NA	23	0
EPS8L2	0	0	2	4	729.63	1459.26	15	2	1	NA	1	NA	6	0
ERAL1	0	0	9	6	461.67	923.34	15	2	1	NA	1	NA	15	0
ERAP1	0	0	6	8	896.61	1793.22	15	2	1	NA	1	NA	14	0
ERBB4	0	0	0	2	518.76	1037.52	15	2	1	NA	1	NA	2	0
ERC2	0	0	1	1	231.66	463.32	15	2	1	NA	1	NA	2	0
ERCC3	0	0	2	7	773.19	1546.38	15	2	1	NA	1	NA	9	0
ERCC4	0	0	1	1	925.98	1851.96	15	2	1	NA	1	NA	2	0
ERCC6	0	0	8	7	1433.52	2867.04	15	2	1	NA	1	NA	15	0
ERCC6L	0	0	11	10	1328.91	2657.82	15	2	1	NA	1	NA	21	0
ERCC6L2	0	0	9	2	1585.65	3171.3	15	2	1	NA	1	NA	11	0
EREG	0	0	0	2	150.15	300.3	15	2	1	NA	1	NA	2	0
ERGIC3	0	0	1	3	379.83	759.66	15	2	1	NA	1	NA	4	0
ERI2	0	0	2	0	679.47	1358.94	15	2	1	NA	1	NA	2	0
ERICH3	0	0	20	8	1316.7	2633.4	15	2	1	NA	1	NA	28	0
ERLIN2	0	0	5	3	305.91	611.82	15	2	1	NA	1	NA	8	0
ERMN	0	0	4	6	246.18	492.36	15	2	1	NA	1	NA	10	0
ERMP1	0	0	3	2	778.8	1557.6	15	2	1	NA	1	NA	5	0
ERN1	0	0	1	2	964.26	1928.52	15	2	1	NA	1	NA	3	0
ERN2	0	0	5	21	922.68	1845.36	15	2	1	NA	1	NA	26	0
ERO1A	0	0	2	11	459.36	918.72	15	2	1	NA	1	NA	13	0
ERP29	0	0	1	3	248.49	496.98	15	2	1	NA	1	NA	4	0
ES1ML2	0	0	2	0	247.17	494.34	15	2	1	NA	1	NA	2	0
ESAM	0	0	1	3	231.66	463.32	15	2	1	NA	1	NA	4	0
ESPL1	0	0	16	10	2026.53	4053.06	15	2	1	NA	1	NA	26	0
ESPN	0	0	7	5	1073.49	2146.98	15	2	1	NA	1	NA	12	0
ESR2	0	0	2	5	562.32	1124.64	15	2	1	NA	1	NA	7	0
ESRP2	0	0	1	1	734.58	1469.16	15	2	1	NA	1	NA	2	0
ESRRB	0	0	1	7	425.04	850.08	15	2	1	NA	1	NA	8	0
ESYT3	0	0	3	9	840.51	1681.02	15	2	1	NA	1	NA	12	0
ETF1	0	0	0	3	405.24	810.48	15	2	1	NA	1	NA	3	0
ETFDH	0	0	0	2	613.8	1227.6	15	2	1	NA	1	NA	2	0
ETNK2	0	0	1	12	386.1	772.2	15	2	1	NA	1	NA	13	0
ETNPPL	0	0	0	2	502.92	1005.84	15	2	1	NA	1	NA	2	0
ETS1	0	0	2	6	437.58	875.16	15	2	1	NA	1	NA	8	0
ETV3	0	0	6	18	519.42	1038.84	15	2	1	NA	1	NA	24	0
ETV3L	0	0	4	4	141.24	282.48	15	2	1	NA	1	NA	8	0
ETV4	0	0	6	8	442.53	885.06	15	2	1	NA	1	NA	14	0
ETV5	0	0	2	12	472.23	944.46	15	2	1	NA	1	NA	14	0
EVA1B	0	0	2	5	151.8	303.6	15	2	1	NA	1	NA	7	0
EVA1CL	0	0	1	9	408.87	817.74	15	2	1	NA	1	NA	10	0
EVC	0	0	5	3	973.17	1946.34	15	2	1	NA	1	NA	8	0
EVC2	0	0	23	1	1249.38	2498.76	15	2	1	NA	1	NA	24	0
EVI5	0	0	1	4	971.19	1942.38	15	2	1	NA	1	NA	5	0
EVI5L	0	0	1	6	359.37	718.74	15	2	1	NA	1	NA	7	0
EVL	0	0	1	2	428.67	857.34	15	2	1	NA	1	NA	3	0
EVPL	0	0	14	27	2010.69	4021.38	15	2	1	NA	1	NA	41	0
EXD2	0	0	1	10	611.82	1223.64	15	2	1	NA	1	NA	11	0
EXD3	0	0	5	1	774.18	1548.36	15	2	1	NA	1	NA	6	0
EXFABP	0	0	0	2	471.9	943.8	15	2	1	NA	1	NA	2	0
EXOC3L	0	0	7	3	649.44	1298.88	15	2	1	NA	1	NA	10	0
EXOC3L1	0	0	5	14	746.46	1492.92	15	2	1	NA	1	NA	19	0
EXOC3L4	0	0	5	4	697.95	1395.9	15	2	1	NA	1	NA	9	0
EXOC6	0	0	1	1	831.6	1663.2	15	2	1	NA	1	NA	2	0
EXOC6B	0	0	1	1	556.38	1112.76	15	2	1	NA	1	NA	2	0
EXOC7	0	0	3	11	713.79	1427.58	15	2	1	NA	1	NA	14	0
EXOSC1	0	0	0	2	145.86	291.72	15	2	1	NA	1	NA	2	0
EXOSC10	0	0	4	7	895.95	1791.9	15	2	1	NA	1	NA	11	0
EXOSC2	0	0	0	2	269.28	538.56	15	2	1	NA	1	NA	2	0
EXOSC3	0	0	0	2	247.5	495	15	2	1	NA	1	NA	2	0
EXOSC6	0	0	1	3	196.35	392.7	15	2	1	NA	1	NA	4	0
EXOSC9	0	0	3	3	435.6	871.2	15	2	1	NA	1	NA	6	0
EXT2	0	0	4	4	694.98	1389.96	15	2	1	NA	1	NA	8	0
EXTL1	0	0	11	13	596.64	1193.28	15	2	1	NA	1	NA	24	0
EXTL2	0	0	1	3	328.68	657.36	15	2	1	NA	1	NA	4	0
EZH1	0	0	1	8	737.55	1475.1	15	2	1	NA	1	NA	9	0
F11	0	0	3	3	636.24	1272.48	15	2	1	NA	1	NA	6	0
F13B	0	0	4	0	84.48	168.96	15	2	1	NA	1	NA	4	0
F2	0	0	2	2	603.9	1207.8	15	2	1	NA	1	NA	4	0
F2RL1	0	0	0	3	388.08	776.16	15	2	1	NA	1	NA	3	0
F2RL3	0	0	7	3	385.11	770.22	15	2	1	NA	1	NA	10	0
F3	0	0	0	2	281.16	562.32	15	2	1	NA	1	NA	2	0
F8	0	0	26	30	2175.03	4350.06	15	2	1	NA	1	NA	56	0
F8A3	0	0	2	0	100.98	201.96	15	2	1	NA	1	NA	2	0
F9	0	0	0	2	463.32	926.64	15	2	1	NA	1	NA	2	0
FAAH	0	0	3	5	571.23	1142.46	15	2	1	NA	1	NA	8	0
FAAH2	0	0	3	8	521.73	1043.46	15	2	1	NA	1	NA	11	0
FAAP100	0	0	11	19	859.65	1719.3	15	2	1	NA	1	NA	30	0
FAAP24	0	0	2	0	213.84	427.68	15	2	1	NA	1	NA	2	0
FABP2	0	0	3	0	131.67	263.34	15	2	1	NA	1	NA	3	0
FABP3	0	0	1	2	132.66	265.32	15	2	1	NA	1	NA	3	0
FADS1L1	0	0	3	1	444.51	889.02	15	2	1	NA	1	NA	4	0
FADS1L2	0	0	4	3	466.29	932.58	15	2	1	NA	1	NA	7	0
FADS2	0	0	0	2	492.69	985.38	15	2	1	NA	1	NA	2	0
FADS6	0	0	4	7	411.84	823.68	15	2	1	NA	1	NA	11	0
FAF1	0	0	1	5	682.11	1364.22	15	2	1	NA	1	NA	6	0
FAF2	0	0	0	2	396.99	793.98	15	2	1	NA	1	NA	2	0
FAH	0	0	2	3	415.8	831.6	15	2	1	NA	1	NA	5	0
FAIM2	0	0	0	2	308.88	617.76	15	2	1	NA	1	NA	2	0
FAM102B-LOC429054	0	0	2	3	350.46	700.92	15	2	1	NA	1	NA	5	0
FAM107A	0	0	5	2	213.84	427.68	15	2	1	NA	1	NA	7	0
FAM109A	0	0	6	12	257.4	514.8	15	2	1	NA	1	NA	18	0
FAM110A	0	0	9	11	325.71	651.42	15	2	1	NA	1	NA	20	0
FAM114A1	0	0	3	3	557.37	1114.74	15	2	1	NA	1	NA	6	0
FAM114A2	0	0	2	2	495.99	991.98	15	2	1	NA	1	NA	4	0
FAM117A	0	0	8	13	414.48	828.96	15	2	1	NA	1	NA	21	0
FAM117B	0	0	0	2	342.54	685.08	15	2	1	NA	1	NA	2	0
FAM120A	0	0	1	2	1128.6	2257.2	15	2	1	NA	1	NA	3	0
FAM122A	0	0	0	2	273.24	546.48	15	2	1	NA	1	NA	2	0
FAM124B	0	0	9	11	434.28	868.56	15	2	1	NA	1	NA	20	0
FAM126B	0	0	1	3	582.12	1164.24	15	2	1	NA	1	NA	4	0
FAM129A	0	0	9	6	1099.56	2199.12	15	2	1	NA	1	NA	15	0
FAM129B	0	0	4	14	712.47	1424.94	15	2	1	NA	1	NA	18	0
FAM131A	0	0	2	11	294.03	588.06	15	2	1	NA	1	NA	13	0
FAM134C	0	0	3	8	450.78	901.56	15	2	1	NA	1	NA	11	0
FAM136A	0	0	1	7	137.61	275.22	15	2	1	NA	1	NA	8	0
FAM13B	0	0	3	6	924.66	1849.32	15	2	1	NA	1	NA	9	0
FAM13C	0	0	4	0	965.58	1931.16	15	2	1	NA	1	NA	4	0
FAM149B1	0	0	7	4	585.09	1170.18	15	2	1	NA	1	NA	11	0
FAM160B1	0	0	1	6	758.34	1516.68	15	2	1	NA	1	NA	7	0
FAM161B	0	0	4	2	537.57	1075.14	15	2	1	NA	1	NA	6	0
FAM163A	0	0	0	2	145.2	290.4	15	2	1	NA	1	NA	2	0
FAM163B	0	0	2	5	159.39	318.78	15	2	1	NA	1	NA	7	0
FAM166A	0	0	4	7	315.81	631.62	15	2	1	NA	1	NA	11	0
FAM167B	0	0	2	2	180.18	360.36	15	2	1	NA	1	NA	4	0
FAM169A	0	0	1	3	538.89	1077.78	15	2	1	NA	1	NA	4	0
FAM169B	0	0	1	1	288.09	576.18	15	2	1	NA	1	NA	2	0
FAM171B	0	0	2	1	752.4	1504.8	15	2	1	NA	1	NA	3	0
FAM172A	0	0	0	2	205.92	411.84	15	2	1	NA	1	NA	2	0
FAM175A	0	0	2	3	374.22	748.44	15	2	1	NA	1	NA	5	0
FAM175B	0	0	3	4	410.85	821.7	15	2	1	NA	1	NA	7	0
FAM177A1	0	0	1	1	211.86	423.72	15	2	1	NA	1	NA	2	0
FAM179B	0	0	11	18	1494.24	2988.48	15	2	1	NA	1	NA	29	0
FAM180B	0	0	0	2	195.03	390.06	15	2	1	NA	1	NA	2	0
FAM181A	0	0	2	7	287.1	574.2	15	2	1	NA	1	NA	9	0
FAM184B	0	0	2	1	686.07	1372.14	15	2	1	NA	1	NA	3	0
FAM187A	0	0	3	2	246.51	493.02	15	2	1	NA	1	NA	5	0
FAM189A1	0	0	5	3	520.74	1041.48	15	2	1	NA	1	NA	8	0
FAM189A2	0	0	3	0	449.79	899.58	15	2	1	NA	1	NA	3	0
FAM193A	0	0	7	6	1502.16	3004.32	15	2	1	NA	1	NA	13	0
FAM193B	0	0	7	22	880.44	1760.88	15	2	1	NA	1	NA	29	0
FAM194A	0	0	4	6	494.01	988.02	15	2	1	NA	1	NA	10	0
FAM195A	0	0	2	1	125.4	250.8	15	2	1	NA	1	NA	3	0
FAM196A	0	0	5	7	453.42	906.84	15	2	1	NA	1	NA	12	0
FAM198B	0	0	1	1	540.87	1081.74	15	2	1	NA	1	NA	2	0
FAM199X	0	0	1	2	371.91	743.82	15	2	1	NA	1	NA	3	0
FAM204A	0	0	2	2	235.29	470.58	15	2	1	NA	1	NA	4	0
FAM208A	0	0	7	2	1621.95	3243.9	15	2	1	NA	1	NA	9	0
FAM20A	0	0	4	10	403.26	806.52	15	2	1	NA	1	NA	14	0
FAM20C	0	0	0	2	457.71	915.42	15	2	1	NA	1	NA	2	0
FAM212B	0	0	1	1	317.79	635.58	15	2	1	NA	1	NA	2	0
FAM214A	0	0	8	7	978.12	1956.24	15	2	1	NA	1	NA	15	0
FAM214B	0	0	3	11	593.01	1186.02	15	2	1	NA	1	NA	14	0
FAM217B	0	0	3	2	1021.02	2042.04	15	2	1	NA	1	NA	5	0
FAM219B	0	0	5	5	153.78	307.56	15	2	1	NA	1	NA	10	0
FAM222A	0	0	3	5	469.26	938.52	15	2	1	NA	1	NA	8	0
FAM222B	0	0	3	1	449.13	898.26	15	2	1	NA	1	NA	4	0
FAM32A	0	0	0	2	111.87	223.74	15	2	1	NA	1	NA	2	0
FAM35A	0	0	5	2	889.02	1778.04	15	2	1	NA	1	NA	7	0
FAM3D	0	0	1	1	224.73	449.46	15	2	1	NA	1	NA	2	0
FAM43B	0	0	1	6	297.99	595.98	15	2	1	NA	1	NA	7	0
FAM45A	0	0	1	1	351.45	702.9	15	2	1	NA	1	NA	2	0
FAM46B	0	0	1	4	400.95	801.9	15	2	1	NA	1	NA	5	0
FAM49AL	0	0	0	2	324.39	648.78	15	2	1	NA	1	NA	2	0
FAM53A	0	0	0	3	415.8	831.6	15	2	1	NA	1	NA	3	0
FAM53B	0	0	6	3	401.94	803.88	15	2	1	NA	1	NA	9	0
FAM57A	0	0	2	2	259.38	518.76	15	2	1	NA	1	NA	4	0
FAM63A	0	0	4	3	474.21	948.42	15	2	1	NA	1	NA	7	0
FAM64A	0	0	2	0	297	594	15	2	1	NA	1	NA	2	0
FAM65A	0	0	13	12	1096.92	2193.84	15	2	1	NA	1	NA	25	0
FAM65C	0	0	2	3	933.57	1867.14	15	2	1	NA	1	NA	5	0
FAM69A	0	0	0	2	424.05	848.1	15	2	1	NA	1	NA	2	0
FAM69B	0	0	5	5	426.03	852.06	15	2	1	NA	1	NA	10	0
FAM72A	0	0	0	2	128.7	257.4	15	2	1	NA	1	NA	2	0
FAM76A	0	0	0	5	278.19	556.38	15	2	1	NA	1	NA	5	0
FAM78A	0	0	5	7	340.56	681.12	15	2	1	NA	1	NA	12	0
FAM78B	0	0	0	4	239.91	479.82	15	2	1	NA	1	NA	4	0
FAM83C	0	0	1	6	682.11	1364.22	15	2	1	NA	1	NA	7	0
FAM83D	0	0	10	9	942.15	1884.3	15	2	1	NA	1	NA	19	0
FAM83G	0	0	4	19	746.46	1492.92	15	2	1	NA	1	NA	23	0
FAM96A	0	0	0	2	156.42	312.84	15	2	1	NA	1	NA	2	0
FAN1	0	0	10	15	1024.65	2049.3	15	2	1	NA	1	NA	25	0
FANCA	0	0	17	22	1420.65	2841.3	15	2	1	NA	1	NA	39	0
FANCC	0	0	1	1	411.18	822.36	15	2	1	NA	1	NA	2	0
FANCD2	0	0	19	37	1439.46	2878.92	15	2	1	NA	1	NA	56	0
FANCE	0	0	9	18	522.72	1045.44	15	2	1	NA	1	NA	27	0
FANCF	0	0	2	0	286.11	572.22	15	2	1	NA	1	NA	2	0
FANCG	0	0	12	9	641.52	1283.04	15	2	1	NA	1	NA	21	0
FANCI	0	0	6	10	1330.56	2661.12	15	2	1	NA	1	NA	16	0
FANCM	0	0	20	20	1751.64	3503.28	15	2	1	NA	1	NA	40	0
FAP	0	0	2	3	752.4	1504.8	15	2	1	NA	1	NA	5	0
FAR1	0	0	1	3	510.84	1021.68	15	2	1	NA	1	NA	4	0
FARP2	0	0	5	4	1389.96	2779.92	15	2	1	NA	1	NA	9	0
FARSB	0	0	1	4	584.1	1168.2	15	2	1	NA	1	NA	5	0
FAS	0	0	0	2	399.3	798.6	15	2	1	NA	1	NA	2	0
FASLG	0	0	3	3	266.31	532.62	15	2	1	NA	1	NA	6	0
FASN	0	0	3	5	2487.87	4975.74	15	2	1	NA	1	NA	8	0
FASTKD1	0	0	2	3	800.91	1601.82	15	2	1	NA	1	NA	5	0
FASTKD2	0	0	2	3	616.77	1233.54	15	2	1	NA	1	NA	5	0
FAT1	0	0	9	16	4545.09	9090.18	15	2	1	NA	1	NA	25	0
FAT2	0	0	37	52	4355.01	8710.02	15	2	1	NA	1	NA	89	0
FAT4	0	0	15	19	2642.31	5284.62	15	2	1	NA	1	NA	34	0
FAXDC2	0	0	3	2	330.66	661.32	15	2	1	NA	1	NA	5	0
FBLIM1	0	0	6	9	334.62	669.24	15	2	1	NA	1	NA	15	0
FBLN2	0	0	4	7	759.33	1518.66	15	2	1	NA	1	NA	11	0
FBLN5	0	0	2	3	440.55	881.1	15	2	1	NA	1	NA	5	0
FBN3	0	0	8	27	2921.16	5842.32	15	2	1	NA	1	NA	35	0
FBP2	0	0	1	1	319.77	639.54	15	2	1	NA	1	NA	2	0
FBRSL1	0	0	0	4	954.36	1908.72	15	2	1	NA	1	NA	4	0
FBXL18	0	0	8	12	776.16	1552.32	15	2	1	NA	1	NA	20	0
FBXL21	0	0	1	1	427.68	855.36	15	2	1	NA	1	NA	2	0
FBXL5	0	0	4	1	745.47	1490.94	15	2	1	NA	1	NA	5	0
FBXL8	0	0	4	2	376.2	752.4	15	2	1	NA	1	NA	6	0
FBXO2	0	0	2	6	245.52	491.04	15	2	1	NA	1	NA	8	0
FBXO21	0	0	0	4	594.99	1189.98	15	2	1	NA	1	NA	4	0
FBXO22	0	0	1	2	390.06	780.12	15	2	1	NA	1	NA	3	0
FBXO3	0	0	0	2	412.5	825	15	2	1	NA	1	NA	2	0
FBXO31	0	0	3	7	555.06	1110.12	15	2	1	NA	1	NA	10	0
FBXO33	0	0	1	5	414.48	828.96	15	2	1	NA	1	NA	6	0
FBXO34	0	0	7	11	742.5	1485	15	2	1	NA	1	NA	18	0
FBXO38	0	0	0	2	1176.45	2352.9	15	2	1	NA	1	NA	2	0
FBXO4	0	0	0	3	304.92	609.84	15	2	1	NA	1	NA	3	0
FBXO41	0	0	3	21	771.87	1543.74	15	2	1	NA	1	NA	24	0
FBXO42	0	0	1	1	265.65	531.3	15	2	1	NA	1	NA	2	0
FBXO45	0	0	1	4	237.6	475.2	15	2	1	NA	1	NA	5	0
FBXO47	0	0	1	1	449.46	898.92	15	2	1	NA	1	NA	2	0
FBXO6	0	0	2	4	252.45	504.9	15	2	1	NA	1	NA	6	0
FBXW11	0	0	0	5	509.85	1019.7	15	2	1	NA	1	NA	5	0
FBXW4	0	0	3	2	371.25	742.5	15	2	1	NA	1	NA	5	0
FBXW5	0	0	0	2	559.68	1119.36	15	2	1	NA	1	NA	2	0
FBXW7	0	0	0	3	561.66	1123.32	15	2	1	NA	1	NA	3	0
FBXW8	0	0	3	5	590.04	1180.08	15	2	1	NA	1	NA	8	0
FCER2	0	0	7	6	306.9	613.8	15	2	1	NA	1	NA	13	0
FCGBP	0	0	5	5	2506.35	5012.7	15	2	1	NA	1	NA	10	0
FCGBPL	0	0	51	73	2640	5280	15	2	1	NA	1	NA	124	0
FCN2-LOC112531347	0	0	2	0	210.54	421.08	15	2	1	NA	1	NA	2	0
FDXR	0	0	3	8	443.52	887.04	15	2	1	NA	1	NA	11	0
FEM1A	0	0	2	12	642.84	1285.68	15	2	1	NA	1	NA	14	0
FEM1B	0	0	2	8	598.29	1196.58	15	2	1	NA	1	NA	10	0
FEM1C	0	0	0	3	611.82	1223.64	15	2	1	NA	1	NA	3	0
FEN1	0	0	1	6	377.52	755.04	15	2	1	NA	1	NA	7	0
FER1L4	0	0	14	13	1512.72	3025.44	15	2	1	NA	1	NA	27	0
FERMT2	0	0	2	8	746.79	1493.58	15	2	1	NA	1	NA	10	0
FETUB	0	0	8	3	438.57	877.14	15	2	1	NA	1	NA	11	0
FEV	0	0	0	4	210.87	421.74	15	2	1	NA	1	NA	4	0
FEZ1	0	0	3	0	393.03	786.06	15	2	1	NA	1	NA	3	0
FEZF2	0	0	1	3	381.48	762.96	15	2	1	NA	1	NA	4	0
FFAR4	0	0	0	2	351.45	702.9	15	2	1	NA	1	NA	2	0
FGA	0	0	0	2	755.37	1510.74	15	2	1	NA	1	NA	2	0
FGB	0	0	0	3	476.19	952.38	15	2	1	NA	1	NA	3	0
FGD5	0	0	5	7	1787.28	3574.56	15	2	1	NA	1	NA	12	0
FGF1	0	0	0	4	154.44	308.88	15	2	1	NA	1	NA	4	0
FGF12	0	0	4	1	308.88	617.76	15	2	1	NA	1	NA	5	0
FGF18	0	0	1	1	225.72	451.44	15	2	1	NA	1	NA	2	0
FGF19	0	0	0	2	178.86	357.72	15	2	1	NA	1	NA	2	0
FGF22	0	0	0	2	98.67	197.34	15	2	1	NA	1	NA	2	0
FGF4	0	0	0	2	177.21	354.42	15	2	1	NA	1	NA	2	0
FGF5	0	0	3	4	249.81	499.62	15	2	1	NA	1	NA	7	0
FGF8	0	0	1	4	212.85	425.7	15	2	1	NA	1	NA	5	0
FGFBP1	0	0	2	5	236.61	473.22	15	2	1	NA	1	NA	7	0
FGFBP2	0	0	0	2	206.91	413.82	15	2	1	NA	1	NA	2	0
FGFBP3	0	0	1	2	33.99	67.98	15	2	1	NA	1	NA	3	0
FGFR1	0	0	1	13	812.79	1625.58	15	2	1	NA	1	NA	14	0
FGFR2	0	0	2	9	832.59	1665.18	15	2	1	NA	1	NA	11	0
FGFR3	0	0	4	2	763.95	1527.9	15	2	1	NA	1	NA	6	0
FGFR4	0	0	4	19	771.54	1543.08	15	2	1	NA	1	NA	23	0
FGFRL1	0	0	1	5	384.12	768.24	15	2	1	NA	1	NA	6	0
FGG	0	0	1	1	430.65	861.3	15	2	1	NA	1	NA	2	0
FGGY	0	0	2	1	546.48	1092.96	15	2	1	NA	1	NA	3	0
FGR	0	0	3	16	527.67	1055.34	15	2	1	NA	1	NA	19	0
FHAD1-LOC112529958	0	0	22	17	1253.34	2506.68	15	2	1	NA	1	NA	39	0
FHDC1	0	0	6	7	1124.31	2248.62	15	2	1	NA	1	NA	13	0
FHL1	0	0	2	2	326.7	653.4	15	2	1	NA	1	NA	4	0
FHL3	0	0	0	4	277.2	554.4	15	2	1	NA	1	NA	4	0
FIBCD1	0	0	4	9	456.39	912.78	15	2	1	NA	1	NA	13	0
FICD	0	0	1	4	355.08	710.16	15	2	1	NA	1	NA	5	0
FIGNL2	0	0	5	24	633.93	1267.86	15	2	1	NA	1	NA	29	0
FIP1L1	0	0	3	0	549.45	1098.9	15	2	1	NA	1	NA	3	0
FKBP10	0	0	2	7	530.97	1061.94	15	2	1	NA	1	NA	9	0
FKBP11	0	0	1	3	164.34	328.68	15	2	1	NA	1	NA	4	0
FKBP15	0	0	8	18	1237.83	2475.66	15	2	1	NA	1	NA	26	0
FKBP5	0	0	1	9	453.42	906.84	15	2	1	NA	1	NA	10	0
FKBP6	0	0	2	1	268.29	536.58	15	2	1	NA	1	NA	3	0
FKBP8	0	0	4	11	380.49	760.98	15	2	1	NA	1	NA	15	0
FLAD1	0	0	8	14	470.25	940.5	15	2	1	NA	1	NA	22	0
FLCN	0	0	0	2	863.28	1726.56	15	2	1	NA	1	NA	2	0
FLII	0	0	11	35	1231.56	2463.12	15	2	1	NA	1	NA	46	0
FLNB	0	0	9	16	2600.73	5201.46	15	2	1	NA	1	NA	25	0
FLOT1	0	0	0	9	413.49	826.98	15	2	1	NA	1	NA	9	0
FLOT2	0	0	1	7	424.71	849.42	15	2	1	NA	1	NA	8	0
FLRT2	0	0	1	5	655.38	1310.76	15	2	1	NA	1	NA	6	0
FLT4	0	0	3	12	1348.05	2696.1	15	2	1	NA	1	NA	15	0
FLVCR2	0	0	3	3	450.45	900.9	15	2	1	NA	1	NA	6	0
FMN1	0	0	3	2	1093.95	2187.9	15	2	1	NA	1	NA	5	0
FMNL1	0	0	6	8	936.54	1873.08	15	2	1	NA	1	NA	14	0
FMO3	0	0	9	6	522.72	1045.44	15	2	1	NA	1	NA	15	0
FMO5	0	0	8	4	146.19	292.38	15	2	1	NA	1	NA	12	0
FMOD	0	0	2	6	376.86	753.72	15	2	1	NA	1	NA	8	0
FN1	0	0	2	13	2457.18	4914.36	15	2	1	NA	1	NA	15	0
FN3K	0	0	3	3	306.9	613.8	15	2	1	NA	1	NA	6	0
FN3KRP	0	0	3	1	306.9	613.8	15	2	1	NA	1	NA	4	0
FNBP1	0	0	3	7	680.46	1360.92	15	2	1	NA	1	NA	10	0
FNBP4	0	0	8	17	900.9	1801.8	15	2	1	NA	1	NA	25	0
FNDC10	0	0	2	2	213.84	427.68	15	2	1	NA	1	NA	4	0
FNDC3B	0	0	3	12	1135.2	2270.4	15	2	1	NA	1	NA	15	0
FNDC7	0	0	6	0	589.05	1178.1	15	2	1	NA	1	NA	6	0
FNIP1	0	0	6	10	1105.83	2211.66	15	2	1	NA	1	NA	16	0
FNIP2	0	0	5	3	1128.6	2257.2	15	2	1	NA	1	NA	8	0
FNTA	0	0	3	2	292.71	585.42	15	2	1	NA	1	NA	5	0
FOCAD	0	0	7	7	1752.96	3505.92	15	2	1	NA	1	NA	14	0
FOPNL	0	0	3	1	174.24	348.48	15	2	1	NA	1	NA	4	0
FOS	0	0	0	2	338.91	677.82	15	2	1	NA	1	NA	2	0
FOXA1	0	0	0	2	440.55	881.1	15	2	1	NA	1	NA	2	0
FOXD3	0	0	0	3	263.01	526.02	15	2	1	NA	1	NA	3	0
FOXE3	0	0	3	7	387.09	774.18	15	2	1	NA	1	NA	10	0
FOXG1	0	0	1	1	436.92	873.84	15	2	1	NA	1	NA	2	0
FOXI1	0	0	0	3	372.24	744.48	15	2	1	NA	1	NA	3	0
FOXI2	0	0	0	2	131.67	263.34	15	2	1	NA	1	NA	2	0
FOXI3	0	0	1	2	272.25	544.5	15	2	1	NA	1	NA	3	0
FOXJ1	0	0	5	16	428.34	856.68	15	2	1	NA	1	NA	21	0
FOXK1	0	0	3	9	629.64	1259.28	15	2	1	NA	1	NA	12	0
FOXK2	0	0	2	4	795.96	1591.92	15	2	1	NA	1	NA	6	0
FOXN1	0	0	4	6	649.44	1298.88	15	2	1	NA	1	NA	10	0
FOXN4	0	0	7	6	511.83	1023.66	15	2	1	NA	1	NA	13	0
FOXO4	0	0	2	2	410.85	821.7	15	2	1	NA	1	NA	4	0
FOXP1	0	0	1	2	636.57	1273.14	15	2	1	NA	1	NA	3	0
FOXP4L	0	0	1	5	646.8	1293.6	15	2	1	NA	1	NA	6	0
FPGT	0	0	5	4	560.34	1120.68	15	2	1	NA	1	NA	9	0
FRA10AC1	0	0	3	2	315.81	631.62	15	2	1	NA	1	NA	5	0
FRAS1	0	0	26	28	3944.16	7888.32	15	2	1	NA	1	NA	54	0
FREM1	0	0	6	3	1870.77	3741.54	15	2	1	NA	1	NA	9	0
FREM3	0	0	9	7	1470.48	2940.96	15	2	1	NA	1	NA	16	0
FRG1	0	0	0	2	254.43	508.86	15	2	1	NA	1	NA	2	0
FRMD3	0	0	2	0	302.28	604.56	15	2	1	NA	1	NA	2	0
FRMD4B	0	0	6	11	1025.64	2051.28	15	2	1	NA	1	NA	17	0
FRMD5	0	0	4	10	538.56	1077.12	15	2	1	NA	1	NA	14	0
FRMD6	0	0	3	11	604.89	1209.78	15	2	1	NA	1	NA	14	0
FRMD7	0	0	13	5	686.07	1372.14	15	2	1	NA	1	NA	18	0
FRMPD1	0	0	10	8	1548.36	3096.72	15	2	1	NA	1	NA	18	0
FRMPD2	0	0	14	14	2071.08	4142.16	15	2	1	NA	1	NA	28	0
FRMPD3	0	0	12	22	1673.76	3347.52	15	2	1	NA	1	NA	34	0
FRRS1	0	0	7	4	594.66	1189.32	15	2	1	NA	1	NA	11	0
FRS3	0	0	2	6	474.54	949.08	15	2	1	NA	1	NA	8	0
FRYL	0	0	3	6	3011.25	6022.5	15	2	1	NA	1	NA	9	0
FRZB	0	0	2	4	285.45	570.9	15	2	1	NA	1	NA	6	0
FSCN1	0	0	1	8	484.77	969.54	15	2	1	NA	1	NA	9	0
FSCN2	0	0	7	10	481.14	962.28	15	2	1	NA	1	NA	17	0
FSD2	0	0	4	1	777.15	1554.3	15	2	1	NA	1	NA	5	0
FSHB	0	0	2	2	130.68	261.36	15	2	1	NA	1	NA	4	0
FSTL3	0	0	0	6	229.68	459.36	15	2	1	NA	1	NA	6	0
FSTL4	0	0	10	6	589.71	1179.42	15	2	1	NA	1	NA	16	0
FSTL5	0	0	3	1	618.09	1236.18	15	2	1	NA	1	NA	4	0
FTCD	0	0	3	5	536.58	1073.16	15	2	1	NA	1	NA	8	0
FTL	0	0	1	1	248.82	497.64	15	2	1	NA	1	NA	2	0
FTO	0	0	1	2	557.7	1115.4	15	2	1	NA	1	NA	3	0
FTSJ3	0	0	2	3	822.69	1645.38	15	2	1	NA	1	NA	5	0
FUBP3	0	0	1	1	541.53	1083.06	15	2	1	NA	1	NA	2	0
FUK	0	0	1	1	341.55	683.1	15	2	1	NA	1	NA	2	0
FUNDC2	0	0	2	0	144.54	289.08	15	2	1	NA	1	NA	2	0
FUT10	0	0	1	1	457.71	915.42	15	2	1	NA	1	NA	2	0
FUT11	0	0	1	4	446.16	892.32	15	2	1	NA	1	NA	5	0
FUT7	0	0	0	2	344.52	689.04	15	2	1	NA	1	NA	2	0
FUT8	0	0	1	1	276.54	553.08	15	2	1	NA	1	NA	2	0
FXR1	0	0	0	3	654.39	1308.78	15	2	1	NA	1	NA	3	0
FXYD6	0	0	1	3	293.04	586.08	15	2	1	NA	1	NA	4	0
FYB	0	0	1	2	866.91	1733.82	15	2	1	NA	1	NA	3	0
FYTTD1	0	0	4	0	312.84	625.68	15	2	1	NA	1	NA	4	0
FYTTD1L	0	0	6	1	282.81	565.62	15	2	1	NA	1	NA	7	0
FZD10	0	0	1	2	580.14	1160.28	15	2	1	NA	1	NA	3	0
FZD5	0	0	0	2	523.71	1047.42	15	2	1	NA	1	NA	2	0
FZD7	0	0	0	3	561.66	1123.32	15	2	1	NA	1	NA	3	0
FZR1	0	0	0	8	489.06	978.12	15	2	1	NA	1	NA	8	0
G3BP1	0	0	0	2	461.34	922.68	15	2	1	NA	1	NA	2	0
G3BP2	0	0	0	7	445.5	891	15	2	1	NA	1	NA	7	0
G6PC	0	0	6	11	355.41	710.82	15	2	1	NA	1	NA	17	0
G6PC2	0	0	1	1	352.44	704.88	15	2	1	NA	1	NA	2	0
GAA	0	0	15	22	795.96	1591.92	15	2	1	NA	1	NA	37	0
GAAGSD	0	0	6	12	942.81	1885.62	15	2	1	NA	1	NA	18	0
GAB3	0	0	2	9	592.02	1184.04	15	2	1	NA	1	NA	11	0
GABPB1	0	0	0	2	380.16	760.32	15	2	1	NA	1	NA	2	0
GABPB2	0	0	0	2	405.9	811.8	15	2	1	NA	1	NA	2	0
GABRA1	0	0	1	3	487.41	974.82	15	2	1	NA	1	NA	4	0
GABRA3	0	0	0	4	469.26	938.52	15	2	1	NA	1	NA	4	0
GABRA6	0	0	1	3	419.43	838.86	15	2	1	NA	1	NA	4	0
GABRD	0	0	0	2	447.48	894.96	15	2	1	NA	1	NA	2	0
GABRG1	0	0	6	1	769.23	1538.46	15	2	1	NA	1	NA	7	0
GABRP	0	0	2	3	441.54	883.08	15	2	1	NA	1	NA	5	0
GAD1	0	0	0	3	585.09	1170.18	15	2	1	NA	1	NA	3	0
GADD45B	0	0	0	3	131.34	262.68	15	2	1	NA	1	NA	3	0
GADD45G	0	0	6	1	145.2	290.4	15	2	1	NA	1	NA	7	0
GAK	0	0	4	3	1062.27	2124.54	15	2	1	NA	1	NA	7	0
GAL3ST2	0	0	2	3	465.3	930.6	15	2	1	NA	1	NA	5	0
GAL3ST4	0	0	6	7	648.45	1296.9	15	2	1	NA	1	NA	13	0
GALC	0	0	4	1	632.28	1264.56	15	2	1	NA	1	NA	5	0
GALE	0	0	1	1	331.65	663.3	15	2	1	NA	1	NA	2	0
GALK1	0	0	9	4	387.09	774.18	15	2	1	NA	1	NA	13	0
GALK2	0	0	2	1	454.41	908.82	15	2	1	NA	1	NA	3	0
GALNT10	0	0	1	3	556.38	1112.76	15	2	1	NA	1	NA	4	0
GALNT13	0	0	3	7	564.96	1129.92	15	2	1	NA	1	NA	10	0
GALNT16	0	0	3	2	554.07	1108.14	15	2	1	NA	1	NA	5	0
GALNT5	0	0	3	7	451.77	903.54	15	2	1	NA	1	NA	10	0
GALNT9	0	0	0	8	726.33	1452.66	15	2	1	NA	1	NA	8	0
GALR1L	0	0	4	4	465.96	931.92	15	2	1	NA	1	NA	8	0
GALR2	0	0	6	6	368.28	736.56	15	2	1	NA	1	NA	12	0
GALT	0	0	4	4	287.43	574.86	15	2	1	NA	1	NA	8	0
GAMT	0	0	1	4	235.62	471.24	15	2	1	NA	1	NA	5	0
GANC	0	0	3	3	721.71	1443.42	15	2	1	NA	1	NA	6	0
GAPVD1	0	0	2	13	1399.53	2799.06	15	2	1	NA	1	NA	15	0
GAR1	0	0	1	4	211.2	422.4	15	2	1	NA	1	NA	5	0
GARNL3	0	0	26	21	971.52	1943.04	15	2	1	NA	1	NA	47	0
GAS2L1	0	0	5	6	208.56	417.12	15	2	1	NA	1	NA	11	0
GAS2L2	0	0	7	2	219.78	439.56	15	2	1	NA	1	NA	9	0
GASTL	0	0	4	8	385.11	770.22	15	2	1	NA	1	NA	12	0
GATA5	0	0	1	2	177.87	355.74	15	2	1	NA	1	NA	3	0
GATB	0	0	2	1	518.1	1036.2	15	2	1	NA	1	NA	3	0
GATSL2	0	0	1	5	353.43	706.86	15	2	1	NA	1	NA	6	0
GBA2	0	0	9	12	852.06	1704.12	15	2	1	NA	1	NA	21	0
GBAS	0	0	0	2	282.15	564.3	15	2	1	NA	1	NA	2	0
GBF1	0	0	2	16	1792.89	3585.78	15	2	1	NA	1	NA	18	0
GBGT1	0	0	4	1	338.58	677.16	15	2	1	NA	1	NA	5	0
GBP7-LOC112531454-LOC112531455	0	0	3	1	607.53	1215.06	15	2	1	NA	1	NA	4	0
GBX2	0	0	3	2	342.54	685.08	15	2	1	NA	1	NA	5	0
GC	0	0	0	4	480.15	960.3	15	2	1	NA	1	NA	4	0
GCGR	0	0	4	7	494.01	988.02	15	2	1	NA	1	NA	11	0
GCH1	0	0	1	2	232.65	465.3	15	2	1	NA	1	NA	3	0
GCHFR	0	0	2	0	82.17	164.34	15	2	1	NA	1	NA	2	0
GCLM	0	0	2	1	268.95	537.9	15	2	1	NA	1	NA	3	0
GCNA	0	0	12	4	504.57	1009.14	15	2	1	NA	1	NA	16	0
GCNT3	0	0	1	4	425.7	851.4	15	2	1	NA	1	NA	5	0
GCNT4	0	0	2	2	448.14	896.28	15	2	1	NA	1	NA	4	0
GCNT7	0	0	4	0	396.99	793.98	15	2	1	NA	1	NA	4	0
GCSH	0	0	0	4	161.37	322.74	15	2	1	NA	1	NA	4	0
GDAP1L1	0	0	3	3	364.32	728.64	15	2	1	NA	1	NA	6	0
GDF10	0	0	2	5	451.44	902.88	15	2	1	NA	1	NA	7	0
GDF15	0	0	9	16	365.31	730.62	15	2	1	NA	1	NA	25	0
GDF2	0	0	5	5	424.71	849.42	15	2	1	NA	1	NA	10	0
GDF3	0	0	6	7	369.27	738.54	15	2	1	NA	1	NA	13	0
GDF5	0	0	2	3	495.99	991.98	15	2	1	NA	1	NA	5	0
GDF9	0	0	2	8	455.4	910.8	15	2	1	NA	1	NA	10	0
GDPD2	0	0	5	2	534.27	1068.54	15	2	1	NA	1	NA	7	0
GDPGP1	0	0	4	8	250.8	501.6	15	2	1	NA	1	NA	12	0
GEMIN2	0	0	2	2	261.36	522.72	15	2	1	NA	1	NA	4	0
GEMIN4	0	0	22	21	1037.19	2074.38	15	2	1	NA	1	NA	43	0
GEMIN5	0	0	11	7	1514.7	3029.4	15	2	1	NA	1	NA	18	0
GEMIN7-TBCB	0	0	1	3	92.4	184.8	15	2	1	NA	1	NA	4	0
GET4	0	0	0	2	324.72	649.44	15	2	1	NA	1	NA	2	0
GFAP	0	0	4	5	429.66	859.32	15	2	1	NA	1	NA	9	0
GFER	0	0	1	3	190.08	380.16	15	2	1	NA	1	NA	4	0
GFI1	0	0	2	3	401.94	803.88	15	2	1	NA	1	NA	5	0
GFI1B	0	0	3	2	332.64	665.28	15	2	1	NA	1	NA	5	0
GFM1	0	0	5	11	732.6	1465.2	15	2	1	NA	1	NA	16	0
GFM2	0	0	4	3	755.04	1510.08	15	2	1	NA	1	NA	7	0
GFOD2	0	0	1	4	382.14	764.28	15	2	1	NA	1	NA	5	0
GFPT2	0	0	0	2	676.17	1352.34	15	2	1	NA	1	NA	2	0
GFRA1	0	0	1	2	362.34	724.68	15	2	1	NA	1	NA	3	0
GFRA2	0	0	5	12	460.35	920.7	15	2	1	NA	1	NA	17	0
GFRA3	0	0	0	2	404.58	809.16	15	2	1	NA	1	NA	2	0
GFRA4	0	0	2	13	427.68	855.36	15	2	1	NA	1	NA	15	0
GGA2	0	0	10	11	996.93	1993.86	15	2	1	NA	1	NA	21	0
GGA3	0	0	6	2	747.45	1494.9	15	2	1	NA	1	NA	8	0
GGNBP2	0	0	2	2	730.62	1461.24	15	2	1	NA	1	NA	4	0
GGT7	0	0	1	1	628.98	1257.96	15	2	1	NA	1	NA	2	0
GHITM	0	0	3	1	343.53	687.06	15	2	1	NA	1	NA	4	0
GHRH	0	0	1	1	168.3	336.6	15	2	1	NA	1	NA	2	0
GHRL	0	0	3	0	115.83	231.66	15	2	1	NA	1	NA	3	0
GHSR	0	0	0	3	349.47	698.94	15	2	1	NA	1	NA	3	0
GID4	0	0	2	4	211.86	423.72	15	2	1	NA	1	NA	6	0
GID8	0	0	0	4	226.71	453.42	15	2	1	NA	1	NA	4	0
GIF	0	0	8	19	420.09	840.18	15	2	1	NA	1	NA	27	0
GIMD1	0	0	3	1	219.78	439.56	15	2	1	NA	1	NA	4	0
GIN1	0	0	2	1	521.07	1042.14	15	2	1	NA	1	NA	3	0
GINS2	0	0	1	1	164.34	328.68	15	2	1	NA	1	NA	2	0
GINS3	0	0	0	3	212.85	425.7	15	2	1	NA	1	NA	3	0
GIPC2	0	0	3	1	314.82	629.64	15	2	1	NA	1	NA	4	0
GIPC3	0	0	6	8	317.79	635.58	15	2	1	NA	1	NA	14	0
GIT1	0	0	1	16	655.05	1310.1	15	2	1	NA	1	NA	17	0
GIT2	0	0	0	11	720.72	1441.44	15	2	1	NA	1	NA	11	0
GJA4	0	0	6	11	339.57	679.14	15	2	1	NA	1	NA	17	0
GJA9	0	0	4	7	513.81	1027.62	15	2	1	NA	1	NA	11	0
GJB3	0	0	0	5	266.31	532.62	15	2	1	NA	1	NA	5	0
GJB5	0	0	11	7	295.02	590.04	15	2	1	NA	1	NA	18	0
GJD2	0	0	0	2	301.95	603.9	15	2	1	NA	1	NA	2	0
GK5	0	0	5	6	514.8	1029.6	15	2	1	NA	1	NA	11	0
GKN1	0	0	1	1	287.1	574.2	15	2	1	NA	1	NA	2	0
GLA	0	0	5	3	350.46	700.92	15	2	1	NA	1	NA	8	0
GLB1L	0	0	5	5	287.43	574.86	15	2	1	NA	1	NA	10	0
GLB1L2	0	0	5	11	655.38	1310.76	15	2	1	NA	1	NA	16	0
GLCE	0	0	4	10	634.59	1269.18	15	2	1	NA	1	NA	14	0
GLDC	0	0	2	3	1011.12	2022.24	15	2	1	NA	1	NA	5	0
GLDN	0	0	3	6	519.75	1039.5	15	2	1	NA	1	NA	9	0
GLE1	0	0	5	1	695.97	1391.94	15	2	1	NA	1	NA	6	0
GLI1	0	0	4	2	1253.34	2506.68	15	2	1	NA	1	NA	6	0
GLI2	0	0	2	9	1477.08	2954.16	15	2	1	NA	1	NA	11	0
GLIS3	0	0	4	3	611.16	1222.32	15	2	1	NA	1	NA	7	0
GLMN	0	0	1	1	629.64	1259.28	15	2	1	NA	1	NA	2	0
GLOD4	0	0	2	4	296.01	592.02	15	2	1	NA	1	NA	6	0
GLOD5	0	0	2	0	148.5	297	15	2	1	NA	1	NA	2	0
GLP2R	0	0	1	1	216.81	433.62	15	2	1	NA	1	NA	2	0
GLRA1	0	0	4	4	446.49	892.98	15	2	1	NA	1	NA	8	0
GLRA4	0	0	5	16	477.51	955.02	15	2	1	NA	1	NA	21	0
GLRX	0	0	1	3	90.09	180.18	15	2	1	NA	1	NA	4	0
GLRX2	0	0	0	2	132.66	265.32	15	2	1	NA	1	NA	2	0
GLRX3	0	0	3	2	311.19	622.38	15	2	1	NA	1	NA	5	0
GLS	0	0	2	3	602.91	1205.82	15	2	1	NA	1	NA	5	0
GLT1D1	0	0	3	0	463.65	927.3	15	2	1	NA	1	NA	3	0
GLT8D1	0	0	1	7	369.27	738.54	15	2	1	NA	1	NA	8	0
GLTP	0	0	1	6	171.93	343.86	15	2	1	NA	1	NA	7	0
GLUD1	0	0	0	3	533.28	1066.56	15	2	1	NA	1	NA	3	0
GLUL	0	0	1	10	370.26	740.52	15	2	1	NA	1	NA	11	0
GLYCTK	0	0	8	1	501.93	1003.86	15	2	1	NA	1	NA	9	0
GLYR1	0	0	1	3	595.98	1191.96	15	2	1	NA	1	NA	4	0
GM2A	0	0	2	3	201.96	403.92	15	2	1	NA	1	NA	5	0
GMCL1	0	0	1	6	436.92	873.84	15	2	1	NA	1	NA	7	0
GMEB2	0	0	2	9	526.68	1053.36	15	2	1	NA	1	NA	11	0
GMFB	0	0	3	0	117.81	235.62	15	2	1	NA	1	NA	3	0
GMNC	0	0	2	0	316.14	632.28	15	2	1	NA	1	NA	2	0
GMPPA	0	0	2	3	419.76	839.52	15	2	1	NA	1	NA	5	0
GMPS	0	0	2	4	688.05	1376.1	15	2	1	NA	1	NA	6	0
GNA12	0	0	1	4	382.14	764.28	15	2	1	NA	1	NA	5	0
GNA13	0	0	0	3	374.22	748.44	15	2	1	NA	1	NA	3	0
GNAI2	0	0	1	5	342.54	685.08	15	2	1	NA	1	NA	6	0
GNAO1	0	0	0	7	351.45	702.9	15	2	1	NA	1	NA	7	0
GNAT1	0	0	0	2	347.49	694.98	15	2	1	NA	1	NA	2	0
GNAT2	0	0	2	7	377.19	754.38	15	2	1	NA	1	NA	9	0
GNB1L	0	0	5	4	325.71	651.42	15	2	1	NA	1	NA	9	0
GNB4	0	0	0	2	337.59	675.18	15	2	1	NA	1	NA	2	0
GNE	0	0	2	3	714.78	1429.56	15	2	1	NA	1	NA	5	0
GNG12	0	0	1	1	28.71	57.42	15	2	1	NA	1	NA	2	0
GNG2	0	0	0	2	71.28	142.56	15	2	1	NA	1	NA	2	0
GNL2	0	0	5	9	714.78	1429.56	15	2	1	NA	1	NA	14	0
GNL3	0	0	4	5	554.07	1108.14	15	2	1	NA	1	NA	9	0
GNOT2	0	0	2	0	88.11	176.22	15	2	1	NA	1	NA	2	0
GNPDA1	0	0	3	1	286.11	572.22	15	2	1	NA	1	NA	4	0
GNPNAT1	0	0	1	3	189.09	378.18	15	2	1	NA	1	NA	4	0
GNPTG	0	0	2	2	303.93	607.86	15	2	1	NA	1	NA	4	0
GNRH1	0	0	2	0	92.07	184.14	15	2	1	NA	1	NA	2	0
GNRHR	0	0	4	16	463.32	926.64	15	2	1	NA	1	NA	20	0
GOLGA1	0	0	3	5	797.94	1595.88	15	2	1	NA	1	NA	8	0
GOLGA2	0	0	3	1	829.62	1659.24	15	2	1	NA	1	NA	4	0
GOLGA3	0	0	8	8	1497.87	2995.74	15	2	1	NA	1	NA	16	0
GOLGA5	0	0	6	5	729.63	1459.26	15	2	1	NA	1	NA	11	0
GOLGA7B	0	0	1	2	144.21	288.42	15	2	1	NA	1	NA	3	0
GOLPH3L	0	0	7	12	639.54	1279.08	15	2	1	NA	1	NA	19	0
GON4L	0	0	4	13	2187.57	4375.14	15	2	1	NA	1	NA	17	0
GORAB	0	0	5	8	372.24	744.48	15	2	1	NA	1	NA	13	0
GORASP2	0	0	1	3	415.8	831.6	15	2	1	NA	1	NA	4	0
GOSR1	0	0	1	1	242.22	484.44	15	2	1	NA	1	NA	2	0
GOSR2	0	0	0	2	210.87	421.74	15	2	1	NA	1	NA	2	0
GOT1	0	0	0	3	329.67	659.34	15	2	1	NA	1	NA	3	0
GP1BA-LOC101750889	0	0	5	6	752.07	1504.14	15	2	1	NA	1	NA	11	0
GP1BB	0	0	3	2	196.02	392.04	15	2	1	NA	1	NA	5	0
GPAM	0	0	1	3	814.11	1628.22	15	2	1	NA	1	NA	4	0
GPAT3	0	0	0	7	442.53	885.06	15	2	1	NA	1	NA	7	0
GPAT4	0	0	0	3	451.44	902.88	15	2	1	NA	1	NA	3	0
GPATCH1	0	0	2	2	943.47	1886.94	15	2	1	NA	1	NA	4	0
GPATCH2L	0	0	3	3	480.15	960.3	15	2	1	NA	1	NA	6	0
GPATCH3	0	0	5	7	489.06	978.12	15	2	1	NA	1	NA	12	0
GPATCH4	0	0	3	6	255.42	510.84	15	2	1	NA	1	NA	9	0
GPATCH8	0	0	10	10	1505.46	3010.92	15	2	1	NA	1	NA	20	0
GPBP1	0	0	1	3	345.18	690.36	15	2	1	NA	1	NA	4	0
GPBP1L1	0	0	0	2	467.28	934.56	15	2	1	NA	1	NA	2	0
GPC1	0	0	2	0	450.45	900.9	15	2	1	NA	1	NA	2	0
GPC2	0	0	1	1	307.89	615.78	15	2	1	NA	1	NA	2	0
GPC4	0	0	0	3	556.38	1112.76	15	2	1	NA	1	NA	3	0
GPD1L2	0	0	0	2	346.5	693	15	2	1	NA	1	NA	2	0
GPD2	0	0	1	7	720.72	1441.44	15	2	1	NA	1	NA	8	0
GPHB5	0	0	0	3	129.69	259.38	15	2	1	NA	1	NA	3	0
GPM6A	0	0	1	1	306.9	613.8	15	2	1	NA	1	NA	2	0
GPN2	0	0	0	2	309.87	619.74	15	2	1	NA	1	NA	2	0
GPN3	0	0	1	5	453.42	906.84	15	2	1	NA	1	NA	6	0
GPR107	0	0	2	4	555.39	1110.78	15	2	1	NA	1	NA	6	0
GPR119	0	0	0	3	323.73	647.46	15	2	1	NA	1	NA	3	0
GPR135	0	0	1	6	223.41	446.82	15	2	1	NA	1	NA	7	0
GPR137C	0	0	0	5	389.07	778.14	15	2	1	NA	1	NA	5	0
GPR142	0	0	8	6	331.65	663.3	15	2	1	NA	1	NA	14	0
GPR149	0	0	7	9	668.25	1336.5	15	2	1	NA	1	NA	16	0
GPR153	0	0	4	2	596.97	1193.94	15	2	1	NA	1	NA	6	0
GPR155	0	0	5	4	848.43	1696.86	15	2	1	NA	1	NA	9	0
GPR157	0	0	2	3	331.65	663.3	15	2	1	NA	1	NA	5	0
GPR160	0	0	11	4	335.61	671.22	15	2	1	NA	1	NA	15	0
GPR17	0	0	0	3	341.55	683.1	15	2	1	NA	1	NA	3	0
GPR21	0	0	1	2	345.51	691.02	15	2	1	NA	1	NA	3	0
GPR26	0	0	0	2	334.62	669.24	15	2	1	NA	1	NA	2	0
GPR34L	0	0	4	3	334.62	669.24	15	2	1	NA	1	NA	7	0
GPR35	0	0	2	3	306.9	613.8	15	2	1	NA	1	NA	5	0
GPR35L	0	0	2	0	312.84	625.68	15	2	1	NA	1	NA	2	0
GPR37L1	0	0	3	9	475.2	950.4	15	2	1	NA	1	NA	12	0
GPR39	0	0	0	3	304.92	609.84	15	2	1	NA	1	NA	3	0
GPR50	0	0	3	4	331.65	663.3	15	2	1	NA	1	NA	7	0
GPR52	0	0	2	1	358.38	716.76	15	2	1	NA	1	NA	3	0
GPR62	0	0	2	4	405.9	811.8	15	2	1	NA	1	NA	6	0
GPR68	0	0	2	4	354.42	708.84	15	2	1	NA	1	NA	6	0
GPR87	0	0	1	4	352.44	704.88	15	2	1	NA	1	NA	5	0
GPRC5C	0	0	8	12	429.66	859.32	15	2	1	NA	1	NA	20	0
GPRIN1	0	0	9	14	418.77	837.54	15	2	1	NA	1	NA	23	0
GPRIN2	0	0	2	2	601.92	1203.84	15	2	1	NA	1	NA	4	0
GPRIN3	0	0	21	15	755.37	1510.74	15	2	1	NA	1	NA	36	0
GPS1	0	0	1	2	483.12	966.24	15	2	1	NA	1	NA	3	0
GPSM1	0	0	1	8	649.77	1299.54	15	2	1	NA	1	NA	9	0
GPSM2	0	0	1	3	657.36	1314.72	15	2	1	NA	1	NA	4	0
GPT2	0	0	0	2	438.57	877.14	15	2	1	NA	1	NA	2	0
GPX1	0	0	0	3	120.78	241.56	15	2	1	NA	1	NA	3	0
GPX3	0	0	2	2	214.83	429.66	15	2	1	NA	1	NA	4	0
GPX4	0	0	1	2	107.25	214.5	15	2	1	NA	1	NA	3	0
GPX7	0	0	3	0	208.89	417.78	15	2	1	NA	1	NA	3	0
GPX8	0	0	2	0	208.89	417.78	15	2	1	NA	1	NA	2	0
GRAMD1B	0	0	4	5	693.33	1386.66	15	2	1	NA	1	NA	9	0
GRAMD3	0	0	1	3	452.43	904.86	15	2	1	NA	1	NA	4	0
GRASP	0	0	0	4	281.82	563.64	15	2	1	NA	1	NA	4	0
GRB14	0	0	2	1	374.22	748.44	15	2	1	NA	1	NA	3	0
GRB2	0	0	4	2	270.27	540.54	15	2	1	NA	1	NA	6	0
GRB7	0	0	3	10	470.25	940.5	15	2	1	NA	1	NA	13	0
GRIA1	0	0	0	2	861.3	1722.6	15	2	1	NA	1	NA	2	0
GRIA2-GRIA3-GRIA4	0	0	0	4	584.1	1168.2	15	2	1	NA	1	NA	4	0
GRID2	0	0	3	3	445.5	891	15	2	1	NA	1	NA	6	0
GRID2IP	0	0	12	20	1051.38	2102.76	15	2	1	NA	1	NA	32	0
GRIK3	0	0	1	11	903.87	1807.74	15	2	1	NA	1	NA	12	0
GRIK4	0	0	13	46	920.7	1841.4	15	2	1	NA	1	NA	59	0
GRIN2A	0	0	4	2	1344.42	2688.84	15	2	1	NA	1	NA	6	0
GRIN2C	0	0	37	41	1284.36	2568.72	15	2	1	NA	1	NA	78	0
GRIN3A	0	0	4	4	1164.57	2329.14	15	2	1	NA	1	NA	8	0
GRIN3B	0	0	14	16	871.86	1743.72	15	2	1	NA	1	NA	30	0
GRIP2	0	0	4	8	1069.86	2139.72	15	2	1	NA	1	NA	12	0
GRK4	0	0	0	2	564.3	1128.6	15	2	1	NA	1	NA	2	0
GRK6	0	0	0	6	553.08	1106.16	15	2	1	NA	1	NA	6	0
GRK7	0	0	4	5	640.53	1281.06	15	2	1	NA	1	NA	9	0
GRM4	0	0	8	23	878.13	1756.26	15	2	1	NA	1	NA	31	0
GRM7	0	0	4	13	812.46	1624.92	15	2	1	NA	1	NA	17	0
GRPEL1	0	0	1	4	218.79	437.58	15	2	1	NA	1	NA	5	0
GRSF1	0	0	0	5	372.57	745.14	15	2	1	NA	1	NA	5	0
GSC2	0	0	1	5	218.79	437.58	15	2	1	NA	1	NA	6	0
GSE1	0	0	3	15	588.06	1176.12	15	2	1	NA	1	NA	18	0
GSG2	0	0	0	2	429.66	859.32	15	2	1	NA	1	NA	2	0
GSL	0	0	1	11	371.25	742.5	15	2	1	NA	1	NA	12	0
GSN	0	0	0	5	787.05	1574.1	15	2	1	NA	1	NA	5	0
GSR	0	0	3	7	460.35	920.7	15	2	1	NA	1	NA	10	0
GSTCD	0	0	5	9	619.74	1239.48	15	2	1	NA	1	NA	14	0
GSTM2	0	0	1	8	191.4	382.8	15	2	1	NA	1	NA	9	0
GSTO1	0	0	2	1	240.57	481.14	15	2	1	NA	1	NA	3	0
GSTT1	0	0	2	2	259.38	518.76	15	2	1	NA	1	NA	4	0
GSTT1L	0	0	1	2	240.57	481.14	15	2	1	NA	1	NA	3	0
GSTZ1	0	0	0	2	208.89	417.78	15	2	1	NA	1	NA	2	0
GTDC1	0	0	9	2	524.7	1049.4	15	2	1	NA	1	NA	11	0
GTF2E1L	0	0	9	2	418.77	837.54	15	2	1	NA	1	NA	11	0
GTF2E2	0	0	0	4	289.08	578.16	15	2	1	NA	1	NA	4	0
GTF2H1	0	0	1	3	543.51	1087.02	15	2	1	NA	1	NA	4	0
GTF2I	0	0	3	10	1021.68	2043.36	15	2	1	NA	1	NA	13	0
GTF2IRD1	0	0	3	17	983.07	1966.14	15	2	1	NA	1	NA	20	0
GTF3C3	0	0	0	7	903.87	1807.74	15	2	1	NA	1	NA	7	0
GTF3C4	0	0	2	9	805.86	1611.72	15	2	1	NA	1	NA	11	0
GTPBP3	0	0	4	7	248.82	497.64	15	2	1	NA	1	NA	11	0
GTSF1	0	0	2	1	157.08	314.16	15	2	1	NA	1	NA	3	0
GUCA1A	0	0	1	1	198	396	15	2	1	NA	1	NA	2	0
GUCY1A3	0	0	4	3	682.11	1364.22	15	2	1	NA	1	NA	7	0
GUCY1B4	0	0	5	6	773.19	1546.38	15	2	1	NA	1	NA	11	0
GUF1	0	0	4	3	654.39	1308.78	15	2	1	NA	1	NA	7	0
GUSB	0	0	4	5	646.47	1292.94	15	2	1	NA	1	NA	9	0
GXYLT2	0	0	2	2	351.45	702.9	15	2	1	NA	1	NA	4	0
GZMK	0	0	5	1	329.67	659.34	15	2	1	NA	1	NA	6	0
GZMM	0	0	8	14	312.84	625.68	15	2	1	NA	1	NA	22	0
H1FOO	0	0	3	3	268.29	536.58	15	2	1	NA	1	NA	6	0
H2AFV	0	0	0	2	80.85	161.7	15	2	1	NA	1	NA	2	0
H2AFY2	0	0	1	3	369.27	738.54	15	2	1	NA	1	NA	4	0
H2AFZ	0	0	0	3	127.71	255.42	15	2	1	NA	1	NA	3	0
H6PD	0	0	6	9	783.09	1566.18	15	2	1	NA	1	NA	15	0
HABP2	0	0	3	2	560.34	1120.68	15	2	1	NA	1	NA	5	0
HABP4	0	0	3	0	261.03	522.06	15	2	1	NA	1	NA	3	0
HACD2	0	0	0	2	244.53	489.06	15	2	1	NA	1	NA	2	0
HACD3	0	0	0	4	290.07	580.14	15	2	1	NA	1	NA	4	0
HADH	0	0	0	6	315.81	631.62	15	2	1	NA	1	NA	6	0
HAGHL	0	0	2	3	248.16	496.32	15	2	1	NA	1	NA	5	0
HAND1	0	0	0	2	193.71	387.42	15	2	1	NA	1	NA	2	0
HAP1	0	0	9	7	565.62	1131.24	15	2	1	NA	1	NA	16	0
HAPLN1	0	0	1	1	352.44	704.88	15	2	1	NA	1	NA	2	0
HAPLN2	0	0	6	7	381.81	763.62	15	2	1	NA	1	NA	13	0
HAPLN3	0	0	1	12	357.39	714.78	15	2	1	NA	1	NA	13	0
HAPLN4	0	0	14	18	733.26	1466.52	15	2	1	NA	1	NA	32	0
HARBI1	0	0	3	4	335.94	671.88	15	2	1	NA	1	NA	7	0
HARS	0	0	4	7	423.39	846.78	15	2	1	NA	1	NA	11	0
HARS2	0	0	2	5	359.7	719.4	15	2	1	NA	1	NA	7	0
HAUS2	0	0	2	0	252.12	504.24	15	2	1	NA	1	NA	2	0
HAUS3	0	0	6	5	594.99	1189.98	15	2	1	NA	1	NA	11	0
HAUS3L	0	0	2	1	247.83	495.66	15	2	1	NA	1	NA	3	0
HAVCR1	0	0	6	9	297	594	15	2	1	NA	1	NA	15	0
HAX1	0	0	1	1	59.73	119.46	15	2	1	NA	1	NA	2	0
HBEGF	0	0	0	2	204.93	409.86	15	2	1	NA	1	NA	2	0
HCCS	0	0	1	2	271.26	542.52	15	2	1	NA	1	NA	3	0
HCK	0	0	0	12	497.97	995.94	15	2	1	NA	1	NA	12	0
HCN1	0	0	1	2	422.73	845.46	15	2	1	NA	1	NA	3	0
HCN2	0	0	1	6	755.7	1511.4	15	2	1	NA	1	NA	7	0
HCN3	0	0	1	2	616.77	1233.54	15	2	1	NA	1	NA	3	0
HCN4	0	0	2	6	1232.22	2464.44	15	2	1	NA	1	NA	8	0
HDAC1	0	0	1	4	460.02	920.04	15	2	1	NA	1	NA	5	0
HDAC11	0	0	0	7	361.35	722.7	15	2	1	NA	1	NA	7	0
HDAC4	0	0	5	17	1082.73	2165.46	15	2	1	NA	1	NA	22	0
HDAC7	0	0	4	28	976.14	1952.28	15	2	1	NA	1	NA	32	0
HDAC8	0	0	0	9	371.25	742.5	15	2	1	NA	1	NA	9	0
HDC	0	0	4	6	622.71	1245.42	15	2	1	NA	1	NA	10	0
HDGFRP2	0	0	6	14	636.57	1273.14	15	2	1	NA	1	NA	20	0
HDHD2	0	0	3	2	256.74	513.48	15	2	1	NA	1	NA	5	0
HDHD3	0	0	5	3	231.99	463.98	15	2	1	NA	1	NA	8	0
HDLBP	0	0	0	11	1255.32	2510.64	15	2	1	NA	1	NA	11	0
HDX	0	0	2	4	691.02	1382.04	15	2	1	NA	1	NA	6	0
HEATR3	0	0	3	10	658.02	1316.04	15	2	1	NA	1	NA	13	0
HEATR5A	0	0	3	4	2034.45	4068.9	15	2	1	NA	1	NA	7	0
HEBP2	0	0	4	1	182.16	364.32	15	2	1	NA	1	NA	5	0
HECTD2	0	0	2	3	733.92	1467.84	15	2	1	NA	1	NA	5	0
HECTD3	0	0	1	6	795.63	1591.26	15	2	1	NA	1	NA	7	0
HECTD3L	0	0	4	13	842.82	1685.64	15	2	1	NA	1	NA	17	0
HECTD4	0	0	8	37	4333.56	8667.12	15	2	1	NA	1	NA	45	0
HECW1	0	0	0	4	456.72	913.44	15	2	1	NA	1	NA	4	0
HECW2	0	0	5	5	1093.62	2187.24	15	2	1	NA	1	NA	10	0
HEG1	0	0	22	20	1756.59	3513.18	15	2	1	NA	1	NA	42	0
HELLS	0	0	2	6	803.88	1607.76	15	2	1	NA	1	NA	8	0
HELQ	0	0	5	6	1008.81	2017.62	15	2	1	NA	1	NA	11	0
HELZ	0	0	1	7	1888.92	3777.84	15	2	1	NA	1	NA	8	0
HELZ2	0	0	13	53	2790.15	5580.3	15	2	1	NA	1	NA	66	0
HEMGN	0	0	2	2	263.34	526.68	15	2	1	NA	1	NA	4	0
HEMK1	0	0	6	3	350.46	700.92	15	2	1	NA	1	NA	9	0
HEP21	0	0	3	6	106.92	213.84	15	2	1	NA	1	NA	9	0
HEPACAM	0	0	3	2	299.64	599.28	15	2	1	NA	1	NA	5	0
HERC1	0	0	4	11	4635.18	9270.36	15	2	1	NA	1	NA	15	0
HERC4	0	0	3	4	1036.2	2072.4	15	2	1	NA	1	NA	7	0
HERPUD1	0	0	8	2	399.63	799.26	15	2	1	NA	1	NA	10	0
HES1	0	0	5	3	230.67	461.34	15	2	1	NA	1	NA	8	0
HES4	0	0	0	4	292.05	584.1	15	2	1	NA	1	NA	4	0
HES5	0	0	1	2	156.42	312.84	15	2	1	NA	1	NA	3	0
HES6	0	0	5	1	225.72	451.44	15	2	1	NA	1	NA	6	0
HESX1	0	0	1	1	198	396	15	2	1	NA	1	NA	2	0
HEXA	0	0	8	7	517.44	1034.88	15	2	1	NA	1	NA	15	0
HEXB	0	0	1	2	501.93	1003.86	15	2	1	NA	1	NA	3	0
HEXDC	0	0	3	3	462	924	15	2	1	NA	1	NA	6	0
HEXDCL	0	0	12	12	559.35	1118.7	15	2	1	NA	1	NA	24	0
HFM1	0	0	0	3	1183.71	2367.42	15	2	1	NA	1	NA	3	0
HGFAC	0	0	2	1	540.54	1081.08	15	2	1	NA	1	NA	3	0
HGSNAT	0	0	3	4	581.79	1163.58	15	2	1	NA	1	NA	7	0
HHIP	0	0	1	3	643.5	1287	15	2	1	NA	1	NA	4	0
HHIPL1	0	0	2	5	764.94	1529.88	15	2	1	NA	1	NA	7	0
HHLA2	0	0	2	2	107.25	214.5	15	2	1	NA	1	NA	4	0
HIBCH	0	0	1	2	382.14	764.28	15	2	1	NA	1	NA	3	0
HIC2	0	0	2	5	565.29	1130.58	15	2	1	NA	1	NA	7	0
HID1	0	0	5	6	843.48	1686.96	15	2	1	NA	1	NA	11	0
HIF1A	0	0	0	4	802.56	1605.12	15	2	1	NA	1	NA	4	0
HIF1AN	0	0	1	1	341.55	683.1	15	2	1	NA	1	NA	2	0
HIGD2A	0	0	2	0	69.96	139.92	15	2	1	NA	1	NA	2	0
HINFP	0	0	8	7	508.53	1017.06	15	2	1	NA	1	NA	15	0
HINT1Z-HINT2Z	0	0	0	3	127.05	254.1	15	2	1	NA	1	NA	3	0
HIP1	0	0	12	8	2018.94	4037.88	15	2	1	NA	1	NA	20	0
HIP1R	0	0	17	20	1679.7	3359.4	15	2	1	NA	1	NA	37	0
HIPK1	0	0	2	2	1200.87	2401.74	15	2	1	NA	1	NA	4	0
HIPK3	0	0	5	11	1182.06	2364.12	15	2	1	NA	1	NA	16	0
HIST1H2B8	0	0	0	4	125.73	251.46	15	2	1	NA	1	NA	4	0
HIST2H4B	0	0	0	5	72.6	145.2	15	2	1	NA	1	NA	5	0
HIVEP3	0	0	17	30	2473.02	4946.04	15	2	1	NA	1	NA	47	0
HK2	0	0	5	20	914.76	1829.52	15	2	1	NA	1	NA	25	0
HK3	0	0	7	28	998.58	1997.16	15	2	1	NA	1	NA	35	0
HLF	0	0	0	2	290.07	580.14	15	2	1	NA	1	NA	2	0
HM13	0	0	0	4	371.25	742.5	15	2	1	NA	1	NA	4	0
HMCN1	0	0	11	10	3623.4	7246.8	15	2	1	NA	1	NA	21	0
HMG20A	0	0	0	2	345.51	691.02	15	2	1	NA	1	NA	2	0
HMG20B	0	0	1	7	316.8	633.6	15	2	1	NA	1	NA	8	0
HMGB3	0	0	0	2	199.65	399.3	15	2	1	NA	1	NA	2	0
HMGCL	0	0	1	1	319.77	639.54	15	2	1	NA	1	NA	2	0
HMGCR	0	0	0	6	835.56	1671.12	15	2	1	NA	1	NA	6	0
HMGCS1	0	0	12	7	559.35	1118.7	15	2	1	NA	1	NA	19	0
HMGCS2	0	0	3	8	503.91	1007.82	15	2	1	NA	1	NA	11	0
HMGN4	0	0	0	4	106.92	213.84	15	2	1	NA	1	NA	4	0
HMGXB3	0	0	10	7	1305.81	2611.62	15	2	1	NA	1	NA	17	0
HMMR	0	0	5	3	660.33	1320.66	15	2	1	NA	1	NA	8	0
HMP19	0	0	1	2	232.65	465.3	15	2	1	NA	1	NA	3	0
HMX2	0	0	0	3	200.64	401.28	15	2	1	NA	1	NA	3	0
HMX3	0	0	0	2	277.86	555.72	15	2	1	NA	1	NA	2	0
HNF1B	0	0	1	4	522.06	1044.12	15	2	1	NA	1	NA	5	0
HNF4A	0	0	1	3	463.32	926.64	15	2	1	NA	1	NA	4	0
HNF4beta	0	0	1	9	453.09	906.18	15	2	1	NA	1	NA	10	0
HNMT	0	0	2	1	290.07	580.14	15	2	1	NA	1	NA	3	0
HNRNPA0	0	0	1	2	310.86	621.72	15	2	1	NA	1	NA	3	0
HNRNPA3	0	0	0	4	383.13	766.26	15	2	1	NA	1	NA	4	0
HNRNPD	0	0	0	2	256.74	513.48	15	2	1	NA	1	NA	2	0
HNRNPDL	0	0	0	5	298.98	597.96	15	2	1	NA	1	NA	5	0
HNRNPH2	0	0	0	7	473.22	946.44	15	2	1	NA	1	NA	7	0
HNRNPM	0	0	0	3	641.85	1283.7	15	2	1	NA	1	NA	3	0
HNRNPR	0	0	1	1	627.66	1255.32	15	2	1	NA	1	NA	2	0
HOGA1	0	0	16	11	330.66	661.32	15	2	1	NA	1	NA	27	0
HOMER2	0	0	0	2	381.15	762.3	15	2	1	NA	1	NA	2	0
HOMER3	0	0	3	3	395.01	790.02	15	2	1	NA	1	NA	6	0
HOOK1	0	0	1	2	711.81	1423.62	15	2	1	NA	1	NA	3	0
HORMAD2	0	0	6	4	352.44	704.88	15	2	1	NA	1	NA	10	0
HOXC6	0	0	2	4	187.11	374.22	15	2	1	NA	1	NA	6	0
HOXCDX1L	0	0	2	2	275.22	550.44	15	2	1	NA	1	NA	4	0
HOXD9	0	0	2	2	265.32	530.64	15	2	1	NA	1	NA	4	0
HP1BP3	0	0	1	1	528.66	1057.32	15	2	1	NA	1	NA	2	0
HPCA	0	0	1	1	192.06	384.12	15	2	1	NA	1	NA	2	0
HPD	0	0	4	10	390.06	780.12	15	2	1	NA	1	NA	14	0
HPRT1	0	0	0	3	201.96	403.92	15	2	1	NA	1	NA	3	0
HPS1	0	0	5	7	589.05	1178.1	15	2	1	NA	1	NA	12	0
HPS3	0	0	4	5	1090.98	2181.96	15	2	1	NA	1	NA	9	0
HPS4	0	0	16	10	613.8	1227.6	15	2	1	NA	1	NA	26	0
HPS5	0	0	5	8	1257.3	2514.6	15	2	1	NA	1	NA	13	0
HPSE	0	0	7	10	503.91	1007.82	15	2	1	NA	1	NA	17	0
HPSE2	0	0	1	3	406.89	813.78	15	2	1	NA	1	NA	4	0
HR	0	0	2	6	132.66	265.32	15	2	1	NA	1	NA	8	0
HRASLS	0	0	1	1	168.3	336.6	15	2	1	NA	1	NA	2	0
HRG	0	0	1	4	571.89	1143.78	15	2	1	NA	1	NA	5	0
HRH2	0	0	2	4	361.02	722.04	15	2	1	NA	1	NA	6	0
HRH2L	0	0	3	3	384.12	768.24	15	2	1	NA	1	NA	6	0
HRH3	0	0	1	3	403.92	807.84	15	2	1	NA	1	NA	4	0
HS2ST1	0	0	3	0	333.63	667.26	15	2	1	NA	1	NA	3	0
HS3ST2	0	0	0	3	262.02	524.04	15	2	1	NA	1	NA	3	0
HS3ST3B1L	0	0	5	4	474.87	949.74	15	2	1	NA	1	NA	9	0
HS3ST4	0	0	1	2	241.89	483.78	15	2	1	NA	1	NA	3	0
HS3ST6	0	0	1	3	310.2	620.4	15	2	1	NA	1	NA	4	0
HS6ST1	0	0	4	0	294.03	588.06	15	2	1	NA	1	NA	4	0
HSCB	0	0	1	1	212.19	424.38	15	2	1	NA	1	NA	2	0
HSD11B1a	0	0	3	2	291.06	582.12	15	2	1	NA	1	NA	5	0
HSD11B1b	0	0	1	3	308.88	617.76	15	2	1	NA	1	NA	4	0
HSD17B1	0	0	10	4	293.04	586.08	15	2	1	NA	1	NA	14	0
HSD17B11-HSD17B11L	0	0	3	4	298.65	597.3	15	2	1	NA	1	NA	7	0
HSD17B14	0	0	8	4	554.4	1108.8	15	2	1	NA	1	NA	12	0
HSD17B2	0	0	1	3	387.09	774.18	15	2	1	NA	1	NA	4	0
HSD17B4	0	0	1	1	447.15	894.3	15	2	1	NA	1	NA	2	0
HSD3B1	0	0	0	2	50.82	101.64	15	2	1	NA	1	NA	2	0
HSD3B7	0	0	6	8	370.26	740.52	15	2	1	NA	1	NA	14	0
HSDL1	0	0	0	3	328.68	657.36	15	2	1	NA	1	NA	3	0
HSDL2	0	0	5	2	521.73	1043.46	15	2	1	NA	1	NA	7	0
HSF4	0	0	8	4	503.91	1007.82	15	2	1	NA	1	NA	12	0
HSF5	0	0	6	2	520.74	1041.48	15	2	1	NA	1	NA	8	0
HSPA12A	0	0	1	1	697.95	1395.9	15	2	1	NA	1	NA	2	0
HSPA2	0	0	0	10	628.65	1257.3	15	2	1	NA	1	NA	10	0
HSPA4	0	0	1	10	798.27	1596.54	15	2	1	NA	1	NA	11	0
HSPA4L	0	0	0	2	834.57	1669.14	15	2	1	NA	1	NA	2	0
HSPA5	0	0	0	9	646.47	1292.94	15	2	1	NA	1	NA	9	0
HSPA8	0	0	0	13	640.53	1281.06	15	2	1	NA	1	NA	13	0
HSPA9	0	0	4	12	639.54	1279.08	15	2	1	NA	1	NA	16	0
HSPB1	0	0	0	4	173.91	347.82	15	2	1	NA	1	NA	4	0
HSPB11	0	0	2	0	140.58	281.16	15	2	1	NA	1	NA	2	0
HSPB2	0	0	3	4	180.18	360.36	15	2	1	NA	1	NA	7	0
HSPB7	0	0	0	3	150.48	300.96	15	2	1	NA	1	NA	3	0
HSPB7L	0	0	2	0	152.79	305.58	15	2	1	NA	1	NA	2	0
HSPB8	0	0	2	4	198.99	397.98	15	2	1	NA	1	NA	6	0
HSPBAP1	0	0	5	3	483.12	966.24	15	2	1	NA	1	NA	8	0
HSPD1	0	0	1	5	556.05	1112.1	15	2	1	NA	1	NA	6	0
HSPG2	0	0	43	130	5123.91	10247.82	15	2	1	NA	1	NA	173	0
HTATSF1	0	0	2	2	450.45	900.9	15	2	1	NA	1	NA	4	0
HTR1A	0	0	1	2	409.86	819.72	15	2	1	NA	1	NA	3	0
HTR2B	0	0	3	6	459.36	918.72	15	2	1	NA	1	NA	9	0
HTR2C	0	0	0	3	469.26	938.52	15	2	1	NA	1	NA	3	0
HTR3A	0	0	6	3	482.13	964.26	15	2	1	NA	1	NA	9	0
HTR4	0	0	1	1	499.62	999.24	15	2	1	NA	1	NA	2	0
HTR6	0	0	3	7	432.63	865.26	15	2	1	NA	1	NA	10	0
HTR7	0	0	1	6	421.74	843.48	15	2	1	NA	1	NA	7	0
HTR7L	0	0	4	12	421.74	843.48	15	2	1	NA	1	NA	16	0
HTRA1	0	0	0	7	369.27	738.54	15	2	1	NA	1	NA	7	0
HTRA2	0	0	4	4	341.55	683.1	15	2	1	NA	1	NA	8	0
HTT	0	0	0	6	1323.96	2647.92	15	2	1	NA	1	NA	6	0
HVCN1	0	0	3	2	235.62	471.24	15	2	1	NA	1	NA	5	0
HYAL1	0	0	8	24	428.67	857.34	15	2	1	NA	1	NA	32	0
HYAL2	0	0	1	9	426.36	852.72	15	2	1	NA	1	NA	10	0
HYDIN	0	0	2	0	2368.41	4736.82	15	2	1	NA	1	NA	2	0
HYI	0	0	9	3	206.25	412.5	15	2	1	NA	1	NA	12	0
HYKK	0	0	5	1	379.17	758.34	15	2	1	NA	1	NA	6	0
HYOU1	0	0	4	5	974.49	1948.98	15	2	1	NA	1	NA	9	0
IARS	0	0	1	9	978.45	1956.9	15	2	1	NA	1	NA	10	0
IBSP	0	0	2	8	231.99	463.98	15	2	1	NA	1	NA	10	0
ICE2	0	0	3	7	973.17	1946.34	15	2	1	NA	1	NA	10	0
ICOS	0	0	1	1	210.87	421.74	15	2	1	NA	1	NA	2	0
IDE	0	0	3	3	1059.3	2118.6	15	2	1	NA	1	NA	6	0
IDH1	0	0	1	2	411.84	823.68	15	2	1	NA	1	NA	3	0
IDH2	0	0	0	7	396.99	793.98	15	2	1	NA	1	NA	7	0
IDH3A	0	0	0	3	363.33	726.66	15	2	1	NA	1	NA	3	0
IDH3B	0	0	0	8	344.52	689.04	15	2	1	NA	1	NA	8	0
IDNK	0	0	2	0	170.94	341.88	15	2	1	NA	1	NA	2	0
IDO2	0	0	6	2	397.98	795.96	15	2	1	NA	1	NA	8	0
IDS	0	0	5	1	548.46	1096.92	15	2	1	NA	1	NA	6	0
IDUA	0	0	6	4	556.05	1112.1	15	2	1	NA	1	NA	10	0
IER3IP1	0	0	2	3	81.84	163.68	15	2	1	NA	1	NA	5	0
IER5	0	0	8	1	244.53	489.06	15	2	1	NA	1	NA	9	0
IFFO2	0	0	2	4	488.4	976.8	15	2	1	NA	1	NA	6	0
IFI30	0	0	4	12	252.45	504.9	15	2	1	NA	1	NA	16	0
IFI35	0	0	22	21	1514.04	3028.08	15	2	1	NA	1	NA	43	0
IFIH1	0	0	8	4	989.01	1978.02	15	2	1	NA	1	NA	12	0
IFIT5	0	0	2	2	475.2	950.4	15	2	1	NA	1	NA	4	0
IFITM10	0	0	0	2	119.79	239.58	15	2	1	NA	1	NA	2	0
IFITM5	0	0	0	3	133.65	267.3	15	2	1	NA	1	NA	3	0
IFNKL1	0	0	2	1	183.15	366.3	15	2	1	NA	1	NA	3	0
IFNL3A-IFNL3L-LOC112532795	0	0	2	5	185.13	370.26	15	2	1	NA	1	NA	7	0
IFT122	0	0	3	4	856.35	1712.7	15	2	1	NA	1	NA	7	0
IFT140	0	0	14	11	1569.15	3138.3	15	2	1	NA	1	NA	25	0
IFT22	0	0	0	2	185.13	370.26	15	2	1	NA	1	NA	2	0
IFT43	0	0	2	2	240.57	481.14	15	2	1	NA	1	NA	4	0
IFT52	0	0	2	3	433.62	867.24	15	2	1	NA	1	NA	5	0
IFT80	0	0	8	11	813.78	1627.56	15	2	1	NA	1	NA	19	0
IFT81	0	0	2	1	707.85	1415.7	15	2	1	NA	1	NA	3	0
IGDCC3	0	0	5	25	766.92	1533.84	15	2	1	NA	1	NA	30	0
IGDCC4	0	0	8	11	1185.03	2370.06	15	2	1	NA	1	NA	19	0
IGF1R	0	0	1	6	1170.18	2340.36	15	2	1	NA	1	NA	7	0
IGF2	0	0	1	2	217.14	434.28	15	2	1	NA	1	NA	3	0
IGF2BP1	0	0	1	4	565.29	1130.58	15	2	1	NA	1	NA	5	0
IGF2BP2	0	0	3	4	565.29	1130.58	15	2	1	NA	1	NA	7	0
IGFBP2	0	0	2	1	204.6	409.2	15	2	1	NA	1	NA	3	0
IGFBP4	0	0	0	3	152.79	305.58	15	2	1	NA	1	NA	3	0
IGFBP5	0	0	0	5	264	528	15	2	1	NA	1	NA	5	0
IGFBP7	0	0	2	0	234.63	469.26	15	2	1	NA	1	NA	2	0
IGFN1	0	0	13	10	1924.56	3849.12	15	2	1	NA	1	NA	23	0
IGHMBP2	0	0	22	21	982.08	1964.16	15	2	1	NA	1	NA	43	0
IGHVL	0	0	6	0	197.01	394.02	15	2	1	NA	1	NA	6	0
IGLL1	0	0	2	0	111.87	223.74	15	2	1	NA	1	NA	2	0
IGSF10	0	0	43	19	2613.6	5227.2	15	2	1	NA	1	NA	62	0
IGSF21	0	0	2	5	396.99	793.98	15	2	1	NA	1	NA	7	0
IGSF9	0	0	22	32	1519.98	3039.96	15	2	1	NA	1	NA	54	0
IGSF9B	0	0	0	28	1401.51	2803.02	15	2	1	NA	1	NA	28	0
IHH	0	0	3	4	357.06	714.12	15	2	1	NA	1	NA	7	0
IK	0	0	0	5	513.81	1027.62	15	2	1	NA	1	NA	5	0
IKBKAP	0	0	9	4	1208.79	2417.58	15	2	1	NA	1	NA	13	0
IKBKB	0	0	2	3	733.92	1467.84	15	2	1	NA	1	NA	5	0
IKBKE	0	0	5	9	718.74	1437.48	15	2	1	NA	1	NA	14	0
IKZF3	0	0	4	7	498.96	997.92	15	2	1	NA	1	NA	11	0
IKZF4	0	0	1	5	508.86	1017.72	15	2	1	NA	1	NA	6	0
IL10	0	0	1	3	176.22	352.44	15	2	1	NA	1	NA	4	0
IL10RA	0	0	3	7	590.04	1180.08	15	2	1	NA	1	NA	10	0
IL11RA	0	0	1	7	407.22	814.44	15	2	1	NA	1	NA	8	0
IL12A	0	0	3	4	209.88	419.76	15	2	1	NA	1	NA	7	0
IL12RB1	0	0	16	21	660.66	1321.32	15	2	1	NA	1	NA	37	0
IL12RB2	0	0	14	10	841.17	1682.34	15	2	1	NA	1	NA	24	0
IL13	0	0	1	2	140.58	281.16	15	2	1	NA	1	NA	3	0
IL13RA1	0	0	2	3	368.61	737.22	15	2	1	NA	1	NA	5	0
IL13RA2	0	0	1	3	356.07	712.14	15	2	1	NA	1	NA	4	0
IL15	0	0	2	1	263.01	526.02	15	2	1	NA	1	NA	3	0
IL16	0	0	6	2	1394.91	2789.82	15	2	1	NA	1	NA	8	0
IL17B	0	0	2	0	171.27	342.54	15	2	1	NA	1	NA	2	0
IL17C	0	0	2	7	193.05	386.1	15	2	1	NA	1	NA	9	0
IL17RC	0	0	13	11	480.81	961.62	15	2	1	NA	1	NA	24	0
IL17RD	0	0	1	1	673.53	1347.06	15	2	1	NA	1	NA	2	0
IL17RE	0	0	9	18	562.98	1125.96	15	2	1	NA	1	NA	27	0
IL18	0	0	1	2	196.02	392.04	15	2	1	NA	1	NA	3	0
IL1RAP	0	0	2	10	592.02	1184.04	15	2	1	NA	1	NA	12	0
IL1RAPL2	0	0	2	5	444.51	889.02	15	2	1	NA	1	NA	7	0
IL20	0	0	1	3	175.23	350.46	15	2	1	NA	1	NA	4	0
IL21R	0	0	1	2	585.09	1170.18	15	2	1	NA	1	NA	3	0
IL2RG	0	0	2	5	350.46	700.92	15	2	1	NA	1	NA	7	0
IL3-KK34	0	0	4	2	220.77	441.54	15	2	1	NA	1	NA	6	0
IL31RA	0	0	2	1	853.05	1706.1	15	2	1	NA	1	NA	3	0
IL4	0	0	4	2	130.02	260.04	15	2	1	NA	1	NA	6	0
IL4I1	0	0	5	16	520.74	1041.48	15	2	1	NA	1	NA	21	0
IL4R	0	0	8	3	998.91	1997.82	15	2	1	NA	1	NA	11	0
IL5	0	0	3	0	172.26	344.52	15	2	1	NA	1	NA	3	0
IL5RA	0	0	1	3	410.85	821.7	15	2	1	NA	1	NA	4	0
IL6ST	0	0	3	5	914.1	1828.2	15	2	1	NA	1	NA	8	0
IL7R	0	0	0	2	431.64	863.28	15	2	1	NA	1	NA	2	0
IL8L1	0	0	2	0	103.95	207.9	15	2	1	NA	1	NA	2	0
IL8L2	0	0	1	1	102.96	205.92	15	2	1	NA	1	NA	2	0
ILKAP	0	0	3	5	370.92	741.84	15	2	1	NA	1	NA	8	0
IMMT	0	0	4	9	709.83	1419.66	15	2	1	NA	1	NA	13	0
INA	0	0	1	2	422.73	845.46	15	2	1	NA	1	NA	3	0
INAFM2	0	0	2	3	156.42	312.84	15	2	1	NA	1	NA	5	0
INF2	0	0	9	5	1314.06	2628.12	15	2	1	NA	1	NA	14	0
INHA	0	0	5	5	327.69	655.38	15	2	1	NA	1	NA	10	0
INHBB	0	0	1	2	389.07	778.14	15	2	1	NA	1	NA	3	0
INHBE	0	0	2	3	346.5	693	15	2	1	NA	1	NA	5	0
INO80	0	0	1	3	1541.76	3083.52	15	2	1	NA	1	NA	4	0
INO80D	0	0	0	3	867.24	1734.48	15	2	1	NA	1	NA	3	0
INPP4B	0	0	5	4	995.94	1991.88	15	2	1	NA	1	NA	9	0
INPP5D	0	0	2	8	1203.84	2407.68	15	2	1	NA	1	NA	10	0
INPP5E	0	0	6	6	653.4	1306.8	15	2	1	NA	1	NA	12	0
INPP5F	0	0	4	4	1105.83	2211.66	15	2	1	NA	1	NA	8	0
INPP5K	0	0	1	5	532.29	1064.58	15	2	1	NA	1	NA	6	0
INS-IGF2	0	0	0	3	106.92	213.84	15	2	1	NA	1	NA	3	0
INSC	0	0	2	4	288.42	576.84	15	2	1	NA	1	NA	6	0
INSIG2	0	0	0	3	223.74	447.48	15	2	1	NA	1	NA	3	0
INSR	0	0	0	16	1368.84	2737.68	15	2	1	NA	1	NA	16	0
INSRR	0	0	2	16	1191.3	2382.6	15	2	1	NA	1	NA	18	0
INTS1	0	0	8	12	2175.69	4351.38	15	2	1	NA	1	NA	20	0
INTS10	0	0	2	1	704.88	1409.76	15	2	1	NA	1	NA	3	0
INTS11	0	0	0	6	588.72	1177.44	15	2	1	NA	1	NA	6	0
INTS12	0	0	1	5	459.36	918.72	15	2	1	NA	1	NA	6	0
INTS2	0	0	5	23	2471.04	4942.08	15	2	1	NA	1	NA	28	0
INTS3	0	0	2	17	1076.46	2152.92	15	2	1	NA	1	NA	19	0
INTS6L	0	0	3	9	891	1782	15	2	1	NA	1	NA	12	0
INTU	0	0	5	2	894.96	1789.92	15	2	1	NA	1	NA	7	0
IP6K2	0	0	0	2	420.75	841.5	15	2	1	NA	1	NA	2	0
IP6K3	0	0	2	1	404.91	809.82	15	2	1	NA	1	NA	3	0
IPO11	0	0	3	7	920.04	1840.08	15	2	1	NA	1	NA	10	0
IPO13	0	0	2	10	996.27	1992.54	15	2	1	NA	1	NA	12	0
IPO7	0	0	1	6	985.71	1971.42	15	2	1	NA	1	NA	7	0
IPO9	0	0	1	8	743.49	1486.98	15	2	1	NA	1	NA	9	0
IPP	0	0	3	2	581.13	1162.26	15	2	1	NA	1	NA	5	0
IPPK	0	0	5	6	533.28	1066.56	15	2	1	NA	1	NA	11	0
IQCA1	0	0	7	7	1149.72	2299.44	15	2	1	NA	1	NA	14	0
IQCB1	0	0	3	1	578.16	1156.32	15	2	1	NA	1	NA	4	0
IQCC	0	0	4	3	254.1	508.2	15	2	1	NA	1	NA	7	0
IQCD	0	0	4	2	425.7	851.4	15	2	1	NA	1	NA	6	0
IQCE	0	0	7	2	692.01	1384.02	15	2	1	NA	1	NA	9	0
IQCG	0	0	5	1	435.6	871.2	15	2	1	NA	1	NA	6	0
IQCH	0	0	13	8	1129.59	2259.18	15	2	1	NA	1	NA	21	0
IQGAP3-LOC415616	0	0	4	12	1677.06	3354.12	15	2	1	NA	1	NA	16	0
IQSEC1	0	0	3	3	1181.73	2363.46	15	2	1	NA	1	NA	6	0
IRAK2	0	0	4	7	690.03	1380.06	15	2	1	NA	1	NA	11	0
IREB2	0	0	4	2	848.43	1696.86	15	2	1	NA	1	NA	6	0
IRF1	0	0	0	5	314.82	629.64	15	2	1	NA	1	NA	5	0
IRF6	0	0	1	1	503.91	1007.82	15	2	1	NA	1	NA	2	0
IRF8	0	0	7	13	509.52	1019.04	15	2	1	NA	1	NA	20	0
IRF9	0	0	6	8	396.33	792.66	15	2	1	NA	1	NA	14	0
IRX5	0	0	6	9	422.4	844.8	15	2	1	NA	1	NA	15	0
IRX6	0	0	2	5	369.93	739.86	15	2	1	NA	1	NA	7	0
ISCA2	0	0	1	3	173.25	346.5	15	2	1	NA	1	NA	4	0
ISCU	0	0	2	2	152.13	304.26	15	2	1	NA	1	NA	4	0
ISLR	0	0	4	10	418.77	837.54	15	2	1	NA	1	NA	14	0
ISM2	0	0	6	8	483.78	967.56	15	2	1	NA	1	NA	14	0
ISOC1	0	0	0	2	151.47	302.94	15	2	1	NA	1	NA	2	0
IST1	0	0	1	4	363.33	726.66	15	2	1	NA	1	NA	5	0
ISY1	0	0	0	3	279.18	558.36	15	2	1	NA	1	NA	3	0
ITFG1	0	0	4	7	574.2	1148.4	15	2	1	NA	1	NA	11	0
ITGA1	0	0	6	2	1141.47	2282.94	15	2	1	NA	1	NA	8	0
ITGA11	0	0	9	25	1180.08	2360.16	15	2	1	NA	1	NA	34	0
ITGA2	0	0	4	0	1099.23	2198.46	15	2	1	NA	1	NA	4	0
ITGA2B	0	0	3	5	572.88	1145.76	15	2	1	NA	1	NA	8	0
ITGA4	0	0	6	6	1010.79	2021.58	15	2	1	NA	1	NA	12	0
ITGA6	0	0	4	4	1062.27	2124.54	15	2	1	NA	1	NA	8	0
ITGA7	0	0	12	15	435.93	871.86	15	2	1	NA	1	NA	27	0
ITGAV	0	0	0	8	1025.97	2051.94	15	2	1	NA	1	NA	8	0
ITGB1BP2	0	0	5	7	375.21	750.42	15	2	1	NA	1	NA	12	0
ITGB2	0	0	1	6	730.29	1460.58	15	2	1	NA	1	NA	7	0
ITGB3	0	0	7	30	1538.46	3076.92	15	2	1	NA	1	NA	37	0
ITGB3BP	0	0	2	0	138.6	277.2	15	2	1	NA	1	NA	2	0
ITGB4	0	0	8	42	1845.69	3691.38	15	2	1	NA	1	NA	50	0
ITGB5	0	0	5	12	779.46	1558.92	15	2	1	NA	1	NA	17	0
ITGB6	0	0	2	2	782.1	1564.2	15	2	1	NA	1	NA	4	0
ITIH3	0	0	3	4	879.12	1758.24	15	2	1	NA	1	NA	7	0
ITK	0	0	1	5	625.68	1251.36	15	2	1	NA	1	NA	6	0
ITM2C	0	0	0	5	262.35	524.7	15	2	1	NA	1	NA	5	0
ITPA	0	0	1	3	193.71	387.42	15	2	1	NA	1	NA	4	0
ITPK1	0	0	1	1	377.19	754.38	15	2	1	NA	1	NA	2	0
ITPKA	0	0	0	4	461.34	922.68	15	2	1	NA	1	NA	4	0
ITPR1	0	0	3	24	2650.23	5300.46	15	2	1	NA	1	NA	27	0
ITPR3	0	0	4	46	2618.88	5237.76	15	2	1	NA	1	NA	50	0
ITPRIP	0	0	3	4	544.5	1089	15	2	1	NA	1	NA	7	0
IVD	0	0	0	6	372.24	744.48	15	2	1	NA	1	NA	6	0
IWS1	0	0	1	2	683.1	1366.2	15	2	1	NA	1	NA	3	0
JADE1	0	0	3	3	833.58	1667.16	15	2	1	NA	1	NA	6	0
JADE2	0	0	5	16	795.96	1591.92	15	2	1	NA	1	NA	21	0
JAG2	0	0	2	1	1199.88	2399.76	15	2	1	NA	1	NA	3	0
JAK1	0	0	2	13	1115.73	2231.46	15	2	1	NA	1	NA	15	0
JAK2	0	0	3	4	1107.81	2215.62	15	2	1	NA	1	NA	7	0
JAKMIP2	0	0	2	2	1348.38	2696.76	15	2	1	NA	1	NA	4	0
JAKMIP3	0	0	4	9	900.57	1801.14	15	2	1	NA	1	NA	13	0
JAM3	0	0	0	2	299.97	599.94	15	2	1	NA	1	NA	2	0
JAML	0	0	4	6	290.07	580.14	15	2	1	NA	1	NA	10	0
JCHAIN	0	0	0	4	159.39	318.78	15	2	1	NA	1	NA	4	0
JDP2	0	0	0	2	162.36	324.72	15	2	1	NA	1	NA	2	0
JKAMP	0	0	2	11	311.85	623.7	15	2	1	NA	1	NA	13	0
JMJD1C	0	0	8	17	2173.05	4346.1	15	2	1	NA	1	NA	25	0
JMJD6	0	0	4	7	407.22	814.44	15	2	1	NA	1	NA	11	0
JMY	0	0	7	7	870.54	1741.08	15	2	1	NA	1	NA	14	0
JPH2-LOC107054877	0	0	6	18	709.83	1419.66	15	2	1	NA	1	NA	24	0
JPH3	0	0	0	11	753.39	1506.78	15	2	1	NA	1	NA	11	0
JPT1	0	0	0	2	156.42	312.84	15	2	1	NA	1	NA	2	0
JPT2	0	0	2	1	187.11	374.22	15	2	1	NA	1	NA	3	0
JTB	0	0	0	3	106.59	213.18	15	2	1	NA	1	NA	3	0
JUN	0	0	0	8	311.19	622.38	15	2	1	NA	1	NA	8	0
JUND	0	0	0	8	325.71	651.42	15	2	1	NA	1	NA	8	0
JUP	0	0	1	18	737.22	1474.44	15	2	1	NA	1	NA	19	0
KALRN	0	0	9	9	2349.27	4698.54	15	2	1	NA	1	NA	18	0
KANK1	0	0	9	11	1295.91	2591.82	15	2	1	NA	1	NA	20	0
KANK3	0	0	10	34	955.68	1911.36	15	2	1	NA	1	NA	44	0
KANK4	0	0	14	16	995.94	1991.88	15	2	1	NA	1	NA	30	0
KANSL1	0	0	11	13	1272.81	2545.62	15	2	1	NA	1	NA	24	0
KANSL1L	0	0	8	6	1550.67	3101.34	15	2	1	NA	1	NA	14	0
KANSL2	0	0	2	10	499.95	999.9	15	2	1	NA	1	NA	12	0
KANSL3	0	0	15	20	1337.82	2675.64	15	2	1	NA	1	NA	35	0
KARS	0	0	2	3	585.09	1170.18	15	2	1	NA	1	NA	5	0
KAT6A	0	0	2	8	2028.84	4057.68	15	2	1	NA	1	NA	10	0
KAT6B	0	0	6	11	1831.17	3662.34	15	2	1	NA	1	NA	17	0
KAT7	0	0	1	4	605.88	1211.76	15	2	1	NA	1	NA	5	0
KATNAL2	0	0	1	2	518.76	1037.52	15	2	1	NA	1	NA	3	0
KATNB1	0	0	1	2	646.8	1293.6	15	2	1	NA	1	NA	3	0
KATNBL1	0	0	4	0	300.96	601.92	15	2	1	NA	1	NA	4	0
KAZALD1	0	0	3	7	296.01	592.02	15	2	1	NA	1	NA	10	0
KBP	0	0	0	3	483.12	966.24	15	2	1	NA	1	NA	3	0
KBTBD12	0	0	5	9	613.8	1227.6	15	2	1	NA	1	NA	14	0
KBTBD13	0	0	3	8	454.41	908.82	15	2	1	NA	1	NA	11	0
KBTBD4	0	0	0	4	524.37	1048.74	15	2	1	NA	1	NA	4	0
KBTBD8	0	0	1	2	590.7	1181.4	15	2	1	NA	1	NA	3	0
KCNA10	0	0	4	12	511.83	1023.66	15	2	1	NA	1	NA	16	0
KCNA2	0	0	0	3	495	990	15	2	1	NA	1	NA	3	0
KCNA3	0	0	4	3	573.21	1146.42	15	2	1	NA	1	NA	7	0
KCNA4	0	0	3	8	647.79	1295.58	15	2	1	NA	1	NA	11	0
KCNAB1	0	0	1	9	383.46	766.92	15	2	1	NA	1	NA	10	0
KCNAB2	0	0	8	2	383.46	766.92	15	2	1	NA	1	NA	10	0
KCNB1	0	0	1	2	719.73	1439.46	15	2	1	NA	1	NA	3	0
KCNC1	0	0	0	6	607.86	1215.72	15	2	1	NA	1	NA	6	0
KCNC4	0	0	0	2	630.63	1261.26	15	2	1	NA	1	NA	2	0
KCND3	0	0	0	3	440.55	881.1	15	2	1	NA	1	NA	3	0
KCNE4	0	0	1	1	162.36	324.72	15	2	1	NA	1	NA	2	0
KCNG1	0	0	1	2	503.91	1007.82	15	2	1	NA	1	NA	3	0
KCNG4	0	0	2	4	506.88	1013.76	15	2	1	NA	1	NA	6	0
KCNH5	0	0	0	3	596.97	1193.94	15	2	1	NA	1	NA	3	0
KCNH6	0	0	7	12	1222.65	2445.3	15	2	1	NA	1	NA	19	0
KCNH7	0	0	4	0	1115.73	2231.46	15	2	1	NA	1	NA	4	0
KCNJ1	0	0	2	1	368.28	736.56	15	2	1	NA	1	NA	3	0
KCNJ11	0	0	0	6	395.67	791.34	15	2	1	NA	1	NA	6	0
KCNJ12	0	0	0	4	425.7	851.4	15	2	1	NA	1	NA	4	0
KCNJ13	0	0	4	1	363.33	726.66	15	2	1	NA	1	NA	5	0
KCNJ14L	0	0	5	4	594.99	1189.98	15	2	1	NA	1	NA	9	0
KCNJ16	0	0	1	3	425.7	851.4	15	2	1	NA	1	NA	4	0
KCNJ2	0	0	0	6	423.72	847.44	15	2	1	NA	1	NA	6	0
KCNJ3	0	0	1	10	477.84	955.68	15	2	1	NA	1	NA	11	0
KCNJ9	0	0	3	11	444.51	889.02	15	2	1	NA	1	NA	14	0
KCNK10	0	0	1	1	531.63	1063.26	15	2	1	NA	1	NA	2	0
KCNK13	0	0	0	4	357.06	714.12	15	2	1	NA	1	NA	4	0
KCNK15	0	0	3	7	376.53	753.06	15	2	1	NA	1	NA	10	0
KCNK18	0	0	0	3	393.03	786.06	15	2	1	NA	1	NA	3	0
KCNK4	0	0	1	2	316.8	633.6	15	2	1	NA	1	NA	3	0
KCNMB1	0	0	3	4	198.99	397.98	15	2	1	NA	1	NA	7	0
KCNN2	0	0	2	1	545.82	1091.64	15	2	1	NA	1	NA	3	0
KCNN3	0	0	0	11	583.77	1167.54	15	2	1	NA	1	NA	11	0
KCNQ2	0	0	1	15	885.72	1771.44	15	2	1	NA	1	NA	16	0
KCNQ4	0	0	4	21	548.46	1096.92	15	2	1	NA	1	NA	25	0
KCNS1	0	0	1	9	469.26	938.52	15	2	1	NA	1	NA	10	0
KCNT1	0	0	3	27	1210.77	2421.54	15	2	1	NA	1	NA	30	0
KCNT2	0	0	3	5	1162.26	2324.52	15	2	1	NA	1	NA	8	0
KCNU1	0	0	3	4	898.26	1796.52	15	2	1	NA	1	NA	7	0
KCNV2	0	0	6	5	560.34	1120.68	15	2	1	NA	1	NA	11	0
KCTD16	0	0	1	5	472.23	944.46	15	2	1	NA	1	NA	6	0
KCTD19	0	0	8	10	854.37	1708.74	15	2	1	NA	1	NA	18	0
KCTD20	0	0	2	0	434.61	869.22	15	2	1	NA	1	NA	2	0
KCTD8	0	0	1	1	301.95	603.9	15	2	1	NA	1	NA	2	0
KCTD9	0	0	1	7	382.47	764.94	15	2	1	NA	1	NA	8	0
KDF1	0	0	1	3	413.82	827.64	15	2	1	NA	1	NA	4	0
KDM1A	0	0	5	9	899.91	1799.82	15	2	1	NA	1	NA	14	0
KDM2A	0	0	3	9	1157.31	2314.62	15	2	1	NA	1	NA	12	0
KDM2B	0	0	1	6	666.27	1332.54	15	2	1	NA	1	NA	7	0
KDM3A	0	0	3	10	1315.71	2631.42	15	2	1	NA	1	NA	13	0
KDM3B	0	0	5	5	1648.35	3296.7	15	2	1	NA	1	NA	10	0
KDM4A	0	0	3	7	976.8	1953.6	15	2	1	NA	1	NA	10	0
KDM4C	0	0	1	1	339.24	678.48	15	2	1	NA	1	NA	2	0
KDM5B	0	0	2	8	1501.83	3003.66	15	2	1	NA	1	NA	10	0
KDM8	0	0	2	2	412.83	825.66	15	2	1	NA	1	NA	4	0
KDR	0	0	4	15	1314.39	2628.78	15	2	1	NA	1	NA	19	0
KIAA0100	0	0	12	60	2215.62	4431.24	15	2	1	NA	1	NA	72	0
KIAA0232	0	0	8	4	1378.08	2756.16	15	2	1	NA	1	NA	12	0
KIAA0319L	0	0	3	10	1110.78	2221.56	15	2	1	NA	1	NA	13	0
KIAA0355	0	0	0	2	1048.41	2096.82	15	2	1	NA	1	NA	2	0
KIAA0430	0	0	3	6	1725.57	3451.14	15	2	1	NA	1	NA	9	0
KIAA0513	0	0	3	8	394.02	788.04	15	2	1	NA	1	NA	11	0
KIAA0753	0	0	3	1	875.16	1750.32	15	2	1	NA	1	NA	4	0
KIAA0825	0	0	4	4	592.02	1184.04	15	2	1	NA	1	NA	8	0
KIAA0895L	0	0	0	6	338.58	677.16	15	2	1	NA	1	NA	6	0
KIAA0922	0	0	6	4	1548.69	3097.38	15	2	1	NA	1	NA	10	0
KIAA1024	0	0	1	4	942.48	1884.96	15	2	1	NA	1	NA	5	0
KIAA1107	0	0	9	4	1798.83	3597.66	15	2	1	NA	1	NA	13	0
KIAA1109	0	0	9	31	4870.47	9740.94	15	2	1	NA	1	NA	40	0
KIAA1191	0	0	3	5	305.91	611.82	15	2	1	NA	1	NA	8	0
KIAA1210	0	0	9	6	995.94	1991.88	15	2	1	NA	1	NA	15	0
KIAA1257	0	0	13	7	1277.76	2555.52	15	2	1	NA	1	NA	20	0
KIAA1324	0	0	10	23	747.45	1494.9	15	2	1	NA	1	NA	33	0
KIAA1328	0	0	4	1	442.53	885.06	15	2	1	NA	1	NA	5	0
KIAA1456	0	0	1	5	460.35	920.7	15	2	1	NA	1	NA	6	0
KIAA1522	0	0	16	23	1083.72	2167.44	15	2	1	NA	1	NA	39	0
KIAA1549L	0	0	20	20	2212.98	4425.96	15	2	1	NA	1	NA	40	0
KIAA1614	0	0	28	24	819.06	1638.12	15	2	1	NA	1	NA	52	0
KIAA1671	0	0	27	19	2012.01	4024.02	15	2	1	NA	1	NA	46	0
KIAA1683	0	0	7	7	385.44	770.88	15	2	1	NA	1	NA	14	0
KIAA1755	0	0	28	21	1139.16	2278.32	15	2	1	NA	1	NA	49	0
KIAA1958	0	0	1	4	726.66	1453.32	15	2	1	NA	1	NA	5	0
KIAA2013	0	0	4	5	609.84	1219.68	15	2	1	NA	1	NA	9	0
KIAA2026	0	0	8	4	1979.34	3958.68	15	2	1	NA	1	NA	12	0
KIF11	0	0	2	4	1056.33	2112.66	15	2	1	NA	1	NA	6	0
KIF12	0	0	13	9	452.43	904.86	15	2	1	NA	1	NA	22	0
KIF14	0	0	12	13	1645.38	3290.76	15	2	1	NA	1	NA	25	0
KIF17	0	0	11	10	786.06	1572.12	15	2	1	NA	1	NA	21	0
KIF18A	0	0	6	4	921.69	1843.38	15	2	1	NA	1	NA	10	0
KIF18B	0	0	6	16	850.41	1700.82	15	2	1	NA	1	NA	22	0
KIF1A	0	0	5	26	1859.88	3719.76	15	2	1	NA	1	NA	31	0
KIF1B	0	0	1	15	2362.14	4724.28	15	2	1	NA	1	NA	16	0
KIF1BP	0	0	3	4	589.05	1178.1	15	2	1	NA	1	NA	7	0
KIF20A	0	0	4	5	877.14	1754.28	15	2	1	NA	1	NA	9	0
KIF20B-KIF20BL	0	0	20	11	1925.88	3851.76	15	2	1	NA	1	NA	31	0
KIF23	0	0	7	11	954.03	1908.06	15	2	1	NA	1	NA	18	0
KIF24	0	0	2	5	1409.76	2819.52	15	2	1	NA	1	NA	7	0
KIF26A	0	0	9	4	1969.11	3938.22	15	2	1	NA	1	NA	13	0
KIF27	0	0	4	2	1324.29	2648.58	15	2	1	NA	1	NA	6	0
KIF2B	0	0	7	8	652.08	1304.16	15	2	1	NA	1	NA	15	0
KIF2C	0	0	3	7	730.62	1461.24	15	2	1	NA	1	NA	10	0
KIF5C	0	0	1	14	906.84	1813.68	15	2	1	NA	1	NA	15	0
KIF7	0	0	14	14	1358.28	2716.56	15	2	1	NA	1	NA	28	0
KIFAP3	0	0	3	7	805.86	1611.72	15	2	1	NA	1	NA	10	0
KIFC3	0	0	0	7	832.59	1665.18	15	2	1	NA	1	NA	7	0
KIRREL	0	0	1	9	550.77	1101.54	15	2	1	NA	1	NA	10	0
KIRREL3	0	0	1	2	774.18	1548.36	15	2	1	NA	1	NA	3	0
KIT	0	0	1	4	953.37	1906.74	15	2	1	NA	1	NA	5	0
KLB	0	0	2	7	996.93	1993.86	15	2	1	NA	1	NA	9	0
KLC1	0	0	1	2	737.55	1475.1	15	2	1	NA	1	NA	3	0
KLF13	0	0	0	2	275.22	550.44	15	2	1	NA	1	NA	2	0
KLF15	0	0	1	1	399.96	799.92	15	2	1	NA	1	NA	2	0
KLF2	0	0	1	4	377.19	754.38	15	2	1	NA	1	NA	5	0
KLF3	0	0	0	3	344.52	689.04	15	2	1	NA	1	NA	3	0
KLF4	0	0	4	7	303.93	607.86	15	2	1	NA	1	NA	11	0
KLF8	0	0	0	3	451.44	902.88	15	2	1	NA	1	NA	3	0
KLHDC1	0	0	0	2	476.19	952.38	15	2	1	NA	1	NA	2	0
KLHDC2	0	0	1	6	415.47	830.94	15	2	1	NA	1	NA	7	0
KLHDC4	0	0	4	8	577.17	1154.34	15	2	1	NA	1	NA	12	0
KLHDC7A	0	0	12	12	766.26	1532.52	15	2	1	NA	1	NA	24	0
KLHDC8A	0	0	5	7	347.49	694.98	15	2	1	NA	1	NA	12	0
KLHDC8B	0	0	3	16	351.45	702.9	15	2	1	NA	1	NA	19	0
KLHL10	0	0	0	13	599.94	1199.88	15	2	1	NA	1	NA	13	0
KLHL11	0	0	1	3	626.01	1252.02	15	2	1	NA	1	NA	4	0
KLHL12	0	0	0	6	557.37	1114.74	15	2	1	NA	1	NA	6	0
KLHL17	0	0	1	15	513.81	1027.62	15	2	1	NA	1	NA	16	0
KLHL2	0	0	1	2	577.5	1155	15	2	1	NA	1	NA	3	0
KLHL21	0	0	1	3	594	1188	15	2	1	NA	1	NA	4	0
KLHL23-SSB	0	0	3	4	909.81	1819.62	15	2	1	NA	1	NA	7	0
KLHL24	0	0	1	1	594.99	1189.98	15	2	1	NA	1	NA	2	0
KLHL25	0	0	1	9	584.1	1168.2	15	2	1	NA	1	NA	10	0
KLHL26	0	0	2	6	582.45	1164.9	15	2	1	NA	1	NA	8	0
KLHL28	0	0	0	6	566.28	1132.56	15	2	1	NA	1	NA	6	0
KLHL3	0	0	3	10	643.5	1287	15	2	1	NA	1	NA	13	0
KLHL30	0	0	5	14	586.08	1172.16	15	2	1	NA	1	NA	19	0
KLHL33	0	0	10	6	759.33	1518.66	15	2	1	NA	1	NA	16	0
KLHL36	0	0	0	6	608.19	1216.38	15	2	1	NA	1	NA	6	0
KLHL4	0	0	2	4	713.79	1427.58	15	2	1	NA	1	NA	6	0
KLHL41	0	0	1	1	600.93	1201.86	15	2	1	NA	1	NA	2	0
KLHL5	0	0	0	3	700.92	1401.84	15	2	1	NA	1	NA	3	0
KLHL6	0	0	0	6	604.89	1209.78	15	2	1	NA	1	NA	6	0
KLHL8	0	0	1	8	611.82	1223.64	15	2	1	NA	1	NA	9	0
KMO	0	0	4	4	569.25	1138.5	15	2	1	NA	1	NA	8	0
KMT2A	0	0	11	13	3849.78	7699.56	15	2	1	NA	1	NA	24	0
KMT2D	0	0	0	3	429	858	15	2	1	NA	1	NA	3	0
KMT5B	0	0	2	4	849.42	1698.84	15	2	1	NA	1	NA	6	0
KNDC1	0	0	12	6	1867.14	3734.28	15	2	1	NA	1	NA	18	0
KNG1	0	0	3	3	651.09	1302.18	15	2	1	NA	1	NA	6	0
KNL1	0	0	18	7	2313.63	4627.26	15	2	1	NA	1	NA	25	0
KNOP1	0	0	3	1	597.96	1195.92	15	2	1	NA	1	NA	4	0
KNSTRN	0	0	7	2	263.34	526.68	15	2	1	NA	1	NA	9	0
KNTC1	0	0	16	19	2162.82	4325.64	15	2	1	NA	1	NA	35	0
KPNA4	0	0	0	3	505.89	1011.78	15	2	1	NA	1	NA	3	0
KPNA7	0	0	4	9	467.28	934.56	15	2	1	NA	1	NA	13	0
KPNB1	0	0	0	9	869.88	1739.76	15	2	1	NA	1	NA	9	0
KREMEN1	0	0	3	1	562.98	1125.96	15	2	1	NA	1	NA	4	0
KRT10	0	0	2	11	642.51	1285.02	15	2	1	NA	1	NA	13	0
KRT14	0	0	0	6	380.82	761.64	15	2	1	NA	1	NA	6	0
KRT15	0	0	1	3	474.21	948.42	15	2	1	NA	1	NA	4	0
KRT17	0	0	1	2	300.63	601.26	15	2	1	NA	1	NA	3	0
KRT18	0	0	4	5	382.14	764.28	15	2	1	NA	1	NA	9	0
KRT19	0	0	3	4	419.76	839.52	15	2	1	NA	1	NA	7	0
KRT20	0	0	0	6	433.62	867.24	15	2	1	NA	1	NA	6	0
KRT222	0	0	0	2	278.19	556.38	15	2	1	NA	1	NA	2	0
KRT23	0	0	3	4	429.66	859.32	15	2	1	NA	1	NA	7	0
KRT5	0	0	0	3	486.09	972.18	15	2	1	NA	1	NA	3	0
KRT6A	0	0	2	1	532.62	1065.24	15	2	1	NA	1	NA	3	0
KRT7	0	0	0	2	467.28	934.56	15	2	1	NA	1	NA	2	0
KRT75L4	0	0	0	3	613.8	1227.6	15	2	1	NA	1	NA	3	0
KRT8	0	0	4	8	879.45	1758.9	15	2	1	NA	1	NA	12	0
KRT80	0	0	4	1	484.11	968.22	15	2	1	NA	1	NA	5	0
KRT9L	0	0	8	5	617.76	1235.52	15	2	1	NA	1	NA	13	0
KRTC42L	0	0	2	6	510.84	1021.68	15	2	1	NA	1	NA	8	0
KSR1	0	0	2	4	830.61	1661.22	15	2	1	NA	1	NA	6	0
KSR2	0	0	0	19	791.01	1582.02	15	2	1	NA	1	NA	19	0
KTI12	0	0	1	3	235.62	471.24	15	2	1	NA	1	NA	4	0
KTN1	0	0	7	15	1328.58	2657.16	15	2	1	NA	1	NA	22	0
KY	0	0	4	10	678.15	1356.3	15	2	1	NA	1	NA	14	0
KYAT3	0	0	2	0	449.46	898.92	15	2	1	NA	1	NA	2	0
KYNU	0	0	3	2	498.96	997.92	15	2	1	NA	1	NA	5	0
L2HGDH	0	0	5	8	440.55	881.1	15	2	1	NA	1	NA	13	0
L3HYPDH	0	0	8	8	322.41	644.82	15	2	1	NA	1	NA	16	0
L3MBTL1	0	0	1	1	891.66	1783.32	15	2	1	NA	1	NA	2	0
L3MBTL4	0	0	3	3	792.99	1585.98	15	2	1	NA	1	NA	6	0
LACTB	0	0	3	3	514.14	1028.28	15	2	1	NA	1	NA	6	0
LACTBL1	0	0	3	5	577.17	1154.34	15	2	1	NA	1	NA	8	0
LAD1	0	0	3	6	420.75	841.5	15	2	1	NA	1	NA	9	0
LAMA5	0	0	26	44	3704.25	7408.5	15	2	1	NA	1	NA	70	0
LAMB2	0	0	34	51	1680.36	3360.72	15	2	1	NA	1	NA	85	0
LAMB3	0	0	17	17	1160.28	2320.56	15	2	1	NA	1	NA	34	0
LAMC1	0	0	7	6	1462.89	2925.78	15	2	1	NA	1	NA	13	0
LAMC2	0	0	8	6	1162.26	2324.52	15	2	1	NA	1	NA	14	0
LAMC3	0	0	46	43	1563.21	3126.42	15	2	1	NA	1	NA	89	0
LAMP2	0	0	2	2	427.68	855.36	15	2	1	NA	1	NA	4	0
LAMP3	0	0	2	1	421.74	843.48	15	2	1	NA	1	NA	3	0
LAMTOR2	0	0	0	2	75.57	151.14	15	2	1	NA	1	NA	2	0
LANCL1	0	0	1	5	396.99	793.98	15	2	1	NA	1	NA	6	0
LAPTM5	0	0	4	2	256.41	512.82	15	2	1	NA	1	NA	6	0
LARGE2	0	0	4	13	722.7	1445.4	15	2	1	NA	1	NA	17	0
LARP1	0	0	7	10	1040.49	2080.98	15	2	1	NA	1	NA	17	0
LARP1B	0	0	3	2	921.36	1842.72	15	2	1	NA	1	NA	5	0
LARP4	0	0	5	5	721.71	1443.42	15	2	1	NA	1	NA	10	0
LARP6	0	0	5	8	430.65	861.3	15	2	1	NA	1	NA	13	0
LARP7	0	0	3	4	589.05	1178.1	15	2	1	NA	1	NA	7	0
LARS	0	0	4	5	1172.16	2344.32	15	2	1	NA	1	NA	9	0
LASP1	0	0	0	5	273.24	546.48	15	2	1	NA	1	NA	5	0
LAT2	0	0	0	3	186.78	373.56	15	2	1	NA	1	NA	3	0
LCAT	0	0	1	5	446.49	892.98	15	2	1	NA	1	NA	6	0
LCK	0	0	0	6	503.91	1007.82	15	2	1	NA	1	NA	6	0
LCMT1	0	0	2	3	326.7	653.4	15	2	1	NA	1	NA	5	0
LCOR	0	0	19	22	1927.53	3855.06	15	2	1	NA	1	NA	41	0
LCP2	0	0	0	7	528.66	1057.32	15	2	1	NA	1	NA	7	0
LCT	0	0	10	21	1907.73	3815.46	15	2	1	NA	1	NA	31	0
LCTL	0	0	9	7	537.57	1075.14	15	2	1	NA	1	NA	16	0
LDB1	0	0	0	4	418.77	837.54	15	2	1	NA	1	NA	4	0
LDHA	0	0	0	3	329.67	659.34	15	2	1	NA	1	NA	3	0
LDHD	0	0	2	11	357.06	714.12	15	2	1	NA	1	NA	13	0
LDLRAD3	0	0	3	6	575.19	1150.38	15	2	1	NA	1	NA	9	0
LEAP2	0	0	1	1	113.85	227.7	15	2	1	NA	1	NA	2	0
LECT2	0	0	2	4	321.75	643.5	15	2	1	NA	1	NA	6	0
LEF1	0	0	0	4	379.83	759.66	15	2	1	NA	1	NA	4	0
LEKR1	0	0	15	7	695.97	1391.94	15	2	1	NA	1	NA	22	0
LEMD2	0	0	5	7	720.72	1441.44	15	2	1	NA	1	NA	12	0
LEO1	0	0	0	6	650.43	1300.86	15	2	1	NA	1	NA	6	0
LEPR	0	0	7	10	1144.44	2288.88	15	2	1	NA	1	NA	17	0
LEPROT	0	0	0	5	130.68	261.36	15	2	1	NA	1	NA	5	0
LETM1	0	0	1	5	746.46	1492.92	15	2	1	NA	1	NA	6	0
LEXM	0	0	6	4	297	594	15	2	1	NA	1	NA	10	0
LFNG	0	0	1	4	360.36	720.72	15	2	1	NA	1	NA	5	0
LGALS3	0	0	1	3	284.13	568.26	15	2	1	NA	1	NA	4	0
LGI2	0	0	2	2	543.51	1087.02	15	2	1	NA	1	NA	4	0
LGMN	0	0	2	1	427.68	855.36	15	2	1	NA	1	NA	3	0
LGR6	0	0	2	10	946.44	1892.88	15	2	1	NA	1	NA	12	0
LHFPL2	0	0	0	3	216.48	432.96	15	2	1	NA	1	NA	3	0
LHFPL5	0	0	0	3	219.78	439.56	15	2	1	NA	1	NA	3	0
LHPP	0	0	0	8	262.35	524.7	15	2	1	NA	1	NA	8	0
LHX1	0	0	1	1	295.35	590.7	15	2	1	NA	1	NA	2	0
LHX2	0	0	1	2	435.6	871.2	15	2	1	NA	1	NA	3	0
LHX3	0	0	2	1	392.04	784.08	15	2	1	NA	1	NA	3	0
LHX4	0	0	2	2	306.24	612.48	15	2	1	NA	1	NA	4	0
LHX4-AS1	0	0	1	1	259.38	518.76	15	2	1	NA	1	NA	2	0
LHX6	0	0	0	7	373.23	746.46	15	2	1	NA	1	NA	7	0
LHX9	0	0	1	2	375.21	750.42	15	2	1	NA	1	NA	3	0
LIAS	0	0	2	3	374.55	749.1	15	2	1	NA	1	NA	5	0
LIFR	0	0	3	3	1075.14	2150.28	15	2	1	NA	1	NA	6	0
LIG1	0	0	2	3	301.95	603.9	15	2	1	NA	1	NA	5	0
LIG3	0	0	0	11	873.51	1747.02	15	2	1	NA	1	NA	11	0
LIMA1	0	0	6	6	838.86	1677.72	15	2	1	NA	1	NA	12	0
LIMCH1	0	0	17	10	1660.56	3321.12	15	2	1	NA	1	NA	27	0
LIMD2	0	0	0	2	127.71	255.42	15	2	1	NA	1	NA	2	0
LIME1	0	0	6	7	266.64	533.28	15	2	1	NA	1	NA	13	0
LIMK1	0	0	9	16	989.01	1978.02	15	2	1	NA	1	NA	25	0
LIMS1-LIMS2	0	0	2	0	261.36	522.72	15	2	1	NA	1	NA	2	0
LIN28A	0	0	1	1	190.74	381.48	15	2	1	NA	1	NA	2	0
LIN54	0	0	3	4	774.18	1548.36	15	2	1	NA	1	NA	7	0
LINGO1	0	0	1	6	600.93	1201.86	15	2	1	NA	1	NA	7	0
LIPA	0	0	0	2	395.01	790.02	15	2	1	NA	1	NA	2	0
LIPC	0	0	2	1	536.58	1073.16	15	2	1	NA	1	NA	3	0
LIPG	0	0	1	11	498.63	997.26	15	2	1	NA	1	NA	12	0
LIPML4	0	0	1	9	702.24	1404.48	15	2	1	NA	1	NA	10	0
LITAF	0	0	1	1	215.82	431.64	15	2	1	NA	1	NA	2	0
LIX1	0	0	6	2	269.28	538.56	15	2	1	NA	1	NA	8	0
LLGL2	0	0	1	4	1014.09	2028.18	15	2	1	NA	1	NA	5	0
LMAN1	0	0	1	4	435.27	870.54	15	2	1	NA	1	NA	5	0
LMAN2	0	0	0	8	336.6	673.2	15	2	1	NA	1	NA	8	0
LMCD1	0	0	2	9	323.07	646.14	15	2	1	NA	1	NA	11	0
LMF1	0	0	10	12	683.43	1366.86	15	2	1	NA	1	NA	22	0
LMINA	0	0	2	3	579.15	1158.3	15	2	1	NA	1	NA	5	0
LMLN	0	0	2	4	651.42	1302.84	15	2	1	NA	1	NA	6	0
LMNB1	0	0	1	1	486.75	973.5	15	2	1	NA	1	NA	2	0
LMNB2	0	0	0	6	594	1188	15	2	1	NA	1	NA	6	0
LMO1	0	0	0	2	158.4	316.8	15	2	1	NA	1	NA	2	0
LMOD1	0	0	3	9	626.67	1253.34	15	2	1	NA	1	NA	12	0
LMOD3	0	0	7	5	530.31	1060.62	15	2	1	NA	1	NA	12	0
LMTK2	0	0	4	3	1458.6	2917.2	15	2	1	NA	1	NA	7	0
LMX1A	0	0	1	10	339.57	679.14	15	2	1	NA	1	NA	11	0
LNPEP	0	0	3	7	1001.22	2002.44	15	2	1	NA	1	NA	10	0
LNPK	0	0	4	1	439.56	879.12	15	2	1	NA	1	NA	5	0
LNX1	0	0	6	7	772.2	1544.4	15	2	1	NA	1	NA	13	0
LOC100857191	0	0	3	2	76.56	153.12	15	2	1	NA	1	NA	5	0
LOC100857197	0	0	1	1	187.44	374.88	15	2	1	NA	1	NA	2	0
LOC100857335	0	0	3	3	251.13	502.26	15	2	1	NA	1	NA	6	0
LOC100857468	0	0	1	1	142.56	285.12	15	2	1	NA	1	NA	2	0
LOC100857512	0	0	2	4	185.46	370.92	15	2	1	NA	1	NA	6	0
LOC100857632	0	0	4	12	725.67	1451.34	15	2	1	NA	1	NA	16	0
LOC100857698-LOC100857710-LOC100858444-LOC100859148-LOC107049929-LOC107052804-LOC107052814	0	0	1	1	265.32	530.64	15	2	1	NA	1	NA	2	0
LOC100857706	0	0	5	6	346.5	693	15	2	1	NA	1	NA	11	0
LOC100857834	0	0	9	8	382.14	764.28	15	2	1	NA	1	NA	17	0
LOC100857843	0	0	3	3	193.38	386.76	15	2	1	NA	1	NA	6	0
LOC100857883	0	0	9	10	532.95	1065.9	15	2	1	NA	1	NA	19	0
LOC100857892	0	0	5	2	223.74	447.48	15	2	1	NA	1	NA	7	0
LOC100858068	0	0	5	5	95.7	191.4	15	2	1	NA	1	NA	10	0
LOC100858293	0	0	7	8	292.38	584.76	15	2	1	NA	1	NA	15	0
LOC100858347	0	0	9	15	776.16	1552.32	15	2	1	NA	1	NA	24	0
LOC100858360	0	0	1	2	295.68	591.36	15	2	1	NA	1	NA	3	0
LOC100858796	0	0	0	3	372.57	745.14	15	2	1	NA	1	NA	3	0
LOC100858814	0	0	5	4	168.3	336.6	15	2	1	NA	1	NA	9	0
LOC100858942	0	0	1	2	81.84	163.68	15	2	1	NA	1	NA	3	0
LOC100858953	0	0	14	8	201.96	403.92	15	2	1	NA	1	NA	22	0
LOC100858995	0	0	6	5	207.9	415.8	15	2	1	NA	1	NA	11	0
LOC100859276-RBM14	0	0	4	11	689.37	1378.74	15	2	1	NA	1	NA	15	0
LOC100859284	0	0	3	4	150.81	301.62	15	2	1	NA	1	NA	7	0
LOC100859449	0	0	3	6	406.89	813.78	15	2	1	NA	1	NA	9	0
LOC100859602	0	0	1	1	727.65	1455.3	15	2	1	NA	1	NA	2	0
LOC100859615	0	0	4	5	260.37	520.74	15	2	1	NA	1	NA	9	0
LOC100859636	0	0	1	1	222.75	445.5	15	2	1	NA	1	NA	2	0
LOC100859726	0	0	1	5	319.77	639.54	15	2	1	NA	1	NA	6	0
LOC100859848	0	0	1	1	76.23	152.46	15	2	1	NA	1	NA	2	0
LOC100859850	0	0	2	0	257.4	514.8	15	2	1	NA	1	NA	2	0
LOC101747310	0	0	1	3	139.59	279.18	15	2	1	NA	1	NA	4	0
LOC101747338	0	0	4	11	321.75	643.5	15	2	1	NA	1	NA	15	0
LOC101747367	0	0	1	3	329.67	659.34	15	2	1	NA	1	NA	4	0
LOC101747386	0	0	1	1	140.58	281.16	15	2	1	NA	1	NA	2	0
LOC101747521	0	0	3	4	410.85	821.7	15	2	1	NA	1	NA	7	0
LOC101747522	0	0	14	17	702.24	1404.48	15	2	1	NA	1	NA	31	0
LOC101747537	0	0	3	1	185.13	370.26	15	2	1	NA	1	NA	4	0
LOC101747588	0	0	18	7	746.46	1492.92	15	2	1	NA	1	NA	25	0
LOC101747660	0	0	15	7	426.69	853.38	15	2	1	NA	1	NA	22	0
LOC101747799	0	0	1	2	258.06	516.12	15	2	1	NA	1	NA	3	0
LOC101747820	0	0	3	4	387.09	774.18	15	2	1	NA	1	NA	7	0
LOC101748017	0	0	1	9	715.44	1430.88	15	2	1	NA	1	NA	10	0
LOC101748032	0	0	3	2	231.33	462.66	15	2	1	NA	1	NA	5	0
LOC101748113	0	0	8	2	455.4	910.8	15	2	1	NA	1	NA	10	0
LOC101748153	0	0	30	33	1407.78	2815.56	15	2	1	NA	1	NA	63	0
LOC101748203	0	0	2	7	305.25	610.5	15	2	1	NA	1	NA	9	0
LOC101748207	0	0	6	4	798.27	1596.54	15	2	1	NA	1	NA	10	0
LOC101748543	0	0	2	9	397.98	795.96	15	2	1	NA	1	NA	11	0
LOC101748744	0	0	2	10	396	792	15	2	1	NA	1	NA	12	0
LOC101748751	0	0	4	3	778.14	1556.28	15	2	1	NA	1	NA	7	0
LOC101748951	0	0	5	1	819.72	1639.44	15	2	1	NA	1	NA	6	0
LOC101749017	0	0	9	8	352.44	704.88	15	2	1	NA	1	NA	17	0
LOC101749151	0	0	3	3	357.39	714.78	15	2	1	NA	1	NA	6	0
LOC101749214	0	0	6	6	540.54	1081.08	15	2	1	NA	1	NA	12	0
LOC101749220	0	0	60	27	1699.83	3399.66	15	2	1	NA	1	NA	87	0
LOC101749275	0	0	1	2	575.52	1151.04	15	2	1	NA	1	NA	3	0
LOC101749307	0	0	7	4	260.37	520.74	15	2	1	NA	1	NA	11	0
LOC101749344	0	0	2	4	131.34	262.68	15	2	1	NA	1	NA	6	0
LOC101749460	0	0	2	0	487.74	975.48	15	2	1	NA	1	NA	2	0
LOC101749593	0	0	8	9	514.8	1029.6	15	2	1	NA	1	NA	17	0
LOC101749694	0	0	4	5	416.79	833.58	15	2	1	NA	1	NA	9	0
LOC101749834	0	0	3	4	435.6	871.2	15	2	1	NA	1	NA	7	0
LOC101749904-LOC107049162-LOC112532554	0	0	4	4	521.73	1043.46	15	2	1	NA	1	NA	8	0
LOC101749950	0	0	2	4	602.25	1204.5	15	2	1	NA	1	NA	6	0
LOC101750121	0	0	0	7	316.8	633.6	15	2	1	NA	1	NA	7	0
LOC101750367	0	0	1	3	203.94	407.88	15	2	1	NA	1	NA	4	0
LOC101750423	0	0	3	3	393.03	786.06	15	2	1	NA	1	NA	6	0
LOC101750445	0	0	6	8	320.43	640.86	15	2	1	NA	1	NA	14	0
LOC101750583	0	0	5	5	671.22	1342.44	15	2	1	NA	1	NA	10	0
LOC101750612	0	0	16	12	852.39	1704.78	15	2	1	NA	1	NA	28	0
LOC101750621	0	0	5	5	325.71	651.42	15	2	1	NA	1	NA	10	0
LOC101750658	0	0	1	1	223.74	447.48	15	2	1	NA	1	NA	2	0
LOC101750822	0	0	5	8	326.7	653.4	15	2	1	NA	1	NA	13	0
LOC101750842	0	0	1	1	327.03	654.06	15	2	1	NA	1	NA	2	0
LOC101750892	0	0	3	3	473.22	946.44	15	2	1	NA	1	NA	6	0
LOC101750908	0	0	2	4	219.78	439.56	15	2	1	NA	1	NA	6	0
LOC101750948	0	0	1	2	379.17	758.34	15	2	1	NA	1	NA	3	0
LOC101751418	0	0	2	1	169.29	338.58	15	2	1	NA	1	NA	3	0
LOC101751615-LOC770126	0	0	12	6	295.35	590.7	15	2	1	NA	1	NA	18	0
LOC101751669	0	0	2	12	393.36	786.72	15	2	1	NA	1	NA	14	0
LOC101751717	0	0	5	3	193.05	386.1	15	2	1	NA	1	NA	8	0
LOC101751902	0	0	0	3	169.29	338.58	15	2	1	NA	1	NA	3	0
LOC101751992	0	0	1	2	173.25	346.5	15	2	1	NA	1	NA	3	0
LOC101752158	0	0	5	5	326.7	653.4	15	2	1	NA	1	NA	10	0
LOC107048987-LOC112532770-MT	0	0	1	2	269.28	538.56	15	2	1	NA	1	NA	3	0
LOC107049011	0	0	5	8	688.05	1376.1	15	2	1	NA	1	NA	13	0
LOC107049018	0	0	7	0	310.86	621.72	15	2	1	NA	1	NA	7	0
LOC107049033	0	0	0	6	566.61	1133.22	15	2	1	NA	1	NA	6	0
LOC107049046-LOC107055485-RPL17	0	0	0	5	183.15	366.3	15	2	1	NA	1	NA	5	0
LOC107049146	0	0	3	10	319.44	638.88	15	2	1	NA	1	NA	13	0
LOC107049165	0	0	6	10	649.44	1298.88	15	2	1	NA	1	NA	16	0
LOC107049250	0	0	1	3	354.75	709.5	15	2	1	NA	1	NA	4	0
LOC107049257	0	0	4	2	107.58	215.16	15	2	1	NA	1	NA	6	0
LOC107049500-LOC107050261	0	0	0	2	113.52	227.04	15	2	1	NA	1	NA	2	0
LOC107049639-LOC107050249-LOC107050274-LOC112531365-LOC112531366-LOC112531367-LOC112531368-LOC112531369-LOC112531380-LOC112531381-LOC112531382-LOC112531383-LOC112531389-LOC112531391-LOC112531395-LOC112531398-LOC112531399-LOC112531413-LOC112531414-LOC112531417	0	0	1	1	44.22	88.44	15	2	1	NA	1	NA	2	0
LOC107049672	0	0	4	3	754.38	1508.76	15	2	1	NA	1	NA	7	0
LOC107049895	0	0	3	1	235.62	471.24	15	2	1	NA	1	NA	4	0
LOC107050083	0	0	14	7	628.98	1257.96	15	2	1	NA	1	NA	21	0
LOC107050229	0	0	2	4	495.66	991.32	15	2	1	NA	1	NA	6	0
LOC107050638	0	0	42	56	1607.1	3214.2	15	2	1	NA	1	NA	98	0
LOC107050717	0	0	1	3	98.67	197.34	15	2	1	NA	1	NA	4	0
LOC107050724	0	0	0	2	212.85	425.7	15	2	1	NA	1	NA	2	0
LOC107050760	0	0	2	3	349.47	698.94	15	2	1	NA	1	NA	5	0
LOC107050775	0	0	1	1	116.16	232.32	15	2	1	NA	1	NA	2	0
LOC107051508-LOC771972	0	0	6	5	260.37	520.74	15	2	1	NA	1	NA	11	0
LOC107051846	0	0	9	20	1132.89	2265.78	15	2	1	NA	1	NA	29	0
LOC107051857	0	0	0	2	196.02	392.04	15	2	1	NA	1	NA	2	0
LOC107052215	0	0	5	3	132.99	265.98	15	2	1	NA	1	NA	8	0
LOC107053414	0	0	2	4	1631.52	3263.04	15	2	1	NA	1	NA	6	0
LOC107053690	0	0	2	4	222.75	445.5	15	2	1	NA	1	NA	6	0
LOC107053700	0	0	2	1	209.55	419.1	15	2	1	NA	1	NA	3	0
LOC107053714	0	0	1	5	646.8	1293.6	15	2	1	NA	1	NA	6	0
LOC107053715	0	0	10	16	1183.05	2366.1	15	2	1	NA	1	NA	26	0
LOC107054051	0	0	1	1	181.17	362.34	15	2	1	NA	1	NA	2	0
LOC107054133	0	0	1	5	777.15	1554.3	15	2	1	NA	1	NA	6	0
LOC107054221	0	0	2	5	345.84	691.68	15	2	1	NA	1	NA	7	0
LOC107054460-LOC107054461-LOC107054462-LOC107054465-LOC107054466-LOC107054467-LOC107054471-LOC107056903-LOC107056913-LOC107056929-LOC107056948-LOC107056991-LOC112531205-LOC112533411	0	0	50	76	1292.61	2585.22	15	2	1	NA	1	NA	126	0
LOC107054473	0	0	12	6	472.23	944.46	15	2	1	NA	1	NA	18	0
LOC107054634	0	0	2	2	140.58	281.16	15	2	1	NA	1	NA	4	0
LOC107054696-ZNF692	0	0	10	5	334.95	669.9	15	2	1	NA	1	NA	15	0
LOC107054849	0	0	11	7	241.56	483.12	15	2	1	NA	1	NA	18	0
LOC107055024	0	0	9	11	1043.13	2086.26	15	2	1	NA	1	NA	20	0
LOC107055037	0	0	3	0	193.05	386.1	15	2	1	NA	1	NA	3	0
LOC107055038	0	0	7	2	342.87	685.74	15	2	1	NA	1	NA	9	0
LOC107055419-LOC112530874-LOC431300	0	0	7	6	1036.2	2072.4	15	2	1	NA	1	NA	13	0
LOC107055431-NEDD4L	0	0	1	7	922.35	1844.7	15	2	1	NA	1	NA	8	0
LOC107056274	0	0	6	6	660.99	1321.98	15	2	1	NA	1	NA	12	0
LOC107056275	0	0	9	6	511.17	1022.34	15	2	1	NA	1	NA	15	0
LOC107056277	0	0	3	6	322.74	645.48	15	2	1	NA	1	NA	9	0
LOC107056377	0	0	1	1	268.29	536.58	15	2	1	NA	1	NA	2	0
LOC107056410-MRPL16	0	0	4	2	229.35	458.7	15	2	1	NA	1	NA	6	0
LOC107056412	0	0	0	2	152.79	305.58	15	2	1	NA	1	NA	2	0
LOC107056877	0	0	2	5	208.89	417.78	15	2	1	NA	1	NA	7	0
LOC107057078	0	0	10	22	1179.09	2358.18	15	2	1	NA	1	NA	32	0
LOC107057310	0	0	4	7	656.37	1312.74	15	2	1	NA	1	NA	11	0
LOC107057318	0	0	6	4	334.62	669.24	15	2	1	NA	1	NA	10	0
LOC107057363	0	0	2	2	167.31	334.62	15	2	1	NA	1	NA	4	0
LOC107057394	0	0	1	2	589.71	1179.42	15	2	1	NA	1	NA	3	0
LOC107057564	0	0	0	2	321.09	642.18	15	2	1	NA	1	NA	2	0
LOC107080643-LOC112533303	0	0	8	1	228.69	457.38	15	2	1	NA	1	NA	9	0
LOC112529925	0	0	12	14	1923.24	3846.48	15	2	1	NA	1	NA	26	0
LOC112529955	0	0	18	14	1269.18	2538.36	15	2	1	NA	1	NA	32	0
LOC112529965	0	0	3	2	305.25	610.5	15	2	1	NA	1	NA	5	0
LOC112529973	0	0	4	9	187.11	374.22	15	2	1	NA	1	NA	13	0
LOC112529978-TPRN	0	0	9	3	646.14	1292.28	15	2	1	NA	1	NA	12	0
LOC112530162	0	0	0	2	318.78	637.56	15	2	1	NA	1	NA	2	0
LOC112530190	0	0	0	2	44.55	89.1	15	2	1	NA	1	NA	2	0
LOC112530196-TMEM79	0	0	2	0	375.21	750.42	15	2	1	NA	1	NA	2	0
LOC112530201	0	0	2	9	543.18	1086.36	15	2	1	NA	1	NA	11	0
LOC112530287	0	0	1	10	292.71	585.42	15	2	1	NA	1	NA	11	0
LOC112530477	0	0	0	2	420.42	840.84	15	2	1	NA	1	NA	2	0
LOC112530656	0	0	3	0	306.57	613.14	15	2	1	NA	1	NA	3	0
LOC112530906-SLC5A10	0	0	7	8	325.71	651.42	15	2	1	NA	1	NA	15	0
LOC112530959	0	0	2	1	443.19	886.38	15	2	1	NA	1	NA	3	0
LOC112531049-UTRIM39L	0	0	3	4	537.57	1075.14	15	2	1	NA	1	NA	7	0
LOC112532100	0	0	2	0	1089	2178	15	2	1	NA	1	NA	2	0
LOC112532300	0	0	3	3	138.27	276.54	15	2	1	NA	1	NA	6	0
LOC112532338	0	0	3	3	171.93	343.86	15	2	1	NA	1	NA	6	0
LOC112532351	0	0	9	5	846.78	1693.56	15	2	1	NA	1	NA	14	0
LOC112532570-MUC	0	0	6	4	2076.03	4152.06	15	2	1	NA	1	NA	10	0
LOC112532692	0	0	1	1	198	396	15	2	1	NA	1	NA	2	0
LOC112532694	0	0	6	8	410.85	821.7	15	2	1	NA	1	NA	14	0
LOC112532762	0	0	8	1	390.06	780.12	15	2	1	NA	1	NA	9	0
LOC112532802	0	0	4	1	129.69	259.38	15	2	1	NA	1	NA	5	0
LOC112532911	0	0	2	0	233.31	466.62	15	2	1	NA	1	NA	2	0
LOC112532977	0	0	3	4	307.89	615.78	15	2	1	NA	1	NA	7	0
LOC112532998	0	0	9	4	206.91	413.82	15	2	1	NA	1	NA	13	0
LOC112533016	0	0	8	13	343.2	686.4	15	2	1	NA	1	NA	21	0
LOC112533191-OR6B1-OR6B1L2	0	0	2	1	321.75	643.5	15	2	1	NA	1	NA	3	0
LOC112533358	0	0	1	3	113.85	227.7	15	2	1	NA	1	NA	4	0
LOC112533511	0	0	7	10	578.16	1156.32	15	2	1	NA	1	NA	17	0
LOC112533543	0	0	7	11	686.07	1372.14	15	2	1	NA	1	NA	18	0
LOC112533548-TRIM7	0	0	1	9	473.22	946.44	15	2	1	NA	1	NA	10	0
LOC395381	0	0	5	3	2172.72	4345.44	15	2	1	NA	1	NA	8	0
LOC395991	0	0	3	5	304.92	609.84	15	2	1	NA	1	NA	8	0
LOC396365	0	0	5	4	108.9	217.8	15	2	1	NA	1	NA	9	0
LOC415324	0	0	0	2	395.67	791.34	15	2	1	NA	1	NA	2	0
LOC415478	0	0	12	10	1406.79	2813.58	15	2	1	NA	1	NA	22	0
LOC415664	0	0	2	4	254.43	508.86	15	2	1	NA	1	NA	6	0
LOC415780	0	0	1	2	899.91	1799.82	15	2	1	NA	1	NA	3	0
LOC415787	0	0	3	2	558.36	1116.72	15	2	1	NA	1	NA	5	0
LOC416055	0	0	6	4	326.7	653.4	15	2	1	NA	1	NA	10	0
LOC416090	0	0	2	2	179.19	358.38	15	2	1	NA	1	NA	4	0
LOC416169	0	0	11	14	871.53	1743.06	15	2	1	NA	1	NA	25	0
LOC416263	0	0	6	7	609.84	1219.68	15	2	1	NA	1	NA	13	0
LOC416530	0	0	1	7	702.9	1405.8	15	2	1	NA	1	NA	8	0
LOC416755	0	0	19	21	1050.39	2100.78	15	2	1	NA	1	NA	40	0
LOC416924	0	0	36	34	1518.66	3037.32	15	2	1	NA	1	NA	70	0
LOC417013	0	0	10	5	641.52	1283.04	15	2	1	NA	1	NA	15	0
LOC417113	0	0	4	9	605.22	1210.44	15	2	1	NA	1	NA	13	0
LOC417372	0	0	17	7	447.48	894.96	15	2	1	NA	1	NA	24	0
LOC417386	0	0	1	1	299.97	599.94	15	2	1	NA	1	NA	2	0
LOC419250	0	0	3	4	380.16	760.32	15	2	1	NA	1	NA	7	0
LOC419333	0	0	3	1	708.84	1417.68	15	2	1	NA	1	NA	4	0
LOC419409	0	0	1	7	621.72	1243.44	15	2	1	NA	1	NA	8	0
LOC419429	0	0	1	6	589.05	1178.1	15	2	1	NA	1	NA	7	0
LOC419584	0	0	16	23	562.65	1125.3	15	2	1	NA	1	NA	39	0
LOC419602	0	0	5	1	132.33	264.66	15	2	1	NA	1	NA	6	0
LOC419741	0	0	8	6	433.62	867.24	15	2	1	NA	1	NA	14	0
LOC419830	0	0	0	2	212.85	425.7	15	2	1	NA	1	NA	2	0
LOC419851-PFKFB2	0	0	7	19	1097.25	2194.5	15	2	1	NA	1	NA	26	0
LOC420107	0	0	4	5	186.12	372.24	15	2	1	NA	1	NA	9	0
LOC420160	0	0	3	13	327.69	655.38	15	2	1	NA	1	NA	16	0
LOC422106	0	0	6	5	198	396	15	2	1	NA	1	NA	11	0
LOC422177	0	0	15	9	518.76	1037.52	15	2	1	NA	1	NA	24	0
LOC422214	0	0	0	4	138.6	277.2	15	2	1	NA	1	NA	4	0
LOC422224	0	0	6	0	160.38	320.76	15	2	1	NA	1	NA	6	0
LOC422295	0	0	5	4	434.61	869.22	15	2	1	NA	1	NA	9	0
LOC422304	0	0	4	2	203.94	407.88	15	2	1	NA	1	NA	6	0
LOC422308	0	0	9	14	856.35	1712.7	15	2	1	NA	1	NA	23	0
LOC422320	0	0	4	8	674.19	1348.38	15	2	1	NA	1	NA	12	0
LOC422426	0	0	6	7	844.47	1688.94	15	2	1	NA	1	NA	13	0
LOC422442	0	0	4	0	220.77	441.54	15	2	1	NA	1	NA	4	0
LOC422926	0	0	6	11	866.25	1732.5	15	2	1	NA	1	NA	17	0
LOC422928	0	0	6	3	306.9	613.8	15	2	1	NA	1	NA	9	0
LOC423110	0	0	16	19	772.2	1544.4	15	2	1	NA	1	NA	35	0
LOC423240	0	0	0	2	364.32	728.64	15	2	1	NA	1	NA	2	0
LOC423277	0	0	0	2	143.55	287.1	15	2	1	NA	1	NA	2	0
LOC423462	0	0	3	0	263.34	526.68	15	2	1	NA	1	NA	3	0
LOC423629	0	0	3	0	219.78	439.56	15	2	1	NA	1	NA	3	0
LOC423693	0	0	2	3	660.99	1321.98	15	2	1	NA	1	NA	5	0
LOC423719	0	0	11	16	506.88	1013.76	15	2	1	NA	1	NA	27	0
LOC423731	0	0	3	1	200.97	401.94	15	2	1	NA	1	NA	4	0
LOC423752	0	0	2	5	544.5	1089	15	2	1	NA	1	NA	7	0
LOC423967	0	0	3	5	177.54	355.08	15	2	1	NA	1	NA	8	0
LOC424167	0	0	1	2	1064.25	2128.5	15	2	1	NA	1	NA	3	0
LOC424199	0	0	9	15	498.96	997.92	15	2	1	NA	1	NA	24	0
LOC424300	0	0	18	11	1910.04	3820.08	15	2	1	NA	1	NA	29	0
LOC424430	0	0	4	8	335.94	671.88	15	2	1	NA	1	NA	12	0
LOC424473	0	0	7	5	726.33	1452.66	15	2	1	NA	1	NA	12	0
LOC424748	0	0	7	7	617.76	1235.52	15	2	1	NA	1	NA	14	0
LOC424919	0	0	9	18	511.17	1022.34	15	2	1	NA	1	NA	27	0
LOC425001	0	0	4	2	278.19	556.38	15	2	1	NA	1	NA	6	0
LOC425431-NES	0	0	25	18	1064.91	2129.82	15	2	1	NA	1	NA	43	0
LOC425470	0	0	6	3	485.1	970.2	15	2	1	NA	1	NA	9	0
LOC425795	0	0	1	9	584.1	1168.2	15	2	1	NA	1	NA	10	0
LOC426220	0	0	2	4	135.96	271.92	15	2	1	NA	1	NA	6	0
LOC426514	0	0	5	8	360.03	720.06	15	2	1	NA	1	NA	13	0
LOC426710	0	0	4	1	163.35	326.7	15	2	1	NA	1	NA	5	0
LOC426743	0	0	20	25	770.22	1540.44	15	2	1	NA	1	NA	45	0
LOC426821	0	0	3	9	559.35	1118.7	15	2	1	NA	1	NA	12	0
LOC426897	0	0	5	6	515.13	1030.26	15	2	1	NA	1	NA	11	0
LOC426957-LOC428289	0	0	0	3	52.14	104.28	15	2	1	NA	1	NA	3	0
LOC427400	0	0	1	1	336.93	673.86	15	2	1	NA	1	NA	2	0
LOC427533	0	0	14	7	423.72	847.44	15	2	1	NA	1	NA	21	0
LOC427545	0	0	3	2	431.64	863.28	15	2	1	NA	1	NA	5	0
LOC427594	0	0	2	9	459.36	918.72	15	2	1	NA	1	NA	11	0
LOC427656	0	0	1	2	247.5	495	15	2	1	NA	1	NA	3	0
LOC427665	0	0	2	8	358.38	716.76	15	2	1	NA	1	NA	10	0
LOC427775	0	0	4	2	371.91	743.82	15	2	1	NA	1	NA	6	0
LOC427778	0	0	6	13	594.99	1189.98	15	2	1	NA	1	NA	19	0
LOC427783	0	0	3	1	315.15	630.3	15	2	1	NA	1	NA	4	0
LOC427799	0	0	0	3	345.51	691.02	15	2	1	NA	1	NA	3	0
LOC427826	0	0	1	5	503.91	1007.82	15	2	1	NA	1	NA	6	0
LOC428144	0	0	2	2	384.12	768.24	15	2	1	NA	1	NA	4	0
LOC428250	0	0	45	27	2587.53	5175.06	15	2	1	NA	1	NA	72	0
LOC428541	0	0	2	5	240.9	481.8	15	2	1	NA	1	NA	7	0
LOC428702	0	0	3	4	275.88	551.76	15	2	1	NA	1	NA	7	0
LOC428714	0	0	6	4	897.6	1795.2	15	2	1	NA	1	NA	10	0
LOC428824	0	0	8	17	674.19	1348.38	15	2	1	NA	1	NA	25	0
LOC429098	0	0	4	9	581.13	1162.26	15	2	1	NA	1	NA	13	0
LOC430422	0	0	8	9	956.67	1913.34	15	2	1	NA	1	NA	17	0
LOC430433-LOC776507	0	0	13	5	577.83	1155.66	15	2	1	NA	1	NA	18	0
LOC431092	0	0	5	1	154.77	309.54	15	2	1	NA	1	NA	6	0
LOC431321	0	0	1	3	157.41	314.82	15	2	1	NA	1	NA	4	0
LOC768477	0	0	6	4	135.63	271.26	15	2	1	NA	1	NA	10	0
LOC768647	0	0	2	1	764.28	1528.56	15	2	1	NA	1	NA	3	0
LOC768760	0	0	15	16	946.77	1893.54	15	2	1	NA	1	NA	31	0
LOC768978	0	0	0	5	610.83	1221.66	15	2	1	NA	1	NA	5	0
LOC769486	0	0	3	0	65.01	130.02	15	2	1	NA	1	NA	3	0
LOC769646	0	0	8	3	188.1	376.2	15	2	1	NA	1	NA	11	0
LOC769726	0	0	1	2	296.01	592.02	15	2	1	NA	1	NA	3	0
LOC770277	0	0	6	5	441.54	883.08	15	2	1	NA	1	NA	11	0
LOC770492	0	0	1	6	235.62	471.24	15	2	1	NA	1	NA	7	0
LOC770548	0	0	4	0	90.42	180.84	15	2	1	NA	1	NA	4	0
LOC770617	0	0	0	2	122.76	245.52	15	2	1	NA	1	NA	2	0
LOC770653	0	0	3	1	380.16	760.32	15	2	1	NA	1	NA	4	0
LOC770881	0	0	2	3	216.81	433.62	15	2	1	NA	1	NA	5	0
LOC770936	0	0	1	1	298.98	597.96	15	2	1	NA	1	NA	2	0
LOC771069	0	0	0	5	251.46	502.92	15	2	1	NA	1	NA	5	0
LOC771308	0	0	1	1	371.25	742.5	15	2	1	NA	1	NA	2	0
LOC771362	0	0	3	2	707.85	1415.7	15	2	1	NA	1	NA	5	0
LOC771388	0	0	1	4	360.36	720.72	15	2	1	NA	1	NA	5	0
LOC771422	0	0	3	2	446.49	892.98	15	2	1	NA	1	NA	5	0
LOC771456	0	0	3	3	319.77	639.54	15	2	1	NA	1	NA	6	0
LOC771494	0	0	8	6	782.1	1564.2	15	2	1	NA	1	NA	14	0
LOC771515	0	0	5	3	168.63	337.26	15	2	1	NA	1	NA	8	0
LOC771545	0	0	4	5	223.41	446.82	15	2	1	NA	1	NA	9	0
LOC771612	0	0	3	1	270.27	540.54	15	2	1	NA	1	NA	4	0
LOC771811	0	0	3	4	354.42	708.84	15	2	1	NA	1	NA	7	0
LOC771917	0	0	3	2	187.11	374.22	15	2	1	NA	1	NA	5	0
LOC771994	0	0	18	11	265.65	531.3	15	2	1	NA	1	NA	29	0
LOC771995	0	0	5	7	436.59	873.18	15	2	1	NA	1	NA	12	0
LOC772017	0	0	11	7	582.45	1164.9	15	2	1	NA	1	NA	18	0
LOC772071	0	0	0	2	165.33	330.66	15	2	1	NA	1	NA	2	0
LOC776275	0	0	1	5	106.59	213.18	15	2	1	NA	1	NA	6	0
LOC776594	0	0	6	6	415.8	831.6	15	2	1	NA	1	NA	12	0
LOH11CR2A	0	0	10	4	796.95	1593.9	15	2	1	NA	1	NA	14	0
LONP1	0	0	3	8	835.56	1671.12	15	2	1	NA	1	NA	11	0
LONP2	0	0	1	8	844.47	1688.94	15	2	1	NA	1	NA	9	0
LONRF1	0	0	4	8	710.82	1421.64	15	2	1	NA	1	NA	12	0
LONRF3	0	0	0	2	581.46	1162.92	15	2	1	NA	1	NA	2	0
LOX	0	0	0	2	189.42	378.84	15	2	1	NA	1	NA	2	0
LOXHD1	0	0	6	17	2259.51	4519.02	15	2	1	NA	1	NA	23	0
LOXL1	0	0	2	7	495.99	991.98	15	2	1	NA	1	NA	9	0
LOXL2	0	0	1	14	669.24	1338.48	15	2	1	NA	1	NA	15	0
LOXL3	0	0	6	9	817.74	1635.48	15	2	1	NA	1	NA	15	0
LOXL4	0	0	20	18	1228.92	2457.84	15	2	1	NA	1	NA	38	0
LPAR1	0	0	0	3	366.3	732.6	15	2	1	NA	1	NA	3	0
LPCAT2	0	0	2	2	540.54	1081.08	15	2	1	NA	1	NA	4	0
LPL	0	0	0	4	457.71	915.42	15	2	1	NA	1	NA	4	0
LPXN	0	0	1	2	380.16	760.32	15	2	1	NA	1	NA	3	0
LRAT	0	0	1	1	233.31	466.62	15	2	1	NA	1	NA	2	0
LRBA	0	0	10	4	2831.4	5662.8	15	2	1	NA	1	NA	14	0
LRCH2	0	0	0	4	715.77	1431.54	15	2	1	NA	1	NA	4	0
LRCH3	0	0	4	1	820.71	1641.42	15	2	1	NA	1	NA	5	0
LRFN3	0	0	1	8	681.12	1362.24	15	2	1	NA	1	NA	9	0
LRG1	0	0	10	12	333.63	667.26	15	2	1	NA	1	NA	22	0
LRIF1	0	0	2	5	729.3	1458.6	15	2	1	NA	1	NA	7	0
LRIG1	0	0	3	14	1084.05	2168.1	15	2	1	NA	1	NA	17	0
LRIT1	0	0	7	6	620.73	1241.46	15	2	1	NA	1	NA	13	0
LRIT2	0	0	3	5	523.71	1047.42	15	2	1	NA	1	NA	8	0
LRIT3	0	0	10	15	919.71	1839.42	15	2	1	NA	1	NA	25	0
LRMPL	0	0	8	9	387.09	774.18	15	2	1	NA	1	NA	17	0
LRP1	0	0	4	31	4407.48	8814.96	15	2	1	NA	1	NA	35	0
LRP1B	0	0	12	12	4426.62	8853.24	15	2	1	NA	1	NA	24	0
LRP2	0	0	13	9	4616.37	9232.74	15	2	1	NA	1	NA	22	0
LRP3	0	0	1	2	823.68	1647.36	15	2	1	NA	1	NA	3	0
LRP4	0	0	4	11	1864.83	3729.66	15	2	1	NA	1	NA	15	0
LRP5	0	0	1	3	1514.04	3028.08	15	2	1	NA	1	NA	4	0
LRP8	0	0	5	4	828.63	1657.26	15	2	1	NA	1	NA	9	0
LRPAP1	0	0	2	0	348.48	696.96	15	2	1	NA	1	NA	2	0
LRR1	0	0	3	7	418.77	837.54	15	2	1	NA	1	NA	10	0
LRRC15	0	0	9	11	567.27	1134.54	15	2	1	NA	1	NA	20	0
LRRC18	0	0	3	0	260.37	520.74	15	2	1	NA	1	NA	3	0
LRRC27	0	0	4	11	884.07	1768.14	15	2	1	NA	1	NA	15	0
LRRC31	0	0	9	3	577.17	1154.34	15	2	1	NA	1	NA	12	0
LRRC34	0	0	6	5	414.81	829.62	15	2	1	NA	1	NA	11	0
LRRC38	0	0	0	2	291.06	582.12	15	2	1	NA	1	NA	2	0
LRRC39	0	0	2	0	336.6	673.2	15	2	1	NA	1	NA	2	0
LRRC3C	0	0	1	3	254.76	509.52	15	2	1	NA	1	NA	4	0
LRRC40	0	0	4	7	548.13	1096.26	15	2	1	NA	1	NA	11	0
LRRC41	0	0	4	9	739.53	1479.06	15	2	1	NA	1	NA	13	0
LRRC42	0	0	3	3	418.77	837.54	15	2	1	NA	1	NA	6	0
LRRC45	0	0	1	2	591.69	1183.38	15	2	1	NA	1	NA	3	0
LRRC46	0	0	2	0	164.01	328.02	15	2	1	NA	1	NA	2	0
LRRC47	0	0	5	6	578.16	1156.32	15	2	1	NA	1	NA	11	0
LRRC49	0	0	4	3	724.68	1449.36	15	2	1	NA	1	NA	7	0
LRRC4C	0	0	3	2	628.65	1257.3	15	2	1	NA	1	NA	5	0
LRRC56	0	0	5	7	645.48	1290.96	15	2	1	NA	1	NA	12	0
LRRC59	0	0	2	1	272.91	545.82	15	2	1	NA	1	NA	3	0
LRRC66	0	0	26	10	1220.01	2440.02	15	2	1	NA	1	NA	36	0
LRRC7	0	0	2	13	1439.46	2878.92	15	2	1	NA	1	NA	15	0
LRRC74A	0	0	9	3	462.33	924.66	15	2	1	NA	1	NA	12	0
LRRC75A	0	0	6	4	365.31	730.62	15	2	1	NA	1	NA	10	0
LRRC8A	0	0	0	6	802.89	1605.78	15	2	1	NA	1	NA	6	0
LRRC8C	0	0	0	4	794.97	1589.94	15	2	1	NA	1	NA	4	0
LRRC9	0	0	15	7	1372.14	2744.28	15	2	1	NA	1	NA	22	0
LRRFIP1	0	0	7	5	1282.05	2564.1	15	2	1	NA	1	NA	12	0
LRRIQ4	0	0	3	4	580.14	1160.28	15	2	1	NA	1	NA	7	0
LRRN1	0	0	0	4	709.83	1419.66	15	2	1	NA	1	NA	4	0
LRRN2	0	0	11	14	707.85	1415.7	15	2	1	NA	1	NA	25	0
LRRTM2	0	0	5	4	379.17	758.34	15	2	1	NA	1	NA	9	0
LRRTM4	0	0	2	1	121.77	243.54	15	2	1	NA	1	NA	3	0
LRSAM1	0	0	6	3	720.72	1441.44	15	2	1	NA	1	NA	9	0
LRWD1	0	0	3	7	743.49	1486.98	15	2	1	NA	1	NA	10	0
LSM1	0	0	0	2	94.71	189.42	15	2	1	NA	1	NA	2	0
LSM10	0	0	2	5	122.76	245.52	15	2	1	NA	1	NA	7	0
LSM11	0	0	2	1	207.57	415.14	15	2	1	NA	1	NA	3	0
LSM14A	0	0	0	2	417.12	834.24	15	2	1	NA	1	NA	2	0
LSM14B	0	0	1	6	412.83	825.66	15	2	1	NA	1	NA	7	0
LSM4	0	0	0	4	121.77	243.54	15	2	1	NA	1	NA	4	0
LSM7	0	0	5	8	660.33	1320.66	15	2	1	NA	1	NA	13	0
LSP1	0	0	3	2	349.47	698.94	15	2	1	NA	1	NA	5	0
LSS	0	0	2	7	716.76	1433.52	15	2	1	NA	1	NA	9	0
LTBP2	0	0	12	33	1630.53	3261.06	15	2	1	NA	1	NA	45	0
LTC4S	0	0	1	2	149.49	298.98	15	2	1	NA	1	NA	3	0
LTK	0	0	6	4	1436.82	2873.64	15	2	1	NA	1	NA	10	0
LURAP1	0	0	4	3	260.04	520.08	15	2	1	NA	1	NA	7	0
LUZP1	0	0	6	4	1149.39	2298.78	15	2	1	NA	1	NA	10	0
LUZP2	0	0	5	0	178.53	357.06	15	2	1	NA	1	NA	5	0
LVRN	0	0	5	2	963.6	1927.2	15	2	1	NA	1	NA	7	0
LY75	0	0	9	4	1662.21	3324.42	15	2	1	NA	1	NA	13	0
LY9	0	0	6	11	431.31	862.62	15	2	1	NA	1	NA	17	0
LYAR	0	0	5	0	363.33	726.66	15	2	1	NA	1	NA	5	0
LYPD6	0	0	2	0	168.3	336.6	15	2	1	NA	1	NA	2	0
LYPD6B	0	0	2	1	168.3	336.6	15	2	1	NA	1	NA	3	0
LYPLA2	0	0	1	1	230.67	461.34	15	2	1	NA	1	NA	2	0
LYSMD2	0	0	3	0	177.54	355.08	15	2	1	NA	1	NA	3	0
LYSMD3	0	0	2	4	305.91	611.82	15	2	1	NA	1	NA	6	0
LYSMD4	0	0	6	6	299.97	599.94	15	2	1	NA	1	NA	12	0
LYVE1	0	0	3	3	273.9	547.8	15	2	1	NA	1	NA	6	0
LZTR1	0	0	2	15	927.63	1855.26	15	2	1	NA	1	NA	17	0
LZTS1	0	0	6	13	591.69	1183.38	15	2	1	NA	1	NA	19	0
LZTS2	0	0	12	13	642.51	1285.02	15	2	1	NA	1	NA	25	0
M1AP	0	0	9	4	521.73	1043.46	15	2	1	NA	1	NA	13	0
MAB21L2	0	0	0	2	356.4	712.8	15	2	1	NA	1	NA	2	0
MAD1L1	0	0	0	2	364.65	729.3	15	2	1	NA	1	NA	2	0
MAD2L1	0	0	1	4	168.3	336.6	15	2	1	NA	1	NA	5	0
MAD2L2	0	0	0	8	209.88	419.76	15	2	1	NA	1	NA	8	0
MADCAM1	0	0	7	5	465.3	930.6	15	2	1	NA	1	NA	12	0
MADD	0	0	6	7	1608.75	3217.5	15	2	1	NA	1	NA	13	0
MAF1	0	0	2	3	219.45	438.9	15	2	1	NA	1	NA	5	0
MAFB	0	0	0	4	308.88	617.76	15	2	1	NA	1	NA	4	0
MAGI3	0	0	2	1	1410.75	2821.5	15	2	1	NA	1	NA	3	0
MAGOH	0	0	0	2	160.38	320.76	15	2	1	NA	1	NA	2	0
MAK16	0	0	5	4	281.49	562.98	15	2	1	NA	1	NA	9	0
MAMDC2	0	0	2	0	629.97	1259.94	15	2	1	NA	1	NA	2	0
MAMDC4	0	0	11	5	1153.68	2307.36	15	2	1	NA	1	NA	16	0
MAML1	0	0	4	9	1042.8	2085.6	15	2	1	NA	1	NA	13	0
MAML3	0	0	7	4	482.46	964.92	15	2	1	NA	1	NA	11	0
MAMLD1	0	0	7	5	1031.58	2063.16	15	2	1	NA	1	NA	12	0
MAN2A1	0	0	5	1	832.59	1665.18	15	2	1	NA	1	NA	6	0
MAN2A2	0	0	7	14	1172.82	2345.64	15	2	1	NA	1	NA	21	0
MAN2B2	0	0	3	7	1000.89	2001.78	15	2	1	NA	1	NA	10	0
MAN2C1	0	0	14	20	1033.56	2067.12	15	2	1	NA	1	NA	34	0
MANBA	0	0	5	4	873.18	1746.36	15	2	1	NA	1	NA	9	0
MANEAL	0	0	2	6	283.14	566.28	15	2	1	NA	1	NA	8	0
MAP1A	0	0	12	6	3183.51	6367.02	15	2	1	NA	1	NA	18	0
MAP1B	0	0	10	8	2086.92	4173.84	15	2	1	NA	1	NA	18	0
MAP1LC3A	0	0	0	2	120.78	241.56	15	2	1	NA	1	NA	2	0
MAP2	0	0	11	13	2035.44	4070.88	15	2	1	NA	1	NA	24	0
MAP2K1	0	0	0	5	392.04	784.08	15	2	1	NA	1	NA	5	0
MAP2K3	0	0	0	10	345.51	691.02	15	2	1	NA	1	NA	10	0
MAP2K5	0	0	0	5	313.83	627.66	15	2	1	NA	1	NA	5	0
MAP2K6	0	0	0	4	328.68	657.36	15	2	1	NA	1	NA	4	0
MAP3K1	0	0	3	7	1251.36	2502.72	15	2	1	NA	1	NA	10	0
MAP3K13	0	0	2	7	956.34	1912.68	15	2	1	NA	1	NA	9	0
MAP3K14	0	0	3	1	934.56	1869.12	15	2	1	NA	1	NA	4	0
MAP3K19	0	0	13	16	1248.39	2496.78	15	2	1	NA	1	NA	29	0
MAP3K2	0	0	3	4	887.04	1774.08	15	2	1	NA	1	NA	7	0
MAP3K20	0	0	3	7	899.91	1799.82	15	2	1	NA	1	NA	10	0
MAP3K3	0	0	2	5	649.11	1298.22	15	2	1	NA	1	NA	7	0
MAP3K6	0	0	34	30	1202.85	2405.7	15	2	1	NA	1	NA	64	0
MAP7D1	0	0	9	14	566.61	1133.22	15	2	1	NA	1	NA	23	0
MAP7D3	0	0	4	2	748.11	1496.22	15	2	1	NA	1	NA	6	0
MAP9	0	0	8	3	552.09	1104.18	15	2	1	NA	1	NA	11	0
MAPK10	0	0	5	4	511.17	1022.34	15	2	1	NA	1	NA	9	0
MAPK13	0	0	0	2	362.34	724.68	15	2	1	NA	1	NA	2	0
MAPK14	0	0	0	2	357.39	714.78	15	2	1	NA	1	NA	2	0
MAPK6	0	0	0	2	714.78	1429.56	15	2	1	NA	1	NA	2	0
MAPK8	0	0	0	4	418.11	836.22	15	2	1	NA	1	NA	4	0
MAPK8IP3	0	0	12	20	1452.33	2904.66	15	2	1	NA	1	NA	32	0
MAPKAP1	0	0	0	2	517.77	1035.54	15	2	1	NA	1	NA	2	0
MAPKAPK2	0	0	2	7	338.58	677.16	15	2	1	NA	1	NA	9	0
MAPKAPK3	0	0	0	4	384.12	768.24	15	2	1	NA	1	NA	4	0
MAPKAPK5	0	0	1	5	464.64	929.28	15	2	1	NA	1	NA	6	0
MAPT	0	0	13	10	719.73	1439.46	15	2	1	NA	1	NA	23	0
MARCH1	0	0	2	2	503.91	1007.82	15	2	1	NA	1	NA	4	0
MARCH3	0	0	0	5	190.41	380.82	15	2	1	NA	1	NA	5	0
MARCH7	0	0	2	5	760.32	1520.64	15	2	1	NA	1	NA	7	0
MARCH8	0	0	3	4	554.4	1108.8	15	2	1	NA	1	NA	7	0
MARCO	0	0	3	0	469.26	938.52	15	2	1	NA	1	NA	3	0
MARK3	0	0	1	3	777.15	1554.3	15	2	1	NA	1	NA	4	0
MARS	0	0	12	18	901.23	1802.46	15	2	1	NA	1	NA	30	0
MARS2	0	0	5	7	521.07	1042.14	15	2	1	NA	1	NA	12	0
MARVELD1	0	0	0	2	174.24	348.48	15	2	1	NA	1	NA	2	0
MARVELD2	0	0	1	2	408.21	816.42	15	2	1	NA	1	NA	3	0
MASP1	0	0	4	14	723.69	1447.38	15	2	1	NA	1	NA	18	0
MASP2	0	0	2	6	682.11	1364.22	15	2	1	NA	1	NA	8	0
MAST2	0	0	5	8	1875.06	3750.12	15	2	1	NA	1	NA	13	0
MAST3	0	0	15	49	1422.3	2844.6	15	2	1	NA	1	NA	64	0
MAST4	0	0	4	4	2216.94	4433.88	15	2	1	NA	1	NA	8	0
MAT2A	0	0	3	2	406.23	812.46	15	2	1	NA	1	NA	5	0
MAT2B	0	0	1	2	310.86	621.72	15	2	1	NA	1	NA	3	0
MATK	0	0	8	14	582.45	1164.9	15	2	1	NA	1	NA	22	0
MATN1	0	0	0	14	445.83	891.66	15	2	1	NA	1	NA	14	0
MATN4	0	0	5	9	614.79	1229.58	15	2	1	NA	1	NA	14	0
MATR3	0	0	0	3	893.97	1787.94	15	2	1	NA	1	NA	3	0
MAU2	0	0	0	5	482.13	964.26	15	2	1	NA	1	NA	5	0
MB21D2	0	0	1	3	482.13	964.26	15	2	1	NA	1	NA	4	0
MBD3	0	0	1	1	231.66	463.32	15	2	1	NA	1	NA	2	0
MBD5	0	0	2	4	1731.51	3463.02	15	2	1	NA	1	NA	6	0
MBIP	0	0	3	0	318.78	637.56	15	2	1	NA	1	NA	3	0
MBLAC2	0	0	3	2	241.23	482.46	15	2	1	NA	1	NA	5	0
MBNL1	0	0	11	4	438.9	877.8	15	2	1	NA	1	NA	15	0
MBTD1	0	0	1	2	685.08	1370.16	15	2	1	NA	1	NA	3	0
MBTPS1	0	0	1	5	1050.39	2100.78	15	2	1	NA	1	NA	6	0
MC1R	0	0	1	1	311.85	623.7	15	2	1	NA	1	NA	2	0
MC3R	0	0	2	0	322.74	645.48	15	2	1	NA	1	NA	2	0
MCAM	0	0	6	16	562.98	1125.96	15	2	1	NA	1	NA	22	0
MCC	0	0	0	4	419.1	838.2	15	2	1	NA	1	NA	4	0
MCCC1	0	0	2	4	920.7	1841.4	15	2	1	NA	1	NA	6	0
MCCC2	0	0	1	1	502.59	1005.18	15	2	1	NA	1	NA	2	0
MCCC2L	0	0	5	6	602.91	1205.82	15	2	1	NA	1	NA	11	0
MCEE	0	0	2	0	170.28	340.56	15	2	1	NA	1	NA	2	0
MCF2	0	0	3	3	1105.83	2211.66	15	2	1	NA	1	NA	6	0
MCF2L2	0	0	3	7	1358.61	2717.22	15	2	1	NA	1	NA	10	0
MCHR1	0	0	2	2	365.31	730.62	15	2	1	NA	1	NA	4	0
MCHR2	0	0	1	4	405.9	811.8	15	2	1	NA	1	NA	5	0
MCM2	0	0	2	9	878.13	1756.26	15	2	1	NA	1	NA	11	0
MCM3AP	0	0	8	9	1530.54	3061.08	15	2	1	NA	1	NA	17	0
MCM6	0	0	2	3	814.77	1629.54	15	2	1	NA	1	NA	5	0
MCMBP	0	0	0	4	604.89	1209.78	15	2	1	NA	1	NA	4	0
MCOLN2	0	0	1	1	531.63	1063.26	15	2	1	NA	1	NA	2	0
MCOLN3	0	0	2	1	553.41	1106.82	15	2	1	NA	1	NA	3	0
MCRS1	0	0	1	8	406.89	813.78	15	2	1	NA	1	NA	9	0
MCT2L	0	0	1	2	498.96	997.92	15	2	1	NA	1	NA	3	0
MCTP1	0	0	4	0	201.96	403.92	15	2	1	NA	1	NA	4	0
MCTS1	0	0	0	2	180.18	360.36	15	2	1	NA	1	NA	2	0
MCU	0	0	1	1	299.97	599.94	15	2	1	NA	1	NA	2	0
MDC1	0	0	10	6	1184.37	2368.74	15	2	1	NA	1	NA	16	0
MDFI	0	0	6	2	232.65	465.3	15	2	1	NA	1	NA	8	0
MDGA2	0	0	6	17	876.48	1752.96	15	2	1	NA	1	NA	23	0
MDH1B	0	0	4	1	742.17	1484.34	15	2	1	NA	1	NA	5	0
MDH2	0	0	0	2	313.83	627.66	15	2	1	NA	1	NA	2	0
MDK	0	0	0	3	141.57	283.14	15	2	1	NA	1	NA	3	0
MDM4	0	0	5	1	470.25	940.5	15	2	1	NA	1	NA	6	0
MEAF6	0	0	1	2	307.56	615.12	15	2	1	NA	1	NA	3	0
MECOM	0	0	1	6	1090.98	2181.96	15	2	1	NA	1	NA	7	0
MECR	0	0	3	8	336.27	672.54	15	2	1	NA	1	NA	11	0
MED1	0	0	1	18	1568.16	3136.32	15	2	1	NA	1	NA	19	0
MED12	0	0	1	9	2145.33	4290.66	15	2	1	NA	1	NA	10	0
MED12L	0	0	6	8	1524.6	3049.2	15	2	1	NA	1	NA	14	0
MED13	0	0	4	7	2186.91	4373.82	15	2	1	NA	1	NA	11	0
MED13L	0	0	9	20	2123.55	4247.1	15	2	1	NA	1	NA	29	0
MED16	0	0	0	13	815.76	1631.52	15	2	1	NA	1	NA	13	0
MED18	0	0	2	0	199.98	399.96	15	2	1	NA	1	NA	2	0
MED20	0	0	1	4	210.87	421.74	15	2	1	NA	1	NA	5	0
MED22	0	0	0	3	201.96	403.92	15	2	1	NA	1	NA	3	0
MED24	0	0	3	16	900.9	1801.8	15	2	1	NA	1	NA	19	0
MED26	0	0	2	2	609.51	1219.02	15	2	1	NA	1	NA	4	0
MED8	0	0	0	4	265.32	530.64	15	2	1	NA	1	NA	4	0
MEF2B	0	0	8	10	398.97	797.94	15	2	1	NA	1	NA	18	0
MEF2D	0	0	0	4	549.45	1098.9	15	2	1	NA	1	NA	4	0
MEGF10	0	0	3	3	1115.73	2231.46	15	2	1	NA	1	NA	6	0
MEGF11	0	0	1	3	1047.42	2094.84	15	2	1	NA	1	NA	4	0
MEGF6	0	0	15	23	1408.77	2817.54	15	2	1	NA	1	NA	38	0
MEGF6L	0	0	1	2	1716.66	3433.32	15	2	1	NA	1	NA	3	0
MEGF9	0	0	7	5	526.02	1052.04	15	2	1	NA	1	NA	12	0
MEIKIN	0	0	11	3	403.26	806.52	15	2	1	NA	1	NA	14	0
MEIOB	0	0	3	2	513.81	1027.62	15	2	1	NA	1	NA	5	0
MEIOC	0	0	6	3	863.28	1726.56	15	2	1	NA	1	NA	9	0
MELK	0	0	6	3	598.29	1196.58	15	2	1	NA	1	NA	9	0
MELTF	0	0	9	2	733.59	1467.18	15	2	1	NA	1	NA	11	0
MEOX1	0	0	1	1	241.56	483.12	15	2	1	NA	1	NA	2	0
MEPE	0	0	9	7	523.38	1046.76	15	2	1	NA	1	NA	16	0
MESDC1	0	0	1	2	353.43	706.86	15	2	1	NA	1	NA	3	0
MESP1-MESP2	0	0	12	10	319.77	639.54	15	2	1	NA	1	NA	22	0
METAP1	0	0	2	0	379.83	759.66	15	2	1	NA	1	NA	2	0
METTL10	0	0	3	2	217.8	435.6	15	2	1	NA	1	NA	5	0
METTL11B	0	0	2	0	322.74	645.48	15	2	1	NA	1	NA	2	0
METTL15	0	0	2	0	275.22	550.44	15	2	1	NA	1	NA	2	0
METTL18	0	0	6	7	342.54	685.08	15	2	1	NA	1	NA	13	0
METTL22	0	0	9	4	388.08	776.16	15	2	1	NA	1	NA	13	0
METTL23	0	0	3	4	222.75	445.5	15	2	1	NA	1	NA	7	0
METTL2A	0	0	3	1	372.24	744.48	15	2	1	NA	1	NA	4	0
METTL7A	0	0	0	4	244.53	489.06	15	2	1	NA	1	NA	4	0
METTL8	0	0	4	0	393.03	786.06	15	2	1	NA	1	NA	4	0
MEX3A	0	0	2	4	400.62	801.24	15	2	1	NA	1	NA	6	0
MEX3D	0	0	4	12	490.05	980.1	15	2	1	NA	1	NA	16	0
MFAP1	0	0	0	2	435.6	871.2	15	2	1	NA	1	NA	2	0
MFAP2	0	0	0	2	180.18	360.36	15	2	1	NA	1	NA	2	0
MFAP3	0	0	2	5	338.58	677.16	15	2	1	NA	1	NA	7	0
MFAP3L	0	0	1	2	379.17	758.34	15	2	1	NA	1	NA	3	0
MFF	0	0	1	3	308.88	617.76	15	2	1	NA	1	NA	4	0
MFGE8	0	0	2	10	464.31	928.62	15	2	1	NA	1	NA	12	0
MFN1	0	0	3	7	733.59	1467.18	15	2	1	NA	1	NA	10	0
MFN2	0	0	1	12	748.44	1496.88	15	2	1	NA	1	NA	13	0
MFRP	0	0	16	17	798.93	1597.86	15	2	1	NA	1	NA	33	0
MFSD1	0	0	4	6	509.85	1019.7	15	2	1	NA	1	NA	10	0
MFSD11	0	0	3	2	444.51	889.02	15	2	1	NA	1	NA	5	0
MFSD12	0	0	5	6	497.97	995.94	15	2	1	NA	1	NA	11	0
MFSD13A	0	0	5	6	504.9	1009.8	15	2	1	NA	1	NA	11	0
MFSD2A	0	0	1	4	523.71	1047.42	15	2	1	NA	1	NA	5	0
MFSD4A	0	0	3	2	500.28	1000.56	15	2	1	NA	1	NA	5	0
MFSD8	0	0	4	0	519.75	1039.5	15	2	1	NA	1	NA	4	0
MGA	0	0	10	12	2429.46	4858.92	15	2	1	NA	1	NA	22	0
MGAM	0	0	7	12	594.66	1189.32	15	2	1	NA	1	NA	19	0
MGARP	0	0	2	2	241.56	483.12	15	2	1	NA	1	NA	4	0
MGAT2	0	0	3	6	367.29	734.58	15	2	1	NA	1	NA	9	0
MGAT4B	0	0	2	4	559.68	1119.36	15	2	1	NA	1	NA	6	0
MGAT4C	0	0	5	6	936.54	1873.08	15	2	1	NA	1	NA	11	0
MGAT4D	0	0	2	2	524.7	1049.4	15	2	1	NA	1	NA	4	0
MGAT5	0	0	0	3	735.57	1471.14	15	2	1	NA	1	NA	3	0
MGAT5B	0	0	4	15	782.43	1564.86	15	2	1	NA	1	NA	19	0
MGEA5	0	0	0	10	906.84	1813.68	15	2	1	NA	1	NA	10	0
MGLL	0	0	1	5	308.88	617.76	15	2	1	NA	1	NA	6	0
MGST3	0	0	1	3	142.56	285.12	15	2	1	NA	1	NA	4	0
MGTNIPA2L	0	0	1	3	355.41	710.82	15	2	1	NA	1	NA	4	0
MHCDMA	0	0	0	3	224.4	448.8	15	2	1	NA	1	NA	3	0
MIA2	0	0	11	6	1357.95	2715.9	15	2	1	NA	1	NA	17	0
MIB2	0	0	3	11	945.45	1890.9	15	2	1	NA	1	NA	14	0
MICAL1	0	0	24	24	1106.49	2212.98	15	2	1	NA	1	NA	48	0
MICAL2	0	0	18	12	1928.52	3857.04	15	2	1	NA	1	NA	30	0
MICALL2	0	0	5	3	792	1584	15	2	1	NA	1	NA	8	0
MICU1	0	0	2	5	448.14	896.28	15	2	1	NA	1	NA	7	0
MICU3	0	0	0	3	387.42	774.84	15	2	1	NA	1	NA	3	0
MID2	0	0	1	10	681.12	1362.24	15	2	1	NA	1	NA	11	0
MIDN	0	0	7	12	435.93	871.86	15	2	1	NA	1	NA	19	0
MIEF2	0	0	8	10	454.41	908.82	15	2	1	NA	1	NA	18	0
MIER1	0	0	3	1	505.89	1011.78	15	2	1	NA	1	NA	4	0
MIF	0	0	0	2	114.84	229.68	15	2	1	NA	1	NA	2	0
MIGA2	0	0	5	17	582.12	1164.24	15	2	1	NA	1	NA	22	0
MILR1	0	0	2	1	338.58	677.16	15	2	1	NA	1	NA	3	0
MINDY4B	0	0	10	4	508.2	1016.4	15	2	1	NA	1	NA	14	0
MIPOL1	0	0	2	0	426.69	853.38	15	2	1	NA	1	NA	2	0
MIS12	0	0	0	3	217.8	435.6	15	2	1	NA	1	NA	3	0
MIS18BP1	0	0	13	9	1030.26	2060.52	15	2	1	NA	1	NA	22	0
MISP	0	0	6	15	843.48	1686.96	15	2	1	NA	1	NA	21	0
MITF	0	0	3	2	528.66	1057.32	15	2	1	NA	1	NA	5	0
MKI67	0	0	37	19	2083.29	4166.58	15	2	1	NA	1	NA	56	0
MKNK1	0	0	1	2	408.87	817.74	15	2	1	NA	1	NA	3	0
MKNK2	0	0	0	2	448.47	896.94	15	2	1	NA	1	NA	2	0
MKRN2	0	0	8	6	870.21	1740.42	15	2	1	NA	1	NA	14	0
MKS1	0	0	2	1	559.35	1118.7	15	2	1	NA	1	NA	3	0
MLF1	0	0	3	4	263.34	526.68	15	2	1	NA	1	NA	7	0
MLH3	0	0	24	10	1426.59	2853.18	15	2	1	NA	1	NA	34	0
MLLT3	0	0	2	2	562.98	1125.96	15	2	1	NA	1	NA	4	0
MLLT6	0	0	2	13	1018.38	2036.76	15	2	1	NA	1	NA	15	0
MLPH	0	0	4	4	658.35	1316.7	15	2	1	NA	1	NA	8	0
MLX	0	0	1	1	191.4	382.8	15	2	1	NA	1	NA	2	0
MLXIP	0	0	3	12	965.91	1931.82	15	2	1	NA	1	NA	15	0
MLXIPL	0	0	3	2	1200.21	2400.42	15	2	1	NA	1	NA	5	0
MLYCD	0	0	2	2	450.45	900.9	15	2	1	NA	1	NA	4	0
MMAA	0	0	2	3	408.87	817.74	15	2	1	NA	1	NA	5	0
MMAB	0	0	3	9	194.37	388.74	15	2	1	NA	1	NA	12	0
MMACHC	0	0	1	4	236.61	473.22	15	2	1	NA	1	NA	5	0
MMADHC	0	0	1	2	294.03	588.06	15	2	1	NA	1	NA	3	0
MMD	0	0	0	3	237.6	475.2	15	2	1	NA	1	NA	3	0
MMD2	0	0	0	5	239.58	479.16	15	2	1	NA	1	NA	5	0
MME	0	0	0	4	731.61	1463.22	15	2	1	NA	1	NA	4	0
MMEL1	0	0	1	5	766.26	1532.52	15	2	1	NA	1	NA	6	0
MMP11	0	0	0	10	456.39	912.78	15	2	1	NA	1	NA	10	0
MMP15	0	0	1	7	604.89	1209.78	15	2	1	NA	1	NA	8	0
MMP17	0	0	4	7	572.22	1144.44	15	2	1	NA	1	NA	11	0
MMP2	0	0	0	5	657.36	1314.72	15	2	1	NA	1	NA	5	0
MMP23B	0	0	4	1	396	792	15	2	1	NA	1	NA	5	0
MMP24	0	0	2	5	416.79	833.58	15	2	1	NA	1	NA	7	0
MMP28	0	0	4	13	472.23	944.46	15	2	1	NA	1	NA	17	0
MMRN1	0	0	12	5	1214.73	2429.46	15	2	1	NA	1	NA	17	0
MMRN2	0	0	1	6	1003.86	2007.72	15	2	1	NA	1	NA	7	0
MMS19	0	0	7	14	981.75	1963.5	15	2	1	NA	1	NA	21	0
MN1	0	0	10	10	1143.45	2286.9	15	2	1	NA	1	NA	20	0
MNR2	0	0	2	1	150.15	300.3	15	2	1	NA	1	NA	3	0
MNS1	0	0	3	3	451.44	902.88	15	2	1	NA	1	NA	6	0
MNT	0	0	2	6	527.67	1055.34	15	2	1	NA	1	NA	8	0
MOB3A	0	0	1	1	214.83	429.66	15	2	1	NA	1	NA	2	0
MOB3C	0	0	0	3	215.82	431.64	15	2	1	NA	1	NA	3	0
MOB4	0	0	0	2	203.94	407.88	15	2	1	NA	1	NA	2	0
MOCS3	0	0	3	7	465.3	930.6	15	2	1	NA	1	NA	10	0
MOGAT1	0	0	0	7	331.65	663.3	15	2	1	NA	1	NA	7	0
MORC2	0	0	1	10	1024.32	2048.64	15	2	1	NA	1	NA	11	0
MORN3	0	0	3	3	236.61	473.22	15	2	1	NA	1	NA	6	0
MORN4	0	0	0	6	123.42	246.84	15	2	1	NA	1	NA	6	0
MORN5	0	0	0	2	159.06	318.12	15	2	1	NA	1	NA	2	0
MPDZ	0	0	8	4	2158.86	4317.72	15	2	1	NA	1	NA	12	0
MPHOSPH10	0	0	4	4	634.92	1269.84	15	2	1	NA	1	NA	8	0
MPHOSPH9	0	0	11	8	1154.34	2308.68	15	2	1	NA	1	NA	19	0
MPI	0	0	4	17	414.48	828.96	15	2	1	NA	1	NA	21	0
MPL	0	0	4	10	516.12	1032.24	15	2	1	NA	1	NA	14	0
MPND	0	0	1	1	86.46	172.92	15	2	1	NA	1	NA	2	0
MPP1	0	0	2	8	459.03	918.06	15	2	1	NA	1	NA	10	0
MPP3	0	0	1	1	581.13	1162.26	15	2	1	NA	1	NA	2	0
MPP4	0	0	4	2	611.82	1223.64	15	2	1	NA	1	NA	6	0
MPPED2	0	0	0	3	292.05	584.1	15	2	1	NA	1	NA	3	0
MPRIP	0	0	17	28	2416.59	4833.18	15	2	1	NA	1	NA	45	0
MPZL3	0	0	1	3	229.68	459.36	15	2	1	NA	1	NA	4	0
MRAS	0	0	1	1	206.91	413.82	15	2	1	NA	1	NA	2	0
MRC2	0	0	5	29	1414.05	2828.1	15	2	1	NA	1	NA	34	0
MREG	0	0	1	2	204.6	409.2	15	2	1	NA	1	NA	3	0
MRGPRH	0	0	0	5	313.83	627.66	15	2	1	NA	1	NA	5	0
MRM2	0	0	5	1	250.47	500.94	15	2	1	NA	1	NA	6	0
MRM3	0	0	8	8	398.97	797.94	15	2	1	NA	1	NA	16	0
MRNIP	0	0	3	7	339.57	679.14	15	2	1	NA	1	NA	10	0
MRPL1	0	0	6	5	287.1	574.2	15	2	1	NA	1	NA	11	0
MRPL10	0	0	7	5	247.17	494.34	15	2	1	NA	1	NA	12	0
MRPL17	0	0	0	3	115.5	231	15	2	1	NA	1	NA	3	0
MRPL22	0	0	1	1	209.88	419.76	15	2	1	NA	1	NA	2	0
MRPL27	0	0	1	3	138.6	277.2	15	2	1	NA	1	NA	4	0
MRPL34	0	0	3	1	105.93	211.86	15	2	1	NA	1	NA	4	0
MRPL35	0	0	1	2	177.21	354.42	15	2	1	NA	1	NA	3	0
MRPL37	0	0	4	8	364.98	729.96	15	2	1	NA	1	NA	12	0
MRPL38	0	0	2	4	341.22	682.44	15	2	1	NA	1	NA	6	0
MRPL40	0	0	3	3	201.96	403.92	15	2	1	NA	1	NA	6	0
MRPL41	0	0	1	2	134.64	269.28	15	2	1	NA	1	NA	3	0
MRPL44	0	0	3	7	296.34	592.68	15	2	1	NA	1	NA	10	0
MRPL46	0	0	4	5	262.35	524.7	15	2	1	NA	1	NA	9	0
MRPL47	0	0	4	1	247.5	495	15	2	1	NA	1	NA	5	0
MRPL58	0	0	5	3	197.01	394.02	15	2	1	NA	1	NA	8	0
MRPP3	0	0	8	9	582.12	1164.24	15	2	1	NA	1	NA	17	0
MRPS11	0	0	0	2	179.19	358.38	15	2	1	NA	1	NA	2	0
MRPS14	0	0	2	1	127.71	255.42	15	2	1	NA	1	NA	3	0
MRPS15	0	0	4	1	216.81	433.62	15	2	1	NA	1	NA	5	0
MRPS17	0	0	0	2	136.62	273.24	15	2	1	NA	1	NA	2	0
MRPS2	0	0	0	2	129.36	258.72	15	2	1	NA	1	NA	2	0
MRPS22	0	0	5	3	306.57	613.14	15	2	1	NA	1	NA	8	0
MRPS23	0	0	1	6	188.1	376.2	15	2	1	NA	1	NA	7	0
MRPS30	0	0	5	0	409.53	819.06	15	2	1	NA	1	NA	5	0
MRPS36	0	0	2	1	233.31	466.62	15	2	1	NA	1	NA	3	0
MRPS7	0	0	2	1	231.66	463.32	15	2	1	NA	1	NA	3	0
MRTO4	0	0	1	2	236.61	473.22	15	2	1	NA	1	NA	3	0
MRVLDC3	0	0	1	2	259.38	518.76	15	2	1	NA	1	NA	3	0
MSANTD1	0	0	0	2	274.56	549.12	15	2	1	NA	1	NA	2	0
MSANTD2	0	0	1	3	526.35	1052.7	15	2	1	NA	1	NA	4	0
MSH3	0	0	3	3	889.35	1778.7	15	2	1	NA	1	NA	6	0
MSH4	0	0	1	4	830.94	1661.88	15	2	1	NA	1	NA	5	0
MSI2	0	0	2	1	137.94	275.88	15	2	1	NA	1	NA	3	0
MSL2	0	0	1	4	541.53	1083.06	15	2	1	NA	1	NA	5	0
MSLN	0	0	7	2	865.26	1730.52	15	2	1	NA	1	NA	9	0
MSLNL	0	0	19	13	879.12	1758.24	15	2	1	NA	1	NA	32	0
MSMO1	0	0	0	3	294.03	588.06	15	2	1	NA	1	NA	3	0
MST1	0	0	13	17	558.69	1117.38	15	2	1	NA	1	NA	30	0
MSTO1	0	0	1	1	476.19	952.38	15	2	1	NA	1	NA	2	0
MSX2	0	0	0	2	257.4	514.8	15	2	1	NA	1	NA	2	0
MTA1	0	0	0	5	682.77	1365.54	15	2	1	NA	1	NA	5	0
MTCH1	0	0	0	3	320.1	640.2	15	2	1	NA	1	NA	3	0
MTCH2	0	0	1	5	286.77	573.54	15	2	1	NA	1	NA	6	0
MTERF4	0	0	7	2	248.49	496.98	15	2	1	NA	1	NA	9	0
MTF1	0	0	1	3	720.72	1441.44	15	2	1	NA	1	NA	4	0
MTF2	0	0	3	0	600.6	1201.2	15	2	1	NA	1	NA	3	0
MTFMT	0	0	3	4	375.21	750.42	15	2	1	NA	1	NA	7	0
MTG1	0	0	2	0	300.63	601.26	15	2	1	NA	1	NA	2	0
MTG2	0	0	2	5	725.67	1451.34	15	2	1	NA	1	NA	7	0
MTHFD1	0	0	1	1	926.64	1853.28	15	2	1	NA	1	NA	2	0
MTHFD2	0	0	0	2	331.98	663.96	15	2	1	NA	1	NA	2	0
MTHFD2L	0	0	1	3	297.33	594.66	15	2	1	NA	1	NA	4	0
MTHFR	0	0	1	5	645.48	1290.96	15	2	1	NA	1	NA	6	0
MTM1	0	0	2	4	597.96	1195.92	15	2	1	NA	1	NA	6	0
MTMR1	0	0	4	1	619.08	1238.16	15	2	1	NA	1	NA	5	0
MTMR10	0	0	3	5	763.62	1527.24	15	2	1	NA	1	NA	8	0
MTMR11	0	0	8	19	578.16	1156.32	15	2	1	NA	1	NA	27	0
MTMR12	0	0	4	4	669.24	1338.48	15	2	1	NA	1	NA	8	0
MTMR14	0	0	1	12	577.83	1155.66	15	2	1	NA	1	NA	13	0
MTMR3	0	0	4	15	1195.92	2391.84	15	2	1	NA	1	NA	19	0
MTMR4	0	0	4	3	1146.42	2292.84	15	2	1	NA	1	NA	7	0
MTMR7	0	0	2	3	605.88	1211.76	15	2	1	NA	1	NA	5	0
MTMR8	0	0	5	11	621.39	1242.78	15	2	1	NA	1	NA	16	0
MTMR9LP	0	0	6	5	549.45	1098.9	15	2	1	NA	1	NA	11	0
MTNR1A	0	0	3	1	350.46	700.92	15	2	1	NA	1	NA	4	0
MTOR	0	0	0	18	1391.94	2783.88	15	2	1	NA	1	NA	18	0
MTTP	0	0	1	1	885.06	1770.12	15	2	1	NA	1	NA	2	0
MTUS1	0	0	6	2	908.82	1817.64	15	2	1	NA	1	NA	8	0
MTX2	0	0	1	1	275.22	550.44	15	2	1	NA	1	NA	2	0
MTX3	0	0	1	6	303.93	607.86	15	2	1	NA	1	NA	7	0
MUC13	0	0	3	1	344.52	689.04	15	2	1	NA	1	NA	4	0
MUC2	0	0	8	5	2437.38	4874.76	15	2	1	NA	1	NA	13	0
MUC4	0	0	63	55	1874.4	3748.8	15	2	1	NA	1	NA	118	0
MUC4L	0	0	13	18	440.55	881.1	15	2	1	NA	1	NA	31	0
MUC6	0	0	0	9	1284.03	2568.06	15	2	1	NA	1	NA	9	0
MUL1	0	0	4	2	347.49	694.98	15	2	1	NA	1	NA	6	0
MUL1L	0	0	3	10	307.56	615.12	15	2	1	NA	1	NA	13	0
MUM1	0	0	4	3	926.64	1853.28	15	2	1	NA	1	NA	7	0
MUSK	0	0	6	11	911.79	1823.58	15	2	1	NA	1	NA	17	0
MUSTN1	0	0	2	2	364.98	729.96	15	2	1	NA	1	NA	4	0
MUTYH	0	0	13	18	483.78	967.56	15	2	1	NA	1	NA	31	0
MVD	0	0	6	9	377.85	755.7	15	2	1	NA	1	NA	15	0
MVK	0	0	6	11	394.02	788.04	15	2	1	NA	1	NA	17	0
MVP	0	0	1	6	840.84	1681.68	15	2	1	NA	1	NA	7	0
MXD1	0	0	0	3	158.4	316.8	15	2	1	NA	1	NA	3	0
MXD3	0	0	11	12	639.87	1279.74	15	2	1	NA	1	NA	23	0
MXRA7	0	0	1	7	233.97	467.94	15	2	1	NA	1	NA	8	0
MXRA8	0	0	0	8	433.62	867.24	15	2	1	NA	1	NA	8	0
MYBBP1A	0	0	10	21	1272.48	2544.96	15	2	1	NA	1	NA	31	0
MYBL2	0	0	1	13	680.13	1360.26	15	2	1	NA	1	NA	14	0
MYBPC3	0	0	5	3	1259.28	2518.56	15	2	1	NA	1	NA	8	0
MYBPH	0	0	6	10	506.88	1013.76	15	2	1	NA	1	NA	16	0
MYCBPAP	0	0	26	21	1509.09	3018.18	15	2	1	NA	1	NA	47	0
MYCL	0	0	0	3	351.45	702.9	15	2	1	NA	1	NA	3	0
MYDGF	0	0	1	1	167.31	334.62	15	2	1	NA	1	NA	2	0
MYH10	0	0	3	13	1978.02	3956.04	15	2	1	NA	1	NA	16	0
MYH13	0	0	8	10	1932.48	3864.96	15	2	1	NA	1	NA	18	0
MYH1E	0	0	3	10	603.9	1207.8	15	2	1	NA	1	NA	13	0
MYL2	0	0	0	6	164.34	328.68	15	2	1	NA	1	NA	6	0
MYL4	0	0	2	5	255.42	510.84	15	2	1	NA	1	NA	7	0
MYLK	0	0	1	5	1885.95	3771.9	15	2	1	NA	1	NA	6	0
MYLK3	0	0	3	5	863.28	1726.56	15	2	1	NA	1	NA	8	0
MYLKSML	0	0	1	1	390.06	780.12	15	2	1	NA	1	NA	2	0
MYNN	0	0	2	3	609.84	1219.68	15	2	1	NA	1	NA	5	0
MYO10L	0	0	7	6	2002.77	4005.54	15	2	1	NA	1	NA	13	0
MYO15A	0	0	64	78	3328.71	6657.42	15	2	1	NA	1	NA	142	0
MYO15L	0	0	10	14	1638.45	3276.9	15	2	1	NA	1	NA	24	0
MYO18A	0	0	11	42	2030.16	4060.32	15	2	1	NA	1	NA	53	0
MYO18B	0	0	49	58	2880.24	5760.48	15	2	1	NA	1	NA	107	0
MYO19	0	0	10	7	958.32	1916.64	15	2	1	NA	1	NA	17	0
MYO1B	0	0	3	9	1232.88	2465.76	15	2	1	NA	1	NA	12	0
MYO1E	0	0	3	10	1105.83	2211.66	15	2	1	NA	1	NA	13	0
MYO1H	0	0	2	15	1011.78	2023.56	15	2	1	NA	1	NA	17	0
MYO3AL	0	0	10	9	1107.48	2214.96	15	2	1	NA	1	NA	19	0
MYO3B	0	0	6	2	1255.98	2511.96	15	2	1	NA	1	NA	8	0
MYO5A	0	0	6	17	1820.61	3641.22	15	2	1	NA	1	NA	23	0
MYO5B	0	0	38	44	1698.18	3396.36	15	2	1	NA	1	NA	82	0
MYO5C	0	0	5	10	1690.92	3381.84	15	2	1	NA	1	NA	15	0
MYO7B	0	0	8	9	2028.18	4056.36	15	2	1	NA	1	NA	17	0
MYO9B	0	0	7	21	2192.85	4385.7	15	2	1	NA	1	NA	28	0
MYOC	0	0	10	12	319.44	638.88	15	2	1	NA	1	NA	22	0
MYOCD	0	0	1	1	932.58	1865.16	15	2	1	NA	1	NA	2	0
MYOD1	0	0	1	3	294.03	588.06	15	2	1	NA	1	NA	4	0
MYOF	0	0	7	4	2005.74	4011.48	15	2	1	NA	1	NA	11	0
MYOG	0	0	2	6	225.72	451.44	15	2	1	NA	1	NA	8	0
MYOM3	0	0	4	2	1300.53	2601.06	15	2	1	NA	1	NA	6	0
MYOT	0	0	2	3	510.84	1021.68	15	2	1	NA	1	NA	5	0
MYOZ1	0	0	0	3	292.05	584.1	15	2	1	NA	1	NA	3	0
MYOZ2	0	0	1	1	219.78	439.56	15	2	1	NA	1	NA	2	0
MYOZ3	0	0	2	3	242.55	485.1	15	2	1	NA	1	NA	5	0
MYPN	0	0	9	11	1329.57	2659.14	15	2	1	NA	1	NA	20	0
MYSM1	0	0	5	2	824.67	1649.34	15	2	1	NA	1	NA	7	0
MYT1	0	0	5	17	1158.3	2316.6	15	2	1	NA	1	NA	22	0
MZB1	0	0	5	11	213.84	427.68	15	2	1	NA	1	NA	16	0
N4BP1	0	0	4	6	920.7	1841.4	15	2	1	NA	1	NA	10	0
N4BP2	0	0	16	7	1757.25	3514.5	15	2	1	NA	1	NA	23	0
N4BP3	0	0	6	7	407.88	815.76	15	2	1	NA	1	NA	13	0
NAA25	0	0	2	10	963.27	1926.54	15	2	1	NA	1	NA	12	0
NAAA	0	0	3	0	347.49	694.98	15	2	1	NA	1	NA	3	0
NAALADL2	0	0	8	5	773.19	1546.38	15	2	1	NA	1	NA	13	0
NAB1	0	0	1	5	495	990	15	2	1	NA	1	NA	6	0
NABP1	0	0	2	10	207.9	415.8	15	2	1	NA	1	NA	12	0
NACC2	0	0	0	6	532.95	1065.9	15	2	1	NA	1	NA	6	0
NADK2	0	0	0	2	411.84	823.68	15	2	1	NA	1	NA	2	0
NADSYN1	0	0	5	4	701.91	1403.82	15	2	1	NA	1	NA	9	0
NAE1	0	0	4	2	1155.33	2310.66	15	2	1	NA	1	NA	6	0
NAGLU	0	0	9	18	584.76	1169.52	15	2	1	NA	1	NA	27	0
NAGPA	0	0	16	16	904.2	1808.4	15	2	1	NA	1	NA	32	0
NANOS1	0	0	0	8	250.47	500.94	15	2	1	NA	1	NA	8	0
NANS	0	0	4	4	313.5	627	15	2	1	NA	1	NA	8	0
NARF	0	0	1	3	455.4	910.8	15	2	1	NA	1	NA	4	0
NARFL	0	0	5	6	472.23	944.46	15	2	1	NA	1	NA	11	0
NARS	0	0	0	5	541.86	1083.72	15	2	1	NA	1	NA	5	0
NASP	0	0	2	3	713.79	1427.58	15	2	1	NA	1	NA	5	0
NAT	0	0	2	0	293.04	586.08	15	2	1	NA	1	NA	2	0
NAT10	0	0	7	1	1003.86	2007.72	15	2	1	NA	1	NA	8	0
NAT8L	0	0	0	2	230.01	460.02	15	2	1	NA	1	NA	2	0
NAT9	0	0	3	5	202.29	404.58	15	2	1	NA	1	NA	8	0
NATD1	0	0	0	2	106.59	213.18	15	2	1	NA	1	NA	2	0
NAV1	0	0	10	38	1823.58	3647.16	15	2	1	NA	1	NA	48	0
NAV2	0	0	4	4	2339.37	4678.74	15	2	1	NA	1	NA	8	0
NBEAL1	0	0	7	2	2713.92	5427.84	15	2	1	NA	1	NA	9	0
NBL1	0	0	1	3	177.21	354.42	15	2	1	NA	1	NA	4	0
NBR1	0	0	3	5	985.05	1970.1	15	2	1	NA	1	NA	8	0
NCAM1	0	0	4	8	1113.75	2227.5	15	2	1	NA	1	NA	12	0
NCAN	0	0	35	29	1265.88	2531.76	15	2	1	NA	1	NA	64	0
NCAPD3	0	0	9	17	1452.33	2904.66	15	2	1	NA	1	NA	26	0
NCAPG	0	0	3	1	1029.6	2059.2	15	2	1	NA	1	NA	4	0
NCAPH	0	0	2	2	706.2	1412.4	15	2	1	NA	1	NA	4	0
NCBP3	0	0	1	4	576.84	1153.68	15	2	1	NA	1	NA	5	0
NCDN	0	0	8	6	712.8	1425.6	15	2	1	NA	1	NA	14	0
NCEH1	0	0	2	1	401.61	803.22	15	2	1	NA	1	NA	3	0
NCF1	0	0	1	4	386.1	772.2	15	2	1	NA	1	NA	5	0
NCF2	0	0	3	3	512.82	1025.64	15	2	1	NA	1	NA	6	0
NCKAP1	0	0	0	2	1130.25	2260.5	15	2	1	NA	1	NA	2	0
NCKAP1L	0	0	6	12	848.1	1696.2	15	2	1	NA	1	NA	18	0
NCKIPSD	0	0	5	12	752.4	1504.8	15	2	1	NA	1	NA	17	0
NCL	0	0	4	10	671.55	1343.1	15	2	1	NA	1	NA	14	0
NCLN	0	0	0	2	574.2	1148.4	15	2	1	NA	1	NA	2	0
NCOA3	0	0	4	4	1388.97	2777.94	15	2	1	NA	1	NA	8	0
NCOA4	0	0	2	3	554.4	1108.8	15	2	1	NA	1	NA	5	0
NCOA5	0	0	4	1	706.86	1413.72	15	2	1	NA	1	NA	5	0
NCOA6	0	0	5	5	2030.49	4060.98	15	2	1	NA	1	NA	10	0
NCOR1	0	0	3	12	2511.3	5022.6	15	2	1	NA	1	NA	15	0
NCOR2	0	0	15	24	2404.38	4808.76	15	2	1	NA	1	NA	39	0
NCS1	0	0	0	2	189.09	378.18	15	2	1	NA	1	NA	2	0
NCSTN	0	0	4	5	712.8	1425.6	15	2	1	NA	1	NA	9	0
NDC1	0	0	4	7	668.25	1336.5	15	2	1	NA	1	NA	11	0
NDE1	0	0	2	1	339.57	679.14	15	2	1	NA	1	NA	3	0
NDFIP1	0	0	0	2	220.44	440.88	15	2	1	NA	1	NA	2	0
NDNF	0	0	2	1	563.31	1126.62	15	2	1	NA	1	NA	3	0
NDST1	0	0	4	15	869.22	1738.44	15	2	1	NA	1	NA	19	0
NDST2	0	0	0	8	871.2	1742.4	15	2	1	NA	1	NA	8	0
NDST4	0	0	3	7	865.26	1730.52	15	2	1	NA	1	NA	10	0
NDUFA1	0	0	1	1	69.63	139.26	15	2	1	NA	1	NA	2	0
NDUFA10	0	0	2	2	354.42	708.84	15	2	1	NA	1	NA	4	0
NDUFA2	0	0	1	2	99.99	199.98	15	2	1	NA	1	NA	3	0
NDUFA7	0	0	2	2	114.84	229.68	15	2	1	NA	1	NA	4	0
NDUFA8	0	0	1	4	171.27	342.54	15	2	1	NA	1	NA	5	0
NDUFAB1	0	0	2	8	391.71	783.42	15	2	1	NA	1	NA	10	0
NDUFAF1	0	0	4	0	276.21	552.42	15	2	1	NA	1	NA	4	0
NDUFAF3	0	0	0	3	166.32	332.64	15	2	1	NA	1	NA	3	0
NDUFB10	0	0	2	5	173.25	346.5	15	2	1	NA	1	NA	7	0
NDUFB3	0	0	2	1	119.79	239.58	15	2	1	NA	1	NA	3	0
NDUFB6	0	0	0	2	127.71	255.42	15	2	1	NA	1	NA	2	0
NDUFB8	0	0	3	2	184.8	369.6	15	2	1	NA	1	NA	5	0
NDUFS1	0	0	2	1	721.71	1443.42	15	2	1	NA	1	NA	3	0
NDUFS8	0	0	0	7	172.92	345.84	15	2	1	NA	1	NA	7	0
NEBL1	0	0	19	51	5611.98	11223.96	15	2	1	NA	1	NA	70	0
NECAB2	0	0	1	2	298.65	597.3	15	2	1	NA	1	NA	3	0
NECAB3	0	0	4	6	346.17	692.34	15	2	1	NA	1	NA	10	0
NECAP2	0	0	2	10	266.31	532.62	15	2	1	NA	1	NA	12	0
NECTIN1	0	0	0	8	495	990	15	2	1	NA	1	NA	8	0
NEDD4	0	0	7	8	1300.86	2601.72	15	2	1	NA	1	NA	15	0
NEFH	0	0	8	12	551.76	1103.52	15	2	1	NA	1	NA	20	0
NEFL	0	0	1	5	552.42	1104.84	15	2	1	NA	1	NA	6	0
NEFM	0	0	2	9	840.51	1681.02	15	2	1	NA	1	NA	11	0
NEGR1	0	0	0	3	231.66	463.32	15	2	1	NA	1	NA	3	0
NEIL1	0	0	16	6	385.11	770.22	15	2	1	NA	1	NA	22	0
NEIL3	0	0	6	0	600.93	1201.86	15	2	1	NA	1	NA	6	0
NEK1	0	0	2	3	1286.01	2572.02	15	2	1	NA	1	NA	5	0
NEK4	0	0	10	5	799.92	1599.84	15	2	1	NA	1	NA	15	0
NEK6	0	0	0	2	311.85	623.7	15	2	1	NA	1	NA	2	0
NEK8	0	0	2	13	755.37	1510.74	15	2	1	NA	1	NA	15	0
NEK9	0	0	3	11	955.35	1910.7	15	2	1	NA	1	NA	14	0
NELFB	0	0	0	2	572.22	1144.44	15	2	1	NA	1	NA	2	0
NELFCD	0	0	2	1	578.16	1156.32	15	2	1	NA	1	NA	3	0
NEMF	0	0	8	16	1061.28	2122.56	15	2	1	NA	1	NA	24	0
NEMP2	0	0	1	4	433.62	867.24	15	2	1	NA	1	NA	5	0
NEO1	0	0	7	11	1404.81	2809.62	15	2	1	NA	1	NA	18	0
NETO2	0	0	2	0	516.12	1032.24	15	2	1	NA	1	NA	2	0
NEU2	0	0	2	2	376.2	752.4	15	2	1	NA	1	NA	4	0
NEU4	0	0	1	4	450.45	900.9	15	2	1	NA	1	NA	5	0
NEURL1B	0	0	3	6	542.19	1084.38	15	2	1	NA	1	NA	9	0
NEURL2	0	0	3	1	227.04	454.08	15	2	1	NA	1	NA	4	0
NEUROD1	0	0	1	2	334.29	668.58	15	2	1	NA	1	NA	3	0
NEUROD4	0	0	2	5	328.68	657.36	15	2	1	NA	1	NA	7	0
NF1	0	0	0	3	1581.03	3162.06	15	2	1	NA	1	NA	3	0
NF2	0	0	0	10	552.42	1104.84	15	2	1	NA	1	NA	10	0
NF2L	0	0	1	1	634.26	1268.52	15	2	1	NA	1	NA	2	0
NFASC	0	0	6	31	1327.92	2655.84	15	2	1	NA	1	NA	37	0
NFAT5	0	0	3	9	1474.11	2948.22	15	2	1	NA	1	NA	12	0
NFATC2	0	0	1	2	957.99	1915.98	15	2	1	NA	1	NA	3	0
NFATC3	0	0	0	3	1112.76	2225.52	15	2	1	NA	1	NA	3	0
NFE2L2	0	0	4	2	578.16	1156.32	15	2	1	NA	1	NA	6	0
NFIC	0	0	1	4	476.52	953.04	15	2	1	NA	1	NA	5	0
NFIL3	0	0	2	3	454.41	908.82	15	2	1	NA	1	NA	5	0
NFKB1	0	0	6	5	1010.79	2021.58	15	2	1	NA	1	NA	11	0
NFKB2	0	0	10	15	913.77	1827.54	15	2	1	NA	1	NA	25	0
NFKBIA	0	0	0	4	300.96	601.92	15	2	1	NA	1	NA	4	0
NFRKB	0	0	5	18	1294.92	2589.84	15	2	1	NA	1	NA	23	0
NFS1	0	0	0	3	384.45	768.9	15	2	1	NA	1	NA	3	0
NFU1	0	0	4	2	250.47	500.94	15	2	1	NA	1	NA	6	0
NFXL1	0	0	4	6	827.64	1655.28	15	2	1	NA	1	NA	10	0
NFYC	0	0	0	6	332.64	665.28	15	2	1	NA	1	NA	6	0
NGEF	0	0	0	3	571.23	1142.46	15	2	1	NA	1	NA	3	0
NGFR	0	0	4	12	412.83	825.66	15	2	1	NA	1	NA	16	0
NHEJ1	0	0	4	5	237.6	475.2	15	2	1	NA	1	NA	9	0
NHLH1	0	0	1	2	131.67	263.34	15	2	1	NA	1	NA	3	0
NHLRC2	0	0	6	5	719.73	1439.46	15	2	1	NA	1	NA	11	0
NHLRC4	0	0	6	7	348.48	696.96	15	2	1	NA	1	NA	13	0
NID2	0	0	28	36	1286.67	2573.34	15	2	1	NA	1	NA	64	0
NIF3L1	0	0	3	3	371.25	742.5	15	2	1	NA	1	NA	6	0
NIFK	0	0	2	7	259.38	518.76	15	2	1	NA	1	NA	9	0
NIN	0	0	23	31	2087.91	4175.82	15	2	1	NA	1	NA	54	0
NIP7	0	0	3	9	169.29	338.58	15	2	1	NA	1	NA	12	0
NIPAL1	0	0	3	0	376.2	752.4	15	2	1	NA	1	NA	3	0
NIPAL4	0	0	2	4	396	792	15	2	1	NA	1	NA	6	0
NIPSNAP1	0	0	2	4	262.35	524.7	15	2	1	NA	1	NA	6	0
NIPSNAP3L	0	0	2	1	225.06	450.12	15	2	1	NA	1	NA	3	0
NISCH	0	0	8	8	1378.74	2757.48	15	2	1	NA	1	NA	16	0
NKAIN1	0	0	2	4	163.35	326.7	15	2	1	NA	1	NA	6	0
NKAIN4	0	0	0	5	216.81	433.62	15	2	1	NA	1	NA	5	0
NKAP	0	0	3	1	368.94	737.88	15	2	1	NA	1	NA	4	0
NKD1	0	0	3	1	418.77	837.54	15	2	1	NA	1	NA	4	0
NKIRAS2	0	0	1	1	190.08	380.16	15	2	1	NA	1	NA	2	0
NKRF	0	0	2	10	714.12	1428.24	15	2	1	NA	1	NA	12	0
NKX1-1	0	0	2	3	422.73	845.46	15	2	1	NA	1	NA	5	0
NKX1-2	0	0	2	3	250.8	501.6	15	2	1	NA	1	NA	5	0
NKX2-5	0	0	0	2	270.93	541.86	15	2	1	NA	1	NA	2	0
NKX2-8	0	0	1	1	234.3	468.6	15	2	1	NA	1	NA	2	0
NKX3-1	0	0	5	5	221.76	443.52	15	2	1	NA	1	NA	10	0
NKX3-2	0	0	1	1	161.7	323.4	15	2	1	NA	1	NA	2	0
NKX6-3	0	0	0	3	258.39	516.78	15	2	1	NA	1	NA	3	0
NLK	0	0	1	2	522.72	1045.44	15	2	1	NA	1	NA	3	0
NLN	0	0	4	0	667.26	1334.52	15	2	1	NA	1	NA	4	0
NLRC5	0	0	19	21	2289.87	4579.74	15	2	1	NA	1	NA	40	0
NLRP1L	0	0	3	6	497.31	994.62	15	2	1	NA	1	NA	9	0
NLRPL	0	0	14	10	900.24	1800.48	15	2	1	NA	1	NA	24	0
NLRX1	0	0	18	14	964.26	1928.52	15	2	1	NA	1	NA	32	0
NMB	0	0	2	1	127.71	255.42	15	2	1	NA	1	NA	3	0
NMD3	0	0	2	3	499.95	999.9	15	2	1	NA	1	NA	5	0
NME1	0	0	2	4	152.46	304.92	15	2	1	NA	1	NA	6	0
NME5	0	0	1	3	211.86	423.72	15	2	1	NA	1	NA	4	0
NMI	0	0	3	2	352.44	704.88	15	2	1	NA	1	NA	5	0
NMNAT2	0	0	0	3	304.92	609.84	15	2	1	NA	1	NA	3	0
NMNAT3	0	0	3	1	272.25	544.5	15	2	1	NA	1	NA	4	0
NMT1	0	0	1	3	484.77	969.54	15	2	1	NA	1	NA	4	0
NMUR1	0	0	1	12	428.67	857.34	15	2	1	NA	1	NA	13	0
NMUR2	0	0	2	5	393.03	786.06	15	2	1	NA	1	NA	7	0
NOA1	0	0	5	4	618.75	1237.5	15	2	1	NA	1	NA	9	0
NOB1	0	0	3	7	300.63	601.26	15	2	1	NA	1	NA	10	0
NOC2L	0	0	10	13	757.02	1514.04	15	2	1	NA	1	NA	23	0
NOC3L	0	0	9	8	1389.96	2779.92	15	2	1	NA	1	NA	17	0
NOC4L	0	0	7	7	509.85	1019.7	15	2	1	NA	1	NA	14	0
NOCT	0	0	2	7	365.31	730.62	15	2	1	NA	1	NA	9	0
NODAL	0	0	8	7	312.51	625.02	15	2	1	NA	1	NA	15	0
NOG	0	0	0	2	221.76	443.52	15	2	1	NA	1	NA	2	0
NOL11	0	0	3	5	685.08	1370.16	15	2	1	NA	1	NA	8	0
NOL8	0	0	12	11	1157.31	2314.62	15	2	1	NA	1	NA	23	0
NOL9	0	0	0	2	483.78	967.56	15	2	1	NA	1	NA	2	0
NOLC1	0	0	7	4	701.91	1403.82	15	2	1	NA	1	NA	11	0
NOMO3	0	0	6	5	1196.91	2393.82	15	2	1	NA	1	NA	11	0
NOP14	0	0	2	3	965.91	1931.82	15	2	1	NA	1	NA	5	0
NOP16	0	0	1	3	137.94	275.88	15	2	1	NA	1	NA	4	0
NOP56	0	0	5	8	505.56	1011.12	15	2	1	NA	1	NA	13	0
NOP58	0	0	2	2	522.72	1045.44	15	2	1	NA	1	NA	4	0
NOS1	0	0	10	32	1425.6	2851.2	15	2	1	NA	1	NA	42	0
NOS2	0	0	2	10	1138.5	2277	15	2	1	NA	1	NA	12	0
NOTCH1	0	0	25	62	2512.62	5025.24	15	2	1	NA	1	NA	87	0
NOTCH2	0	0	6	36	2408.67	4817.34	15	2	1	NA	1	NA	42	0
NOX1	0	0	1	6	556.71	1113.42	15	2	1	NA	1	NA	7	0
NOX5	0	0	17	17	742.5	1485	15	2	1	NA	1	NA	34	0
NOXO1	0	0	2	6	472.23	944.46	15	2	1	NA	1	NA	8	0
NOXRED1-VIPAS39	0	0	9	7	868.23	1736.46	15	2	1	NA	1	NA	16	0
NPAS3	0	0	1	3	664.29	1328.58	15	2	1	NA	1	NA	4	0
NPBWR2	0	0	1	2	329.67	659.34	15	2	1	NA	1	NA	3	0
NPC2	0	0	1	1	121.44	242.88	15	2	1	NA	1	NA	2	0
NPEPL1	0	0	1	6	469.26	938.52	15	2	1	NA	1	NA	7	0
NPEPPS	0	0	1	5	835.56	1671.12	15	2	1	NA	1	NA	6	0
NPFFR2	0	0	3	4	418.77	837.54	15	2	1	NA	1	NA	7	0
NPHP4	0	0	11	9	1359.27	2718.54	15	2	1	NA	1	NA	20	0
NPHS2	0	0	0	6	377.52	755.04	15	2	1	NA	1	NA	6	0
NPLOC4	0	0	1	8	600.27	1200.54	15	2	1	NA	1	NA	9	0
NPM1	0	0	1	5	284.46	568.92	15	2	1	NA	1	NA	6	0
NPM3	0	0	1	6	144.54	289.08	15	2	1	NA	1	NA	7	0
NPNT	0	0	9	3	644.16	1288.32	15	2	1	NA	1	NA	12	0
NPPA	0	0	2	0	139.59	279.18	15	2	1	NA	1	NA	2	0
NPR1	0	0	5	4	840.84	1681.68	15	2	1	NA	1	NA	9	0
NPR2	0	0	6	28	831.27	1662.54	15	2	1	NA	1	NA	34	0
NPR3	0	0	0	2	520.74	1041.48	15	2	1	NA	1	NA	2	0
NPRL2	0	0	3	6	351.12	702.24	15	2	1	NA	1	NA	9	0
NPTX1	0	0	2	7	427.02	854.04	15	2	1	NA	1	NA	9	0
NPTX2	0	0	3	2	431.64	863.28	15	2	1	NA	1	NA	5	0
NPY1R	0	0	0	3	397.98	795.96	15	2	1	NA	1	NA	3	0
NPY2R	0	0	0	2	382.14	764.28	15	2	1	NA	1	NA	2	0
NPY4R	0	0	2	0	374.22	748.44	15	2	1	NA	1	NA	2	0
NPY5R	0	0	2	1	440.55	881.1	15	2	1	NA	1	NA	3	0
NPY7R	0	0	1	5	384.12	768.24	15	2	1	NA	1	NA	6	0
NQO1	0	0	6	6	269.94	539.88	15	2	1	NA	1	NA	12	0
NR0B2	0	0	0	6	272.25	544.5	15	2	1	NA	1	NA	6	0
NR1D1	0	0	2	5	461.34	922.68	15	2	1	NA	1	NA	7	0
NR1H3	0	0	0	2	416.79	833.58	15	2	1	NA	1	NA	2	0
NR2C2	0	0	2	3	623.7	1247.4	15	2	1	NA	1	NA	5	0
NR2C2AP	0	0	2	5	134.64	269.28	15	2	1	NA	1	NA	7	0
NR2E3	0	0	0	6	383.46	766.92	15	2	1	NA	1	NA	6	0
NR2F6	0	0	1	9	308.22	616.44	15	2	1	NA	1	NA	10	0
NR3C1	0	0	0	9	384.45	768.9	15	2	1	NA	1	NA	9	0
NR4A2	0	0	1	4	566.28	1132.56	15	2	1	NA	1	NA	5	0
NR5A1	0	0	1	6	461.34	922.68	15	2	1	NA	1	NA	7	0
NR5A2	0	0	0	2	496.98	993.96	15	2	1	NA	1	NA	2	0
NR6A1	0	0	1	3	433.62	867.24	15	2	1	NA	1	NA	4	0
NRAP	0	0	10	1	1721.61	3443.22	15	2	1	NA	1	NA	11	0
NRBF2	0	0	2	3	278.19	556.38	15	2	1	NA	1	NA	5	0
NRDC	0	0	4	18	1068.21	2136.42	15	2	1	NA	1	NA	22	0
NRDE2	0	0	11	7	1159.29	2318.58	15	2	1	NA	1	NA	18	0
NRG1	0	0	1	4	613.14	1226.28	15	2	1	NA	1	NA	5	0
NRG2	0	0	1	4	483.12	966.24	15	2	1	NA	1	NA	5	0
NRG3	0	0	1	2	361.35	722.7	15	2	1	NA	1	NA	3	0
NRIP3	0	0	2	5	216.81	433.62	15	2	1	NA	1	NA	7	0
NRK	0	0	4	8	1222.65	2445.3	15	2	1	NA	1	NA	12	0
NRN1L	0	0	2	2	143.22	286.44	15	2	1	NA	1	NA	4	0
NRP2	0	0	5	7	900.24	1800.48	15	2	1	NA	1	NA	12	0
NRROS	0	0	6	8	697.95	1395.9	15	2	1	NA	1	NA	14	0
NRSN2	0	0	7	2	119.79	239.58	15	2	1	NA	1	NA	9	0
NRXN3	0	0	7	12	1105.5	2211	15	2	1	NA	1	NA	19	0
NSD1	0	0	7	22	2585.88	5171.76	15	2	1	NA	1	NA	29	0
NSDHL	0	0	3	2	343.53	687.06	15	2	1	NA	1	NA	5	0
NSF	0	0	2	3	812.13	1624.26	15	2	1	NA	1	NA	5	0
NSFL1C	0	0	0	6	366.3	732.6	15	2	1	NA	1	NA	6	0
NSMCE1	0	0	4	1	253.44	506.88	15	2	1	NA	1	NA	5	0
NSMCE4A	0	0	2	2	367.29	734.58	15	2	1	NA	1	NA	4	0
NSMF	0	0	1	3	522.39	1044.78	15	2	1	NA	1	NA	4	0
NSRP1	0	0	8	7	544.5	1089	15	2	1	NA	1	NA	15	0
NSUN4	0	0	7	16	402.93	805.86	15	2	1	NA	1	NA	23	0
NSUN5	0	0	1	1	386.76	773.52	15	2	1	NA	1	NA	2	0
NSUN7	0	0	7	2	717.75	1435.5	15	2	1	NA	1	NA	9	0
NT5C1A	0	0	1	2	355.41	710.82	15	2	1	NA	1	NA	3	0
NT5C2	0	0	1	3	561.33	1122.66	15	2	1	NA	1	NA	4	0
NT5C3B	0	0	1	7	287.1	574.2	15	2	1	NA	1	NA	8	0
NT5DC2	0	0	2	7	481.14	962.28	15	2	1	NA	1	NA	9	0
NT5M	0	0	2	2	230.01	460.02	15	2	1	NA	1	NA	4	0
NTHL1	0	0	0	2	253.11	506.22	15	2	1	NA	1	NA	2	0
NTL	0	0	3	5	814.77	1629.54	15	2	1	NA	1	NA	8	0
NTM	0	0	1	7	296.01	592.02	15	2	1	NA	1	NA	8	0
NTMT1	0	0	1	2	221.76	443.52	15	2	1	NA	1	NA	3	0
NTN3	0	0	2	13	582.12	1164.24	15	2	1	NA	1	NA	15	0
NTN4L	0	0	3	2	632.61	1265.22	15	2	1	NA	1	NA	5	0
NTNG2	0	0	3	10	645.15	1290.3	15	2	1	NA	1	NA	13	0
NTRK1	0	0	4	12	612.81	1225.62	15	2	1	NA	1	NA	16	0
NTSR1	0	0	1	7	397.98	795.96	15	2	1	NA	1	NA	8	0
NUAK2	0	0	15	17	629.64	1259.28	15	2	1	NA	1	NA	32	0
NUBP1	0	0	1	3	279.51	559.02	15	2	1	NA	1	NA	4	0
NUBPL	0	0	1	3	308.88	617.76	15	2	1	NA	1	NA	4	0
NUCB2	0	0	1	3	451.44	902.88	15	2	1	NA	1	NA	4	0
NUDC	0	0	1	7	338.58	677.16	15	2	1	NA	1	NA	8	0
NUDCD2	0	0	1	1	168.3	336.6	15	2	1	NA	1	NA	2	0
NUDCD3	0	0	8	8	362.67	725.34	15	2	1	NA	1	NA	16	0
NUDT12	0	0	4	3	479.16	958.32	15	2	1	NA	1	NA	7	0
NUDT13	0	0	2	4	339.57	679.14	15	2	1	NA	1	NA	6	0
NUDT14	0	0	0	3	267.3	534.6	15	2	1	NA	1	NA	3	0
NUDT19	0	0	3	3	371.25	742.5	15	2	1	NA	1	NA	6	0
NUDT3	0	0	1	1	135.63	271.26	15	2	1	NA	1	NA	2	0
NUDT6	0	0	1	2	189.09	378.18	15	2	1	NA	1	NA	3	0
NUF2	0	0	0	3	465.3	930.6	15	2	1	NA	1	NA	3	0
NUFIP2	0	0	0	2	645.48	1290.96	15	2	1	NA	1	NA	2	0
NUMB	0	0	2	5	632.61	1265.22	15	2	1	NA	1	NA	7	0
NUP155	0	0	6	2	1272.81	2545.62	15	2	1	NA	1	NA	8	0
NUP160	0	0	10	28	1372.8	2745.6	15	2	1	NA	1	NA	38	0
NUP188	0	0	9	17	1720.62	3441.24	15	2	1	NA	1	NA	26	0
NUP210	0	0	10	19	1869.45	3738.9	15	2	1	NA	1	NA	29	0
NUP210L	0	0	15	21	1992.21	3984.42	15	2	1	NA	1	NA	36	0
NUP214	0	0	13	22	2065.14	4130.28	15	2	1	NA	1	NA	35	0
NUP54	0	0	2	4	549.45	1098.9	15	2	1	NA	1	NA	6	0
NUP62	0	0	4	5	559.35	1118.7	15	2	1	NA	1	NA	9	0
NUP85	0	0	0	3	645.48	1290.96	15	2	1	NA	1	NA	3	0
NUP88	0	0	2	6	636.57	1273.14	15	2	1	NA	1	NA	8	0
NUP93	0	0	2	5	877.14	1754.28	15	2	1	NA	1	NA	7	0
NUR2L	0	0	3	10	737.88	1475.76	15	2	1	NA	1	NA	13	0
NUSAP1	0	0	4	3	460.35	920.7	15	2	1	NA	1	NA	7	0
NWD2	0	0	11	15	1726.56	3453.12	15	2	1	NA	1	NA	26	0
NXF1	0	0	1	6	540.21	1080.42	15	2	1	NA	1	NA	7	0
NXN	0	0	0	5	397.98	795.96	15	2	1	NA	1	NA	5	0
NXPH3	0	0	1	2	241.56	483.12	15	2	1	NA	1	NA	3	0
NXPH4	0	0	3	2	318.78	637.56	15	2	1	NA	1	NA	5	0
NYAP2	0	0	1	5	708.84	1417.68	15	2	1	NA	1	NA	6	0
OAF	0	0	0	5	271.26	542.52	15	2	1	NA	1	NA	5	0
OARD1	0	0	0	2	150.48	300.96	15	2	1	NA	1	NA	2	0
OAT	0	0	1	9	435.6	871.2	15	2	1	NA	1	NA	10	0
OAZ2	0	0	0	2	139.59	279.18	15	2	1	NA	1	NA	2	0
OBSL1	0	0	49	41	2321.22	4642.44	15	2	1	NA	1	NA	90	0
OCEL1	0	0	12	11	349.47	698.94	15	2	1	NA	1	NA	23	0
OCIAD1	0	0	2	3	289.74	579.48	15	2	1	NA	1	NA	5	0
OCLN	0	0	2	14	504.9	1009.8	15	2	1	NA	1	NA	16	0
OCRL	0	0	2	8	856.68	1713.36	15	2	1	NA	1	NA	10	0
OCSTAMP	0	0	9	3	472.23	944.46	15	2	1	NA	1	NA	12	0
ODF2	0	0	1	4	814.77	1629.54	15	2	1	NA	1	NA	5	0
ODF2L	0	0	3	2	592.68	1185.36	15	2	1	NA	1	NA	5	0
OGDH	0	0	0	17	937.53	1875.06	15	2	1	NA	1	NA	17	0
OGDHL	0	0	1	6	1004.85	2009.7	15	2	1	NA	1	NA	7	0
OGFOD1	0	0	1	5	534.6	1069.2	15	2	1	NA	1	NA	6	0
OGFOD2	0	0	7	7	346.5	693	15	2	1	NA	1	NA	14	0
OGFOD3	0	0	3	4	416.79	833.58	15	2	1	NA	1	NA	7	0
OGFR	0	0	6	1	690.36	1380.72	15	2	1	NA	1	NA	7	0
OGG1	0	0	6	7	325.71	651.42	15	2	1	NA	1	NA	13	0
OGT	0	0	1	4	1035.54	2071.08	15	2	1	NA	1	NA	5	0
OIP5	0	0	3	4	226.38	452.76	15	2	1	NA	1	NA	7	0
OIT3	0	0	0	5	548.46	1096.92	15	2	1	NA	1	NA	5	0
OLFM1	0	0	0	4	481.14	962.28	15	2	1	NA	1	NA	4	0
OLFM3	0	0	2	4	447.81	895.62	15	2	1	NA	1	NA	6	0
OLFML1	0	0	6	5	394.02	788.04	15	2	1	NA	1	NA	11	0
OLFML3	0	0	0	2	390.06	780.12	15	2	1	NA	1	NA	2	0
OLFR1019L2	0	0	6	5	321.75	643.5	15	2	1	NA	1	NA	11	0
OLFR4	0	0	2	4	309.87	619.74	15	2	1	NA	1	NA	6	0
OMA1	0	0	7	1	525.69	1051.38	15	2	1	NA	1	NA	8	0
OMD	0	0	4	2	413.82	827.64	15	2	1	NA	1	NA	6	0
OMG	0	0	0	4	435.6	871.2	15	2	1	NA	1	NA	4	0
ONECUT2	0	0	1	1	107.91	215.82	15	2	1	NA	1	NA	2	0
OPA1	0	0	1	2	1004.85	2009.7	15	2	1	NA	1	NA	3	0
OPCML	0	0	1	4	330.66	661.32	15	2	1	NA	1	NA	5	0
OPN1MSW	0	0	2	10	352.44	704.88	15	2	1	NA	1	NA	12	0
OPN4	0	0	0	2	561.33	1122.66	15	2	1	NA	1	NA	2	0
OPN4-1	0	0	2	1	535.59	1071.18	15	2	1	NA	1	NA	3	0
OPNP	0	0	6	2	333.3	666.6	15	2	1	NA	1	NA	8	0
OPRD1	0	0	3	6	367.29	734.58	15	2	1	NA	1	NA	9	0
OPRL1	0	0	0	2	365.31	730.62	15	2	1	NA	1	NA	2	0
OPTC	0	0	10	6	321.75	643.5	15	2	1	NA	1	NA	16	0
OR5AS1	0	0	3	3	312.84	625.68	15	2	1	NA	1	NA	6	0
OR8D4	0	0	5	11	312.84	625.68	15	2	1	NA	1	NA	16	0
ORAI2	0	0	0	3	256.41	512.82	15	2	1	NA	1	NA	3	0
ORAOV1	0	0	2	0	140.25	280.5	15	2	1	NA	1	NA	2	0
ORC1	0	0	7	2	850.41	1700.82	15	2	1	NA	1	NA	9	0
ORC2	0	0	3	4	564.3	1128.6	15	2	1	NA	1	NA	7	0
ORC4	0	0	2	2	432.63	865.26	15	2	1	NA	1	NA	4	0
ORC6	0	0	2	2	266.31	532.62	15	2	1	NA	1	NA	4	0
OSBP2	0	0	7	17	792.99	1585.98	15	2	1	NA	1	NA	24	0
OSBPL11	0	0	4	5	692.34	1384.68	15	2	1	NA	1	NA	9	0
OSBPL2	0	0	3	2	477.18	954.36	15	2	1	NA	1	NA	5	0
OSBPL5	0	0	1	6	872.19	1744.38	15	2	1	NA	1	NA	7	0
OSBPL6	0	0	3	3	949.41	1898.82	15	2	1	NA	1	NA	6	0
OSBPL7	0	0	7	10	625.35	1250.7	15	2	1	NA	1	NA	17	0
OSBPL9	0	0	2	2	711.81	1423.62	15	2	1	NA	1	NA	4	0
OSCP1	0	0	2	2	386.1	772.2	15	2	1	NA	1	NA	4	0
OSER1	0	0	3	0	286.11	572.22	15	2	1	NA	1	NA	3	0
OSGEPL1	0	0	2	0	411.84	823.68	15	2	1	NA	1	NA	2	0
OSGIN1	0	0	1	2	494.01	988.02	15	2	1	NA	1	NA	3	0
OSMR	0	0	5	3	806.52	1613.04	15	2	1	NA	1	NA	8	0
OSTN	0	0	4	1	175.23	350.46	15	2	1	NA	1	NA	5	0
OTOA	0	0	2	5	1451.67	2903.34	15	2	1	NA	1	NA	7	0
OTOG	0	0	39	18	3520.44	7040.88	15	2	1	NA	1	NA	57	0
OTOL1	0	0	3	13	421.08	842.16	15	2	1	NA	1	NA	16	0
OTOP1	0	0	4	1	570.24	1140.48	15	2	1	NA	1	NA	5	0
OTOP2	0	0	4	15	589.05	1178.1	15	2	1	NA	1	NA	19	0
OTOP3	0	0	4	8	596.97	1193.94	15	2	1	NA	1	NA	12	0
OTUD3	0	0	6	5	362.34	724.68	15	2	1	NA	1	NA	11	0
OTUD4	0	0	3	9	1128.6	2257.2	15	2	1	NA	1	NA	12	0
OTUD7A	0	0	3	5	906.84	1813.68	15	2	1	NA	1	NA	8	0
OTUD7B	0	0	8	16	852.39	1704.78	15	2	1	NA	1	NA	24	0
OTX2	0	0	1	4	270.93	541.86	15	2	1	NA	1	NA	5	0
OVCH2	0	0	2	3	630.3	1260.6	15	2	1	NA	1	NA	5	0
OXCT1	0	0	1	1	487.74	975.48	15	2	1	NA	1	NA	2	0
OXTR	0	0	1	6	377.19	754.38	15	2	1	NA	1	NA	7	0
P2RX1	0	0	1	7	387.09	774.18	15	2	1	NA	1	NA	8	0
P2RX2	0	0	7	6	367.29	734.58	15	2	1	NA	1	NA	13	0
P2RX4	0	0	1	4	385.11	770.22	15	2	1	NA	1	NA	5	0
P2RX6	0	0	2	2	404.91	809.82	15	2	1	NA	1	NA	4	0
P2RX7	0	0	5	5	555.72	1111.44	15	2	1	NA	1	NA	10	0
P2RY1	0	0	0	3	360.36	720.72	15	2	1	NA	1	NA	3	0
P2RY13	0	0	2	3	340.56	681.12	15	2	1	NA	1	NA	5	0
P2RY14	0	0	3	2	334.62	669.24	15	2	1	NA	1	NA	5	0
P3H1	0	0	3	4	717.75	1435.5	15	2	1	NA	1	NA	7	0
P3H2	0	0	4	4	728.64	1457.28	15	2	1	NA	1	NA	8	0
P3H4	0	0	2	13	415.8	831.6	15	2	1	NA	1	NA	15	0
P4HA1	0	0	1	2	545.49	1090.98	15	2	1	NA	1	NA	3	0
P4HA2	0	0	0	3	508.86	1017.72	15	2	1	NA	1	NA	3	0
P4HB	0	0	1	2	457.38	914.76	15	2	1	NA	1	NA	3	0
P4HTM	0	0	0	3	424.71	849.42	15	2	1	NA	1	NA	3	0
PABPC1L	0	0	3	10	658.35	1316.7	15	2	1	NA	1	NA	13	0
PABPC4	0	0	2	2	615.78	1231.56	15	2	1	NA	1	NA	4	0
PABPN1L	0	0	3	4	269.28	538.56	15	2	1	NA	1	NA	7	0
PACS2	0	0	1	8	834.9	1669.8	15	2	1	NA	1	NA	9	0
PACSIN1	0	0	2	9	435.93	871.86	15	2	1	NA	1	NA	11	0
PACSIN3	0	0	2	4	441.54	883.08	15	2	1	NA	1	NA	6	0
PADI1	0	0	2	19	655.38	1310.76	15	2	1	NA	1	NA	21	0
PADI2	0	0	17	12	589.38	1178.76	15	2	1	NA	1	NA	29	0
PADIL	0	0	13	14	652.74	1305.48	15	2	1	NA	1	NA	27	0
PAFAH1B2	0	0	1	3	230.01	460.02	15	2	1	NA	1	NA	4	0
PAFAH2	0	0	13	14	387.75	775.5	15	2	1	NA	1	NA	27	0
PAICS	0	0	0	2	422.73	845.46	15	2	1	NA	1	NA	2	0
PAIP1	0	0	0	2	342.87	685.74	15	2	1	NA	1	NA	2	0
PAIP2	0	0	0	2	126.72	253.44	15	2	1	NA	1	NA	2	0
PAK2	0	0	0	9	520.74	1041.48	15	2	1	NA	1	NA	9	0
PAK3	0	0	2	3	565.62	1131.24	15	2	1	NA	1	NA	5	0
PAK4	0	0	3	4	594.99	1189.98	15	2	1	NA	1	NA	7	0
PAK6	0	0	4	5	692.01	1384.02	15	2	1	NA	1	NA	9	0
PALB2	0	0	21	12	1348.38	2696.76	15	2	1	NA	1	NA	33	0
PALLD	0	0	4	4	784.08	1568.16	15	2	1	NA	1	NA	8	0
PALLDL	0	0	0	3	194.04	388.08	15	2	1	NA	1	NA	3	0
PALM	0	0	5	9	396.99	793.98	15	2	1	NA	1	NA	14	0
PALMD	0	0	3	6	543.51	1087.02	15	2	1	NA	1	NA	9	0
PAM	0	0	5	1	890.67	1781.34	15	2	1	NA	1	NA	6	0
PAN2	0	0	4	16	1324.62	2649.24	15	2	1	NA	1	NA	20	0
PANK4	0	0	0	9	764.28	1528.56	15	2	1	NA	1	NA	9	0
PANX3	0	0	1	2	482.46	964.92	15	2	1	NA	1	NA	3	0
PAOX	0	0	0	4	492.36	984.72	15	2	1	NA	1	NA	4	0
PAPD4	0	0	1	1	488.4	976.8	15	2	1	NA	1	NA	2	0
PAPD5	0	0	1	5	528.66	1057.32	15	2	1	NA	1	NA	6	0
PAPLN	0	0	19	10	1354.32	2708.64	15	2	1	NA	1	NA	29	0
PAPPA	0	0	5	9	1064.25	2128.5	15	2	1	NA	1	NA	14	0
PAPPA2	0	0	13	22	1539.12	3078.24	15	2	1	NA	1	NA	35	0
PAPSS1	0	0	4	3	654.72	1309.44	15	2	1	NA	1	NA	7	0
PAPSS2	0	0	1	3	630.63	1261.26	15	2	1	NA	1	NA	4	0
PAQR3	0	0	0	3	308.88	617.76	15	2	1	NA	1	NA	3	0
PAQR5	0	0	4	6	308.55	617.1	15	2	1	NA	1	NA	10	0
PAQR7	0	0	1	7	343.53	687.06	15	2	1	NA	1	NA	8	0
PARD3B	0	0	2	2	1130.58	2261.16	15	2	1	NA	1	NA	4	0
PARG	0	0	8	7	908.16	1816.32	15	2	1	NA	1	NA	15	0
PARL	0	0	1	3	246.84	493.68	15	2	1	NA	1	NA	4	0
PARM1	0	0	2	4	291.06	582.12	15	2	1	NA	1	NA	6	0
PARN	0	0	1	3	630.63	1261.26	15	2	1	NA	1	NA	4	0
PARP14	0	0	19	19	3368.97	6737.94	15	2	1	NA	1	NA	38	0
PARP16	0	0	3	6	288.42	576.84	15	2	1	NA	1	NA	9	0
PARP3	0	0	5	9	523.71	1047.42	15	2	1	NA	1	NA	14	0
PARP6	0	0	1	11	608.52	1217.04	15	2	1	NA	1	NA	12	0
PARP9	0	0	12	2	768.9	1537.8	15	2	1	NA	1	NA	14	0
PARS2	0	0	6	4	457.38	914.76	15	2	1	NA	1	NA	10	0
PARVA	0	0	0	8	426.69	853.38	15	2	1	NA	1	NA	8	0
PASD1	0	0	2	7	818.73	1637.46	15	2	1	NA	1	NA	9	0
PASK	0	0	15	10	1350.36	2700.72	15	2	1	NA	1	NA	25	0
PATJ	0	0	11	7	1870.11	3740.22	15	2	1	NA	1	NA	18	0
PATL2	0	0	4	5	686.07	1372.14	15	2	1	NA	1	NA	9	0
PAX3	0	0	1	3	165	330	15	2	1	NA	1	NA	4	0
PAX5	0	0	2	4	303.6	607.2	15	2	1	NA	1	NA	6	0
PAX6	0	0	0	4	432.63	865.26	15	2	1	NA	1	NA	4	0
PAX7	0	0	2	1	379.17	758.34	15	2	1	NA	1	NA	3	0
PBDC1	0	0	2	4	137.94	275.88	15	2	1	NA	1	NA	6	0
PBLD	0	0	5	1	253.44	506.88	15	2	1	NA	1	NA	6	0
PBX3	0	0	3	1	383.79	767.58	15	2	1	NA	1	NA	4	0
PCASP1	0	0	2	5	797.94	1595.88	15	2	1	NA	1	NA	7	0
PCASP2	0	0	7	6	737.88	1475.76	15	2	1	NA	1	NA	13	0
PCASP3	0	0	5	5	629.64	1259.28	15	2	1	NA	1	NA	10	0
PCBP3	0	0	0	2	355.08	710.16	15	2	1	NA	1	NA	2	0
PCBP4	0	0	1	5	389.73	779.46	15	2	1	NA	1	NA	6	0
PCCB	0	0	1	6	484.11	968.22	15	2	1	NA	1	NA	7	0
PCDH1	0	0	6	20	1191.96	2383.92	15	2	1	NA	1	NA	26	0
PCDH10	0	0	1	2	1139.82	2279.64	15	2	1	NA	1	NA	3	0
PCDH11X	0	0	10	3	960.63	1921.26	15	2	1	NA	1	NA	13	0
PCDH12	0	0	22	30	1135.53	2271.06	15	2	1	NA	1	NA	52	0
PCDH15	0	0	2	4	514.47	1028.94	15	2	1	NA	1	NA	6	0
PCDH18	0	0	2	5	1129.59	2259.18	15	2	1	NA	1	NA	7	0
PCDH19	0	0	3	7	1162.92	2325.84	15	2	1	NA	1	NA	10	0
PCDH7	0	0	1	1	1157.31	2314.62	15	2	1	NA	1	NA	2	0
PCDHAC2	0	0	2	8	968.55	1937.1	15	2	1	NA	1	NA	10	0
PCDHGC3	0	0	2	1	177.87	355.74	15	2	1	NA	1	NA	3	0
PCGF2	0	0	1	7	324.72	649.44	15	2	1	NA	1	NA	8	0
PCIF1	0	0	1	5	701.91	1403.82	15	2	1	NA	1	NA	6	0
PCK1	0	0	2	1	616.77	1233.54	15	2	1	NA	1	NA	3	0
PCM1	0	0	11	10	2035.44	4070.88	15	2	1	NA	1	NA	21	0
PCMT1L	0	0	3	5	246.51	493.02	15	2	1	NA	1	NA	8	0
PCNA	0	0	0	3	260.37	520.74	15	2	1	NA	1	NA	3	0
PCNT	0	0	9	4	1708.41	3416.82	15	2	1	NA	1	NA	13	0
PCNX1	0	0	2	9	2307.03	4614.06	15	2	1	NA	1	NA	11	0
PCNX4	0	0	2	7	1112.76	2225.52	15	2	1	NA	1	NA	9	0
PCOLCE2	0	0	2	0	390.72	781.44	15	2	1	NA	1	NA	2	0
PCSK1	0	0	5	11	704.55	1409.1	15	2	1	NA	1	NA	16	0
PCSK4	0	0	14	17	699.27	1398.54	15	2	1	NA	1	NA	31	0
PCSK6	0	0	9	20	864.93	1729.86	15	2	1	NA	1	NA	29	0
PCSK7	0	0	7	18	793.98	1587.96	15	2	1	NA	1	NA	25	0
PCSK9	0	0	11	19	650.43	1300.86	15	2	1	NA	1	NA	30	0
PCTP	0	0	0	2	212.85	425.7	15	2	1	NA	1	NA	2	0
PCYOX1	0	0	4	7	494.01	988.02	15	2	1	NA	1	NA	11	0
PCYT1A	0	0	5	5	591.03	1182.06	15	2	1	NA	1	NA	10	0
PDAP1	0	0	0	3	180.18	360.36	15	2	1	NA	1	NA	3	0
PDCD1	0	0	0	4	245.19	490.38	15	2	1	NA	1	NA	4	0
PDCD11	0	0	9	8	1807.08	3614.16	15	2	1	NA	1	NA	17	0
PDCD1LG2	0	0	2	2	318.78	637.56	15	2	1	NA	1	NA	4	0
PDCD4	0	0	0	2	463.32	926.64	15	2	1	NA	1	NA	2	0
PDCD7	0	0	7	4	374.55	749.1	15	2	1	NA	1	NA	11	0
PDCL	0	0	1	1	297.99	595.98	15	2	1	NA	1	NA	2	0
PDCL2	0	0	6	5	422.73	845.46	15	2	1	NA	1	NA	11	0
PDDC1	0	0	1	2	227.7	455.4	15	2	1	NA	1	NA	3	0
PDE11A	0	0	1	2	831.93	1663.86	15	2	1	NA	1	NA	3	0
PDE12	0	0	2	5	556.38	1112.76	15	2	1	NA	1	NA	7	0
PDE1A	0	0	2	2	588.72	1177.44	15	2	1	NA	1	NA	4	0
PDE3B	0	0	2	5	1015.74	2031.48	15	2	1	NA	1	NA	7	0
PDE4DIP	0	0	36	29	2221.23	4442.46	15	2	1	NA	1	NA	65	0
PDE5A	0	0	3	4	845.46	1690.92	15	2	1	NA	1	NA	7	0
PDE6B	0	0	0	14	827.31	1654.62	15	2	1	NA	1	NA	14	0
PDE6C	0	0	1	4	855.36	1710.72	15	2	1	NA	1	NA	5	0
PDE6D	0	0	2	0	166.32	332.64	15	2	1	NA	1	NA	2	0
PDE6G	0	0	0	3	87.12	174.24	15	2	1	NA	1	NA	3	0
PDE8B	0	0	4	2	762.3	1524.6	15	2	1	NA	1	NA	6	0
PDGFC	0	0	0	3	309.87	619.74	15	2	1	NA	1	NA	3	0
PDGFRA	0	0	1	6	1077.12	2154.24	15	2	1	NA	1	NA	7	0
PDGFRB	0	0	8	22	1083.06	2166.12	15	2	1	NA	1	NA	30	0
PDGFRL	0	0	1	2	353.1	706.2	15	2	1	NA	1	NA	3	0
PDHB	0	0	3	3	358.71	717.42	15	2	1	NA	1	NA	6	0
PDHX	0	0	3	2	453.09	906.18	15	2	1	NA	1	NA	5	0
PDIA3	0	0	0	2	421.74	843.48	15	2	1	NA	1	NA	2	0
PDIA5	0	0	0	3	388.08	776.16	15	2	1	NA	1	NA	3	0
PDIK1L	0	0	0	4	338.58	677.16	15	2	1	NA	1	NA	4	0
PDLIM1	0	0	1	5	420.75	841.5	15	2	1	NA	1	NA	6	0
PDLIM4	0	0	2	3	327.69	655.38	15	2	1	NA	1	NA	5	0
PDLIM5	0	0	8	9	830.28	1660.56	15	2	1	NA	1	NA	17	0
PDLIM7	0	0	7	14	850.41	1700.82	15	2	1	NA	1	NA	21	0
PDPK1	0	0	3	3	551.43	1102.86	15	2	1	NA	1	NA	6	0
PDRG1	0	0	2	3	131.67	263.34	15	2	1	NA	1	NA	5	0
PDS5A	0	0	1	6	1322.64	2645.28	15	2	1	NA	1	NA	7	0
PDXDC1	0	0	3	0	777.15	1554.3	15	2	1	NA	1	NA	3	0
PDYN	0	0	2	4	228.69	457.38	15	2	1	NA	1	NA	6	0
PDZD2	0	0	13	2	2495.46	4990.92	15	2	1	NA	1	NA	15	0
PDZD3	0	0	4	12	416.79	833.58	15	2	1	NA	1	NA	16	0
PDZD7	0	0	2	13	505.23	1010.46	15	2	1	NA	1	NA	15	0
PDZD8	0	0	4	7	1154.01	2308.02	15	2	1	NA	1	NA	11	0
PDZK1IP1	0	0	0	3	114.84	229.68	15	2	1	NA	1	NA	3	0
PDZRN3	0	0	1	9	772.2	1544.4	15	2	1	NA	1	NA	10	0
PEAK1	0	0	8	14	1773.09	3546.18	15	2	1	NA	1	NA	22	0
PEBP1	0	0	2	5	186.12	372.24	15	2	1	NA	1	NA	7	0
PEBP4	0	0	5	4	206.91	413.82	15	2	1	NA	1	NA	9	0
PECAM1	0	0	4	5	725.67	1451.34	15	2	1	NA	1	NA	9	0
PEF1	0	0	4	3	213.84	427.68	15	2	1	NA	1	NA	7	0
PELI1	0	0	0	3	780.45	1560.9	15	2	1	NA	1	NA	3	0
PELO	0	0	1	3	376.53	753.06	15	2	1	NA	1	NA	4	0
PEMT	0	0	0	5	209.88	419.76	15	2	1	NA	1	NA	5	0
PEPD	0	0	2	3	492.03	984.06	15	2	1	NA	1	NA	5	0
PER2	0	0	2	5	1290.96	2581.92	15	2	1	NA	1	NA	7	0
PER3	0	0	6	2	1165.23	2330.46	15	2	1	NA	1	NA	8	0
PERM1	0	0	18	16	690.03	1380.06	15	2	1	NA	1	NA	34	0
PEX10	0	0	2	3	324.72	649.44	15	2	1	NA	1	NA	5	0
PEX11G	0	0	2	4	256.41	512.82	15	2	1	NA	1	NA	6	0
PEX12	0	0	7	10	312.84	625.68	15	2	1	NA	1	NA	17	0
PEX14	0	0	1	1	374.55	749.1	15	2	1	NA	1	NA	2	0
PEX16	0	0	4	2	303.6	607.2	15	2	1	NA	1	NA	6	0
PEX5L	0	0	3	2	579.15	1158.3	15	2	1	NA	1	NA	5	0
PFDN4	0	0	0	3	134.64	269.28	15	2	1	NA	1	NA	3	0
PFDN5	0	0	2	1	181.17	362.34	15	2	1	NA	1	NA	3	0
PFKFB4L	0	0	0	4	414.48	828.96	15	2	1	NA	1	NA	4	0
PFKL	0	0	13	13	773.19	1546.38	15	2	1	NA	1	NA	26	0
PGA5	0	0	1	9	376.53	753.06	15	2	1	NA	1	NA	10	0
PGAM1	0	0	0	4	186.45	372.9	15	2	1	NA	1	NA	4	0
PGAP1	0	0	3	4	928.62	1857.24	15	2	1	NA	1	NA	7	0
PGC	0	0	8	6	376.2	752.4	15	2	1	NA	1	NA	14	0
PGD	0	0	1	4	476.52	953.04	15	2	1	NA	1	NA	5	0
PGF	0	0	0	3	141.57	283.14	15	2	1	NA	1	NA	3	0
PGGHG	0	0	4	5	581.13	1162.26	15	2	1	NA	1	NA	9	0
PGGT1B	0	0	3	1	794.64	1589.28	15	2	1	NA	1	NA	4	0
PGK1	0	0	2	2	413.82	827.64	15	2	1	NA	1	NA	4	0
PGM1	0	0	2	7	556.38	1112.76	15	2	1	NA	1	NA	9	0
PGM2	0	0	1	3	598.95	1197.9	15	2	1	NA	1	NA	4	0
PGPEP1	0	0	0	3	196.68	393.36	15	2	1	NA	1	NA	3	0
PGPEP1L	0	0	0	2	201.96	403.92	15	2	1	NA	1	NA	2	0
PGRMC1	0	0	3	1	194.04	388.08	15	2	1	NA	1	NA	4	0
PGS1	0	0	2	3	531.3	1062.6	15	2	1	NA	1	NA	5	0
PHACTR3	0	0	3	2	600.93	1201.86	15	2	1	NA	1	NA	5	0
PHACTR4	0	0	5	11	542.19	1084.38	15	2	1	NA	1	NA	16	0
PHAX	0	0	2	4	327.69	655.38	15	2	1	NA	1	NA	6	0
PHC3	0	0	7	8	975.15	1950.3	15	2	1	NA	1	NA	15	0
PHF12	0	0	3	8	941.49	1882.98	15	2	1	NA	1	NA	11	0
PHF13	0	0	3	3	291.06	582.12	15	2	1	NA	1	NA	6	0
PHF19	0	0	5	12	583.11	1166.22	15	2	1	NA	1	NA	17	0
PHF2	0	0	1	7	1021.68	2043.36	15	2	1	NA	1	NA	8	0
PHF20	0	0	6	6	1030.26	2060.52	15	2	1	NA	1	NA	12	0
PHF21A	0	0	2	2	651.42	1302.84	15	2	1	NA	1	NA	4	0
PHF24	0	0	1	1	169.29	338.58	15	2	1	NA	1	NA	2	0
PHGDH	0	0	7	13	510.18	1020.36	15	2	1	NA	1	NA	20	0
PHKA1	0	0	7	23	1185.03	2370.06	15	2	1	NA	1	NA	30	0
PHKB	0	0	4	10	1299.87	2599.74	15	2	1	NA	1	NA	14	0
PHKG1	0	0	1	5	385.11	770.22	15	2	1	NA	1	NA	6	0
PHLDA3	0	0	2	7	156.42	312.84	15	2	1	NA	1	NA	9	0
PHLDB1	0	0	8	6	1543.74	3087.48	15	2	1	NA	1	NA	14	0
PHLPP2	0	0	5	8	2068.11	4136.22	15	2	1	NA	1	NA	13	0
PHOSPHO1	0	0	0	2	265.32	530.64	15	2	1	NA	1	NA	2	0
PHOX2B	0	0	2	0	204.93	409.86	15	2	1	NA	1	NA	2	0
PHTF1	0	0	1	5	744.48	1488.96	15	2	1	NA	1	NA	6	0
PHYHD1	0	0	6	1	270.6	541.2	15	2	1	NA	1	NA	7	0
PHYKPL	0	0	3	3	446.49	892.98	15	2	1	NA	1	NA	6	0
PI16	0	0	7	1	518.1	1036.2	15	2	1	NA	1	NA	8	0
PI3	0	0	2	1	76.23	152.46	15	2	1	NA	1	NA	3	0
PI4K2A	0	0	0	3	348.81	697.62	15	2	1	NA	1	NA	3	0
PI4K2B	0	0	1	4	442.2	884.4	15	2	1	NA	1	NA	5	0
PI4KA	0	0	2	9	1320.66	2641.32	15	2	1	NA	1	NA	11	0
PI4KB	0	0	3	6	1119.69	2239.38	15	2	1	NA	1	NA	9	0
PIAS1	0	0	0	7	497.97	995.94	15	2	1	NA	1	NA	7	0
PIAS2	0	0	0	3	499.29	998.58	15	2	1	NA	1	NA	3	0
PIEZO1	0	0	23	45	2408.01	4816.02	15	2	1	NA	1	NA	68	0
PIF1	0	0	3	9	591.36	1182.72	15	2	1	NA	1	NA	12	0
PIGB	0	0	8	10	434.28	868.56	15	2	1	NA	1	NA	18	0
PIGC	0	0	2	10	295.02	590.04	15	2	1	NA	1	NA	12	0
PIGG	0	0	4	8	880.11	1760.22	15	2	1	NA	1	NA	12	0
PIGK	0	0	1	1	382.14	764.28	15	2	1	NA	1	NA	2	0
PIGL	0	0	6	2	291.39	582.78	15	2	1	NA	1	NA	8	0
PIGQ	0	0	5	2	571.23	1142.46	15	2	1	NA	1	NA	7	0
PIGR	0	0	12	7	1157.31	2314.62	15	2	1	NA	1	NA	19	0
PIGS	0	0	7	15	540.21	1080.42	15	2	1	NA	1	NA	22	0
PIGT	0	0	3	9	534.27	1068.54	15	2	1	NA	1	NA	12	0
PIGV	0	0	12	9	484.11	968.22	15	2	1	NA	1	NA	21	0
PIGW	0	0	5	3	501.93	1003.86	15	2	1	NA	1	NA	8	0
PIH1D2	0	0	5	8	288.09	576.18	15	2	1	NA	1	NA	13	0
PIH1D3	0	0	2	0	191.07	382.14	15	2	1	NA	1	NA	2	0
PIK3AP1	0	0	4	4	788.7	1577.4	15	2	1	NA	1	NA	8	0
PIK3C2A	0	0	6	9	1646.37	3292.74	15	2	1	NA	1	NA	15	0
PIK3C2B	0	0	13	30	1602.15	3204.3	15	2	1	NA	1	NA	43	0
PIK3C3	0	0	2	4	863.94	1727.88	15	2	1	NA	1	NA	6	0
PIK3CA	0	0	0	2	1058.31	2116.62	15	2	1	NA	1	NA	2	0
PIK3CB	0	0	1	6	1056.33	2112.66	15	2	1	NA	1	NA	7	0
PIK3CD	0	0	4	11	1036.53	2073.06	15	2	1	NA	1	NA	15	0
PIK3R2	0	0	5	7	720.72	1441.44	15	2	1	NA	1	NA	12	0
PIK3R3	0	0	2	2	459.36	918.72	15	2	1	NA	1	NA	4	0
PIK3R5	0	0	10	14	876.15	1752.3	15	2	1	NA	1	NA	24	0
PIK3R6	0	0	6	16	747.45	1494.9	15	2	1	NA	1	NA	22	0
PIKFYVE	0	0	6	8	2097.81	4195.62	15	2	1	NA	1	NA	14	0
PIN4	0	0	1	1	113.52	227.04	15	2	1	NA	1	NA	2	0
PIP5K1A	0	0	0	5	902.22	1804.44	15	2	1	NA	1	NA	5	0
PIP5K1C	0	0	1	5	605.55	1211.1	15	2	1	NA	1	NA	6	0
PIPOX	0	0	13	13	389.07	778.14	15	2	1	NA	1	NA	26	0
PIRT	0	0	0	2	140.58	281.16	15	2	1	NA	1	NA	2	0
PISD	0	0	3	1	157.74	315.48	15	2	1	NA	1	NA	4	0
PIT54	0	0	3	7	493.02	986.04	15	2	1	NA	1	NA	10	0
PITPNA	0	0	1	1	314.82	629.64	15	2	1	NA	1	NA	2	0
PITPNM2	0	0	4	6	1304.82	2609.64	15	2	1	NA	1	NA	10	0
PITX1	0	0	0	2	275.22	550.44	15	2	1	NA	1	NA	2	0
PITX2	0	0	0	6	316.8	633.6	15	2	1	NA	1	NA	6	0
PITX3	0	0	0	7	290.07	580.14	15	2	1	NA	1	NA	7	0
PIWIL1	0	0	2	4	859.32	1718.64	15	2	1	NA	1	NA	6	0
PJA2	0	0	1	3	683.76	1367.52	15	2	1	NA	1	NA	4	0
PKD1	0	0	33	55	4255.68	8511.36	15	2	1	NA	1	NA	88	0
PKD1L2	0	0	14	12	2479.95	4959.9	15	2	1	NA	1	NA	26	0
PKD2	0	0	2	9	762.96	1525.92	15	2	1	NA	1	NA	11	0
PKD2L1	0	0	4	4	844.47	1688.94	15	2	1	NA	1	NA	8	0
PKD2L2	0	0	3	3	634.59	1269.18	15	2	1	NA	1	NA	6	0
PKDCCB	0	0	2	2	388.74	777.48	15	2	1	NA	1	NA	4	0
PKIG	0	0	1	4	76.23	152.46	15	2	1	NA	1	NA	5	0
PKM	0	0	0	8	545.49	1090.98	15	2	1	NA	1	NA	8	0
PKN2	0	0	3	3	960.3	1920.6	15	2	1	NA	1	NA	6	0
PKN3	0	0	2	4	997.59	1995.18	15	2	1	NA	1	NA	6	0
PKP1	0	0	1	8	727.65	1455.3	15	2	1	NA	1	NA	9	0
PKP3	0	0	3	7	818.73	1637.46	15	2	1	NA	1	NA	10	0
PKP4	0	0	3	6	1182.06	2364.12	15	2	1	NA	1	NA	9	0
PLA2G10	0	0	1	2	153.45	306.9	15	2	1	NA	1	NA	3	0
PLA2G2A	0	0	1	6	135.96	271.92	15	2	1	NA	1	NA	7	0
PLA2G2E-PLA2G5	0	0	5	0	137.61	275.22	15	2	1	NA	1	NA	5	0
PLA2G4A	0	0	2	1	742.5	1485	15	2	1	NA	1	NA	3	0
PLA2R1	0	0	3	3	1443.42	2886.84	15	2	1	NA	1	NA	6	0
PLAA	0	0	5	1	790.02	1580.04	15	2	1	NA	1	NA	6	0
PLAC8L1	0	0	2	3	136.62	273.24	15	2	1	NA	1	NA	5	0
PLAGL2	0	0	1	5	490.05	980.1	15	2	1	NA	1	NA	6	0
PLAT	0	0	4	3	548.46	1096.92	15	2	1	NA	1	NA	7	0
PLAU	0	0	3	2	424.71	849.42	15	2	1	NA	1	NA	5	0
PLBD2	0	0	1	11	360.03	720.06	15	2	1	NA	1	NA	12	0
PLCB2	0	0	10	8	1229.25	2458.5	15	2	1	NA	1	NA	18	0
PLCD3	0	0	3	7	724.02	1448.04	15	2	1	NA	1	NA	10	0
PLCD4	0	0	10	15	747.45	1494.9	15	2	1	NA	1	NA	25	0
PLCE1	0	0	9	8	2120.58	4241.16	15	2	1	NA	1	NA	17	0
PLCG1	0	0	2	20	1307.46	2614.92	15	2	1	NA	1	NA	22	0
PLCG2	0	0	3	5	1253.34	2506.68	15	2	1	NA	1	NA	8	0
PLCH1	0	0	12	18	1680.03	3360.06	15	2	1	NA	1	NA	30	0
PLCH2	0	0	9	13	1639.44	3278.88	15	2	1	NA	1	NA	22	0
PLCL1	0	0	3	6	1047.42	2094.84	15	2	1	NA	1	NA	9	0
PLD1	0	0	3	11	1026.63	2053.26	15	2	1	NA	1	NA	14	0
PLD4	0	0	3	1	507.87	1015.74	15	2	1	NA	1	NA	4	0
PLD6	0	0	1	6	215.82	431.64	15	2	1	NA	1	NA	7	0
PLEK2	0	0	0	2	352.44	704.88	15	2	1	NA	1	NA	2	0
PLEKHA1	0	0	2	1	407.88	815.76	15	2	1	NA	1	NA	3	0
PLEKHA2	0	0	3	6	413.82	827.64	15	2	1	NA	1	NA	9	0
PLEKHA6	0	0	10	27	1341.45	2682.9	15	2	1	NA	1	NA	37	0
PLEKHA7	0	0	10	5	1011.78	2023.56	15	2	1	NA	1	NA	15	0
PLEKHB2	0	0	2	2	220.77	441.54	15	2	1	NA	1	NA	4	0
PLEKHD1	0	0	2	5	519.75	1039.5	15	2	1	NA	1	NA	7	0
PLEKHF1	0	0	0	2	271.26	542.52	15	2	1	NA	1	NA	2	0
PLEKHG3	0	0	10	21	925.65	1851.3	15	2	1	NA	1	NA	31	0
PLEKHG4	0	0	19	34	1937.1	3874.2	15	2	1	NA	1	NA	53	0
PLEKHG5	0	0	2	4	819.72	1639.44	15	2	1	NA	1	NA	6	0
PLEKHH1	0	0	6	9	1434.51	2869.02	15	2	1	NA	1	NA	15	0
PLEKHH3	0	0	10	10	743.49	1486.98	15	2	1	NA	1	NA	20	0
PLEKHM1	0	0	8	8	1009.47	2018.94	15	2	1	NA	1	NA	16	0
PLEKHM2	0	0	12	15	1023.66	2047.32	15	2	1	NA	1	NA	27	0
PLEKHM3	0	0	1	1	837.21	1674.42	15	2	1	NA	1	NA	2	0
PLEKHN1	0	0	6	9	535.59	1071.18	15	2	1	NA	1	NA	15	0
PLEKHO1	0	0	2	3	343.2	686.4	15	2	1	NA	1	NA	5	0
PLEKHO2	0	0	5	5	564.3	1128.6	15	2	1	NA	1	NA	10	0
PLEKHS1	0	0	0	3	457.38	914.76	15	2	1	NA	1	NA	3	0
PLIN1	0	0	3	4	461.34	922.68	15	2	1	NA	1	NA	7	0
PLIN3	0	0	7	7	616.11	1232.22	15	2	1	NA	1	NA	14	0
PLIN3L	0	0	7	4	435.93	871.86	15	2	1	NA	1	NA	11	0
PLIN4	0	0	4	6	347.82	695.64	15	2	1	NA	1	NA	10	0
PLK1	0	0	0	3	536.25	1072.5	15	2	1	NA	1	NA	3	0
PLK3	0	0	3	13	606.87	1213.74	15	2	1	NA	1	NA	16	0
PLK4	0	0	2	9	961.29	1922.58	15	2	1	NA	1	NA	11	0
PLLP	0	0	1	1	163.68	327.36	15	2	1	NA	1	NA	2	0
PLOD1	0	0	4	3	723.69	1447.38	15	2	1	NA	1	NA	7	0
PLP1	0	0	0	3	210.21	420.42	15	2	1	NA	1	NA	3	0
PLPP3	0	0	0	4	310.86	621.72	15	2	1	NA	1	NA	4	0
PLPP4	0	0	2	1	281.16	562.32	15	2	1	NA	1	NA	3	0
PLPP5	0	0	3	2	250.14	500.28	15	2	1	NA	1	NA	5	0
PLPP7	0	0	0	10	269.28	538.56	15	2	1	NA	1	NA	10	0
PLPPR3	0	0	5	11	576.51	1153.02	15	2	1	NA	1	NA	16	0
PLPPR4	0	0	0	7	712.14	1424.28	15	2	1	NA	1	NA	7	0
PLPPR5	0	0	5	1	374.88	749.76	15	2	1	NA	1	NA	6	0
PLRG1	0	0	0	2	511.83	1023.66	15	2	1	NA	1	NA	2	0
PLS1	0	0	0	7	624.69	1249.38	15	2	1	NA	1	NA	7	0
PLS3	0	0	1	3	496.65	993.3	15	2	1	NA	1	NA	4	0
PLTP	0	0	11	5	497.97	995.94	15	2	1	NA	1	NA	16	0
PLVAP	0	0	2	2	420.75	841.5	15	2	1	NA	1	NA	4	0
PLXDC1	0	0	10	11	468.93	937.86	15	2	1	NA	1	NA	21	0
PLXNA1	0	0	4	33	1892.88	3785.76	15	2	1	NA	1	NA	37	0
PLXNA2	0	0	13	31	2040.39	4080.78	15	2	1	NA	1	NA	44	0
PLXNB1	0	0	5	19	2181.96	4363.92	15	2	1	NA	1	NA	24	0
PLXND1	0	0	2	12	1051.38	2102.76	15	2	1	NA	1	NA	14	0
PM20D1	0	0	3	6	517.77	1035.54	15	2	1	NA	1	NA	9	0
PMFBP1	0	0	0	3	471.9	943.8	15	2	1	NA	1	NA	3	0
PML	0	0	1	5	201.63	403.26	15	2	1	NA	1	NA	6	0
PMLL	0	0	19	11	845.46	1690.92	15	2	1	NA	1	NA	30	0
PMM2	0	0	0	5	246.51	493.02	15	2	1	NA	1	NA	5	0
PMPCA	0	0	1	12	506.55	1013.1	15	2	1	NA	1	NA	13	0
PMS1	0	0	8	3	922.68	1845.36	15	2	1	NA	1	NA	11	0
PNAT10	0	0	1	2	288.09	576.18	15	2	1	NA	1	NA	3	0
PNAT3	0	0	1	3	288.09	576.18	15	2	1	NA	1	NA	4	0
PNKD	0	0	3	6	295.02	590.04	15	2	1	NA	1	NA	9	0
PNLIP	0	0	2	5	465.3	930.6	15	2	1	NA	1	NA	7	0
PNLIPRP3	0	0	1	1	463.98	927.96	15	2	1	NA	1	NA	2	0
PNMT	0	0	0	2	165	330	15	2	1	NA	1	NA	2	0
PNN	0	0	1	2	661.32	1322.64	15	2	1	NA	1	NA	3	0
PNP	0	0	0	3	200.31	400.62	15	2	1	NA	1	NA	3	0
PNPLA1	0	0	4	4	908.82	1817.64	15	2	1	NA	1	NA	8	0
PNPLA2	0	0	0	7	477.18	954.36	15	2	1	NA	1	NA	7	0
PNPLA7	0	0	12	10	1560.9	3121.8	15	2	1	NA	1	NA	22	0
PNPO	0	0	5	4	222.42	444.84	15	2	1	NA	1	NA	9	0
POC1A	0	0	2	2	328.35	656.7	15	2	1	NA	1	NA	4	0
POC5	0	0	4	3	466.62	933.24	15	2	1	NA	1	NA	7	0
PODN	0	0	2	4	578.16	1156.32	15	2	1	NA	1	NA	6	0
PODXL2	0	0	6	12	631.95	1263.9	15	2	1	NA	1	NA	18	0
POF1B	0	0	2	1	457.38	914.76	15	2	1	NA	1	NA	3	0
POFUT1	0	0	9	5	378.18	756.36	15	2	1	NA	1	NA	14	0
POFUT2	0	0	3	3	434.61	869.22	15	2	1	NA	1	NA	6	0
POGZ	0	0	2	2	1311.75	2623.5	15	2	1	NA	1	NA	4	0
POLDIP2	0	0	1	5	298.65	597.3	15	2	1	NA	1	NA	6	0
POLE	0	0	9	22	2263.8	4527.6	15	2	1	NA	1	NA	31	0
POLE2	0	0	3	3	502.92	1005.84	15	2	1	NA	1	NA	6	0
POLG	0	0	13	18	1184.04	2368.08	15	2	1	NA	1	NA	31	0
POLG2	0	0	2	2	396.99	793.98	15	2	1	NA	1	NA	4	0
POLK	0	0	4	1	698.94	1397.88	15	2	1	NA	1	NA	5	0
POLL	0	0	4	12	564.3	1128.6	15	2	1	NA	1	NA	16	0
POLN	0	0	1	5	774.18	1548.36	15	2	1	NA	1	NA	6	0
POLR1A	0	0	5	10	1643.4	3286.8	15	2	1	NA	1	NA	15	0
POLR1D	0	0	2	1	113.85	227.7	15	2	1	NA	1	NA	3	0
POLR1E	0	0	1	2	338.91	677.82	15	2	1	NA	1	NA	3	0
POLR2C	0	0	0	4	273.24	546.48	15	2	1	NA	1	NA	4	0
POLR2D	0	0	0	3	141.57	283.14	15	2	1	NA	1	NA	3	0
POLR2E	0	0	0	4	208.89	417.78	15	2	1	NA	1	NA	4	0
POLR2H	0	0	0	3	110.55	221.1	15	2	1	NA	1	NA	3	0
POLR3A	0	0	3	7	1377.09	2754.18	15	2	1	NA	1	NA	10	0
POLR3D	0	0	4	12	320.1	640.2	15	2	1	NA	1	NA	16	0
POLR3E	0	0	1	2	695.97	1391.94	15	2	1	NA	1	NA	3	0
POLR3G	0	0	0	3	213.51	427.02	15	2	1	NA	1	NA	3	0
POLRMT	0	0	8	16	1203.51	2407.02	15	2	1	NA	1	NA	24	0
POMGNT1	0	0	2	6	653.4	1306.8	15	2	1	NA	1	NA	8	0
POMT1	0	0	5	5	776.16	1552.32	15	2	1	NA	1	NA	10	0
POMT2	0	0	4	5	688.05	1376.1	15	2	1	NA	1	NA	9	0
POP4	0	0	0	2	218.79	437.58	15	2	1	NA	1	NA	2	0
POR	0	0	4	5	575.85	1151.7	15	2	1	NA	1	NA	9	0
POU2AF1	0	0	0	5	513.81	1027.62	15	2	1	NA	1	NA	5	0
POU2F3	0	0	1	5	497.31	994.62	15	2	1	NA	1	NA	6	0
POU3F1	0	0	2	2	264	528	15	2	1	NA	1	NA	4	0
POU4F2	0	0	2	1	262.02	524.04	15	2	1	NA	1	NA	3	0
POU4F3	0	0	0	4	527.67	1055.34	15	2	1	NA	1	NA	4	0
PPA2	0	0	0	2	301.95	603.9	15	2	1	NA	1	NA	2	0
PPARD	0	0	0	4	439.56	879.12	15	2	1	NA	1	NA	4	0
PPARG	0	0	1	1	471.24	942.48	15	2	1	NA	1	NA	2	0
PPARGC1B	0	0	2	4	959.64	1919.28	15	2	1	NA	1	NA	6	0
PPAT	0	0	1	3	480.15	960.3	15	2	1	NA	1	NA	4	0
PPCDC	0	0	3	1	208.89	417.78	15	2	1	NA	1	NA	4	0
PPDPF	0	0	1	1	88.11	176.22	15	2	1	NA	1	NA	2	0
PPEF2	0	0	2	4	706.86	1413.72	15	2	1	NA	1	NA	6	0
PPFIA1	0	0	2	3	1178.1	2356.2	15	2	1	NA	1	NA	5	0
PPFIA4	0	0	10	38	1199.88	2399.76	15	2	1	NA	1	NA	48	0
PPFIBP2	0	0	6	3	976.14	1952.28	15	2	1	NA	1	NA	9	0
PPIB	0	0	0	2	170.28	340.56	15	2	1	NA	1	NA	2	0
PPID	0	0	1	1	367.29	734.58	15	2	1	NA	1	NA	2	0
PPIE	0	0	1	1	294.03	588.06	15	2	1	NA	1	NA	2	0
PPIG	0	0	2	2	735.57	1471.14	15	2	1	NA	1	NA	4	0
PPIP5K1	0	0	1	4	1416.69	2833.38	15	2	1	NA	1	NA	5	0
PPIP5K2	0	0	0	3	1130.91	2261.82	15	2	1	NA	1	NA	3	0
PPL	0	0	7	31	1745.37	3490.74	15	2	1	NA	1	NA	38	0
PPM1A	0	0	0	3	379.17	758.34	15	2	1	NA	1	NA	3	0
PPM1D	0	0	1	3	527.01	1054.02	15	2	1	NA	1	NA	4	0
PPM1E	0	0	4	2	628.98	1257.96	15	2	1	NA	1	NA	6	0
PPM1F	0	0	5	2	432.63	865.26	15	2	1	NA	1	NA	7	0
PPM1L	0	0	1	3	229.68	459.36	15	2	1	NA	1	NA	4	0
PPM1M	0	0	2	1	405.9	811.8	15	2	1	NA	1	NA	3	0
PPP1CC	0	0	4	4	320.76	641.52	15	2	1	NA	1	NA	8	0
PPP1R15B	0	0	7	9	497.97	995.94	15	2	1	NA	1	NA	16	0
PPP1R16B	0	0	0	3	566.28	1132.56	15	2	1	NA	1	NA	3	0
PPP1R2	0	0	2	1	218.46	436.92	15	2	1	NA	1	NA	3	0
PPP1R26	0	0	26	19	1338.48	2676.96	15	2	1	NA	1	NA	45	0
PPP1R36	0	0	6	1	383.13	766.26	15	2	1	NA	1	NA	7	0
PPP1R3C	0	0	3	3	312.18	624.36	15	2	1	NA	1	NA	6	0
PPP1R3D	0	0	2	0	303.93	607.86	15	2	1	NA	1	NA	2	0
PPP1R3E	0	0	0	4	622.71	1245.42	15	2	1	NA	1	NA	4	0
PPP1R7	0	0	2	3	352.44	704.88	15	2	1	NA	1	NA	5	0
PPP1R8	0	0	3	1	476.85	953.7	15	2	1	NA	1	NA	4	0
PPP1R9B	0	0	4	10	1349.37	2698.74	15	2	1	NA	1	NA	14	0
PPP2CB	0	0	1	2	306.9	613.8	15	2	1	NA	1	NA	3	0
PPP2R2B	0	0	0	2	439.56	879.12	15	2	1	NA	1	NA	2	0
PPP2R2C	0	0	0	2	475.2	950.4	15	2	1	NA	1	NA	2	0
PPP2R3A	0	0	3	3	1110.78	2221.56	15	2	1	NA	1	NA	6	0
PPP2R3C	0	0	1	2	430.32	860.64	15	2	1	NA	1	NA	3	0
PPP2R5C	0	0	0	2	520.74	1041.48	15	2	1	NA	1	NA	2	0
PPP2R5E	0	0	0	2	463.32	926.64	15	2	1	NA	1	NA	2	0
PPP3CC	0	0	1	4	490.71	981.42	15	2	1	NA	1	NA	5	0
PPP4R2	0	0	1	3	402.93	805.86	15	2	1	NA	1	NA	4	0
PPP4R3A	0	0	0	3	813.78	1627.56	15	2	1	NA	1	NA	3	0
PPP4R4	0	0	1	6	846.78	1693.56	15	2	1	NA	1	NA	7	0
PPP6C	0	0	0	3	302.94	605.88	15	2	1	NA	1	NA	3	0
PPP6R3	0	0	1	6	871.2	1742.4	15	2	1	NA	1	NA	7	0
PPRC1	0	0	27	43	1444.08	2888.16	15	2	1	NA	1	NA	70	0
PPT1	0	0	3	0	296.01	592.02	15	2	1	NA	1	NA	3	0
PPTC7	0	0	0	2	295.02	590.04	15	2	1	NA	1	NA	2	0
PPWD1	0	0	1	6	577.17	1154.34	15	2	1	NA	1	NA	7	0
PQLC2	0	0	3	8	297.99	595.98	15	2	1	NA	1	NA	11	0
PQLC2L	0	0	4	4	331.65	663.3	15	2	1	NA	1	NA	8	0
PRADC1	0	0	0	7	183.15	366.3	15	2	1	NA	1	NA	7	0
PRAM1	0	0	2	6	414.81	829.62	15	2	1	NA	1	NA	8	0
PRC1	0	0	2	6	527.01	1054.02	15	2	1	NA	1	NA	8	0
PRCC	0	0	2	7	412.83	825.66	15	2	1	NA	1	NA	9	0
PRDM10	0	0	3	7	1191.96	2383.92	15	2	1	NA	1	NA	10	0
PRDM11	0	0	0	9	1493.91	2987.82	15	2	1	NA	1	NA	9	0
PRDM12	0	0	0	5	348.48	696.96	15	2	1	NA	1	NA	5	0
PRDM16	0	0	5	4	939.51	1879.02	15	2	1	NA	1	NA	9	0
PRDM5	0	0	3	1	596.97	1193.94	15	2	1	NA	1	NA	4	0
PRDX6	0	0	1	2	222.75	445.5	15	2	1	NA	1	NA	3	0
PRELID1	0	0	1	4	183.48	366.96	15	2	1	NA	1	NA	5	0
PRELP	0	0	2	6	338.58	677.16	15	2	1	NA	1	NA	8	0
PREX1	0	0	5	12	1686.96	3373.92	15	2	1	NA	1	NA	17	0
PRG4	0	0	8	5	975.15	1950.3	15	2	1	NA	1	NA	13	0
PRICKLE2	0	0	3	16	834.57	1669.14	15	2	1	NA	1	NA	19	0
PRICKLE4	0	0	12	12	519.75	1039.5	15	2	1	NA	1	NA	24	0
PRIM1	0	0	4	3	383.13	766.26	15	2	1	NA	1	NA	7	0
PRKAA1	0	0	2	1	515.79	1031.58	15	2	1	NA	1	NA	3	0
PRKAA2	0	0	1	12	547.47	1094.94	15	2	1	NA	1	NA	13	0
PRKAB2	0	0	0	4	272.25	544.5	15	2	1	NA	1	NA	4	0
PRKACB	0	0	0	2	394.02	788.04	15	2	1	NA	1	NA	2	0
PRKAG3	0	0	5	4	357.39	714.78	15	2	1	NA	1	NA	9	0
PRKAR1A	0	0	0	3	326.7	653.4	15	2	1	NA	1	NA	3	0
PRKAR2A	0	0	1	4	396.99	793.98	15	2	1	NA	1	NA	5	0
PRKCA	0	0	0	3	578.16	1156.32	15	2	1	NA	1	NA	3	0
PRKCB	0	0	1	7	646.14	1292.28	15	2	1	NA	1	NA	8	0
PRKCD	0	0	0	3	676.17	1352.34	15	2	1	NA	1	NA	3	0
PRKCH	0	0	0	7	676.17	1352.34	15	2	1	NA	1	NA	7	0
PRKCZ	0	0	0	6	557.37	1114.74	15	2	1	NA	1	NA	6	0
PRKG2	0	0	3	3	762.96	1525.92	15	2	1	NA	1	NA	6	0
PRLH	0	0	0	2	55.11	110.22	15	2	1	NA	1	NA	2	0
PRLHR2	0	0	2	4	360.36	720.72	15	2	1	NA	1	NA	6	0
PRLHRL	0	0	4	9	343.53	687.06	15	2	1	NA	1	NA	13	0
PRLR	0	0	0	3	827.64	1655.28	15	2	1	NA	1	NA	3	0
PRMT7	0	0	6	5	682.11	1364.22	15	2	1	NA	1	NA	11	0
PRMT9	0	0	3	4	835.56	1671.12	15	2	1	NA	1	NA	7	0
PRNP	0	0	4	4	253.44	506.88	15	2	1	NA	1	NA	8	0
PROCA1	0	0	4	10	265.32	530.64	15	2	1	NA	1	NA	14	0
PROCR	0	0	1	4	218.46	436.92	15	2	1	NA	1	NA	5	0
PRODH	0	0	3	3	565.29	1130.58	15	2	1	NA	1	NA	6	0
PROM1	0	0	6	2	860.31	1720.62	15	2	1	NA	1	NA	8	0
PROM1L	0	0	17	18	722.04	1444.08	15	2	1	NA	1	NA	35	0
PROM2	0	0	1	3	816.75	1633.5	15	2	1	NA	1	NA	4	0
PROSC	0	0	2	4	274.23	548.46	15	2	1	NA	1	NA	6	0
PROX2	0	0	15	15	640.53	1281.06	15	2	1	NA	1	NA	30	0
PRPF19	0	0	0	6	493.68	987.36	15	2	1	NA	1	NA	6	0
PRPF3	0	0	0	10	678.15	1356.3	15	2	1	NA	1	NA	10	0
PRPF38A	0	0	0	2	309.87	619.74	15	2	1	NA	1	NA	2	0
PRPF38B	0	0	1	2	544.5	1089	15	2	1	NA	1	NA	3	0
PRPF39	0	0	3	9	610.83	1221.66	15	2	1	NA	1	NA	12	0
PRPF4	0	0	1	6	507.87	1015.74	15	2	1	NA	1	NA	7	0
PRPF40A	0	0	1	11	976.14	1952.28	15	2	1	NA	1	NA	12	0
PRPF6	0	0	0	23	931.92	1863.84	15	2	1	NA	1	NA	23	0
PRPF8	0	0	1	30	2312.64	4625.28	15	2	1	NA	1	NA	31	0
PRPH	0	0	0	7	221.1	442.2	15	2	1	NA	1	NA	7	0
PRPS1-PRPS2	0	0	0	6	315.81	631.62	15	2	1	NA	1	NA	6	0
PRPSAP1	0	0	1	7	376.86	753.72	15	2	1	NA	1	NA	8	0
PRR11	0	0	5	4	341.88	683.76	15	2	1	NA	1	NA	9	0
PRR15L	0	0	1	3	96.03	192.06	15	2	1	NA	1	NA	4	0
PRR16	0	0	1	1	229.68	459.36	15	2	1	NA	1	NA	2	0
PRR29	0	0	5	3	462.66	925.32	15	2	1	NA	1	NA	8	0
PRR33	0	0	8	2	527.67	1055.34	15	2	1	NA	1	NA	10	0
PRR35	0	0	6	11	842.49	1684.98	15	2	1	NA	1	NA	17	0
PRR5L	0	0	1	1	363.33	726.66	15	2	1	NA	1	NA	2	0
PRRC1	0	0	1	2	421.74	843.48	15	2	1	NA	1	NA	3	0
PRRC2B	0	0	25	19	2223.54	4447.08	15	2	1	NA	1	NA	44	0
PRRC2C	0	0	28	31	3283.83	6567.66	15	2	1	NA	1	NA	59	0
PRRG3	0	0	2	2	230.67	461.34	15	2	1	NA	1	NA	4	0
PRRG4	0	0	1	2	222.75	445.5	15	2	1	NA	1	NA	3	0
PRRT3	0	0	21	25	723.03	1446.06	15	2	1	NA	1	NA	46	0
PRRX1	0	0	0	2	164.01	328.02	15	2	1	NA	1	NA	2	0
PRRX2	0	0	4	6	305.58	611.16	15	2	1	NA	1	NA	10	0
PRSS56	0	0	14	15	663.3	1326.6	15	2	1	NA	1	NA	29	0
PRSS57	0	0	2	5	283.14	566.28	15	2	1	NA	1	NA	7	0
PRTG	0	0	9	10	1190.97	2381.94	15	2	1	NA	1	NA	19	0
PRUNE1	0	0	2	4	412.5	825	15	2	1	NA	1	NA	6	0
PRUNE2	0	0	14	4	2908.29	5816.58	15	2	1	NA	1	NA	18	0
PSAP	0	0	1	5	510.84	1021.68	15	2	1	NA	1	NA	6	0
PSD	0	0	7	8	693.33	1386.66	15	2	1	NA	1	NA	15	0
PSD2	0	0	6	3	823.68	1647.36	15	2	1	NA	1	NA	9	0
PSD3	0	0	12	8	976.47	1952.94	15	2	1	NA	1	NA	20	0
PSKH1	0	0	0	4	413.16	826.32	15	2	1	NA	1	NA	4	0
PSMA1	0	0	0	7	259.38	518.76	15	2	1	NA	1	NA	7	0
PSMA3	0	0	0	6	253.44	506.88	15	2	1	NA	1	NA	6	0
PSMA4	0	0	0	3	259.38	518.76	15	2	1	NA	1	NA	3	0
PSMA5	0	0	0	3	230.01	460.02	15	2	1	NA	1	NA	3	0
PSMA6	0	0	0	2	225.39	450.78	15	2	1	NA	1	NA	2	0
PSMB2	0	0	0	2	229.35	458.7	15	2	1	NA	1	NA	2	0
PSMB3	0	0	1	3	242.88	485.76	15	2	1	NA	1	NA	4	0
PSMB4	0	0	0	3	253.77	507.54	15	2	1	NA	1	NA	3	0
PSMB7	0	0	1	3	275.22	550.44	15	2	1	NA	1	NA	4	0
PSMC1	0	0	0	5	436.59	873.18	15	2	1	NA	1	NA	5	0
PSMC3	0	0	0	3	418.77	837.54	15	2	1	NA	1	NA	3	0
PSMC3IP	0	0	2	5	214.83	429.66	15	2	1	NA	1	NA	7	0
PSMC5	0	0	0	6	392.04	784.08	15	2	1	NA	1	NA	6	0
PSMC6	0	0	0	4	399.96	799.92	15	2	1	NA	1	NA	4	0
PSMD1	0	0	0	8	621.39	1242.78	15	2	1	NA	1	NA	8	0
PSMD10	0	0	1	1	205.26	410.52	15	2	1	NA	1	NA	2	0
PSMD11	0	0	0	2	395.01	790.02	15	2	1	NA	1	NA	2	0
PSMD12	0	0	1	2	452.43	904.86	15	2	1	NA	1	NA	3	0
PSMD13	0	0	1	1	363.99	727.98	15	2	1	NA	1	NA	2	0
PSMD2	0	0	0	17	851.4	1702.8	15	2	1	NA	1	NA	17	0
PSMD3	0	0	8	14	895.95	1791.9	15	2	1	NA	1	NA	22	0
PSMD5	0	0	1	3	499.95	999.9	15	2	1	NA	1	NA	4	0
PSMD6	0	0	3	2	386.1	772.2	15	2	1	NA	1	NA	5	0
PSMD7	0	0	0	3	305.58	611.16	15	2	1	NA	1	NA	3	0
PSMD9	0	0	1	1	208.89	417.78	15	2	1	NA	1	NA	2	0
PSME3	0	0	0	2	238.59	477.18	15	2	1	NA	1	NA	2	0
PSMF1	0	0	5	3	268.29	536.58	15	2	1	NA	1	NA	8	0
PSMG3	0	0	1	1	156.42	312.84	15	2	1	NA	1	NA	2	0
PSPH	0	0	0	2	224.73	449.46	15	2	1	NA	1	NA	2	0
PSTK	0	0	6	2	319.77	639.54	15	2	1	NA	1	NA	8	0
PSTPIP1	0	0	5	4	402.93	805.86	15	2	1	NA	1	NA	9	0
PSTPIP2	0	0	0	2	320.76	641.52	15	2	1	NA	1	NA	2	0
PTBP1	0	0	0	3	539.55	1079.1	15	2	1	NA	1	NA	3	0
PTBP2	0	0	0	7	532.62	1065.24	15	2	1	NA	1	NA	7	0
PTBP3	0	0	10	4	863.94	1727.88	15	2	1	NA	1	NA	14	0
PTCD2	0	0	2	1	423.06	846.12	15	2	1	NA	1	NA	3	0
PTCD3	0	0	6	3	642.51	1285.02	15	2	1	NA	1	NA	9	0
PTCH1	0	0	2	12	1270.83	2541.66	15	2	1	NA	1	NA	14	0
PTCH2	0	0	8	13	1155	2310	15	2	1	NA	1	NA	21	0
PTDSS2	0	0	0	3	434.28	868.56	15	2	1	NA	1	NA	3	0
PTGDR	0	0	1	1	88.11	176.22	15	2	1	NA	1	NA	2	0
PTGER2	0	0	3	11	297.66	595.32	15	2	1	NA	1	NA	14	0
PTGER3	0	0	3	13	365.64	731.28	15	2	1	NA	1	NA	16	0
PTGER4	0	0	0	3	470.25	940.5	15	2	1	NA	1	NA	3	0
PTGES	0	0	2	4	145.53	291.06	15	2	1	NA	1	NA	6	0
PTGES2	0	0	3	5	350.46	700.92	15	2	1	NA	1	NA	8	0
PTGR1	0	0	2	0	323.4	646.8	15	2	1	NA	1	NA	2	0
PTGR2	0	0	7	3	344.52	689.04	15	2	1	NA	1	NA	10	0
PTGS1	0	0	2	12	577.17	1154.34	15	2	1	NA	1	NA	14	0
PTHRL	0	0	6	16	531.63	1063.26	15	2	1	NA	1	NA	22	0
PTP4A2	0	0	0	2	166.32	332.64	15	2	1	NA	1	NA	2	0
PTPA	0	0	0	9	310.53	621.06	15	2	1	NA	1	NA	9	0
PTPDC1	0	0	4	6	736.56	1473.12	15	2	1	NA	1	NA	10	0
PTPN1	0	0	0	2	431.64	863.28	15	2	1	NA	1	NA	2	0
PTPN11	0	0	1	4	633.27	1266.54	15	2	1	NA	1	NA	5	0
PTPN13	0	0	17	13	2503.38	5006.76	15	2	1	NA	1	NA	30	0
PTPN21	0	0	4	6	1208.79	2417.58	15	2	1	NA	1	NA	10	0
PTPN22	0	0	2	2	1312.74	2625.48	15	2	1	NA	1	NA	4	0
PTPN4	0	0	2	2	920.7	1841.4	15	2	1	NA	1	NA	4	0
PTPN5	0	0	1	1	551.43	1102.86	15	2	1	NA	1	NA	2	0
PTPN7	0	0	5	8	360.36	720.72	15	2	1	NA	1	NA	13	0
PTPN9	0	0	2	8	564.3	1128.6	15	2	1	NA	1	NA	10	0
PTPRC	0	0	4	3	1071.84	2143.68	15	2	1	NA	1	NA	7	0
PTPRD	0	0	3	0	1084.38	2168.76	15	2	1	NA	1	NA	3	0
PTPRE	0	0	1	6	690.03	1380.06	15	2	1	NA	1	NA	7	0
PTPRF	0	0	1	16	1771.11	3542.22	15	2	1	NA	1	NA	17	0
PTPRG	0	0	2	10	1135.2	2270.4	15	2	1	NA	1	NA	12	0
PTPRJ	0	0	8	11	768.57	1537.14	15	2	1	NA	1	NA	19	0
PTPRS	0	0	3	17	1873.74	3747.48	15	2	1	NA	1	NA	20	0
PTPRT	0	0	13	9	1227.6	2455.2	15	2	1	NA	1	NA	22	0
PTPRU	0	0	14	27	1478.73	2957.46	15	2	1	NA	1	NA	41	0
PTPRVP	0	0	26	32	2241.69	4483.38	15	2	1	NA	1	NA	58	0
PTRF	0	0	1	4	358.38	716.76	15	2	1	NA	1	NA	5	0
PTRH2	0	0	1	2	170.94	341.88	15	2	1	NA	1	NA	3	0
PTS	0	0	0	2	147.51	295.02	15	2	1	NA	1	NA	2	0
PTX3	0	0	2	5	426.69	853.38	15	2	1	NA	1	NA	7	0
PUM1	0	0	0	12	1143.45	2286.9	15	2	1	NA	1	NA	12	0
PUM3	0	0	4	0	610.5	1221	15	2	1	NA	1	NA	4	0
PUS1	0	0	28	16	1397.88	2795.76	15	2	1	NA	1	NA	44	0
PUSL1	0	0	4	7	645.15	1290.3	15	2	1	NA	1	NA	11	0
PWWP2A	0	0	3	2	783.09	1566.18	15	2	1	NA	1	NA	5	0
PWWP2B	0	0	12	9	887.04	1774.08	15	2	1	NA	1	NA	21	0
PXDNL	0	0	6	20	1392.93	2785.86	15	2	1	NA	1	NA	26	0
PXMP4	0	0	2	4	215.82	431.64	15	2	1	NA	1	NA	6	0
PXYLP1	0	0	8	8	564.3	1128.6	15	2	1	NA	1	NA	16	0
PYCR1	0	0	0	2	269.28	538.56	15	2	1	NA	1	NA	2	0
PYCRL	0	0	0	3	131.01	262.02	15	2	1	NA	1	NA	3	0
PYGL	0	0	18	48	813.78	1627.56	15	2	1	NA	1	NA	66	0
PYGO1	0	0	2	5	398.64	797.28	15	2	1	NA	1	NA	7	0
QDPR	0	0	2	2	236.61	473.22	15	2	1	NA	1	NA	4	0
QPCTL	0	0	1	1	86.79	173.58	15	2	1	NA	1	NA	2	0
QRFP	0	0	6	3	130.68	261.36	15	2	1	NA	1	NA	9	0
QRFPR	0	0	2	2	428.67	857.34	15	2	1	NA	1	NA	4	0
QRICH1	0	0	0	7	775.17	1550.34	15	2	1	NA	1	NA	7	0
QRICH2	0	0	10	14	396.66	793.32	15	2	1	NA	1	NA	24	0
QSER1	0	0	6	6	878.79	1757.58	15	2	1	NA	1	NA	12	0
QSOX1	0	0	9	13	642.84	1285.68	15	2	1	NA	1	NA	22	0
QSOX2	0	0	5	7	667.26	1334.52	15	2	1	NA	1	NA	12	0
R3HCC1	0	0	18	13	638.55	1277.1	15	2	1	NA	1	NA	31	0
R3HCC1L	0	0	16	13	639.54	1279.08	15	2	1	NA	1	NA	29	0
R3HDM1	0	0	4	5	1105.83	2211.66	15	2	1	NA	1	NA	9	0
R3HDM2	0	0	2	3	1041.48	2082.96	15	2	1	NA	1	NA	5	0
R3HDM4	0	0	3	8	258.39	516.78	15	2	1	NA	1	NA	11	0
R3HDML	0	0	3	6	251.46	502.92	15	2	1	NA	1	NA	9	0
RAB11B	0	0	0	3	207.9	415.8	15	2	1	NA	1	NA	3	0
RAB11FIP1	0	0	17	10	1349.7	2699.4	15	2	1	NA	1	NA	27	0
RAB11FIP2	0	0	5	2	505.89	1011.78	15	2	1	NA	1	NA	7	0
RAB11FIP4	0	0	4	1	609.84	1219.68	15	2	1	NA	1	NA	5	0
RAB11FIP5	0	0	29	25	1011.12	2022.24	15	2	1	NA	1	NA	54	0
RAB18L	0	0	1	1	202.95	405.9	15	2	1	NA	1	NA	2	0
RAB22A	0	0	1	1	193.05	386.1	15	2	1	NA	1	NA	2	0
RAB24	0	0	1	6	178.53	357.06	15	2	1	NA	1	NA	7	0
RAB25	0	0	3	5	211.86	423.72	15	2	1	NA	1	NA	8	0
RAB26	0	0	0	3	190.08	380.16	15	2	1	NA	1	NA	3	0
RAB27A	0	0	1	4	219.78	439.56	15	2	1	NA	1	NA	5	0
RAB2B	0	0	3	7	213.51	427.02	15	2	1	NA	1	NA	10	0
RAB34	0	0	2	3	120.12	240.24	15	2	1	NA	1	NA	5	0
RAB37	0	0	2	3	198.33	396.66	15	2	1	NA	1	NA	5	0
RAB39B	0	0	0	2	189.75	379.5	15	2	1	NA	1	NA	2	0
RAB3GAP1	0	0	5	1	980.1	1960.2	15	2	1	NA	1	NA	6	0
RAB3IL1	0	0	2	2	411.84	823.68	15	2	1	NA	1	NA	4	0
RAB40B	0	0	0	2	276.21	552.42	15	2	1	NA	1	NA	2	0
RAB40C	0	0	0	3	265.65	531.3	15	2	1	NA	1	NA	3	0
RAB42	0	0	4	8	213.84	427.68	15	2	1	NA	1	NA	12	0
RAB44	0	0	14	8	1716	3432	15	2	1	NA	1	NA	22	0
RAB5C	0	0	0	3	214.83	429.66	15	2	1	NA	1	NA	3	0
RAB7B	0	0	3	6	205.92	411.84	15	2	1	NA	1	NA	9	0
RAB8A	0	0	1	1	205.92	411.84	15	2	1	NA	1	NA	2	0
RAB9B	0	0	0	3	199.98	399.96	15	2	1	NA	1	NA	3	0
RABEP1	0	0	2	3	854.04	1708.08	15	2	1	NA	1	NA	5	0
RABEPK	0	0	7	7	362.34	724.68	15	2	1	NA	1	NA	14	0
RABGAP1	0	0	2	2	606.87	1213.74	15	2	1	NA	1	NA	4	0
RABGAP1L	0	0	9	2	901.89	1803.78	15	2	1	NA	1	NA	11	0
RABL6	0	0	2	2	760.32	1520.64	15	2	1	NA	1	NA	4	0
RACGAP1	0	0	2	6	625.68	1251.36	15	2	1	NA	1	NA	8	0
RACGAP1L	0	0	14	5	517.77	1035.54	15	2	1	NA	1	NA	19	0
RACK1	0	0	0	17	314.82	629.64	15	2	1	NA	1	NA	17	0
RAD17	0	0	1	1	608.85	1217.7	15	2	1	NA	1	NA	2	0
RAD18	0	0	5	7	556.38	1112.76	15	2	1	NA	1	NA	12	0
RAD21L1	0	0	5	6	562.32	1124.64	15	2	1	NA	1	NA	11	0
RAD23B	0	0	2	1	355.08	710.16	15	2	1	NA	1	NA	3	0
RAD50	0	0	3	8	1299.87	2599.74	15	2	1	NA	1	NA	11	0
RAD51	0	0	0	4	336.6	673.2	15	2	1	NA	1	NA	4	0
RAD51B	0	0	5	4	281.16	562.32	15	2	1	NA	1	NA	9	0
RAD51C	0	0	4	4	363.33	726.66	15	2	1	NA	1	NA	8	0
RAD51D	0	0	3	5	326.7	653.4	15	2	1	NA	1	NA	8	0
RAD54L	0	0	7	9	737.55	1475.1	15	2	1	NA	1	NA	16	0
RAD9B	0	0	2	6	303.6	607.2	15	2	1	NA	1	NA	8	0
RADIL	0	0	16	27	1097.25	2194.5	15	2	1	NA	1	NA	43	0
RAF1	0	0	0	6	641.52	1283.04	15	2	1	NA	1	NA	6	0
RAG1	0	0	4	12	1031.58	2063.16	15	2	1	NA	1	NA	16	0
RAG2	0	0	7	6	529.65	1059.3	15	2	1	NA	1	NA	13	0
RAI14	0	0	4	1	928.29	1856.58	15	2	1	NA	1	NA	5	0
RALB	0	0	0	3	204.93	409.86	15	2	1	NA	1	NA	3	0
RALGAPA1	0	0	8	8	2492.49	4984.98	15	2	1	NA	1	NA	16	0
RALGAPB	0	0	5	7	1477.08	2954.16	15	2	1	NA	1	NA	12	0
RALGDS	0	0	2	16	789.69	1579.38	15	2	1	NA	1	NA	18	0
RALGPS1	0	0	1	1	426.36	852.72	15	2	1	NA	1	NA	2	0
RAMP1	0	0	2	0	143.55	287.1	15	2	1	NA	1	NA	2	0
RANBP10	0	0	1	6	603.9	1207.8	15	2	1	NA	1	NA	7	0
RANBP3	0	0	1	3	506.55	1013.1	15	2	1	NA	1	NA	4	0
RANBP3L	0	0	9	1	637.56	1275.12	15	2	1	NA	1	NA	10	0
RAP1GAP1-RAP1GAP2	0	0	0	6	422.4	844.8	15	2	1	NA	1	NA	6	0
RAP1GDS1L	0	0	4	1	502.92	1005.84	15	2	1	NA	1	NA	5	0
RAP2B	0	0	0	2	165.66	331.32	15	2	1	NA	1	NA	2	0
RAPGEF1	0	0	0	6	779.79	1559.58	15	2	1	NA	1	NA	6	0
RAPGEF2	0	0	2	5	1770.45	3540.9	15	2	1	NA	1	NA	7	0
RAPGEF3	0	0	5	24	941.16	1882.32	15	2	1	NA	1	NA	29	0
RAPGEF6	0	0	3	16	1667.16	3334.32	15	2	1	NA	1	NA	19	0
RAPSN	0	0	0	2	416.79	833.58	15	2	1	NA	1	NA	2	0
RARRES1	0	0	2	3	272.91	545.82	15	2	1	NA	1	NA	5	0
RARS	0	0	0	6	655.38	1310.76	15	2	1	NA	1	NA	6	0
RASA1	0	0	10	42	884.07	1768.14	15	2	1	NA	1	NA	52	0
RASA4	0	0	8	13	773.52	1547.04	15	2	1	NA	1	NA	21	0
RASAL1	0	0	17	18	781.44	1562.88	15	2	1	NA	1	NA	35	0
RASAL2	0	0	1	4	1065.24	2130.48	15	2	1	NA	1	NA	5	0
RASD1	0	0	2	5	276.21	552.42	15	2	1	NA	1	NA	7	0
RASEF	0	0	5	0	676.83	1353.66	15	2	1	NA	1	NA	5	0
RASGEF1A	0	0	0	3	495.66	991.32	15	2	1	NA	1	NA	3	0
RASGEF1B	0	0	2	2	468.27	936.54	15	2	1	NA	1	NA	4	0
RASGEF1C	0	0	3	6	830.61	1661.22	15	2	1	NA	1	NA	9	0
RASGRP1	0	0	1	1	754.71	1509.42	15	2	1	NA	1	NA	2	0
RASL10A	0	0	0	6	206.91	413.82	15	2	1	NA	1	NA	6	0
RASL12	0	0	2	5	269.28	538.56	15	2	1	NA	1	NA	7	0
RASSF2	0	0	0	2	299.97	599.94	15	2	1	NA	1	NA	2	0
RASSF5	0	0	0	4	263.34	526.68	15	2	1	NA	1	NA	4	0
RASSF6	0	0	1	5	338.58	677.16	15	2	1	NA	1	NA	6	0
RAVER2	0	0	7	6	490.05	980.1	15	2	1	NA	1	NA	13	0
RAX	0	0	2	2	315.15	630.3	15	2	1	NA	1	NA	4	0
RAX2	0	0	5	2	219.45	438.9	15	2	1	NA	1	NA	7	0
RBBP4	0	0	2	3	416.46	832.92	15	2	1	NA	1	NA	5	0
RBBP5	0	0	5	12	767.25	1534.5	15	2	1	NA	1	NA	17	0
RBBP6	0	0	6	2	1812.69	3625.38	15	2	1	NA	1	NA	8	0
RBBP8NL	0	0	6	11	675.18	1350.36	15	2	1	NA	1	NA	17	0
RBFOX3	0	0	0	5	322.74	645.48	15	2	1	NA	1	NA	5	0
RBL1	0	0	5	1	1002.21	2004.42	15	2	1	NA	1	NA	6	0
RBL2	0	0	9	4	1054.02	2108.04	15	2	1	NA	1	NA	13	0
RBM12	0	0	0	6	872.19	1744.38	15	2	1	NA	1	NA	6	0
RBM15	0	0	1	7	786.72	1573.44	15	2	1	NA	1	NA	8	0
RBM18	0	0	1	4	153.12	306.24	15	2	1	NA	1	NA	5	0
RBM19	0	0	7	5	947.43	1894.86	15	2	1	NA	1	NA	12	0
RBM20	0	0	5	10	1176.12	2352.24	15	2	1	NA	1	NA	15	0
RBM22	0	0	0	6	416.79	833.58	15	2	1	NA	1	NA	6	0
RBM25	0	0	1	4	887.7	1775.4	15	2	1	NA	1	NA	5	0
RBM27	0	0	5	3	979.11	1958.22	15	2	1	NA	1	NA	8	0
RBM41	0	0	5	5	396.99	793.98	15	2	1	NA	1	NA	10	0
RBM43	0	0	2	3	365.31	730.62	15	2	1	NA	1	NA	5	0
RBM44	0	0	8	5	990.99	1981.98	15	2	1	NA	1	NA	13	0
RBM47	0	0	4	16	593.01	1186.02	15	2	1	NA	1	NA	20	0
RBM5	0	0	1	6	898.26	1796.52	15	2	1	NA	1	NA	7	0
RBM7	0	0	1	1	271.59	543.18	15	2	1	NA	1	NA	2	0
RBMS2	0	0	1	1	224.73	449.46	15	2	1	NA	1	NA	2	0
RBMX	0	0	1	1	377.19	754.38	15	2	1	NA	1	NA	2	0
RBMX2	0	0	2	1	528	1056	15	2	1	NA	1	NA	3	0
RBP	0	0	0	2	236.61	473.22	15	2	1	NA	1	NA	2	0
RBP1	0	0	3	1	133.65	267.3	15	2	1	NA	1	NA	4	0
RBP14L	0	0	3	12	255.42	510.84	15	2	1	NA	1	NA	15	0
RBP3	0	0	12	2	1174.8	2349.6	15	2	1	NA	1	NA	14	0
RBP4	0	0	0	3	168.96	337.92	15	2	1	NA	1	NA	3	0
RBP7	0	0	0	2	133.65	267.3	15	2	1	NA	1	NA	2	0
RBPJL	0	0	5	6	481.8	963.6	15	2	1	NA	1	NA	11	0
RBPMS	0	0	0	5	173.25	346.5	15	2	1	NA	1	NA	5	0
RBSN	0	0	2	0	767.25	1534.5	15	2	1	NA	1	NA	2	0
RC3H1	0	0	1	6	1112.76	2225.52	15	2	1	NA	1	NA	7	0
RC3H2	0	0	2	6	1180.08	2360.16	15	2	1	NA	1	NA	8	0
RCC1	0	0	3	12	417.78	835.56	15	2	1	NA	1	NA	15	0
RCC1L	0	0	2	7	449.46	898.92	15	2	1	NA	1	NA	9	0
RCC2	0	0	2	7	442.86	885.72	15	2	1	NA	1	NA	9	0
RCCD1	0	0	3	3	268.62	537.24	15	2	1	NA	1	NA	6	0
RCL1	0	0	1	1	353.43	706.86	15	2	1	NA	1	NA	2	0
RCN1L	0	0	2	3	304.26	608.52	15	2	1	NA	1	NA	5	0
RCN2	0	0	0	2	275.88	551.76	15	2	1	NA	1	NA	2	0
RCOR1	0	0	0	2	453.42	906.84	15	2	1	NA	1	NA	2	0
RD3L	0	0	1	1	197.01	394.02	15	2	1	NA	1	NA	2	0
RDH12	0	0	2	0	321.09	642.18	15	2	1	NA	1	NA	2	0
RDH16	0	0	3	3	317.79	635.58	15	2	1	NA	1	NA	6	0
RDH8	0	0	8	2	1005.84	2011.68	15	2	1	NA	1	NA	10	0
RDM1	0	0	3	1	278.19	556.38	15	2	1	NA	1	NA	4	0
REC114	0	0	2	2	236.61	473.22	15	2	1	NA	1	NA	4	0
RECQL5	0	0	5	9	1066.23	2132.46	15	2	1	NA	1	NA	14	0
REEP1-REEP4	0	0	1	2	213.84	427.68	15	2	1	NA	1	NA	3	0
REEP3	0	0	2	0	244.86	489.72	15	2	1	NA	1	NA	2	0
REEP6	0	0	3	3	176.88	353.76	15	2	1	NA	1	NA	6	0
REG4	0	0	0	4	157.41	314.82	15	2	1	NA	1	NA	4	0
RELL1	0	0	2	2	262.02	524.04	15	2	1	NA	1	NA	4	0
REM1	0	0	4	1	291.06	582.12	15	2	1	NA	1	NA	5	0
REN	0	0	2	16	404.91	809.82	15	2	1	NA	1	NA	18	0
RERE	0	0	7	16	1560.24	3120.48	15	2	1	NA	1	NA	23	0
REST	0	0	3	4	886.05	1772.1	15	2	1	NA	1	NA	7	0
RET	0	0	1	4	1125.63	2251.26	15	2	1	NA	1	NA	5	0
REXO1	0	0	5	5	1179.09	2358.18	15	2	1	NA	1	NA	10	0
REXO4	0	0	3	4	396	792	15	2	1	NA	1	NA	7	0
REXO5	0	0	3	5	769.56	1539.12	15	2	1	NA	1	NA	8	0
RFC1	0	0	5	8	1114.41	2228.82	15	2	1	NA	1	NA	13	0
RFC2	0	0	3	6	348.81	697.62	15	2	1	NA	1	NA	9	0
RFC4	0	0	1	1	359.37	718.74	15	2	1	NA	1	NA	2	0
RFC5	0	0	0	3	320.76	641.52	15	2	1	NA	1	NA	3	0
RFFL	0	0	5	7	398.97	797.94	15	2	1	NA	1	NA	12	0
RFLNB	0	0	0	3	196.35	392.7	15	2	1	NA	1	NA	3	0
RFT1	0	0	4	7	534.6	1069.2	15	2	1	NA	1	NA	11	0
RFTN2	0	0	2	6	627.66	1255.32	15	2	1	NA	1	NA	8	0
RFX3	0	0	2	0	684.75	1369.5	15	2	1	NA	1	NA	2	0
RFX7	0	0	5	5	1364.88	2729.76	15	2	1	NA	1	NA	10	0
RFXANK	0	0	2	6	259.38	518.76	15	2	1	NA	1	NA	8	0
RGI3L1	0	0	22	32	1221	2442	15	2	1	NA	1	NA	54	0
RGL1	0	0	6	9	779.46	1558.92	15	2	1	NA	1	NA	15	0
RGMA	0	0	1	4	446.49	892.98	15	2	1	NA	1	NA	5	0
RGMB	0	0	2	1	319.77	639.54	15	2	1	NA	1	NA	3	0
RGP1	0	0	1	4	358.71	717.42	15	2	1	NA	1	NA	5	0
RGS1	0	0	3	4	198	396	15	2	1	NA	1	NA	7	0
RGS10	0	0	0	2	176.88	353.76	15	2	1	NA	1	NA	2	0
RGS12	0	0	3	4	1519.65	3039.3	15	2	1	NA	1	NA	7	0
RGS14	0	0	2	10	563.31	1126.62	15	2	1	NA	1	NA	12	0
RGS16	0	0	0	2	201.96	403.92	15	2	1	NA	1	NA	2	0
RGS19	0	0	0	4	198	396	15	2	1	NA	1	NA	4	0
RGS2	0	0	2	1	210.87	421.74	15	2	1	NA	1	NA	3	0
RGS3	0	0	13	17	1014.75	2029.5	15	2	1	NA	1	NA	30	0
RGS4	0	0	3	7	207.9	415.8	15	2	1	NA	1	NA	10	0
RGS6	0	0	1	4	467.28	934.56	15	2	1	NA	1	NA	5	0
RGS7BP	0	0	2	3	341.88	683.76	15	2	1	NA	1	NA	5	0
RGS9	0	0	5	5	646.47	1292.94	15	2	1	NA	1	NA	10	0
RGSL1	0	0	11	18	1093.95	2187.9	15	2	1	NA	1	NA	29	0
RHBDD1	0	0	5	3	315.81	631.62	15	2	1	NA	1	NA	8	0
RHBDD2	0	0	0	4	182.49	364.98	15	2	1	NA	1	NA	4	0
RHBDF2	0	0	2	18	820.71	1641.42	15	2	1	NA	1	NA	20	0
RHBDL3	0	0	1	3	366.3	732.6	15	2	1	NA	1	NA	4	0
RHBG	0	0	5	9	409.53	819.06	15	2	1	NA	1	NA	14	0
RHCG	0	0	1	6	463.32	926.64	15	2	1	NA	1	NA	7	0
RHO	0	0	0	3	348.48	696.96	15	2	1	NA	1	NA	3	0
RHOBTB1	0	0	1	1	689.04	1378.08	15	2	1	NA	1	NA	2	0
RHOBTB2	0	0	1	13	752.4	1504.8	15	2	1	NA	1	NA	14	0
RHOD	0	0	3	4	203.94	407.88	15	2	1	NA	1	NA	7	0
RHOF	0	0	1	2	205.92	411.84	15	2	1	NA	1	NA	3	0
RHOH	0	0	1	2	190.08	380.16	15	2	1	NA	1	NA	3	0
RHOT1	0	0	2	3	626.67	1253.34	15	2	1	NA	1	NA	5	0
RHPN2	0	0	2	2	677.16	1354.32	15	2	1	NA	1	NA	4	0
RIC1	0	0	3	5	1497.54	2995.08	15	2	1	NA	1	NA	8	0
RIC3	0	0	4	2	366.63	733.26	15	2	1	NA	1	NA	6	0
RIC8A	0	0	2	8	534.6	1069.2	15	2	1	NA	1	NA	10	0
RICTOR	0	0	4	3	1689.27	3378.54	15	2	1	NA	1	NA	7	0
RIF1	0	0	22	26	2237.73	4475.46	15	2	1	NA	1	NA	48	0
RILP	0	0	11	8	405.9	811.8	15	2	1	NA	1	NA	19	0
RILPL1	0	0	0	2	397.98	795.96	15	2	1	NA	1	NA	2	0
RILPL2	0	0	1	1	210.87	421.74	15	2	1	NA	1	NA	2	0
RIMBP2	0	0	4	11	1495.89	2991.78	15	2	1	NA	1	NA	15	0
RIMS3	0	0	1	4	306.9	613.8	15	2	1	NA	1	NA	5	0
RIMS4	0	0	2	2	268.29	536.58	15	2	1	NA	1	NA	4	0
RIN3	0	0	4	3	967.56	1935.12	15	2	1	NA	1	NA	7	0
RIOK2	0	0	4	4	537.24	1074.48	15	2	1	NA	1	NA	8	0
RIPK3	0	0	3	2	459.36	918.72	15	2	1	NA	1	NA	5	0
RLBP1	0	0	2	4	313.83	627.66	15	2	1	NA	1	NA	6	0
RLF	0	0	4	6	1959.54	3919.08	15	2	1	NA	1	NA	10	0
RLN3	0	0	1	2	165.33	330.66	15	2	1	NA	1	NA	3	0
RLTPR	0	0	25	23	1384.68	2769.36	15	2	1	NA	1	NA	48	0
RMDN3	0	0	1	2	449.46	898.92	15	2	1	NA	1	NA	3	0
RMI1	0	0	2	1	613.8	1227.6	15	2	1	NA	1	NA	3	0
RMI2	0	0	1	1	138.6	277.2	15	2	1	NA	1	NA	2	0
RMND5A	0	0	1	6	341.22	682.44	15	2	1	NA	1	NA	7	0
RNASEL	0	0	14	8	716.1	1432.2	15	2	1	NA	1	NA	22	0
RND1	0	0	5	0	114.51	229.02	15	2	1	NA	1	NA	5	0
RND2	0	0	1	2	215.49	430.98	15	2	1	NA	1	NA	3	0
RND3	0	0	0	3	242.55	485.1	15	2	1	NA	1	NA	3	0
RNF103	0	0	1	3	680.13	1360.26	15	2	1	NA	1	NA	4	0
RNF111	0	0	2	8	976.14	1952.28	15	2	1	NA	1	NA	10	0
RNF113A	0	0	2	3	323.73	647.46	15	2	1	NA	1	NA	5	0
RNF114	0	0	0	2	229.68	459.36	15	2	1	NA	1	NA	2	0
RNF122	0	0	1	1	151.14	302.28	15	2	1	NA	1	NA	2	0
RNF126	0	0	0	3	225.72	451.44	15	2	1	NA	1	NA	3	0
RNF128	0	0	2	3	391.71	783.42	15	2	1	NA	1	NA	5	0
RNF130	0	0	0	5	468.27	936.54	15	2	1	NA	1	NA	5	0
RNF14	0	0	0	6	470.25	940.5	15	2	1	NA	1	NA	6	0
RNF141	0	0	0	2	240.57	481.14	15	2	1	NA	1	NA	2	0
RNF145	0	0	4	6	703.23	1406.46	15	2	1	NA	1	NA	10	0
RNF150	0	0	0	2	267.3	534.6	15	2	1	NA	1	NA	2	0
RNF157	0	0	7	15	650.76	1301.52	15	2	1	NA	1	NA	22	0
RNF165	0	0	2	3	408.54	817.08	15	2	1	NA	1	NA	5	0
RNF166	0	0	1	2	252.45	504.9	15	2	1	NA	1	NA	3	0
RNF168	0	0	6	1	604.89	1209.78	15	2	1	NA	1	NA	7	0
RNF180	0	0	2	0	96.03	192.06	15	2	1	NA	1	NA	2	0
RNF186	0	0	1	2	336.6	673.2	15	2	1	NA	1	NA	3	0
RNF19B	0	0	0	8	565.29	1130.58	15	2	1	NA	1	NA	8	0
RNF2	0	0	2	2	362.34	724.68	15	2	1	NA	1	NA	4	0
RNF20	0	0	9	10	951.72	1903.44	15	2	1	NA	1	NA	19	0
RNF207	0	0	2	5	639.54	1279.08	15	2	1	NA	1	NA	7	0
RNF213	0	0	35	46	5546.97	11093.94	15	2	1	NA	1	NA	81	0
RNF214	0	0	0	3	550.11	1100.22	15	2	1	NA	1	NA	3	0
RNF216	0	0	9	16	948.42	1896.84	15	2	1	NA	1	NA	25	0
RNF220	0	0	2	3	401.94	803.88	15	2	1	NA	1	NA	5	0
RNF222	0	0	2	3	212.85	425.7	15	2	1	NA	1	NA	5	0
RNF223	0	0	8	5	431.64	863.28	15	2	1	NA	1	NA	13	0
RNF25	0	0	3	12	485.1	970.2	15	2	1	NA	1	NA	15	0
RNF26	0	0	9	8	436.59	873.18	15	2	1	NA	1	NA	17	0
RNF34	0	0	2	1	349.47	698.94	15	2	1	NA	1	NA	3	0
RNF38	0	0	2	3	477.18	954.36	15	2	1	NA	1	NA	5	0
RNF41	0	0	0	3	314.82	629.64	15	2	1	NA	1	NA	3	0
RNF43	0	0	5	7	825.66	1651.32	15	2	1	NA	1	NA	12	0
RNFT1	0	0	2	2	386.1	772.2	15	2	1	NA	1	NA	4	0
RNFT2	0	0	3	5	542.85	1085.7	15	2	1	NA	1	NA	8	0
RNH1	0	0	1	5	452.43	904.86	15	2	1	NA	1	NA	6	0
RNPC3	0	0	2	3	447.48	894.96	15	2	1	NA	1	NA	5	0
RNPEP	0	0	4	10	520.74	1041.48	15	2	1	NA	1	NA	14	0
RNPEPL1	0	0	2	5	754.05	1508.1	15	2	1	NA	1	NA	7	0
RNPS1	0	0	1	8	331.65	663.3	15	2	1	NA	1	NA	9	0
ROBO3	0	0	7	8	813.45	1626.9	15	2	1	NA	1	NA	15	0
ROBO4	0	0	11	8	1071.84	2143.68	15	2	1	NA	1	NA	19	0
ROM1	0	0	3	1	361.35	722.7	15	2	1	NA	1	NA	4	0
ROR1	0	0	1	7	888.03	1776.06	15	2	1	NA	1	NA	8	0
RP11-762I7.5	0	0	4	4	271.92	543.84	15	2	1	NA	1	NA	8	0
RPA1	0	0	0	5	608.85	1217.7	15	2	1	NA	1	NA	5	0
RPAIN	0	0	2	5	201.63	403.26	15	2	1	NA	1	NA	7	0
RPAP1	0	0	16	11	1412.07	2824.14	15	2	1	NA	1	NA	27	0
RPAP2	0	0	2	3	593.01	1186.02	15	2	1	NA	1	NA	5	0
RPE65	0	0	4	17	528.66	1057.32	15	2	1	NA	1	NA	21	0
RPESL	0	0	1	1	259.38	518.76	15	2	1	NA	1	NA	2	0
RPGRIP1L	0	0	8	8	1271.16	2542.32	15	2	1	NA	1	NA	16	0
RPH3A	0	0	6	21	657.36	1314.72	15	2	1	NA	1	NA	27	0
RPH3AL	0	0	3	7	354.42	708.84	15	2	1	NA	1	NA	10	0
RPIA	0	0	0	4	233.64	467.28	15	2	1	NA	1	NA	4	0
RPL10A	0	0	1	10	247.5	495	15	2	1	NA	1	NA	11	0
RPL12	0	0	0	3	164.34	328.68	15	2	1	NA	1	NA	3	0
RPL13	0	0	0	3	209.88	419.76	15	2	1	NA	1	NA	3	0
RPL23	0	0	0	2	139.59	279.18	15	2	1	NA	1	NA	2	0
RPL23A	0	0	0	5	146.19	292.38	15	2	1	NA	1	NA	5	0
RPL26L1	0	0	0	3	144.54	289.08	15	2	1	NA	1	NA	3	0
RPL27	0	0	0	2	135.63	271.26	15	2	1	NA	1	NA	2	0
RPL29	0	0	0	2	71.28	142.56	15	2	1	NA	1	NA	2	0
RPL35A	0	0	0	2	109.89	219.78	15	2	1	NA	1	NA	2	0
RPL36A	0	0	0	3	81.84	163.68	15	2	1	NA	1	NA	3	0
RPL3L	0	0	2	4	403.92	807.84	15	2	1	NA	1	NA	6	0
RPL4	0	0	0	6	360.36	720.72	15	2	1	NA	1	NA	6	0
RPL5	0	0	0	2	294.03	588.06	15	2	1	NA	1	NA	2	0
RPL6	0	0	0	4	275.22	550.44	15	2	1	NA	1	NA	4	0
RPL7A	0	0	0	2	264.33	528.66	15	2	1	NA	1	NA	2	0
RPL7L1	0	0	0	4	245.52	491.04	15	2	1	NA	1	NA	4	0
RPL9	0	0	0	2	191.07	382.14	15	2	1	NA	1	NA	2	0
RPN2	0	0	3	8	637.56	1275.12	15	2	1	NA	1	NA	11	0
RPP14	0	0	1	2	126.72	253.44	15	2	1	NA	1	NA	3	0
RPP25	0	0	3	3	207.9	415.8	15	2	1	NA	1	NA	6	0
RPP30	0	0	4	5	349.47	698.94	15	2	1	NA	1	NA	9	0
RPP40	0	0	5	1	1253.34	2506.68	15	2	1	NA	1	NA	6	0
RPRD1B	0	0	0	3	312.18	624.36	15	2	1	NA	1	NA	3	0
RPRD2	0	0	14	30	1673.1	3346.2	15	2	1	NA	1	NA	44	0
RPRML	0	0	2	3	110.88	221.76	15	2	1	NA	1	NA	5	0
RPS10	0	0	2	2	171.27	342.54	15	2	1	NA	1	NA	4	0
RPS14	0	0	0	2	150.48	300.96	15	2	1	NA	1	NA	2	0
RPS2	0	0	0	7	284.13	568.26	15	2	1	NA	1	NA	7	0
RPS28	0	0	0	2	69.3	138.6	15	2	1	NA	1	NA	2	0
RPS4X	0	0	0	5	250.8	501.6	15	2	1	NA	1	NA	5	0
RPS6KA1L	0	0	1	6	782.43	1564.86	15	2	1	NA	1	NA	7	0
RPS6KB1	0	0	0	2	491.7	983.4	15	2	1	NA	1	NA	2	0
RPS6KL1	0	0	4	11	484.44	968.88	15	2	1	NA	1	NA	15	0
RPS8	0	0	0	2	206.91	413.82	15	2	1	NA	1	NA	2	0
RPUSD1	0	0	4	10	300.3	600.6	15	2	1	NA	1	NA	14	0
RPUSD4	0	0	3	0	342.21	684.42	15	2	1	NA	1	NA	3	0
RRAD	0	0	3	0	295.68	591.36	15	2	1	NA	1	NA	3	0
RRAGA	0	0	0	3	301.95	603.9	15	2	1	NA	1	NA	3	0
RRAS2	0	0	1	2	197.01	394.02	15	2	1	NA	1	NA	3	0
RRP12	0	0	14	23	1278.09	2556.18	15	2	1	NA	1	NA	37	0
RSL1D1	0	0	3	3	440.55	881.1	15	2	1	NA	1	NA	6	0
RSL24D1	0	0	2	0	186.45	372.9	15	2	1	NA	1	NA	2	0
RSPH10B	0	0	3	4	894.96	1789.92	15	2	1	NA	1	NA	7	0
RSPO1	0	0	1	3	258.39	516.78	15	2	1	NA	1	NA	4	0
RSPO4	0	0	1	6	221.76	443.52	15	2	1	NA	1	NA	7	0
RSPRY1	0	0	5	6	570.24	1140.48	15	2	1	NA	1	NA	11	0
RSRC2	0	0	0	2	364.32	728.64	15	2	1	NA	1	NA	2	0
RTCA	0	0	0	2	362.34	724.68	15	2	1	NA	1	NA	2	0
RTEL1	0	0	7	22	1477.41	2954.82	15	2	1	NA	1	NA	29	0
RTF1	0	0	0	4	645.81	1291.62	15	2	1	NA	1	NA	4	0
RTKN2	0	0	5	3	620.73	1241.46	15	2	1	NA	1	NA	8	0
RTN1	0	0	5	7	746.46	1492.92	15	2	1	NA	1	NA	12	0
RTN4R	0	0	3	3	481.14	962.28	15	2	1	NA	1	NA	6	0
RTN4RL1	0	0	1	5	441.21	882.42	15	2	1	NA	1	NA	6	0
RTP2	0	0	8	7	211.86	423.72	15	2	1	NA	1	NA	15	0
RUBCN	0	0	10	10	976.8	1953.6	15	2	1	NA	1	NA	20	0
RUFY1	0	0	6	8	688.05	1376.1	15	2	1	NA	1	NA	14	0
RUFY4	0	0	10	17	588.72	1177.44	15	2	1	NA	1	NA	27	0
RUNDC1	0	0	1	7	544.5	1089	15	2	1	NA	1	NA	8	0
RUSC1	0	0	7	8	1093.29	2186.58	15	2	1	NA	1	NA	15	0
RUSC2	0	0	8	5	1554.96	3109.92	15	2	1	NA	1	NA	13	0
RWDD3	0	0	3	0	249.48	498.96	15	2	1	NA	1	NA	3	0
RXFP1	0	0	1	2	623.7	1247.4	15	2	1	NA	1	NA	3	0
RXFP3	0	0	2	2	442.53	885.06	15	2	1	NA	1	NA	4	0
RXRA	0	0	1	23	458.04	916.08	15	2	1	NA	1	NA	24	0
RXRG	0	0	6	23	463.32	926.64	15	2	1	NA	1	NA	29	0
RYBP	0	0	0	3	227.7	455.4	15	2	1	NA	1	NA	3	0
RYR3	0	0	4	9	4764.54	9529.08	15	2	1	NA	1	NA	13	0
S100A11	0	0	0	2	100.98	201.96	15	2	1	NA	1	NA	2	0
S100A16	0	0	1	1	104.94	209.88	15	2	1	NA	1	NA	2	0
S100A4	0	0	2	2	98.01	196.02	15	2	1	NA	1	NA	4	0
S100A9	0	0	0	3	205.92	411.84	15	2	1	NA	1	NA	3	0
S100B	0	0	0	2	92.07	184.14	15	2	1	NA	1	NA	2	0
S100Z	0	0	3	0	99	198	15	2	1	NA	1	NA	3	0
S1PR1	0	0	0	5	376.2	752.4	15	2	1	NA	1	NA	5	0
SAFB	0	0	2	2	757.02	1514.04	15	2	1	NA	1	NA	4	0
SAFB2	0	0	2	0	234.96	469.92	15	2	1	NA	1	NA	2	0
SALL1	0	0	1	4	1296.9	2593.8	15	2	1	NA	1	NA	5	0
SALL4	0	0	6	4	1099.89	2199.78	15	2	1	NA	1	NA	10	0
SAMD11	0	0	4	15	758.34	1516.68	15	2	1	NA	1	NA	19	0
SAMD15	0	0	3	2	119.79	239.58	15	2	1	NA	1	NA	5	0
SAMD4A	0	0	2	3	585.09	1170.18	15	2	1	NA	1	NA	5	0
SAMD7	0	0	2	5	538.56	1077.12	15	2	1	NA	1	NA	7	0
SAMD8	0	0	2	2	411.84	823.68	15	2	1	NA	1	NA	4	0
SAP130	0	0	1	4	1049.4	2098.8	15	2	1	NA	1	NA	5	0
SAR1B	0	0	0	2	197.01	394.02	15	2	1	NA	1	NA	2	0
SARDH-VAV2	0	0	13	36	1750.65	3501.3	15	2	1	NA	1	NA	49	0
SARM1	0	0	7	14	708.51	1417.02	15	2	1	NA	1	NA	21	0
SART3	0	0	13	25	931.59	1863.18	15	2	1	NA	1	NA	38	0
SASH3	0	0	2	13	374.22	748.44	15	2	1	NA	1	NA	15	0
SASS6	0	0	3	3	635.58	1271.16	15	2	1	NA	1	NA	6	0
SAV1	0	0	1	4	381.15	762.3	15	2	1	NA	1	NA	5	0
SAXO2	0	0	4	5	464.31	928.62	15	2	1	NA	1	NA	9	0
SBDS	0	0	1	1	248.49	496.98	15	2	1	NA	1	NA	2	0
SBK3	0	0	2	1	416.46	832.92	15	2	1	NA	1	NA	3	0
SBNO1	0	0	1	12	1391.94	2783.88	15	2	1	NA	1	NA	13	0
SBNO2	0	0	3	17	1352.01	2704.02	15	2	1	NA	1	NA	20	0
SBSPONL	0	0	8	5	248.49	496.98	15	2	1	NA	1	NA	13	0
SC5D	0	0	2	7	286.11	572.22	15	2	1	NA	1	NA	9	0
SCAI	0	0	0	2	575.19	1150.38	15	2	1	NA	1	NA	2	0
SCAMP1	0	0	1	3	336.6	673.2	15	2	1	NA	1	NA	4	0
SCAMP2	0	0	1	7	358.38	716.76	15	2	1	NA	1	NA	8	0
SCAMP3	0	0	1	2	297.99	595.98	15	2	1	NA	1	NA	3	0
SCAMP4	0	0	0	3	227.7	455.4	15	2	1	NA	1	NA	3	0
SCAPER	0	0	8	5	1604.46	3208.92	15	2	1	NA	1	NA	13	0
SCARB1	0	0	2	3	468.27	936.54	15	2	1	NA	1	NA	5	0
SCARB2	0	0	1	2	477.18	954.36	15	2	1	NA	1	NA	3	0
SCARF1	0	0	11	33	816.09	1632.18	15	2	1	NA	1	NA	44	0
SCARF2	0	0	4	18	971.85	1943.7	15	2	1	NA	1	NA	22	0
SCD	0	0	3	2	357.39	714.78	15	2	1	NA	1	NA	5	0
SCD5	0	0	0	4	270.93	541.86	15	2	1	NA	1	NA	4	0
SCFD1	0	0	2	2	626.67	1253.34	15	2	1	NA	1	NA	4	0
SCFD2	0	0	7	6	416.13	832.26	15	2	1	NA	1	NA	13	0
SCFN	0	0	8	4	408.87	817.74	15	2	1	NA	1	NA	12	0
SCG2	0	0	4	4	621.72	1243.44	15	2	1	NA	1	NA	8	0
SCG3	0	0	5	5	436.92	873.84	15	2	1	NA	1	NA	10	0
SCHIP1	0	0	0	2	258.39	516.78	15	2	1	NA	1	NA	2	0
SCLT1	0	0	5	6	678.15	1356.3	15	2	1	NA	1	NA	11	0
SCLY	0	0	11	5	419.76	839.52	15	2	1	NA	1	NA	16	0
SCMH1	0	0	1	2	688.05	1376.1	15	2	1	NA	1	NA	3	0
SCN1A	0	0	3	2	1875.06	3750.12	15	2	1	NA	1	NA	5	0
SCN2A	0	0	0	5	1822.59	3645.18	15	2	1	NA	1	NA	5	0
SCN2B	0	0	0	5	185.13	370.26	15	2	1	NA	1	NA	5	0
SCN3A	0	0	2	1	1847.67	3695.34	15	2	1	NA	1	NA	3	0
SCN4A	0	0	1	10	1864.17	3728.34	15	2	1	NA	1	NA	11	0
SCN8A	0	0	3	15	1955.25	3910.5	15	2	1	NA	1	NA	18	0
SCN9A	0	0	1	7	1876.38	3752.76	15	2	1	NA	1	NA	8	0
SCNM1	0	0	3	5	233.31	466.62	15	2	1	NA	1	NA	8	0
SCNN1B	0	0	6	12	678.81	1357.62	15	2	1	NA	1	NA	18	0
SCNN1D	0	0	5	7	637.89	1275.78	15	2	1	NA	1	NA	12	0
SCNN1G	0	0	3	7	644.49	1288.98	15	2	1	NA	1	NA	10	0
SCOC	0	0	1	1	119.79	239.58	15	2	1	NA	1	NA	2	0
SCPEP1	0	0	1	4	391.38	782.76	15	2	1	NA	1	NA	5	0
SCRN2	0	0	9	6	419.76	839.52	15	2	1	NA	1	NA	15	0
SCRN3	0	0	3	2	416.79	833.58	15	2	1	NA	1	NA	5	0
SCT	0	0	8	5	841.5	1683	15	2	1	NA	1	NA	13	0
SCTR	0	0	1	1	446.49	892.98	15	2	1	NA	1	NA	2	0
SCUBE2	0	0	4	6	850.08	1700.16	15	2	1	NA	1	NA	10	0
SCUBE3	0	0	2	22	979.11	1958.22	15	2	1	NA	1	NA	24	0
SCYL3	0	0	11	14	742.5	1485	15	2	1	NA	1	NA	25	0
SDAD1	0	0	0	2	685.08	1370.16	15	2	1	NA	1	NA	2	0
SDC3	0	0	10	15	423.72	847.44	15	2	1	NA	1	NA	25	0
SDCCAG3	0	0	3	5	245.52	491.04	15	2	1	NA	1	NA	8	0
SDF2L1	0	0	1	1	202.95	405.9	15	2	1	NA	1	NA	2	0
SDF4	0	0	2	4	353.43	706.86	15	2	1	NA	1	NA	6	0
SDHC	0	0	3	3	138.6	277.2	15	2	1	NA	1	NA	6	0
SDK1	0	0	5	16	1922.58	3845.16	15	2	1	NA	1	NA	21	0
SDK2	0	0	17	59	2124.21	4248.42	15	2	1	NA	1	NA	76	0
SDPR	0	0	5	9	321.42	642.84	15	2	1	NA	1	NA	14	0
SDR42E1	0	0	5	3	437.25	874.5	15	2	1	NA	1	NA	8	0
SDR42E2	0	0	1	1	450.45	900.9	15	2	1	NA	1	NA	2	0
SDR42E2L	0	0	1	1	398.97	797.94	15	2	1	NA	1	NA	2	0
SDSL	0	0	7	5	305.91	611.82	15	2	1	NA	1	NA	12	0
SEBOX	0	0	5	5	76.56	153.12	15	2	1	NA	1	NA	10	0
SEC13	0	0	0	4	303.93	607.86	15	2	1	NA	1	NA	4	0
SEC14L1	0	0	1	4	708.84	1417.68	15	2	1	NA	1	NA	5	0
SEC14L5	0	0	1	6	654.39	1308.78	15	2	1	NA	1	NA	7	0
SEC16A	0	0	19	19	2421.54	4843.08	15	2	1	NA	1	NA	38	0
SEC16B	0	0	11	8	874.17	1748.34	15	2	1	NA	1	NA	19	0
SEC22A	0	0	1	2	305.91	611.82	15	2	1	NA	1	NA	3	0
SEC22B	0	0	0	3	213.84	427.68	15	2	1	NA	1	NA	3	0
SEC23IP	0	0	7	8	976.47	1952.94	15	2	1	NA	1	NA	15	0
SEC24A	0	0	2	8	1089.99	2179.98	15	2	1	NA	1	NA	10	0
SEC24B	0	0	3	1	600.6	1201.2	15	2	1	NA	1	NA	4	0
SEC24C	0	0	4	7	1135.53	2271.06	15	2	1	NA	1	NA	11	0
SEC24D	0	0	1	1	83.82	167.64	15	2	1	NA	1	NA	2	0
SEC31A	0	0	4	15	1095.93	2191.86	15	2	1	NA	1	NA	19	0
SEC31B	0	0	9	7	1192.95	2385.9	15	2	1	NA	1	NA	16	0
SEC61A1-SEC61A2	0	0	2	2	472.23	944.46	15	2	1	NA	1	NA	4	0
SEC62	0	0	1	4	396	792	15	2	1	NA	1	NA	5	0
SECISBP2	0	0	0	2	591.69	1183.38	15	2	1	NA	1	NA	2	0
SEL1L	0	0	0	2	782.1	1564.2	15	2	1	NA	1	NA	2	0
SEL1L3	0	0	1	3	1111.11	2222.22	15	2	1	NA	1	NA	4	0
SELE	0	0	3	5	284.46	568.92	15	2	1	NA	1	NA	8	0
SELENBP1	0	0	2	1	467.28	934.56	15	2	1	NA	1	NA	3	0
SELENBP1L3	0	0	3	2	588.06	1176.12	15	2	1	NA	1	NA	5	0
SELENOH	0	0	1	2	110.88	221.76	15	2	1	NA	1	NA	3	0
SELENON	0	0	1	1	517.77	1035.54	15	2	1	NA	1	NA	2	0
SELENOP1	0	0	2	1	255.42	510.84	15	2	1	NA	1	NA	3	0
SELENOP2	0	0	0	5	246.51	493.02	15	2	1	NA	1	NA	5	0
SELENOS	0	0	2	0	175.89	351.78	15	2	1	NA	1	NA	2	0
SEMA3F	0	0	3	14	749.43	1498.86	15	2	1	NA	1	NA	17	0
SEMA3G	0	0	7	22	752.4	1504.8	15	2	1	NA	1	NA	29	0
SEMA4B	0	0	6	13	693.99	1387.98	15	2	1	NA	1	NA	19	0
SEMA4D	0	0	4	7	811.8	1623.6	15	2	1	NA	1	NA	11	0
SEMA5B	0	0	3	8	1082.07	2164.14	15	2	1	NA	1	NA	11	0
SEMA6A	0	0	1	11	1031.25	2062.5	15	2	1	NA	1	NA	12	0
SEMA6B	0	0	4	6	399.96	799.92	15	2	1	NA	1	NA	10	0
SEMA6C	0	0	1	11	518.43	1036.86	15	2	1	NA	1	NA	12	0
SEMA6D	0	0	2	5	1078.11	2156.22	15	2	1	NA	1	NA	7	0
SEMA7A	0	0	4	8	627.66	1255.32	15	2	1	NA	1	NA	12	0
SENP1	0	0	7	35	1553.31	3106.62	15	2	1	NA	1	NA	42	0
SENP2	0	0	2	3	575.19	1150.38	15	2	1	NA	1	NA	5	0
SENP5	0	0	4	2	568.26	1136.52	15	2	1	NA	1	NA	6	0
SEPSECS	0	0	2	5	482.13	964.26	15	2	1	NA	1	NA	7	0
SEPT11	0	0	1	3	494.01	988.02	15	2	1	NA	1	NA	4	0
SEPT2	0	0	0	3	328.68	657.36	15	2	1	NA	1	NA	3	0
SEPT4	0	0	1	4	465.3	930.6	15	2	1	NA	1	NA	5	0
SEPT5	0	0	1	4	378.18	756.36	15	2	1	NA	1	NA	5	0
SEPT9	0	0	3	6	364.98	729.96	15	2	1	NA	1	NA	9	0
SERINC2	0	0	3	8	436.59	873.18	15	2	1	NA	1	NA	11	0
SERINC3	0	0	3	2	468.27	936.54	15	2	1	NA	1	NA	5	0
SERINC4	0	0	5	6	489.06	978.12	15	2	1	NA	1	NA	11	0
SERINC5	0	0	0	3	449.46	898.92	15	2	1	NA	1	NA	3	0
SERPINA10	0	0	1	1	450.45	900.9	15	2	1	NA	1	NA	2	0
SERPINC1	0	0	0	5	451.44	902.88	15	2	1	NA	1	NA	5	0
SERPIND1	0	0	2	0	484.11	968.22	15	2	1	NA	1	NA	2	0
SERPINE2	0	0	2	1	431.64	863.28	15	2	1	NA	1	NA	3	0
SERPINF1	0	0	2	10	413.82	827.64	15	2	1	NA	1	NA	12	0
SERPINF2	0	0	6	6	512.82	1025.64	15	2	1	NA	1	NA	12	0
SERPING1	0	0	4	6	371.91	743.82	15	2	1	NA	1	NA	10	0
SERPINI1	0	0	1	3	406.89	813.78	15	2	1	NA	1	NA	4	0
SESN2	0	0	3	9	422.73	845.46	15	2	1	NA	1	NA	12	0
SETBP1	0	0	3	2	1231.89	2463.78	15	2	1	NA	1	NA	5	0
SETD1B	0	0	14	31	1911.03	3822.06	15	2	1	NA	1	NA	45	0
SETD3	0	0	0	3	714.78	1429.56	15	2	1	NA	1	NA	3	0
SETD5	0	0	5	11	1441.44	2882.88	15	2	1	NA	1	NA	16	0
SETD7	0	0	0	5	350.13	700.26	15	2	1	NA	1	NA	5	0
SETD9	0	0	2	1	281.16	562.32	15	2	1	NA	1	NA	3	0
SETDB1	0	0	0	3	1266.21	2532.42	15	2	1	NA	1	NA	3	0
SETMAR	0	0	3	4	285.12	570.24	15	2	1	NA	1	NA	7	0
SETX	0	0	27	17	2758.14	5516.28	15	2	1	NA	1	NA	44	0
SEZ6L	0	0	8	25	965.91	1931.82	15	2	1	NA	1	NA	33	0
SF3A3	0	0	0	3	474.21	948.42	15	2	1	NA	1	NA	3	0
SF3B1	0	0	0	7	1288.98	2577.96	15	2	1	NA	1	NA	7	0
SF3B3	0	0	4	1	592.68	1185.36	15	2	1	NA	1	NA	5	0
SF3B4	0	0	0	3	279.18	558.36	15	2	1	NA	1	NA	3	0
SFMBT1	0	0	1	5	859.32	1718.64	15	2	1	NA	1	NA	6	0
SFN	0	0	0	6	228.69	457.38	15	2	1	NA	1	NA	6	0
SFPQ	0	0	1	5	644.49	1288.98	15	2	1	NA	1	NA	6	0
SFR1	0	0	3	2	219.78	439.56	15	2	1	NA	1	NA	5	0
SFRP1	0	0	1	6	308.88	617.76	15	2	1	NA	1	NA	7	0
SFRP2	0	0	0	3	290.07	580.14	15	2	1	NA	1	NA	3	0
SFRP5	0	0	5	7	311.85	623.7	15	2	1	NA	1	NA	12	0
SFSWAP	0	0	6	3	935.55	1871.1	15	2	1	NA	1	NA	9	0
SFTPA2	0	0	2	2	217.8	435.6	15	2	1	NA	1	NA	4	0
SFXN3	0	0	1	4	303.27	606.54	15	2	1	NA	1	NA	5	0
SFXN4	0	0	3	3	316.8	633.6	15	2	1	NA	1	NA	6	0
SGCA	0	0	6	6	367.29	734.58	15	2	1	NA	1	NA	12	0
SGCB	0	0	0	6	312.84	625.68	15	2	1	NA	1	NA	6	0
SGK2	0	0	1	5	423.72	847.44	15	2	1	NA	1	NA	6	0
SGMS2	0	0	0	2	362.34	724.68	15	2	1	NA	1	NA	2	0
SGO2	0	0	10	6	997.92	1995.84	15	2	1	NA	1	NA	16	0
SGPL1	0	0	2	10	555.39	1110.78	15	2	1	NA	1	NA	12	0
SGPP2	0	0	5	2	320.43	640.86	15	2	1	NA	1	NA	7	0
SGSH	0	0	7	8	471.57	943.14	15	2	1	NA	1	NA	15	0
SGSM1	0	0	7	20	1090.65	2181.3	15	2	1	NA	1	NA	27	0
SGSM2	0	0	3	6	1049.4	2098.8	15	2	1	NA	1	NA	9	0
SGTA	0	0	1	4	299.64	599.28	15	2	1	NA	1	NA	5	0
SH2B2	0	0	11	19	660.33	1320.66	15	2	1	NA	1	NA	30	0
SH2B3	0	0	4	14	506.55	1013.1	15	2	1	NA	1	NA	18	0
SH2D1A	0	0	1	2	130.68	261.36	15	2	1	NA	1	NA	3	0
SH2D2A	0	0	8	5	304.59	609.18	15	2	1	NA	1	NA	13	0
SH2D4A	0	0	1	2	451.44	902.88	15	2	1	NA	1	NA	3	0
SH2D4B	0	0	2	2	440.88	881.76	15	2	1	NA	1	NA	4	0
SH2D5	0	0	5	6	296.01	592.02	15	2	1	NA	1	NA	11	0
SH3BGRL3	0	0	0	2	93.06	186.12	15	2	1	NA	1	NA	2	0
SH3BP2	0	0	1	2	568.26	1136.52	15	2	1	NA	1	NA	3	0
SH3BP4	0	0	2	8	998.91	1997.82	15	2	1	NA	1	NA	10	0
SH3D19	0	0	8	7	988.02	1976.04	15	2	1	NA	1	NA	15	0
SH3GL1	0	0	0	6	346.5	693	15	2	1	NA	1	NA	6	0
SH3GL2	0	0	1	1	350.46	700.92	15	2	1	NA	1	NA	2	0
SH3GLB1	0	0	1	1	343.2	686.4	15	2	1	NA	1	NA	2	0
SH3PXD2A	0	0	4	5	923.67	1847.34	15	2	1	NA	1	NA	9	0
SH3PXD2B	0	0	5	9	863.28	1726.56	15	2	1	NA	1	NA	14	0
SH3RF1	0	0	2	3	865.26	1730.52	15	2	1	NA	1	NA	5	0
SH3RF2	0	0	3	19	733.59	1467.18	15	2	1	NA	1	NA	22	0
SH3TC1	0	0	5	1	1320	2640	15	2	1	NA	1	NA	6	0
SH3TC2	0	0	19	10	1322.64	2645.28	15	2	1	NA	1	NA	29	0
SHANK2	0	0	1	6	1445.4	2890.8	15	2	1	NA	1	NA	7	0
SHB	0	0	6	1	493.68	987.36	15	2	1	NA	1	NA	7	0
SHC1	0	0	4	12	604.23	1208.46	15	2	1	NA	1	NA	16	0
SHC2	0	0	1	2	472.56	945.12	15	2	1	NA	1	NA	3	0
SHC4	0	0	1	1	623.7	1247.4	15	2	1	NA	1	NA	2	0
SHCBP1	0	0	8	7	660.33	1320.66	15	2	1	NA	1	NA	15	0
SHF	0	0	2	3	372.24	744.48	15	2	1	NA	1	NA	5	0
SHISA3	0	0	2	3	211.2	422.4	15	2	1	NA	1	NA	5	0
SHISA6	0	0	0	3	438.9	877.8	15	2	1	NA	1	NA	3	0
SHMT1	0	0	2	14	480.15	960.3	15	2	1	NA	1	NA	16	0
SHOC2	0	0	0	3	577.17	1154.34	15	2	1	NA	1	NA	3	0
SHPK	0	0	4	3	465.3	930.6	15	2	1	NA	1	NA	7	0
SHQ1	0	0	10	5	613.14	1226.28	15	2	1	NA	1	NA	15	0
SHROOM1	0	0	32	30	1305.81	2611.62	15	2	1	NA	1	NA	62	0
SHROOM3	0	0	11	20	1896.84	3793.68	15	2	1	NA	1	NA	31	0
SHTN1	0	0	2	0	620.73	1241.46	15	2	1	NA	1	NA	2	0
SI	0	0	3	3	1255.32	2510.64	15	2	1	NA	1	NA	6	0
SIDT2	0	0	2	18	812.79	1625.58	15	2	1	NA	1	NA	20	0
SIGIRR	0	0	3	11	411.84	823.68	15	2	1	NA	1	NA	14	0
SIGLEC1	0	0	50	55	1626.9	3253.8	15	2	1	NA	1	NA	105	0
SIGLEC15	0	0	0	3	303.93	607.86	15	2	1	NA	1	NA	3	0
SIGMAR1	0	0	0	3	211.2	422.4	15	2	1	NA	1	NA	3	0
SIK2	0	0	7	10	881.1	1762.2	15	2	1	NA	1	NA	17	0
SIK3	0	0	4	13	1246.41	2492.82	15	2	1	NA	1	NA	17	0
SIL1	0	0	12	7	445.5	891	15	2	1	NA	1	NA	19	0
SIMC1	0	0	11	14	677.16	1354.32	15	2	1	NA	1	NA	25	0
SIN3A	0	0	5	17	1262.25	2524.5	15	2	1	NA	1	NA	22	0
SIPA1L1	0	0	2	12	1768.14	3536.28	15	2	1	NA	1	NA	14	0
SIRPA-TPPNR1L	0	0	13	6	263.34	526.68	15	2	1	NA	1	NA	19	0
SIRT1	0	0	5	4	629.64	1259.28	15	2	1	NA	1	NA	9	0
SIRT3	0	0	2	1	329.67	659.34	15	2	1	NA	1	NA	3	0
SIRT4	0	0	3	1	350.46	700.92	15	2	1	NA	1	NA	4	0
SIRT6	0	0	1	8	333.63	667.26	15	2	1	NA	1	NA	9	0
SIVA1	0	0	2	3	176.22	352.44	15	2	1	NA	1	NA	5	0
SKA2	0	0	2	0	254.43	508.86	15	2	1	NA	1	NA	2	0
SKAP1	0	0	1	4	266.31	532.62	15	2	1	NA	1	NA	5	0
SKI	0	0	4	1	358.05	716.1	15	2	1	NA	1	NA	5	0
SKIL	0	0	2	12	725.67	1451.34	15	2	1	NA	1	NA	14	0
SKOR2	0	0	3	4	624.69	1249.38	15	2	1	NA	1	NA	7	0
SKP2	0	0	2	0	403.59	807.18	15	2	1	NA	1	NA	2	0
SLAIN2	0	0	2	0	474.54	949.08	15	2	1	NA	1	NA	2	0
SLAINL	0	0	5	5	652.41	1304.82	15	2	1	NA	1	NA	10	0
SLBP	0	0	2	1	235.62	471.24	15	2	1	NA	1	NA	3	0
SLC10A1	0	0	3	1	369.27	738.54	15	2	1	NA	1	NA	4	0
SLC10A4	0	0	2	3	338.25	676.5	15	2	1	NA	1	NA	5	0
SLC10A7	0	0	1	1	368.28	736.56	15	2	1	NA	1	NA	2	0
SLC11A1-SLC11A2	0	0	0	13	591.03	1182.06	15	2	1	NA	1	NA	13	0
SLC12A1	0	0	2	3	1184.04	2368.08	15	2	1	NA	1	NA	5	0
SLC12A3	0	0	22	16	987.03	1974.06	15	2	1	NA	1	NA	38	0
SLC12A4	0	0	0	10	1131.57	2263.14	15	2	1	NA	1	NA	10	0
SLC12A5	0	0	1	17	1100.55	2201.1	15	2	1	NA	1	NA	18	0
SLC12A8	0	0	4	4	723.69	1447.38	15	2	1	NA	1	NA	8	0
SLC12A9	0	0	10	28	841.83	1683.66	15	2	1	NA	1	NA	38	0
SLC13A2	0	0	1	4	588.06	1176.12	15	2	1	NA	1	NA	5	0
SLC13A3	0	0	0	4	573.54	1147.08	15	2	1	NA	1	NA	4	0
SLC14A2Z	0	0	1	4	386.1	772.2	15	2	1	NA	1	NA	5	0
SLC15A2	0	0	5	2	777.15	1554.3	15	2	1	NA	1	NA	7	0
SLC15A4	0	0	1	3	570.9	1141.8	15	2	1	NA	1	NA	4	0
SLC16A12	0	0	2	0	481.14	962.28	15	2	1	NA	1	NA	2	0
SLC16A14	0	0	2	0	510.84	1021.68	15	2	1	NA	1	NA	2	0
SLC16A4	0	0	6	2	519.75	1039.5	15	2	1	NA	1	NA	8	0
SLC16A5	0	0	6	4	678.48	1356.96	15	2	1	NA	1	NA	10	0
SLC16A6	0	0	1	5	561.66	1123.32	15	2	1	NA	1	NA	6	0
SLC16A9	0	0	1	1	502.92	1005.84	15	2	1	NA	1	NA	2	0
SLC17A9	0	0	1	4	440.88	881.76	15	2	1	NA	1	NA	5	0
SLC18A1	0	0	2	9	519.75	1039.5	15	2	1	NA	1	NA	11	0
SLC18A2	0	0	1	6	515.46	1030.92	15	2	1	NA	1	NA	7	0
SLC18A3	0	0	1	6	471.57	943.14	15	2	1	NA	1	NA	7	0
SLC19A1	0	0	4	6	493.02	986.04	15	2	1	NA	1	NA	10	0
SLC19A3	0	0	2	2	433.95	867.9	15	2	1	NA	1	NA	4	0
SLC1A2	0	0	2	5	570.57	1141.14	15	2	1	NA	1	NA	7	0
SLC1A6	0	0	1	1	562.32	1124.64	15	2	1	NA	1	NA	2	0
SLC1A7	0	0	0	4	561.33	1122.66	15	2	1	NA	1	NA	4	0
SLC20A2	0	0	0	5	646.47	1292.94	15	2	1	NA	1	NA	5	0
SLC22A15L	0	0	3	1	418.11	836.22	15	2	1	NA	1	NA	4	0
SLC22A18	0	0	0	4	410.85	821.7	15	2	1	NA	1	NA	4	0
SLC22A4	0	0	2	12	548.46	1096.92	15	2	1	NA	1	NA	14	0
SLC22A5	0	0	7	4	625.35	1250.7	15	2	1	NA	1	NA	11	0
SLC23A1	0	0	4	19	490.38	980.76	15	2	1	NA	1	NA	23	0
SLC23A3	0	0	8	18	563.97	1127.94	15	2	1	NA	1	NA	26	0
SLC24A1	0	0	3	6	660.33	1320.66	15	2	1	NA	1	NA	9	0
SLC24A5	0	0	6	0	499.95	999.9	15	2	1	NA	1	NA	6	0
SLC25A1	0	0	2	5	291.06	582.12	15	2	1	NA	1	NA	7	0
SLC25A10	0	0	0	5	254.43	508.86	15	2	1	NA	1	NA	5	0
SLC25A14	0	0	0	3	288.09	576.18	15	2	1	NA	1	NA	3	0
SLC25A19	0	0	1	1	319.77	639.54	15	2	1	NA	1	NA	2	0
SLC25A20	0	0	1	1	325.71	651.42	15	2	1	NA	1	NA	2	0
SLC25A24	0	0	1	4	471.24	942.48	15	2	1	NA	1	NA	5	0
SLC25A26	0	0	8	4	265.32	530.64	15	2	1	NA	1	NA	12	0
SLC25A29	0	0	0	3	287.76	575.52	15	2	1	NA	1	NA	3	0
SLC25A33	0	0	0	2	317.79	635.58	15	2	1	NA	1	NA	2	0
SLC25A34	0	0	4	3	284.13	568.26	15	2	1	NA	1	NA	7	0
SLC25A37	0	0	0	8	304.26	608.52	15	2	1	NA	1	NA	8	0
SLC25A42	0	0	3	5	324.72	649.44	15	2	1	NA	1	NA	8	0
SLC25A43	0	0	1	2	324.72	649.44	15	2	1	NA	1	NA	3	0
SLC25A47	0	0	1	1	293.04	586.08	15	2	1	NA	1	NA	2	0
SLC25A48	0	0	1	8	311.85	623.7	15	2	1	NA	1	NA	9	0
SLC25A5	0	0	0	7	294.69	589.38	15	2	1	NA	1	NA	7	0
SLC26A1	0	0	3	5	706.86	1413.72	15	2	1	NA	1	NA	8	0
SLC26A8	0	0	9	6	783.09	1566.18	15	2	1	NA	1	NA	15	0
SLC26A9	0	0	3	6	796.95	1593.9	15	2	1	NA	1	NA	9	0
SLC27A2	0	0	3	6	614.79	1229.58	15	2	1	NA	1	NA	9	0
SLC27A6	0	0	2	0	807.84	1615.68	15	2	1	NA	1	NA	2	0
SLC28A2	0	0	3	7	653.4	1306.8	15	2	1	NA	1	NA	10	0
SLC28A3	0	0	1	2	615.12	1230.24	15	2	1	NA	1	NA	3	0
SLC29A3	0	0	6	10	456.39	912.78	15	2	1	NA	1	NA	16	0
SLC29A4	0	0	6	11	517.77	1035.54	15	2	1	NA	1	NA	17	0
SLC2A1	0	0	0	2	480.15	960.3	15	2	1	NA	1	NA	2	0
SLC2A10	0	0	8	8	573.21	1146.42	15	2	1	NA	1	NA	16	0
SLC2A11	0	0	9	9	492.03	984.06	15	2	1	NA	1	NA	18	0
SLC2A11L1	0	0	1	3	486.09	972.18	15	2	1	NA	1	NA	4	0
SLC2A11L3	0	0	2	3	494.01	988.02	15	2	1	NA	1	NA	5	0
SLC2A11L4	0	0	2	3	495	990	15	2	1	NA	1	NA	5	0
SLC2A2	0	0	1	4	535.26	1070.52	15	2	1	NA	1	NA	5	0
SLC2A5	0	0	2	8	515.79	1031.58	15	2	1	NA	1	NA	10	0
SLC2A6	0	0	3	11	501.93	1003.86	15	2	1	NA	1	NA	14	0
SLC2A8	0	0	1	1	479.16	958.32	15	2	1	NA	1	NA	2	0
SLC2A9	0	0	2	1	660	1320	15	2	1	NA	1	NA	3	0
SLC2A9L	0	0	14	15	568.59	1137.18	15	2	1	NA	1	NA	29	0
SLC30A2	0	0	5	10	361.35	722.7	15	2	1	NA	1	NA	15	0
SLC30A5	0	0	2	6	393.36	786.72	15	2	1	NA	1	NA	8	0
SLC30A7	0	0	1	4	354.09	708.18	15	2	1	NA	1	NA	5	0
SLC30A9	0	0	5	4	611.82	1223.64	15	2	1	NA	1	NA	9	0
SLC31A1	0	0	1	1	183.15	366.3	15	2	1	NA	1	NA	2	0
SLC31A2	0	0	3	4	137.61	275.22	15	2	1	NA	1	NA	7	0
SLC32A1	0	0	0	10	516.78	1033.56	15	2	1	NA	1	NA	10	0
SLC33A1	0	0	1	3	460.02	920.04	15	2	1	NA	1	NA	4	0
SLC34A1	0	0	8	7	661.98	1323.96	15	2	1	NA	1	NA	15	0
SLC34A2	0	0	1	2	668.25	1336.5	15	2	1	NA	1	NA	3	0
SLC35A3	0	0	2	1	335.94	671.88	15	2	1	NA	1	NA	3	0
SLC35A4	0	0	3	4	319.77	639.54	15	2	1	NA	1	NA	7	0
SLC35B1	0	0	0	4	285.45	570.9	15	2	1	NA	1	NA	4	0
SLC35C1	0	0	1	5	356.4	712.8	15	2	1	NA	1	NA	6	0
SLC35E1	0	0	2	4	402.93	805.86	15	2	1	NA	1	NA	6	0
SLC35F4	0	0	1	2	488.07	976.14	15	2	1	NA	1	NA	3	0
SLC35G1	0	0	1	1	401.94	803.88	15	2	1	NA	1	NA	2	0
SLC35G2	0	0	4	5	407.88	815.76	15	2	1	NA	1	NA	9	0
SLC36A1	0	0	3	11	470.25	940.5	15	2	1	NA	1	NA	14	0
SLC37A2	0	0	3	0	499.29	998.58	15	2	1	NA	1	NA	3	0
SLC37A4	0	0	1	1	376.86	753.72	15	2	1	NA	1	NA	2	0
SLC38A10	0	0	22	42	1897.83	3795.66	15	2	1	NA	1	NA	64	0
SLC38A11	0	0	3	1	445.5	891	15	2	1	NA	1	NA	4	0
SLC38A3	0	0	4	11	488.4	976.8	15	2	1	NA	1	NA	15	0
SLC38A6	0	0	1	1	398.97	797.94	15	2	1	NA	1	NA	2	0
SLC38A8	0	0	9	20	431.31	862.62	15	2	1	NA	1	NA	29	0
SLC38A9	0	0	2	2	552.09	1104.18	15	2	1	NA	1	NA	4	0
SLC39A10	0	0	4	4	850.41	1700.82	15	2	1	NA	1	NA	8	0
SLC39A11	0	0	1	10	320.76	641.52	15	2	1	NA	1	NA	11	0
SLC39A14	0	0	5	6	476.19	952.38	15	2	1	NA	1	NA	11	0
SLC39A3	0	0	2	4	310.86	621.72	15	2	1	NA	1	NA	6	0
SLC39A5	0	0	4	2	141.9	283.8	15	2	1	NA	1	NA	6	0
SLC39A8	0	0	1	2	436.59	873.18	15	2	1	NA	1	NA	3	0
SLC40A1	0	0	1	1	576.18	1152.36	15	2	1	NA	1	NA	2	0
SLC41A3	0	0	0	2	449.46	898.92	15	2	1	NA	1	NA	2	0
SLC43A2	0	0	3	8	543.51	1087.02	15	2	1	NA	1	NA	11	0
SLC44A3	0	0	4	6	619.74	1239.48	15	2	1	NA	1	NA	10	0
SLC45A3	0	0	4	11	569.25	1138.5	15	2	1	NA	1	NA	15	0
SLC46A1	0	0	1	7	386.43	772.86	15	2	1	NA	1	NA	8	0
SLC46A2	0	0	3	5	449.46	898.92	15	2	1	NA	1	NA	8	0
SLC47A1	0	0	9	8	561.33	1122.66	15	2	1	NA	1	NA	17	0
SLC47A2	0	0	11	14	591.03	1182.06	15	2	1	NA	1	NA	25	0
SLC48A1	0	0	0	2	147.51	295.02	15	2	1	NA	1	NA	2	0
SLC4A1	0	0	7	24	726.33	1452.66	15	2	1	NA	1	NA	31	0
SLC4A10	0	0	1	4	1085.7	2171.4	15	2	1	NA	1	NA	5	0
SLC4A11	0	0	1	4	520.41	1040.82	15	2	1	NA	1	NA	5	0
SLC4A3	0	0	2	10	1235.52	2471.04	15	2	1	NA	1	NA	12	0
SLC4A4	0	0	2	4	1025.64	2051.28	15	2	1	NA	1	NA	6	0
SLC4A5	0	0	2	2	1333.53	2667.06	15	2	1	NA	1	NA	4	0
SLC4A8	0	0	5	15	1260.27	2520.54	15	2	1	NA	1	NA	20	0
SLC4A9	0	0	8	13	981.09	1962.18	15	2	1	NA	1	NA	21	0
SLC51A	0	0	6	5	336.6	673.2	15	2	1	NA	1	NA	11	0
SLC51B	0	0	3	3	287.1	574.2	15	2	1	NA	1	NA	6	0
SLC52A3	0	0	3	3	450.45	900.9	15	2	1	NA	1	NA	6	0
SLC5A10	0	0	2	7	328.68	657.36	15	2	1	NA	1	NA	9	0
SLC5A11	0	0	6	7	785.07	1570.14	15	2	1	NA	1	NA	13	0
SLC5A6	0	0	3	1	257.73	515.46	15	2	1	NA	1	NA	4	0
SLC5A9	0	0	2	6	660.33	1320.66	15	2	1	NA	1	NA	8	0
SLC6A1	0	0	0	5	593.01	1186.02	15	2	1	NA	1	NA	5	0
SLC6A11	0	0	0	2	612.48	1224.96	15	2	1	NA	1	NA	2	0
SLC6A14	0	0	0	4	634.59	1269.18	15	2	1	NA	1	NA	4	0
SLC6A17	0	0	0	7	720.72	1441.44	15	2	1	NA	1	NA	7	0
SLC6A2	0	0	0	6	612.81	1225.62	15	2	1	NA	1	NA	6	0
SLC6A4	0	0	2	6	664.29	1328.58	15	2	1	NA	1	NA	8	0
SLC6A6	0	0	0	3	633.6	1267.2	15	2	1	NA	1	NA	3	0
SLC6A7	0	0	2	12	808.83	1617.66	15	2	1	NA	1	NA	14	0
SLC6A9	0	0	5	8	616.11	1232.22	15	2	1	NA	1	NA	13	0
SLC7A10	0	0	0	2	500.94	1001.88	15	2	1	NA	1	NA	2	0
SLC7A11	0	0	1	5	550.77	1101.54	15	2	1	NA	1	NA	6	0
SLC7A14	0	0	2	16	764.28	1528.56	15	2	1	NA	1	NA	18	0
SLC7A3	0	0	5	18	625.35	1250.7	15	2	1	NA	1	NA	23	0
SLC7A5	0	0	1	5	546.48	1092.96	15	2	1	NA	1	NA	6	0
SLC7A6	0	0	0	4	513.81	1027.62	15	2	1	NA	1	NA	4	0
SLC7A6OS	0	0	3	0	327.69	655.38	15	2	1	NA	1	NA	3	0
SLC8A3	0	0	14	23	346.5	693	15	2	1	NA	1	NA	37	0
SLC8B1	0	0	6	13	481.14	962.28	15	2	1	NA	1	NA	19	0
SLC9A1	0	0	1	12	796.95	1593.9	15	2	1	NA	1	NA	13	0
SLC9A3R1	0	0	3	7	333.63	667.26	15	2	1	NA	1	NA	10	0
SLC9A3R2	0	0	3	3	351.45	702.9	15	2	1	NA	1	NA	6	0
SLC9A6	0	0	1	5	541.53	1083.06	15	2	1	NA	1	NA	6	0
SLC9A8	0	0	0	2	532.62	1065.24	15	2	1	NA	1	NA	2	0
SLC9A9	0	0	2	3	499.62	999.24	15	2	1	NA	1	NA	5	0
SLC9B2	0	0	4	5	554.4	1108.8	15	2	1	NA	1	NA	9	0
SLCO2A1	0	0	2	8	631.62	1263.24	15	2	1	NA	1	NA	10	0
SLCO4A1	0	0	10	13	717.75	1435.5	15	2	1	NA	1	NA	23	0
SLCO4C1	0	0	1	2	634.26	1268.52	15	2	1	NA	1	NA	3	0
SLF1	0	0	4	3	894.96	1789.92	15	2	1	NA	1	NA	7	0
SLF2	0	0	12	11	1188.99	2377.98	15	2	1	NA	1	NA	23	0
SLIT1	0	0	12	27	1396.56	2793.12	15	2	1	NA	1	NA	39	0
SLIT3	0	0	8	15	1448.37	2896.74	15	2	1	NA	1	NA	23	0
SLITRK2	0	0	1	7	849.42	1698.84	15	2	1	NA	1	NA	8	0
SLITRK4	0	0	3	2	829.62	1659.24	15	2	1	NA	1	NA	5	0
SLK	0	0	3	5	1258.29	2516.58	15	2	1	NA	1	NA	8	0
SLMAP	0	0	3	1	814.77	1629.54	15	2	1	NA	1	NA	4	0
SLTM	0	0	1	2	943.47	1886.94	15	2	1	NA	1	NA	3	0
SMAD1	0	0	1	3	461.34	922.68	15	2	1	NA	1	NA	4	0
SMAD2W-SMAD2Z	0	0	3	2	406.89	813.78	15	2	1	NA	1	NA	5	0
SMAD3	0	0	0	10	373.23	746.46	15	2	1	NA	1	NA	10	0
SMAD5	0	0	0	4	461.34	922.68	15	2	1	NA	1	NA	4	0
SMAD6	0	0	2	3	466.95	933.9	15	2	1	NA	1	NA	5	0
SMAD7-SMAD7B	0	0	2	4	160.71	321.42	15	2	1	NA	1	NA	6	0
SMAP2	0	0	4	1	413.16	826.32	15	2	1	NA	1	NA	5	0
SMARCA1	0	0	1	8	1023.66	2047.32	15	2	1	NA	1	NA	9	0
SMARCA2-SMARCA4	0	0	2	2	1552.32	3104.64	15	2	1	NA	1	NA	4	0
SMARCAD1	0	0	2	4	952.71	1905.42	15	2	1	NA	1	NA	6	0
SMARCAL1	0	0	7	4	997.92	1995.84	15	2	1	NA	1	NA	11	0
SMARCB1	0	0	1	3	407.55	815.1	15	2	1	NA	1	NA	4	0
SMARCC2	0	0	6	14	773.19	1546.38	15	2	1	NA	1	NA	20	0
SMARCD1	0	0	0	3	417.78	835.56	15	2	1	NA	1	NA	3	0
SMARCE1	0	0	1	3	401.94	803.88	15	2	1	NA	1	NA	4	0
SMC2	0	0	5	4	1162.92	2325.84	15	2	1	NA	1	NA	9	0
SMC3	0	0	0	5	1217.7	2435.4	15	2	1	NA	1	NA	5	0
SMC4	0	0	4	10	1280.07	2560.14	15	2	1	NA	1	NA	14	0
SMC5	0	0	8	2	998.91	1997.82	15	2	1	NA	1	NA	10	0
SMCR8	0	0	8	20	909.48	1818.96	15	2	1	NA	1	NA	28	0
SMG1	0	0	6	2	3597	7194	15	2	1	NA	1	NA	8	0
SMG5	0	0	4	13	1014.09	2028.18	15	2	1	NA	1	NA	17	0
SMG6	0	0	12	22	1155.66	2311.32	15	2	1	NA	1	NA	34	0
SMG8	0	0	5	25	913.77	1827.54	15	2	1	NA	1	NA	30	0
SMIM12	0	0	1	1	93.06	186.12	15	2	1	NA	1	NA	2	0
SMIM4	0	0	0	2	42.9	85.8	15	2	1	NA	1	NA	2	0
SMNDC1	0	0	0	4	236.61	473.22	15	2	1	NA	1	NA	4	0
SMOC1	0	0	2	5	637.56	1275.12	15	2	1	NA	1	NA	7	0
SMOX	0	0	1	5	530.64	1061.28	15	2	1	NA	1	NA	6	0
SMPD2	0	0	6	10	398.97	797.94	15	2	1	NA	1	NA	16	0
SMPD3	0	0	2	2	780.12	1560.24	15	2	1	NA	1	NA	4	0
SMPDL3B	0	0	7	1	470.25	940.5	15	2	1	NA	1	NA	8	0
SMTN	0	0	18	15	1186.35	2372.7	15	2	1	NA	1	NA	33	0
SMU1	0	0	0	2	565.95	1131.9	15	2	1	NA	1	NA	2	0
SMURF1	0	0	1	2	722.7	1445.4	15	2	1	NA	1	NA	3	0
SMURF2	0	0	0	3	743.16	1486.32	15	2	1	NA	1	NA	3	0
SMYD1	0	0	3	5	487.08	974.16	15	2	1	NA	1	NA	8	0
SMYD4	0	0	8	9	688.05	1376.1	15	2	1	NA	1	NA	17	0
SMYD5	0	0	4	7	408.87	817.74	15	2	1	NA	1	NA	11	0
SNAI1	0	0	1	2	250.8	501.6	15	2	1	NA	1	NA	3	0
SNAP29	0	0	1	2	239.25	478.5	15	2	1	NA	1	NA	3	0
SNAPC1	0	0	2	2	243.87	487.74	15	2	1	NA	1	NA	4	0
SNAPC3	0	0	1	2	364.32	728.64	15	2	1	NA	1	NA	3	0
SNAPC4	0	0	15	16	1532.85	3065.7	15	2	1	NA	1	NA	31	0
SNCAIP	0	0	8	2	867.57	1735.14	15	2	1	NA	1	NA	10	0
SNED1	0	0	8	27	1401.84	2803.68	15	2	1	NA	1	NA	35	0
SNIP1	0	0	2	3	337.26	674.52	15	2	1	NA	1	NA	5	0
SNPH	0	0	2	12	470.91	941.82	15	2	1	NA	1	NA	14	0
SNRNP200	0	0	1	24	1676.73	3353.46	15	2	1	NA	1	NA	25	0
SNRNP27	0	0	0	3	103.29	206.58	15	2	1	NA	1	NA	3	0
SNRNP35	0	0	1	3	263.34	526.68	15	2	1	NA	1	NA	4	0
SNRNP40	0	0	0	5	319.44	638.88	15	2	1	NA	1	NA	5	0
SNRPA1	0	0	0	4	253.44	506.88	15	2	1	NA	1	NA	4	0
SNRPC	0	0	0	2	155.76	311.52	15	2	1	NA	1	NA	2	0
SNRPE	0	0	0	3	46.86	93.72	15	2	1	NA	1	NA	3	0
SNTA1	0	0	3	8	385.44	770.88	15	2	1	NA	1	NA	11	0
SNTN	0	0	2	2	143.55	287.1	15	2	1	NA	1	NA	4	0
SNUPN	0	0	5	5	349.47	698.94	15	2	1	NA	1	NA	10	0
SNX1	0	0	2	5	509.85	1019.7	15	2	1	NA	1	NA	7	0
SNX11	0	0	2	3	262.68	525.36	15	2	1	NA	1	NA	5	0
SNX19	0	0	16	15	939.51	1879.02	15	2	1	NA	1	NA	31	0
SNX20	0	0	2	3	324.72	649.44	15	2	1	NA	1	NA	5	0
SNX21	0	0	1	2	299.97	599.94	15	2	1	NA	1	NA	3	0
SNX22	0	0	2	5	175.23	350.46	15	2	1	NA	1	NA	7	0
SNX27	0	0	2	3	535.59	1071.18	15	2	1	NA	1	NA	5	0
SNX29	0	0	3	1	843.81	1687.62	15	2	1	NA	1	NA	4	0
SNX30	0	0	0	2	367.95	735.9	15	2	1	NA	1	NA	2	0
SNX33	0	0	4	10	557.37	1114.74	15	2	1	NA	1	NA	14	0
SNX4	0	0	0	5	427.68	855.36	15	2	1	NA	1	NA	5	0
SNX6	0	0	0	4	385.11	770.22	15	2	1	NA	1	NA	4	0
SNX7	0	0	2	2	411.18	822.36	15	2	1	NA	1	NA	4	0
SNX8	0	0	4	1	437.58	875.16	15	2	1	NA	1	NA	5	0
SOAT1	0	0	0	5	546.48	1092.96	15	2	1	NA	1	NA	5	0
SOCS4	0	0	5	6	432.63	865.26	15	2	1	NA	1	NA	11	0
SOHYE2L	0	0	10	8	713.79	1427.58	15	2	1	NA	1	NA	18	0
SORBS1	0	0	9	8	2062.17	4124.34	15	2	1	NA	1	NA	17	0
SORBS2	0	0	10	8	1533.51	3067.02	15	2	1	NA	1	NA	18	0
SORCS1	0	0	3	4	1013.76	2027.52	15	2	1	NA	1	NA	7	0
SORCS3	0	0	3	0	1016.73	2033.46	15	2	1	NA	1	NA	3	0
SORD	0	0	2	3	510.84	1021.68	15	2	1	NA	1	NA	5	0
SORL1	0	0	10	38	2122.23	4244.46	15	2	1	NA	1	NA	48	0
SOS2	0	0	6	9	1318.68	2637.36	15	2	1	NA	1	NA	15	0
SOST	0	0	0	2	211.86	423.72	15	2	1	NA	1	NA	2	0
SOUL	0	0	3	0	270.27	540.54	15	2	1	NA	1	NA	3	0
SOWAHA	0	0	5	8	475.86	951.72	15	2	1	NA	1	NA	13	0
SOWAHB	0	0	12	7	715.77	1431.54	15	2	1	NA	1	NA	19	0
SOWAHD	0	0	2	4	321.75	643.5	15	2	1	NA	1	NA	6	0
SOX12	0	0	5	7	278.85	557.7	15	2	1	NA	1	NA	12	0
SOX13	0	0	2	16	604.89	1209.78	15	2	1	NA	1	NA	18	0
SOX18	0	0	0	5	417.78	835.56	15	2	1	NA	1	NA	5	0
SOX3	0	0	0	3	260.37	520.74	15	2	1	NA	1	NA	3	0
SOX30	0	0	3	4	615.78	1231.56	15	2	1	NA	1	NA	7	0
SOX8	0	0	5	14	467.28	934.56	15	2	1	NA	1	NA	19	0
SOX9	0	0	4	14	463.65	927.3	15	2	1	NA	1	NA	18	0
SP2	0	0	6	5	577.5	1155	15	2	1	NA	1	NA	11	0
SP3	0	0	3	5	829.62	1659.24	15	2	1	NA	1	NA	8	0
SP5	0	0	2	2	344.52	689.04	15	2	1	NA	1	NA	4	0
SP7	0	0	1	6	323.4	646.8	15	2	1	NA	1	NA	7	0
SPACA9	0	0	1	1	166.32	332.64	15	2	1	NA	1	NA	2	0
SPAG16	0	0	2	1	337.59	675.18	15	2	1	NA	1	NA	3	0
SPAG5	0	0	24	23	1241.79	2483.58	15	2	1	NA	1	NA	47	0
SPAG8	0	0	2	2	225.39	450.78	15	2	1	NA	1	NA	4	0
SPAG9	0	0	3	10	1293.93	2587.86	15	2	1	NA	1	NA	13	0
SPARC	0	0	1	4	296.01	592.02	15	2	1	NA	1	NA	5	0
SPARCL1	0	0	9	2	656.37	1312.74	15	2	1	NA	1	NA	11	0
SPATA1	0	0	5	4	563.31	1126.62	15	2	1	NA	1	NA	9	0
SPATA16	0	0	5	4	571.89	1143.78	15	2	1	NA	1	NA	9	0
SPATA18	0	0	3	1	471.24	942.48	15	2	1	NA	1	NA	4	0
SPATA20	0	0	7	13	753.39	1506.78	15	2	1	NA	1	NA	20	0
SPATA22	0	0	1	1	346.5	693	15	2	1	NA	1	NA	2	0
SPATA4	0	0	2	1	252.45	504.9	15	2	1	NA	1	NA	3	0
SPATA5	0	0	8	8	792	1584	15	2	1	NA	1	NA	16	0
SPATA6	0	0	2	0	475.2	950.4	15	2	1	NA	1	NA	2	0
SPATA7	0	0	6	1	537.57	1075.14	15	2	1	NA	1	NA	7	0
SPATS2	0	0	4	8	537.57	1075.14	15	2	1	NA	1	NA	12	0
SPATS2L	0	0	1	4	590.04	1180.08	15	2	1	NA	1	NA	5	0
SPC25	0	0	2	0	232.65	465.3	15	2	1	NA	1	NA	2	0
SPDEF	0	0	3	8	318.78	637.56	15	2	1	NA	1	NA	11	0
SPDL1	0	0	2	2	619.74	1239.48	15	2	1	NA	1	NA	4	0
SPECC1	0	0	2	6	1041.48	2082.96	15	2	1	NA	1	NA	8	0
SPEF2	0	0	9	2	2221.23	4442.46	15	2	1	NA	1	NA	11	0
SPEG	0	0	40	82	3259.41	6518.82	15	2	1	NA	1	NA	122	0
SPEN	0	0	11	43	2948.22	5896.44	15	2	1	NA	1	NA	54	0
SPG11	0	0	29	15	2401.74	4803.48	15	2	1	NA	1	NA	44	0
SPG21	0	0	1	6	307.89	615.78	15	2	1	NA	1	NA	7	0
SPG7	0	0	3	10	724.68	1449.36	15	2	1	NA	1	NA	13	0
SPHK1	0	0	6	11	461.01	922.02	15	2	1	NA	1	NA	17	0
SPHKAP	0	0	9	12	1694.88	3389.76	15	2	1	NA	1	NA	21	0
SPIA1	0	0	1	1	570.24	1140.48	15	2	1	NA	1	NA	2	0
SPIA3	0	0	4	0	415.8	831.6	15	2	1	NA	1	NA	4	0
SPIA4	0	0	5	0	413.82	827.64	15	2	1	NA	1	NA	5	0
SPIA5	0	0	1	1	418.77	837.54	15	2	1	NA	1	NA	2	0
SPIA9	0	0	3	1	428.67	857.34	15	2	1	NA	1	NA	4	0
SPIK5	0	0	0	2	468.27	936.54	15	2	1	NA	1	NA	2	0
SPINT1	0	0	1	6	504.9	1009.8	15	2	1	NA	1	NA	7	0
SPINT4	0	0	2	3	274.23	548.46	15	2	1	NA	1	NA	5	0
SPIRE2	0	0	2	15	618.42	1236.84	15	2	1	NA	1	NA	17	0
SPNS3	0	0	2	1	559.02	1118.04	15	2	1	NA	1	NA	3	0
SPOCK1	0	0	0	2	225.72	451.44	15	2	1	NA	1	NA	2	0
SPON1	0	0	0	3	490.05	980.1	15	2	1	NA	1	NA	3	0
SPON2	0	0	1	1	327.69	655.38	15	2	1	NA	1	NA	2	0
SPOP	0	0	0	2	371.25	742.5	15	2	1	NA	1	NA	2	0
SPP1	0	0	4	6	301.95	603.9	15	2	1	NA	1	NA	10	0
SPP2	0	0	2	4	179.19	358.38	15	2	1	NA	1	NA	6	0
SPPL2B	0	0	1	1	592.02	1184.04	15	2	1	NA	1	NA	2	0
SPR	0	0	4	6	287.76	575.52	15	2	1	NA	1	NA	10	0
SPRY3	0	0	1	4	303.93	607.86	15	2	1	NA	1	NA	5	0
SPRY4	0	0	1	5	297	594	15	2	1	NA	1	NA	6	0
SPSB1	0	0	1	4	271.26	542.52	15	2	1	NA	1	NA	5	0
SPSB4	0	0	1	3	271.59	543.18	15	2	1	NA	1	NA	4	0
SPTAN1	0	0	3	16	2446.29	4892.58	15	2	1	NA	1	NA	19	0
SPTB	0	0	44	56	2275.68	4551.36	15	2	1	NA	1	NA	100	0
SPTLC1	0	0	1	1	419.1	838.2	15	2	1	NA	1	NA	2	0
SPTSSB	0	0	1	3	104.94	209.88	15	2	1	NA	1	NA	4	0
SPTY2D1	0	0	0	6	704.88	1409.76	15	2	1	NA	1	NA	6	0
SQSTM1	0	0	5	6	449.46	898.92	15	2	1	NA	1	NA	11	0
SRA1	0	0	4	1	208.56	417.12	15	2	1	NA	1	NA	5	0
SRC	0	0	0	9	528.66	1057.32	15	2	1	NA	1	NA	9	0
SRCIN1	0	0	3	11	563.64	1127.28	15	2	1	NA	1	NA	14	0
SRCRB4D	0	0	8	14	509.52	1019.04	15	2	1	NA	1	NA	22	0
SRD5A3	0	0	8	6	310.86	621.72	15	2	1	NA	1	NA	14	0
SREBF1	0	0	2	23	859.32	1718.64	15	2	1	NA	1	NA	25	0
SREK1	0	0	3	0	534.93	1069.86	15	2	1	NA	1	NA	3	0
SRFBP1	0	0	4	3	349.47	698.94	15	2	1	NA	1	NA	7	0
SRGAP3	0	0	1	10	1075.14	2150.28	15	2	1	NA	1	NA	11	0
SRGN	0	0	0	2	144.54	289.08	15	2	1	NA	1	NA	2	0
SRM	0	0	0	2	265.32	530.64	15	2	1	NA	1	NA	2	0
SRP54	0	0	1	2	499.95	999.9	15	2	1	NA	1	NA	3	0
SRP68	0	0	0	9	600.93	1201.86	15	2	1	NA	1	NA	9	0
SRPK1	0	0	1	2	627.99	1255.98	15	2	1	NA	1	NA	3	0
SRPX2	0	0	2	5	459.36	918.72	15	2	1	NA	1	NA	7	0
SRRD	0	0	1	6	126.72	253.44	15	2	1	NA	1	NA	7	0
SRRL	0	0	1	6	525.69	1051.38	15	2	1	NA	1	NA	7	0
SRRM3	0	0	9	15	519.09	1038.18	15	2	1	NA	1	NA	24	0
SRRM4	0	0	3	3	588.06	1176.12	15	2	1	NA	1	NA	6	0
SRSF11	0	0	0	3	412.17	824.34	15	2	1	NA	1	NA	3	0
SRSF3	0	0	2	0	338.25	676.5	15	2	1	NA	1	NA	2	0
SRSF4	0	0	2	2	488.07	976.14	15	2	1	NA	1	NA	4	0
SRSF5	0	0	0	2	264.33	528.66	15	2	1	NA	1	NA	2	0
SRSF6	0	0	1	1	345.51	691.02	15	2	1	NA	1	NA	2	0
SRXN1	0	0	0	2	120.78	241.56	15	2	1	NA	1	NA	2	0
SSBP3-SSBP4	0	0	4	1	139.59	279.18	15	2	1	NA	1	NA	5	0
SSFA2	0	0	5	3	1252.35	2504.7	15	2	1	NA	1	NA	8	0
SSH1	0	0	13	14	1069.2	2138.4	15	2	1	NA	1	NA	27	0
SSH2	0	0	16	16	1402.5	2805	15	2	1	NA	1	NA	32	0
SSR3	0	0	0	4	185.46	370.92	15	2	1	NA	1	NA	4	0
SSTR2	0	0	3	2	368.28	736.56	15	2	1	NA	1	NA	5	0
SSTR5	0	0	0	3	367.29	734.58	15	2	1	NA	1	NA	3	0
SSU72	0	0	1	6	293.7	587.4	15	2	1	NA	1	NA	7	0
SSX2IP	0	0	2	3	555.39	1110.78	15	2	1	NA	1	NA	5	0
ST14	0	0	4	8	829.62	1659.24	15	2	1	NA	1	NA	12	0
ST3GAL2L	0	0	2	3	321.75	643.5	15	2	1	NA	1	NA	5	0
ST3GAL3	0	0	1	2	481.8	963.6	15	2	1	NA	1	NA	3	0
ST3GAL5	0	0	4	5	393.69	787.38	15	2	1	NA	1	NA	9	0
ST5	0	0	9	9	1201.2	2402.4	15	2	1	NA	1	NA	18	0
ST6GALNAC1	0	0	13	9	721.71	1443.42	15	2	1	NA	1	NA	22	0
ST6GALNAC2	0	0	5	8	397.98	795.96	15	2	1	NA	1	NA	13	0
ST6GALNAC2L	0	0	13	8	407.88	815.76	15	2	1	NA	1	NA	21	0
ST6GALNAC5	0	0	0	2	244.53	489.06	15	2	1	NA	1	NA	2	0
ST8SIA2	0	0	0	3	353.43	706.86	15	2	1	NA	1	NA	3	0
ST8SIA5	0	0	2	1	401.61	803.22	15	2	1	NA	1	NA	3	0
STAB1	0	0	17	28	2498.76	4997.52	15	2	1	NA	1	NA	45	0
STAG1	0	0	0	4	1126.62	2253.24	15	2	1	NA	1	NA	4	0
STAG2	0	0	0	6	1313.07	2626.14	15	2	1	NA	1	NA	6	0
STAM2	0	0	2	3	507.54	1015.08	15	2	1	NA	1	NA	5	0
STAMBP	0	0	2	0	597.96	1195.92	15	2	1	NA	1	NA	2	0
STAMBPL1	0	0	2	3	413.82	827.64	15	2	1	NA	1	NA	5	0
STARD3	0	0	6	10	440.55	881.1	15	2	1	NA	1	NA	16	0
STARD5	0	0	1	1	208.89	417.78	15	2	1	NA	1	NA	2	0
STARD9	0	0	61	26	5099.49	10198.98	15	2	1	NA	1	NA	87	0
STAT1	0	0	0	4	1422.63	2845.26	15	2	1	NA	1	NA	4	0
STAT2	0	0	2	3	586.74	1173.48	15	2	1	NA	1	NA	5	0
STBD1	0	0	8	6	307.89	615.78	15	2	1	NA	1	NA	14	0
STC1	0	0	3	7	385.11	770.22	15	2	1	NA	1	NA	10	0
STC2	0	0	1	4	296.34	592.68	15	2	1	NA	1	NA	5	0
STEAP3	0	0	0	5	483.12	966.24	15	2	1	NA	1	NA	5	0
STIL	0	0	10	8	1261.26	2522.52	15	2	1	NA	1	NA	18	0
STIM2	0	0	1	4	684.09	1368.18	15	2	1	NA	1	NA	5	0
STK10	0	0	4	9	963.27	1926.54	15	2	1	NA	1	NA	13	0
STK11	0	0	0	6	415.8	831.6	15	2	1	NA	1	NA	6	0
STK11IP	0	0	7	8	1138.17	2276.34	15	2	1	NA	1	NA	15	0
STK17A	0	0	7	12	340.23	680.46	15	2	1	NA	1	NA	19	0
STK17B	0	0	1	3	369.27	738.54	15	2	1	NA	1	NA	4	0
STK25	0	0	0	3	406.89	813.78	15	2	1	NA	1	NA	3	0
STK32A	0	0	3	1	374.88	749.76	15	2	1	NA	1	NA	4	0
STK32C	0	0	4	4	464.97	929.94	15	2	1	NA	1	NA	8	0
STK35	0	0	0	4	327.69	655.38	15	2	1	NA	1	NA	4	0
STK36	0	0	23	22	1303.5	2607	15	2	1	NA	1	NA	45	0
STK38	0	0	0	2	461.34	922.68	15	2	1	NA	1	NA	2	0
STK39	0	0	0	2	451.11	902.22	15	2	1	NA	1	NA	2	0
STK4	0	0	0	4	513.81	1027.62	15	2	1	NA	1	NA	4	0
STKLD1	0	0	9	4	632.61	1265.22	15	2	1	NA	1	NA	13	0
STN1	0	0	3	2	359.37	718.74	15	2	1	NA	1	NA	5	0
STOML1	0	0	4	10	407.88	815.76	15	2	1	NA	1	NA	14	0
STON2	0	0	4	4	878.13	1756.26	15	2	1	NA	1	NA	8	0
STOX1	0	0	14	3	827.97	1655.94	15	2	1	NA	1	NA	17	0
STRA6	0	0	16	12	665.28	1330.56	15	2	1	NA	1	NA	28	0
STRIP1	0	0	0	9	773.85	1547.7	15	2	1	NA	1	NA	9	0
STX1A	0	0	2	5	231.66	463.32	15	2	1	NA	1	NA	7	0
STX2	0	0	3	1	453.42	906.84	15	2	1	NA	1	NA	4	0
STX3	0	0	0	5	213.84	427.68	15	2	1	NA	1	NA	5	0
STX6	0	0	2	2	244.53	489.06	15	2	1	NA	1	NA	4	0
STX8	0	0	3	3	332.31	664.62	15	2	1	NA	1	NA	6	0
STXBP1	0	0	0	12	575.52	1151.04	15	2	1	NA	1	NA	12	0
STXBP3	0	0	2	7	589.05	1178.1	15	2	1	NA	1	NA	9	0
STXBP4	0	0	2	2	727.65	1455.3	15	2	1	NA	1	NA	4	0
STXBP6	0	0	1	1	173.91	347.82	15	2	1	NA	1	NA	2	0
STYX	0	0	0	5	221.76	443.52	15	2	1	NA	1	NA	5	0
STYXL1	0	0	6	2	293.7	587.4	15	2	1	NA	1	NA	8	0
SUCLG1	0	0	2	1	332.64	665.28	15	2	1	NA	1	NA	3	0
SUCLG2	0	0	4	3	497.97	995.94	15	2	1	NA	1	NA	7	0
SUCNR1	0	0	1	2	307.23	614.46	15	2	1	NA	1	NA	3	0
SUCO	0	0	4	7	1233.54	2467.08	15	2	1	NA	1	NA	11	0
SUFU	0	0	3	1	342.54	685.08	15	2	1	NA	1	NA	4	0
SUGP1	0	0	3	11	675.51	1351.02	15	2	1	NA	1	NA	14	0
SUGP2	0	0	4	9	1110.78	2221.56	15	2	1	NA	1	NA	13	0
SULF2	0	0	1	6	870.21	1740.42	15	2	1	NA	1	NA	7	0
SULT1B-SULT1B1	0	0	2	1	294.03	588.06	15	2	1	NA	1	NA	3	0
SULT2B1L1	0	0	0	8	286.11	572.22	15	2	1	NA	1	NA	8	0
SUMF1	0	0	3	2	286.11	572.22	15	2	1	NA	1	NA	5	0
SUMF2	0	0	7	7	308.88	617.76	15	2	1	NA	1	NA	14	0
SUMO3	0	0	0	2	87.12	174.24	15	2	1	NA	1	NA	2	0
SUN1	0	0	6	3	896.94	1793.88	15	2	1	NA	1	NA	9	0
SUPT5H	0	0	0	4	723.36	1446.72	15	2	1	NA	1	NA	4	0
SUPT6H	0	0	0	30	1709.73	3419.46	15	2	1	NA	1	NA	30	0
SUPV3L1	0	0	5	8	736.56	1473.12	15	2	1	NA	1	NA	13	0
SURF1	0	0	1	2	307.89	615.78	15	2	1	NA	1	NA	3	0
SURF2	0	0	2	2	260.37	520.74	15	2	1	NA	1	NA	4	0
SURF4	0	0	0	3	267.3	534.6	15	2	1	NA	1	NA	3	0
SURF6	0	0	2	1	352.44	704.88	15	2	1	NA	1	NA	3	0
SUSD1	0	0	3	4	718.08	1436.16	15	2	1	NA	1	NA	7	0
SUSD3	0	0	0	6	286.11	572.22	15	2	1	NA	1	NA	6	0
SUSD6	0	0	0	2	325.71	651.42	15	2	1	NA	1	NA	2	0
SUZ12	0	0	1	5	836.88	1673.76	15	2	1	NA	1	NA	6	0
SV2B	0	0	3	7	698.94	1397.88	15	2	1	NA	1	NA	10	0
SV2C	0	0	1	3	371.91	743.82	15	2	1	NA	1	NA	4	0
SVEP1	0	0	17	18	3616.8	7233.6	15	2	1	NA	1	NA	35	0
SVOP	0	0	2	5	586.74	1173.48	15	2	1	NA	1	NA	7	0
SWAP70	0	0	2	3	553.41	1106.82	15	2	1	NA	1	NA	5	0
SWT1	0	0	3	4	849.42	1698.84	15	2	1	NA	1	NA	7	0
SYCP2	0	0	3	5	1111.77	2223.54	15	2	1	NA	1	NA	8	0
SYDE2	0	0	7	8	977.79	1955.58	15	2	1	NA	1	NA	15	0
SYNC	0	0	4	8	569.58	1139.16	15	2	1	NA	1	NA	12	0
SYNDIG1L	0	0	3	4	239.58	479.16	15	2	1	NA	1	NA	7	0
SYNE2	0	0	33	27	6909.87	13819.74	15	2	1	NA	1	NA	60	0
SYNE3	0	0	2	8	1005.51	2011.02	15	2	1	NA	1	NA	10	0
SYNGR3	0	0	1	6	210.21	420.42	15	2	1	NA	1	NA	7	0
SYNJ2BP	0	0	1	3	437.91	875.82	15	2	1	NA	1	NA	4	0
SYNM	0	0	11	6	1582.02	3164.04	15	2	1	NA	1	NA	17	0
SYNPO	0	0	18	24	1108.47	2216.94	15	2	1	NA	1	NA	42	0
SYNPO2	0	0	3	9	1220.67	2441.34	15	2	1	NA	1	NA	12	0
SYNPO2L	0	0	8	15	805.86	1611.72	15	2	1	NA	1	NA	23	0
SYNPR	0	0	1	1	262.35	524.7	15	2	1	NA	1	NA	2	0
SYNRG	0	0	13	18	1944.36	3888.72	15	2	1	NA	1	NA	31	0
SYS1	0	0	0	2	155.43	310.86	15	2	1	NA	1	NA	2	0
SYT11	0	0	0	2	425.7	851.4	15	2	1	NA	1	NA	2	0
SYT12	0	0	2	13	414.81	829.62	15	2	1	NA	1	NA	15	0
SYT13	0	0	2	2	425.7	851.4	15	2	1	NA	1	NA	4	0
SYT16	0	0	3	5	580.14	1160.28	15	2	1	NA	1	NA	8	0
SYT17	0	0	2	1	464.31	928.62	15	2	1	NA	1	NA	3	0
SYT2	0	0	1	14	411.84	823.68	15	2	1	NA	1	NA	15	0
SYT4	0	0	2	1	421.41	842.82	15	2	1	NA	1	NA	3	0
SYT6	0	0	2	1	516.78	1033.56	15	2	1	NA	1	NA	3	0
SYT8	0	0	9	4	392.04	784.08	15	2	1	NA	1	NA	13	0
SYTL1	0	0	11	13	480.15	960.3	15	2	1	NA	1	NA	24	0
SYTL2L	0	0	11	9	957.33	1914.66	15	2	1	NA	1	NA	20	0
SYTL4	0	0	6	5	672.87	1345.74	15	2	1	NA	1	NA	11	0
SZRD1	0	0	2	3	151.47	302.94	15	2	1	NA	1	NA	5	0
SZT2	0	0	14	28	3609.87	7219.74	15	2	1	NA	1	NA	42	0
TA3	0	0	14	11	1565.19	3130.38	15	2	1	NA	1	NA	25	0
TACC1	0	0	8	14	770.55	1541.1	15	2	1	NA	1	NA	22	0
TACC2	0	0	44	42	3103.65	6207.3	15	2	1	NA	1	NA	86	0
TACC3	0	0	2	5	888.03	1776.06	15	2	1	NA	1	NA	7	0
TACR3	0	0	4	1	432.63	865.26	15	2	1	NA	1	NA	5	0
TADA1	0	0	2	2	332.64	665.28	15	2	1	NA	1	NA	4	0
TADA2A	0	0	0	3	415.8	831.6	15	2	1	NA	1	NA	3	0
TADA2B	0	0	0	3	409.86	819.72	15	2	1	NA	1	NA	3	0
TADA3	0	0	0	9	422.07	844.14	15	2	1	NA	1	NA	9	0
TAF11	0	0	0	2	184.14	368.28	15	2	1	NA	1	NA	2	0
TAF15	0	0	0	3	470.25	940.5	15	2	1	NA	1	NA	3	0
TAF1CZ	0	0	3	6	537.24	1074.48	15	2	1	NA	1	NA	9	0
TAF4	0	0	2	6	1047.42	2094.84	15	2	1	NA	1	NA	8	0
TAF5	0	0	4	3	784.08	1568.16	15	2	1	NA	1	NA	7	0
TAF6-TAF6L	0	0	1	6	594.99	1189.98	15	2	1	NA	1	NA	7	0
TAF7	0	0	1	2	350.46	700.92	15	2	1	NA	1	NA	3	0
TAF8	0	0	3	9	290.07	580.14	15	2	1	NA	1	NA	12	0
TAGLN	0	0	1	4	198.99	397.98	15	2	1	NA	1	NA	5	0
TAL1	0	0	0	3	169.29	338.58	15	2	1	NA	1	NA	3	0
TALDO1	0	0	3	2	334.62	669.24	15	2	1	NA	1	NA	5	0
TAMM41	0	0	2	2	324.72	649.44	15	2	1	NA	1	NA	4	0
TANC1	0	0	7	8	1802.79	3605.58	15	2	1	NA	1	NA	15	0
TANC2	0	0	7	31	2163.81	4327.62	15	2	1	NA	1	NA	38	0
TANGO2	0	0	2	4	274.23	548.46	15	2	1	NA	1	NA	6	0
TANK	0	0	2	2	477.18	954.36	15	2	1	NA	1	NA	4	0
TAOK1	0	0	2	3	991.98	1983.96	15	2	1	NA	1	NA	5	0
TAOK3	0	0	0	4	847.44	1694.88	15	2	1	NA	1	NA	4	0
TAP2	0	0	7	11	693.99	1387.98	15	2	1	NA	1	NA	18	0
TAPT1	0	0	2	4	528.66	1057.32	15	2	1	NA	1	NA	6	0
TARSL2	0	0	5	3	664.95	1329.9	15	2	1	NA	1	NA	8	0
TAS1R1	0	0	3	4	955.68	1911.36	15	2	1	NA	1	NA	7	0
TAS1R3	0	0	9	6	828.63	1657.26	15	2	1	NA	1	NA	15	0
TAT	0	0	2	2	451.44	902.88	15	2	1	NA	1	NA	4	0
TBC1D13	0	0	0	4	396	792	15	2	1	NA	1	NA	4	0
TBC1D14	0	0	2	5	705.87	1411.74	15	2	1	NA	1	NA	7	0
TBC1D16	0	0	6	5	780.12	1560.24	15	2	1	NA	1	NA	11	0
TBC1D19	0	0	2	0	521.73	1043.46	15	2	1	NA	1	NA	2	0
TBC1D2	0	0	7	7	929.28	1858.56	15	2	1	NA	1	NA	14	0
TBC1D20	0	0	2	5	388.08	776.16	15	2	1	NA	1	NA	7	0
TBC1D22B	0	0	1	13	551.1	1102.2	15	2	1	NA	1	NA	14	0
TBC1D24	0	0	2	6	478.5	957	15	2	1	NA	1	NA	8	0
TBC1D24L	0	0	9	14	624.69	1249.38	15	2	1	NA	1	NA	23	0
TBC1D2B	0	0	2	7	947.43	1894.86	15	2	1	NA	1	NA	9	0
TBC1D8B	0	0	4	0	1114.74	2229.48	15	2	1	NA	1	NA	4	0
TBC1D9	0	0	2	5	1278.09	2556.18	15	2	1	NA	1	NA	7	0
TBC1D9B	0	0	3	6	1204.5	2409	15	2	1	NA	1	NA	9	0
TBCCD1	0	0	9	3	549.45	1098.9	15	2	1	NA	1	NA	12	0
TBCEL	0	0	1	4	420.75	841.5	15	2	1	NA	1	NA	5	0
TBCK	0	0	0	3	724.02	1448.04	15	2	1	NA	1	NA	3	0
TBKBP1	0	0	4	9	504.24	1008.48	15	2	1	NA	1	NA	13	0
TBL1XR1	0	0	0	2	508.86	1017.72	15	2	1	NA	1	NA	2	0
TBL3	0	0	6	13	787.71	1575.42	15	2	1	NA	1	NA	19	0
TBPL2	0	0	5	6	322.74	645.48	15	2	1	NA	1	NA	11	0
TBRG4	0	0	7	14	539.22	1078.44	15	2	1	NA	1	NA	21	0
TBX1	0	0	7	4	495.66	991.32	15	2	1	NA	1	NA	11	0
TBX10	0	0	4	3	215.49	430.98	15	2	1	NA	1	NA	7	0
TBX21	0	0	0	5	190.08	380.16	15	2	1	NA	1	NA	5	0
TBX4	0	0	0	7	536.58	1073.16	15	2	1	NA	1	NA	7	0
TBX5	0	0	1	4	514.8	1029.6	15	2	1	NA	1	NA	5	0
TBXA2R	0	0	1	7	361.35	722.7	15	2	1	NA	1	NA	8	0
TC2N	0	0	1	2	485.1	970.2	15	2	1	NA	1	NA	3	0
TCAP	0	0	3	1	111.54	223.08	15	2	1	NA	1	NA	4	0
TCEA2	0	0	4	4	327.69	655.38	15	2	1	NA	1	NA	8	0
TCEA3	0	0	1	7	331.98	663.96	15	2	1	NA	1	NA	8	0
TCEANC2	0	0	2	1	178.2	356.4	15	2	1	NA	1	NA	3	0
TCERG1	0	0	1	3	985.05	1970.1	15	2	1	NA	1	NA	4	0
TCERG1L	0	0	6	4	695.97	1391.94	15	2	1	NA	1	NA	10	0
TCF12	0	0	2	3	488.07	976.14	15	2	1	NA	1	NA	5	0
TCF15	0	0	0	3	182.16	364.32	15	2	1	NA	1	NA	3	0
TCF25	0	0	4	14	653.4	1306.8	15	2	1	NA	1	NA	18	0
TCF7	0	0	0	3	409.2	818.4	15	2	1	NA	1	NA	3	0
TCF7L2	0	0	0	6	422.07	844.14	15	2	1	NA	1	NA	6	0
TCHP	0	0	11	11	475.86	951.72	15	2	1	NA	1	NA	22	0
TCIRG1	0	0	6	8	663.96	1327.92	15	2	1	NA	1	NA	14	0
TCP11	0	0	6	5	476.52	953.04	15	2	1	NA	1	NA	11	0
TCP11L1	0	0	9	7	511.83	1023.66	15	2	1	NA	1	NA	16	0
TCTEX1D4	0	0	4	3	214.83	429.66	15	2	1	NA	1	NA	7	0
TCTN1	0	0	8	5	550.44	1100.88	15	2	1	NA	1	NA	13	0
TCTN2	0	0	4	2	672.21	1344.42	15	2	1	NA	1	NA	6	0
TCTN3	0	0	8	2	508.86	1017.72	15	2	1	NA	1	NA	10	0
TDP1	0	0	5	6	670.23	1340.46	15	2	1	NA	1	NA	11	0
TDRD1	0	0	7	7	1063.26	2126.52	15	2	1	NA	1	NA	14	0
TDRD12	0	0	1	1	1052.37	2104.74	15	2	1	NA	1	NA	2	0
TDRD5	0	0	4	8	733.59	1467.18	15	2	1	NA	1	NA	12	0
TDRD7	0	0	4	9	1044.12	2088.24	15	2	1	NA	1	NA	13	0
TDRD9	0	0	3	3	1322.97	2645.94	15	2	1	NA	1	NA	6	0
TEAD1	0	0	3	2	508.53	1017.06	15	2	1	NA	1	NA	5	0
TEAD3	0	0	1	7	372.57	745.14	15	2	1	NA	1	NA	8	0
TECPR1	0	0	7	5	1152.36	2304.72	15	2	1	NA	1	NA	12	0
TECPR2	0	0	2	6	1453.32	2906.64	15	2	1	NA	1	NA	8	0
TECRL	0	0	1	1	422.73	845.46	15	2	1	NA	1	NA	2	0
TECTA	0	0	20	77	2106.06	4212.12	15	2	1	NA	1	NA	97	0
TEKT1	0	0	2	0	411.84	823.68	15	2	1	NA	1	NA	2	0
TEKT2	0	0	1	5	426.69	853.38	15	2	1	NA	1	NA	6	0
TEKT3	0	0	3	15	486.09	972.18	15	2	1	NA	1	NA	18	0
TEKT4	0	0	6	3	447.48	894.96	15	2	1	NA	1	NA	9	0
TEKT5	0	0	1	2	357.39	714.78	15	2	1	NA	1	NA	3	0
TELO2	0	0	10	11	744.48	1488.96	15	2	1	NA	1	NA	21	0
TEN1	0	0	2	3	125.73	251.46	15	2	1	NA	1	NA	5	0
TENM1	0	0	4	21	2447.28	4894.56	15	2	1	NA	1	NA	25	0
TENM2	0	0	2	18	2277.99	4555.98	15	2	1	NA	1	NA	20	0
TENM3	0	0	5	10	2251.26	4502.52	15	2	1	NA	1	NA	15	0
TERAL2-VCP	0	0	0	9	789.36	1578.72	15	2	1	NA	1	NA	9	0
TERB2	0	0	1	5	308.55	617.1	15	2	1	NA	1	NA	6	0
TERF2	0	0	0	7	520.74	1041.48	15	2	1	NA	1	NA	7	0
TERF2IP	0	0	5	3	333.63	667.26	15	2	1	NA	1	NA	8	0
TESK1	0	0	7	9	598.62	1197.24	15	2	1	NA	1	NA	16	0
TESK2	0	0	2	4	686.07	1372.14	15	2	1	NA	1	NA	6	0
TESMIN	0	0	5	1	521.73	1043.46	15	2	1	NA	1	NA	6	0
TESPA1	0	0	8	15	347.82	695.64	15	2	1	NA	1	NA	23	0
TET1	0	0	8	7	2209.35	4418.7	15	2	1	NA	1	NA	15	0
TET2	0	0	12	9	1935.45	3870.9	15	2	1	NA	1	NA	21	0
TET3	0	0	3	8	1597.86	3195.72	15	2	1	NA	1	NA	11	0
TEX11	0	0	5	3	857.34	1714.68	15	2	1	NA	1	NA	8	0
TEX14	0	0	19	8	1489.95	2979.9	15	2	1	NA	1	NA	27	0
TEX2	0	0	4	11	1152.69	2305.38	15	2	1	NA	1	NA	15	0
TEX264	0	0	1	9	325.71	651.42	15	2	1	NA	1	NA	10	0
TEX2L	0	0	20	19	846.45	1692.9	15	2	1	NA	1	NA	39	0
TEX9	0	0	3	1	392.04	784.08	15	2	1	NA	1	NA	4	0
TF	0	0	3	2	699.93	1399.86	15	2	1	NA	1	NA	5	0
TFAM	0	0	2	5	263.34	526.68	15	2	1	NA	1	NA	7	0
TFAP2C	0	0	0	4	378.84	757.68	15	2	1	NA	1	NA	4	0
TFAP2E	0	0	1	4	422.4	844.8	15	2	1	NA	1	NA	5	0
TFCP2L1	0	0	0	2	471.24	942.48	15	2	1	NA	1	NA	2	0
TFDP2	0	0	2	0	442.53	885.06	15	2	1	NA	1	NA	2	0
TFEB	0	0	3	12	439.89	879.78	15	2	1	NA	1	NA	15	0
TFIP11	0	0	1	8	817.74	1635.48	15	2	1	NA	1	NA	9	0
TFPI	0	0	4	3	331.65	663.3	15	2	1	NA	1	NA	7	0
TFRC	0	0	6	9	770.22	1540.44	15	2	1	NA	1	NA	15	0
TGFA	0	0	4	4	153.12	306.24	15	2	1	NA	1	NA	8	0
TGFB3	0	0	0	5	408.87	817.74	15	2	1	NA	1	NA	5	0
TGFBI	0	0	1	10	646.47	1292.94	15	2	1	NA	1	NA	11	0
TGFBR3	0	0	2	2	712.8	1425.6	15	2	1	NA	1	NA	4	0
TGIF2	0	0	2	4	260.37	520.74	15	2	1	NA	1	NA	6	0
TGM2	0	0	8	16	683.1	1366.2	15	2	1	NA	1	NA	24	0
TH	0	0	2	6	487.08	974.16	15	2	1	NA	1	NA	8	0
THAP4	0	0	7	14	1049.73	2099.46	15	2	1	NA	1	NA	21	0
THAP7	0	0	1	3	88.44	176.88	15	2	1	NA	1	NA	4	0
THBS4	0	0	4	5	944.46	1888.92	15	2	1	NA	1	NA	9	0
THEMIS2	0	0	2	0	572.22	1144.44	15	2	1	NA	1	NA	2	0
THG1L	0	0	4	4	294.03	588.06	15	2	1	NA	1	NA	8	0
THNSL2	0	0	4	1	491.04	982.08	15	2	1	NA	1	NA	5	0
THOC2	0	0	1	7	1515.69	3031.38	15	2	1	NA	1	NA	8	0
THOC3	0	0	2	4	309.21	618.42	15	2	1	NA	1	NA	6	0
THOC5	0	0	2	12	676.17	1352.34	15	2	1	NA	1	NA	14	0
THOP1	0	0	0	12	662.64	1325.28	15	2	1	NA	1	NA	12	0
THPO	0	0	8	5	210.54	421.08	15	2	1	NA	1	NA	13	0
THRAP3	0	0	3	3	957.33	1914.66	15	2	1	NA	1	NA	6	0
THSD4	0	0	1	5	631.62	1263.24	15	2	1	NA	1	NA	6	0
THSD7B	0	0	11	12	1035.54	2071.08	15	2	1	NA	1	NA	23	0
THT2L	0	0	2	4	570.57	1141.14	15	2	1	NA	1	NA	6	0
THUMPD3	0	0	0	3	468.93	937.86	15	2	1	NA	1	NA	3	0
THY1	0	0	1	1	160.38	320.76	15	2	1	NA	1	NA	2	0
THYN1	0	0	0	4	240.57	481.14	15	2	1	NA	1	NA	4	0
TIA1	0	0	0	6	369.27	738.54	15	2	1	NA	1	NA	6	0
TICAM1	0	0	9	7	758.67	1517.34	15	2	1	NA	1	NA	16	0
TICRR	0	0	20	21	1843.05	3686.1	15	2	1	NA	1	NA	41	0
TIE1	0	0	3	16	1024.65	2049.3	15	2	1	NA	1	NA	19	0
TIFA	0	0	2	0	186.12	372.24	15	2	1	NA	1	NA	2	0
TIMELESS	0	0	13	13	1155	2310	15	2	1	NA	1	NA	26	0
TIMM13	0	0	0	2	100.98	201.96	15	2	1	NA	1	NA	2	0
TIMM22	0	0	0	3	180.51	361.02	15	2	1	NA	1	NA	3	0
TIMM44	0	0	1	6	460.02	920.04	15	2	1	NA	1	NA	7	0
TIMP2	0	0	2	2	206.25	412.5	15	2	1	NA	1	NA	4	0
TIMP4	0	0	0	2	219.78	439.56	15	2	1	NA	1	NA	2	0
TINAGL1	0	0	0	7	363.33	726.66	15	2	1	NA	1	NA	7	0
TIPARP	0	0	4	8	664.29	1328.58	15	2	1	NA	1	NA	12	0
TIPIN	0	0	2	2	280.17	560.34	15	2	1	NA	1	NA	4	0
TJP1	0	0	2	6	1665.18	3330.36	15	2	1	NA	1	NA	8	0
TJP2	0	0	2	2	678.81	1357.62	15	2	1	NA	1	NA	4	0
TJP3	0	0	10	18	1029.6	2059.2	15	2	1	NA	1	NA	28	0
TKFC	0	0	11	11	571.23	1142.46	15	2	1	NA	1	NA	22	0
TKT	0	0	1	1	599.94	1199.88	15	2	1	NA	1	NA	2	0
TLCD1	0	0	1	3	182.49	364.98	15	2	1	NA	1	NA	4	0
TLCD2	0	0	2	4	239.58	479.16	15	2	1	NA	1	NA	6	0
TLDC1	0	0	2	3	464.31	928.62	15	2	1	NA	1	NA	5	0
TLDC2	0	0	2	3	215.82	431.64	15	2	1	NA	1	NA	5	0
TLE3	0	0	2	20	539.22	1078.44	15	2	1	NA	1	NA	22	0
TLE4Z1	0	0	4	1	786.72	1573.44	15	2	1	NA	1	NA	5	0
TLK1	0	0	2	0	562.32	1124.64	15	2	1	NA	1	NA	2	0
TLK2	0	0	0	3	743.49	1486.98	15	2	1	NA	1	NA	3	0
TLL1	0	0	3	2	962.28	1924.56	15	2	1	NA	1	NA	5	0
TLL2	0	0	1	3	981.09	1962.18	15	2	1	NA	1	NA	4	0
TLN1	0	0	9	30	2385.9	4771.8	15	2	1	NA	1	NA	39	0
TLN2	0	0	1	4	2532.75	5065.5	15	2	1	NA	1	NA	5	0
TLR21	0	0	5	11	894.96	1789.92	15	2	1	NA	1	NA	16	0
TLR2B	0	0	1	1	413.16	826.32	15	2	1	NA	1	NA	2	0
TLR3	0	0	1	2	907.5	1815	15	2	1	NA	1	NA	3	0
TLR4	0	0	4	6	835.56	1671.12	15	2	1	NA	1	NA	10	0
TLX1	0	0	0	5	236.61	473.22	15	2	1	NA	1	NA	5	0
TLX3	0	0	1	9	128.04	256.08	15	2	1	NA	1	NA	10	0
TM2D1	0	0	1	2	136.62	273.24	15	2	1	NA	1	NA	3	0
TM2D3	0	0	1	4	199.32	398.64	15	2	1	NA	1	NA	5	0
TM9SF2L	0	0	0	3	640.53	1281.06	15	2	1	NA	1	NA	3	0
TM9SF3	0	0	0	4	564.63	1129.26	15	2	1	NA	1	NA	4	0
TM9SF4	0	0	1	5	632.61	1265.22	15	2	1	NA	1	NA	6	0
TMBIM1	0	0	3	4	172.59	345.18	15	2	1	NA	1	NA	7	0
TMC3	0	0	6	2	1081.08	2162.16	15	2	1	NA	1	NA	8	0
TMC5	0	0	1	2	827.64	1655.28	15	2	1	NA	1	NA	3	0
TMC6	0	0	7	12	929.61	1859.22	15	2	1	NA	1	NA	19	0
TMCC1	0	0	0	2	457.38	914.76	15	2	1	NA	1	NA	2	0
TMCC2	0	0	2	18	614.79	1229.58	15	2	1	NA	1	NA	20	0
TMCO1	0	0	0	2	187.11	374.22	15	2	1	NA	1	NA	2	0
TMCO4	0	0	4	4	596.97	1193.94	15	2	1	NA	1	NA	8	0
TMCO6	0	0	5	6	431.31	862.62	15	2	1	NA	1	NA	11	0
TMCO7	0	0	20	24	878.13	1756.26	15	2	1	NA	1	NA	44	0
TMED10	0	0	0	2	146.52	293.04	15	2	1	NA	1	NA	2	0
TMED11	0	0	0	2	215.82	431.64	15	2	1	NA	1	NA	2	0
TMED2	0	0	2	0	206.91	413.82	15	2	1	NA	1	NA	2	0
TMED3	0	0	1	1	206.91	413.82	15	2	1	NA	1	NA	2	0
TMED5	0	0	1	1	221.76	443.52	15	2	1	NA	1	NA	2	0
TMED6	0	0	3	4	232.65	465.3	15	2	1	NA	1	NA	7	0
TMED8	0	0	1	1	323.07	646.14	15	2	1	NA	1	NA	2	0
TMEFF2	0	0	2	1	280.17	560.34	15	2	1	NA	1	NA	3	0
TMEM104	0	0	3	9	494.01	988.02	15	2	1	NA	1	NA	12	0
TMEM106C	0	0	2	8	272.25	544.5	15	2	1	NA	1	NA	10	0
TMEM109	0	0	5	4	219.45	438.9	15	2	1	NA	1	NA	9	0
TMEM11	0	0	1	2	193.05	386.1	15	2	1	NA	1	NA	3	0
TMEM114	0	0	3	0	209.88	419.76	15	2	1	NA	1	NA	3	0
TMEM115	0	0	3	4	344.19	688.38	15	2	1	NA	1	NA	7	0
TMEM116	0	0	4	2	359.37	718.74	15	2	1	NA	1	NA	6	0
TMEM119	0	0	5	9	245.52	491.04	15	2	1	NA	1	NA	14	0
TMEM120A	0	0	2	5	338.58	677.16	15	2	1	NA	1	NA	7	0
TMEM120B	0	0	1	1	336.6	673.2	15	2	1	NA	1	NA	2	0
TMEM121	0	0	0	9	309.87	619.74	15	2	1	NA	1	NA	9	0
TMEM125	0	0	1	5	218.79	437.58	15	2	1	NA	1	NA	6	0
TMEM128	0	0	0	2	170.28	340.56	15	2	1	NA	1	NA	2	0
TMEM129	0	0	2	0	359.37	718.74	15	2	1	NA	1	NA	2	0
TMEM130	0	0	3	0	422.73	845.46	15	2	1	NA	1	NA	3	0
TMEM132A	0	0	15	27	941.16	1882.32	15	2	1	NA	1	NA	42	0
TMEM132C	0	0	3	3	620.73	1241.46	15	2	1	NA	1	NA	6	0
TMEM132D	0	0	2	2	722.37	1444.74	15	2	1	NA	1	NA	4	0
TMEM132E	0	0	6	18	999.57	1999.14	15	2	1	NA	1	NA	24	0
TMEM136-1	0	0	9	7	242.55	485.1	15	2	1	NA	1	NA	16	0
TMEM136-2	0	0	4	3	243.54	487.08	15	2	1	NA	1	NA	7	0
TMEM138	0	0	0	2	161.37	322.74	15	2	1	NA	1	NA	2	0
TMEM144	0	0	1	2	373.56	747.12	15	2	1	NA	1	NA	3	0
TMEM150A	0	0	1	2	247.83	495.66	15	2	1	NA	1	NA	3	0
TMEM150C	0	0	0	4	247.5	495	15	2	1	NA	1	NA	4	0
TMEM156	0	0	2	2	287.1	574.2	15	2	1	NA	1	NA	4	0
TMEM161A	0	0	10	14	473.22	946.44	15	2	1	NA	1	NA	24	0
TMEM163	0	0	3	1	374.22	748.44	15	2	1	NA	1	NA	4	0
TMEM164	0	0	5	0	341.55	683.1	15	2	1	NA	1	NA	5	0
TMEM165	0	0	0	3	253.44	506.88	15	2	1	NA	1	NA	3	0
TMEM169	0	0	1	2	305.91	611.82	15	2	1	NA	1	NA	3	0
TMEM170A	0	0	1	2	137.61	275.22	15	2	1	NA	1	NA	3	0
TMEM173	0	0	7	3	379.17	758.34	15	2	1	NA	1	NA	10	0
TMEM174	0	0	5	2	537.9	1075.8	15	2	1	NA	1	NA	7	0
TMEM175	0	0	1	2	418.77	837.54	15	2	1	NA	1	NA	3	0
TMEM177	0	0	3	0	308.88	617.76	15	2	1	NA	1	NA	3	0
TMEM182L	0	0	6	4	243.54	487.08	15	2	1	NA	1	NA	10	0
TMEM183A	0	0	0	7	349.8	699.6	15	2	1	NA	1	NA	7	0
TMEM184A	0	0	4	4	418.77	837.54	15	2	1	NA	1	NA	8	0
TMEM184C	0	0	3	2	441.54	883.08	15	2	1	NA	1	NA	5	0
TMEM186	0	0	5	2	243.54	487.08	15	2	1	NA	1	NA	7	0
TMEM189	0	0	5	2	300.96	601.92	15	2	1	NA	1	NA	7	0
TMEM192	0	0	2	1	266.31	532.62	15	2	1	NA	1	NA	3	0
TMEM198	0	0	2	4	356.4	712.8	15	2	1	NA	1	NA	6	0
TMEM199	0	0	0	2	190.08	380.16	15	2	1	NA	1	NA	2	0
TMEM2	0	0	2	0	1336.5	2673	15	2	1	NA	1	NA	2	0
TMEM200B	0	0	9	12	390.06	780.12	15	2	1	NA	1	NA	21	0
TMEM201	0	0	2	4	659.34	1318.68	15	2	1	NA	1	NA	6	0
TMEM204	0	0	0	3	222.75	445.5	15	2	1	NA	1	NA	3	0
TMEM207	0	0	0	2	148.5	297	15	2	1	NA	1	NA	2	0
TMEM214	0	0	1	1	114.84	229.68	15	2	1	NA	1	NA	2	0
TMEM215	0	0	0	2	238.59	477.18	15	2	1	NA	1	NA	2	0
TMEM216	0	0	1	6	101.64	203.28	15	2	1	NA	1	NA	7	0
TMEM221	0	0	1	7	287.76	575.52	15	2	1	NA	1	NA	8	0
TMEM222	0	0	0	3	142.89	285.78	15	2	1	NA	1	NA	3	0
TMEM237	0	0	3	0	394.02	788.04	15	2	1	NA	1	NA	3	0
TMEM238	0	0	2	0	132.66	265.32	15	2	1	NA	1	NA	2	0
TMEM246	0	0	1	2	392.04	784.08	15	2	1	NA	1	NA	3	0
TMEM248	0	0	0	4	311.85	623.7	15	2	1	NA	1	NA	4	0
TMEM252	0	0	3	1	103.95	207.9	15	2	1	NA	1	NA	4	0
TMEM254	0	0	0	2	94.05	188.1	15	2	1	NA	1	NA	2	0
TMEM255A	0	0	1	2	465.3	930.6	15	2	1	NA	1	NA	3	0
TMEM259	0	0	6	21	732.6	1465.2	15	2	1	NA	1	NA	27	0
TMEM26	0	0	2	1	362.34	724.68	15	2	1	NA	1	NA	3	0
TMEM260	0	0	8	13	670.23	1340.46	15	2	1	NA	1	NA	21	0
TMEM267	0	0	1	1	213.84	427.68	15	2	1	NA	1	NA	2	0
TMEM268	0	0	8	8	331.65	663.3	15	2	1	NA	1	NA	16	0
TMEM269	0	0	0	8	239.58	479.16	15	2	1	NA	1	NA	8	0
TMEM33	0	0	0	4	249.48	498.96	15	2	1	NA	1	NA	4	0
TMEM35A	0	0	1	3	167.31	334.62	15	2	1	NA	1	NA	4	0
TMEM35B	0	0	1	5	138.6	277.2	15	2	1	NA	1	NA	6	0
TMEM37	0	0	2	1	196.02	392.04	15	2	1	NA	1	NA	3	0
TMEM39B	0	0	1	5	485.1	970.2	15	2	1	NA	1	NA	6	0
TMEM40L	0	0	1	1	286.11	572.22	15	2	1	NA	1	NA	2	0
TMEM41A	0	0	0	2	255.42	510.84	15	2	1	NA	1	NA	2	0
TMEM41B	0	0	0	4	277.2	554.4	15	2	1	NA	1	NA	4	0
TMEM43	0	0	3	2	396.99	793.98	15	2	1	NA	1	NA	5	0
TMEM45B	0	0	1	4	279.18	558.36	15	2	1	NA	1	NA	5	0
TMEM45BL	0	0	9	3	283.14	566.28	15	2	1	NA	1	NA	12	0
TMEM51	0	0	2	4	252.45	504.9	15	2	1	NA	1	NA	6	0
TMEM53	0	0	4	4	265.98	531.96	15	2	1	NA	1	NA	8	0
TMEM59L	0	0	3	5	420.09	840.18	15	2	1	NA	1	NA	8	0
TMEM61	0	0	4	6	193.38	386.76	15	2	1	NA	1	NA	10	0
TMEM62	0	0	6	7	633.6	1267.2	15	2	1	NA	1	NA	13	0
TMEM63C	0	0	4	7	822.69	1645.38	15	2	1	NA	1	NA	11	0
TMEM72	0	0	3	2	232.98	465.96	15	2	1	NA	1	NA	5	0
TMEM74B	0	0	2	6	163.35	326.7	15	2	1	NA	1	NA	8	0
TMEM80	0	0	3	1	141.57	283.14	15	2	1	NA	1	NA	4	0
TMEM82	0	0	6	7	313.83	627.66	15	2	1	NA	1	NA	13	0
TMEM86A	0	0	1	1	235.62	471.24	15	2	1	NA	1	NA	2	0
TMEM8B	0	0	3	7	670.56	1341.12	15	2	1	NA	1	NA	10	0
TMEM8C	0	0	2	6	209.88	419.76	15	2	1	NA	1	NA	8	0
TMEM9	0	0	0	4	190.08	380.16	15	2	1	NA	1	NA	4	0
TMEM94	0	0	3	8	1322.64	2645.28	15	2	1	NA	1	NA	11	0
TMEM97	0	0	2	5	171.27	342.54	15	2	1	NA	1	NA	7	0
TMEM98	0	0	1	2	223.74	447.48	15	2	1	NA	1	NA	3	0
TMF1	0	0	7	5	1092.96	2185.92	15	2	1	NA	1	NA	12	0
TMIGD1	0	0	4	5	255.42	510.84	15	2	1	NA	1	NA	9	0
TMLHE	0	0	2	10	417.78	835.56	15	2	1	NA	1	NA	12	0
TMOD1	0	0	2	3	356.4	712.8	15	2	1	NA	1	NA	5	0
TMOD2	0	0	1	1	348.48	696.96	15	2	1	NA	1	NA	2	0
TMOD3	0	0	0	2	348.48	696.96	15	2	1	NA	1	NA	2	0
TMOD4	0	0	2	1	344.52	689.04	15	2	1	NA	1	NA	3	0
TMPRSS11D	0	0	0	2	474.21	948.42	15	2	1	NA	1	NA	2	0
TMPRSS12	0	0	2	3	312.84	625.68	15	2	1	NA	1	NA	5	0
TMPRSS13	0	0	2	14	471.24	942.48	15	2	1	NA	1	NA	16	0
TMPRSS4	0	0	11	15	431.64	863.28	15	2	1	NA	1	NA	26	0
TMPRSS5	0	0	21	24	382.14	764.28	15	2	1	NA	1	NA	45	0
TMPRSS9	0	0	8	8	1103.85	2207.7	15	2	1	NA	1	NA	16	0
TMX1	0	0	2	4	221.76	443.52	15	2	1	NA	1	NA	6	0
TMX2	0	0	1	4	294.03	588.06	15	2	1	NA	1	NA	5	0
TNC	0	0	11	10	2175.36	4350.72	15	2	1	NA	1	NA	21	0
TNFAIP1	0	0	1	5	311.85	623.7	15	2	1	NA	1	NA	6	0
TNFAIP2	0	0	3	9	685.08	1370.16	15	2	1	NA	1	NA	12	0
TNFAIP6	0	0	1	4	273.24	546.48	15	2	1	NA	1	NA	5	0
TNFRSF13B	0	0	2	6	257.4	514.8	15	2	1	NA	1	NA	8	0
TNFRSF18	0	0	1	1	256.41	512.82	15	2	1	NA	1	NA	2	0
TNFRSF1B	0	0	1	2	464.31	928.62	15	2	1	NA	1	NA	3	0
TNFRSF25	0	0	2	1	414.81	829.62	15	2	1	NA	1	NA	3	0
TNFRSF4	0	0	5	2	328.68	657.36	15	2	1	NA	1	NA	7	0
TNFRSF8	0	0	5	4	864.27	1728.54	15	2	1	NA	1	NA	9	0
TNFSF10	0	0	3	2	291.06	582.12	15	2	1	NA	1	NA	5	0
TNIK	0	0	1	9	1376.76	2753.52	15	2	1	NA	1	NA	10	0
TNIP1	0	0	6	14	614.79	1229.58	15	2	1	NA	1	NA	20	0
TNIP2	0	0	1	1	476.19	952.38	15	2	1	NA	1	NA	2	0
TNIP3	0	0	5	1	427.35	854.7	15	2	1	NA	1	NA	6	0
TNK2	0	0	5	19	1029.27	2058.54	15	2	1	NA	1	NA	24	0
TNKS2	0	0	1	1	1134.54	2269.08	15	2	1	NA	1	NA	2	0
TNMD	0	0	2	4	391.05	782.1	15	2	1	NA	1	NA	6	0
TNN	0	0	14	10	1112.76	2225.52	15	2	1	NA	1	NA	24	0
TNNC1	0	0	0	2	160.38	320.76	15	2	1	NA	1	NA	2	0
TNNC2	0	0	6	10	283.47	566.94	15	2	1	NA	1	NA	16	0
TNNI1	0	0	2	6	206.91	413.82	15	2	1	NA	1	NA	8	0
TNNI3K	0	0	3	4	827.64	1655.28	15	2	1	NA	1	NA	7	0
TNNT2	0	0	0	5	288.09	576.18	15	2	1	NA	1	NA	5	0
TNNT3	0	0	1	2	250.47	500.94	15	2	1	NA	1	NA	3	0
TNPO2	0	0	0	3	819.06	1638.12	15	2	1	NA	1	NA	3	0
TNR	0	0	13	15	1342.44	2684.88	15	2	1	NA	1	NA	28	0
TNRC18	0	0	17	47	2768.37	5536.74	15	2	1	NA	1	NA	64	0
TNRC6A	0	0	4	7	1888.92	3777.84	15	2	1	NA	1	NA	11	0
TNRC6C	0	0	8	9	1830.51	3661.02	15	2	1	NA	1	NA	17	0
TNS1	0	0	19	32	1674.09	3348.18	15	2	1	NA	1	NA	51	0
TNS4	0	0	9	13	720.72	1441.44	15	2	1	NA	1	NA	22	0
TNX	0	0	40	41	1307.13	2614.26	15	2	1	NA	1	NA	81	0
TOE1	0	0	4	6	535.26	1070.52	15	2	1	NA	1	NA	10	0
TOLLIP	0	0	1	2	282.48	564.96	15	2	1	NA	1	NA	3	0
TOM1L1	0	0	2	2	340.89	681.78	15	2	1	NA	1	NA	4	0
TOM1L2	0	0	1	2	505.23	1010.46	15	2	1	NA	1	NA	3	0
TOMM6	0	0	0	3	69.3	138.6	15	2	1	NA	1	NA	3	0
TOP1	0	0	0	4	759.33	1518.66	15	2	1	NA	1	NA	4	0
TOP2A	0	0	0	15	1520.64	3041.28	15	2	1	NA	1	NA	15	0
TOP3A	0	0	10	18	1009.14	2018.28	15	2	1	NA	1	NA	28	0
TOP3B	0	0	1	5	854.37	1708.74	15	2	1	NA	1	NA	6	0
TOR1A	0	0	0	5	270.93	541.86	15	2	1	NA	1	NA	5	0
TOR1AIP1	0	0	4	4	364.98	729.96	15	2	1	NA	1	NA	8	0
TOR1AIP2	0	0	7	3	502.92	1005.84	15	2	1	NA	1	NA	10	0
TOR1BL	0	0	5	2	331.65	663.3	15	2	1	NA	1	NA	7	0
TOR3A	0	0	2	6	402.93	805.86	15	2	1	NA	1	NA	8	0
TOR4A	0	0	1	6	520.74	1041.48	15	2	1	NA	1	NA	7	0
TOX2	0	0	7	10	520.74	1041.48	15	2	1	NA	1	NA	17	0
TP53BP1	0	0	15	7	1918.62	3837.24	15	2	1	NA	1	NA	22	0
TP53I11	0	0	2	6	176.55	353.1	15	2	1	NA	1	NA	8	0
TP53INP2	0	0	2	3	200.97	401.94	15	2	1	NA	1	NA	5	0
TP53RK	0	0	1	1	254.43	508.86	15	2	1	NA	1	NA	2	0
TP53TG5	0	0	6	3	330.66	661.32	15	2	1	NA	1	NA	9	0
TP63	0	0	0	5	758.34	1516.68	15	2	1	NA	1	NA	5	0
TP73	0	0	1	8	681.12	1362.24	15	2	1	NA	1	NA	9	0
TPCN1	0	0	5	13	809.82	1619.64	15	2	1	NA	1	NA	18	0
TPCN2	0	0	2	1	730.62	1461.24	15	2	1	NA	1	NA	3	0
TPGS1	0	0	1	2	217.14	434.28	15	2	1	NA	1	NA	3	0
TPGS2	0	0	3	2	330.99	661.98	15	2	1	NA	1	NA	5	0
TPH1	0	0	2	5	294.69	589.38	15	2	1	NA	1	NA	7	0
TPM2-TPM4	0	0	3	2	90.75	181.5	15	2	1	NA	1	NA	5	0
TPM4	0	0	2	1	246.51	493.02	15	2	1	NA	1	NA	3	0
TPPP2	0	0	2	0	167.31	334.62	15	2	1	NA	1	NA	2	0
TPPP3	0	0	0	3	166.98	333.96	15	2	1	NA	1	NA	3	0
TPR	0	0	2	15	2343.33	4686.66	15	2	1	NA	1	NA	17	0
TPST2	0	0	1	12	368.28	736.56	15	2	1	NA	1	NA	13	0
TPX2	0	0	20	28	1528.23	3056.46	15	2	1	NA	1	NA	48	0
TRA2B	0	0	0	2	279.18	558.36	15	2	1	NA	1	NA	2	0
TRABD2A-TRABD2B	0	0	6	3	426.36	852.72	15	2	1	NA	1	NA	9	0
TRADD	0	0	1	2	388.08	776.16	15	2	1	NA	1	NA	3	0
TRAF1	0	0	2	3	551.43	1102.86	15	2	1	NA	1	NA	5	0
TRAF2	0	0	1	2	471.57	943.14	15	2	1	NA	1	NA	3	0
TRAF3	0	0	0	2	562.32	1124.64	15	2	1	NA	1	NA	2	0
TRAF3IP1	0	0	3	2	665.28	1330.56	15	2	1	NA	1	NA	5	0
TRAF3IP3	0	0	5	4	515.79	1031.58	15	2	1	NA	1	NA	9	0
TRAF4	0	0	0	9	427.35	854.7	15	2	1	NA	1	NA	9	0
TRAF6	0	0	2	8	540.54	1081.08	15	2	1	NA	1	NA	10	0
TRAF7	0	0	0	8	664.29	1328.58	15	2	1	NA	1	NA	8	0
TRAFD1	0	0	5	12	583.11	1166.22	15	2	1	NA	1	NA	17	0
TRAIL-LIKE	0	0	4	3	241.56	483.12	15	2	1	NA	1	NA	7	0
TRAK2	0	0	3	4	903.87	1807.74	15	2	1	NA	1	NA	7	0
TRAPPC2L	0	0	1	2	133.98	267.96	15	2	1	NA	1	NA	3	0
TREM-B1	0	0	8	7	537.57	1075.14	15	2	1	NA	1	NA	15	0
TREM-B2	0	0	10	5	226.38	452.76	15	2	1	NA	1	NA	15	0
TRIM10	0	0	12	13	469.26	938.52	15	2	1	NA	1	NA	25	0
TRIM23	0	0	0	3	566.94	1133.88	15	2	1	NA	1	NA	3	0
TRIM25	0	0	2	7	621.72	1243.44	15	2	1	NA	1	NA	9	0
TRIM27.1	0	0	11	9	494.67	989.34	15	2	1	NA	1	NA	20	0
TRIM27.2	0	0	3	8	462.66	925.32	15	2	1	NA	1	NA	11	0
TRIM29	0	0	1	8	584.1	1168.2	15	2	1	NA	1	NA	9	0
TRIM32	0	0	1	4	641.52	1283.04	15	2	1	NA	1	NA	5	0
TRIM36	0	0	1	1	728.97	1457.94	15	2	1	NA	1	NA	2	0
TRIM37	0	0	4	8	976.14	1952.28	15	2	1	NA	1	NA	12	0
TRIM39.1	0	0	6	4	305.91	611.82	15	2	1	NA	1	NA	10	0
TRIM39.2	0	0	7	12	458.37	916.74	15	2	1	NA	1	NA	19	0
TRIM41	0	0	3	10	626.01	1252.02	15	2	1	NA	1	NA	13	0
TRIM42	0	0	7	3	723.69	1447.38	15	2	1	NA	1	NA	10	0
TRIM47	0	0	2	13	674.19	1348.38	15	2	1	NA	1	NA	15	0
TRIM50	0	0	1	2	491.04	982.08	15	2	1	NA	1	NA	3	0
TRIM58	0	0	0	3	482.13	964.26	15	2	1	NA	1	NA	3	0
TRIM59	0	0	3	5	407.88	815.76	15	2	1	NA	1	NA	8	0
TRIM62	0	0	0	9	463.98	927.96	15	2	1	NA	1	NA	9	0
TRIM63	0	0	3	6	350.46	700.92	15	2	1	NA	1	NA	9	0
TRIM65	0	0	9	12	511.83	1023.66	15	2	1	NA	1	NA	21	0
TRIM66	0	0	11	10	1219.68	2439.36	15	2	1	NA	1	NA	21	0
TRIM7.2	0	0	2	8	502.59	1005.18	15	2	1	NA	1	NA	10	0
TRIM9	0	0	0	8	431.31	862.62	15	2	1	NA	1	NA	8	0
TRIP11	0	0	8	8	1964.16	3928.32	15	2	1	NA	1	NA	16	0
TRIP12	0	0	1	9	2056.23	4112.46	15	2	1	NA	1	NA	10	0
TRIP4	0	0	3	9	578.16	1156.32	15	2	1	NA	1	NA	12	0
TRIT1	0	0	1	2	399.96	799.92	15	2	1	NA	1	NA	3	0
TRMT	0	0	6	5	475.2	950.4	15	2	1	NA	1	NA	11	0
TRMT10A	0	0	0	2	314.82	629.64	15	2	1	NA	1	NA	2	0
TRMT12	0	0	8	4	437.58	875.16	15	2	1	NA	1	NA	12	0
TRMT13	0	0	4	1	394.02	788.04	15	2	1	NA	1	NA	5	0
TRMT1L	0	0	2	5	764.61	1529.22	15	2	1	NA	1	NA	7	0
TRMT2A	0	0	3	4	642.84	1285.68	15	2	1	NA	1	NA	7	0
TRMT44	0	0	7	3	660.33	1320.66	15	2	1	NA	1	NA	10	0
TRMT5	0	0	3	4	495	990	15	2	1	NA	1	NA	7	0
TRMT61A	0	0	0	2	323.73	647.46	15	2	1	NA	1	NA	2	0
TRNAU1AP	0	0	0	5	276.21	552.42	15	2	1	NA	1	NA	5	0
TRNT1	0	0	4	9	380.82	761.64	15	2	1	NA	1	NA	13	0
TROVE2	0	0	6	6	481.14	962.28	15	2	1	NA	1	NA	12	0
TRPC1	0	0	0	4	752.73	1505.46	15	2	1	NA	1	NA	4	0
TRPC3	0	0	1	6	947.43	1894.86	15	2	1	NA	1	NA	7	0
TRPC4AP	0	0	0	4	751.41	1502.82	15	2	1	NA	1	NA	4	0
TRPC7	0	0	1	8	839.52	1679.04	15	2	1	NA	1	NA	9	0
TRPM1	0	0	4	8	1617.66	3235.32	15	2	1	NA	1	NA	12	0
TRPM2	0	0	10	9	1493.91	2987.82	15	2	1	NA	1	NA	19	0
TRPM3	0	0	4	1	1308.45	2616.9	15	2	1	NA	1	NA	5	0
TRPM5	0	0	2	6	1157.31	2314.62	15	2	1	NA	1	NA	8	0
TRPM6	0	0	2	2	2246.31	4492.62	15	2	1	NA	1	NA	4	0
TRPM7	0	0	2	6	2448.93	4897.86	15	2	1	NA	1	NA	8	0
TRPM8	0	0	1	13	1085.04	2170.08	15	2	1	NA	1	NA	14	0
TRPV1	0	0	2	1	835.56	1671.12	15	2	1	NA	1	NA	3	0
TRPV2	0	0	4	15	2108.7	4217.4	15	2	1	NA	1	NA	19	0
TRPV4	0	0	3	21	845.46	1690.92	15	2	1	NA	1	NA	24	0
TRRAP	0	0	1	11	3808.53	7617.06	15	2	1	NA	1	NA	12	0
TRUB1	0	0	1	4	285.12	570.24	15	2	1	NA	1	NA	5	0
TSC1	0	0	3	6	1147.08	2294.16	15	2	1	NA	1	NA	9	0
TSC2	0	0	3	20	1792.89	3585.78	15	2	1	NA	1	NA	23	0
TSEN15	0	0	3	4	186.12	372.24	15	2	1	NA	1	NA	7	0
TSEN54	0	0	3	9	510.18	1020.36	15	2	1	NA	1	NA	12	0
TSG101	0	0	4	4	389.07	778.14	15	2	1	NA	1	NA	8	0
TSHR	0	0	0	2	756.36	1512.72	15	2	1	NA	1	NA	2	0
TSHZ2	0	0	1	2	1054.35	2108.7	15	2	1	NA	1	NA	3	0
TSHZ3	0	0	1	2	1067.22	2134.44	15	2	1	NA	1	NA	3	0
TSN	0	0	0	3	256.74	513.48	15	2	1	NA	1	NA	3	0
TSNAXIP1	0	0	3	3	669.24	1338.48	15	2	1	NA	1	NA	6	0
TSPAN1	0	0	1	3	208.56	417.12	15	2	1	NA	1	NA	4	0
TSPAN10	0	0	8	17	327.69	655.38	15	2	1	NA	1	NA	25	0
TSPAN14	0	0	2	1	295.02	590.04	15	2	1	NA	1	NA	3	0
TSPAN2	0	0	1	1	173.25	346.5	15	2	1	NA	1	NA	2	0
TSPAN32	0	0	2	4	240.57	481.14	15	2	1	NA	1	NA	6	0
TSPAN4	0	0	2	3	310.53	621.06	15	2	1	NA	1	NA	5	0
TSPEAR	0	0	6	6	669.24	1338.48	15	2	1	NA	1	NA	12	0
TSPO2	0	0	1	2	163.35	326.7	15	2	1	NA	1	NA	3	0
TSPOAP1	0	0	17	11	2772.33	5544.66	15	2	1	NA	1	NA	28	0
TSR1	0	0	11	17	792.66	1585.32	15	2	1	NA	1	NA	28	0
TSSC4	0	0	3	4	339.57	679.14	15	2	1	NA	1	NA	7	0
TSSK3	0	0	0	3	266.31	532.62	15	2	1	NA	1	NA	3	0
TSSK6L2	0	0	0	3	275.22	550.44	15	2	1	NA	1	NA	3	0
TSTD2	0	0	3	2	435.27	870.54	15	2	1	NA	1	NA	5	0
TTBK2	0	0	3	2	1142.46	2284.92	15	2	1	NA	1	NA	5	0
TTC12	0	0	11	5	687.39	1374.78	15	2	1	NA	1	NA	16	0
TTC14	0	0	0	4	777.48	1554.96	15	2	1	NA	1	NA	4	0
TTC17	0	0	7	8	1208.79	2417.58	15	2	1	NA	1	NA	15	0
TTC19	0	0	2	1	266.31	532.62	15	2	1	NA	1	NA	3	0
TTC21B	0	0	4	7	1303.83	2607.66	15	2	1	NA	1	NA	11	0
TTC25	0	0	3	2	589.05	1178.1	15	2	1	NA	1	NA	5	0
TTC28	0	0	0	9	2326.5	4653	15	2	1	NA	1	NA	9	0
TTC29	0	0	4	1	493.02	986.04	15	2	1	NA	1	NA	5	0
TTC30B	0	0	2	6	660.33	1320.66	15	2	1	NA	1	NA	8	0
TTC31	0	0	9	2	504.57	1009.14	15	2	1	NA	1	NA	11	0
TTC34	0	0	10	4	1031.58	2063.16	15	2	1	NA	1	NA	14	0
TTC36	0	0	0	2	186.12	372.24	15	2	1	NA	1	NA	2	0
TTC39B	0	0	0	2	529.98	1059.96	15	2	1	NA	1	NA	2	0
TTC4	0	0	6	6	370.26	740.52	15	2	1	NA	1	NA	12	0
TTC6	0	0	5	9	1797.84	3595.68	15	2	1	NA	1	NA	14	0
TTC7B	0	0	1	4	807.51	1615.02	15	2	1	NA	1	NA	5	0
TTC8	0	0	3	0	510.84	1021.68	15	2	1	NA	1	NA	3	0
TTF1	0	0	2	6	706.53	1413.06	15	2	1	NA	1	NA	8	0
TTI1	0	0	12	11	1081.41	2162.82	15	2	1	NA	1	NA	23	0
TTI2	0	0	8	9	486.09	972.18	15	2	1	NA	1	NA	17	0
TTLL10	0	0	3	5	583.77	1167.54	15	2	1	NA	1	NA	8	0
TTLL11	0	0	3	5	546.48	1092.96	15	2	1	NA	1	NA	8	0
TTLL4	0	0	14	13	1075.14	2150.28	15	2	1	NA	1	NA	27	0
TTLL5	0	0	10	5	1268.85	2537.7	15	2	1	NA	1	NA	15	0
TTLL7	0	0	3	6	928.62	1857.24	15	2	1	NA	1	NA	9	0
TTLL9	0	0	2	7	408.87	817.74	15	2	1	NA	1	NA	9	0
TTPAL	0	0	3	2	336.6	673.2	15	2	1	NA	1	NA	5	0
TTYH2	0	0	6	8	438.9	877.8	15	2	1	NA	1	NA	14	0
TTYH3	0	0	2	4	522.72	1045.44	15	2	1	NA	1	NA	6	0
TUB	0	0	1	3	475.2	950.4	15	2	1	NA	1	NA	4	0
TUBA3E	0	0	0	7	445.5	891	15	2	1	NA	1	NA	7	0
TUBB	0	0	1	8	201.63	403.26	15	2	1	NA	1	NA	9	0
TUBB1	0	0	1	3	444.51	889.02	15	2	1	NA	1	NA	4	0
TUBB3	0	0	5	15	296.34	592.68	15	2	1	NA	1	NA	20	0
TUBB4B	0	0	0	2	441.54	883.08	15	2	1	NA	1	NA	2	0
TUBD1	0	0	8	4	448.47	896.94	15	2	1	NA	1	NA	12	0
TUBG1	0	0	0	11	429.99	859.98	15	2	1	NA	1	NA	11	0
TUBGCP4	0	0	1	3	750.42	1500.84	15	2	1	NA	1	NA	4	0
TULP1	0	0	9	10	527.34	1054.68	15	2	1	NA	1	NA	19	0
TUSC5	0	0	1	2	135.3	270.6	15	2	1	NA	1	NA	3	0
TUT1	0	0	7	12	780.45	1560.9	15	2	1	NA	1	NA	19	0
TWF2	0	0	1	4	343.2	686.4	15	2	1	NA	1	NA	5	0
TWIST2	0	0	0	2	159.39	318.78	15	2	1	NA	1	NA	2	0
TWIST3	0	0	0	2	160.38	320.76	15	2	1	NA	1	NA	2	0
TWNK	0	0	4	20	641.19	1282.38	15	2	1	NA	1	NA	24	0
TXK	0	0	3	6	522.72	1045.44	15	2	1	NA	1	NA	9	0
TXLNA	0	0	4	4	546.48	1092.96	15	2	1	NA	1	NA	8	0
TXNDC11	0	0	2	0	858.33	1716.66	15	2	1	NA	1	NA	2	0
TXNDC15	0	0	1	6	332.64	665.28	15	2	1	NA	1	NA	7	0
TXNDC16	0	0	10	8	850.41	1700.82	15	2	1	NA	1	NA	18	0
TXNDC17	0	0	2	0	121.77	243.54	15	2	1	NA	1	NA	2	0
TXNIP	0	0	0	10	387.09	774.18	15	2	1	NA	1	NA	10	0
TXNL1	0	0	0	2	287.1	574.2	15	2	1	NA	1	NA	2	0
TXNRD2	0	0	5	2	507.87	1015.74	15	2	1	NA	1	NA	7	0
TXNRD3	0	0	2	4	599.94	1199.88	15	2	1	NA	1	NA	6	0
TYRO3	0	0	4	4	952.38	1904.76	15	2	1	NA	1	NA	8	0
TYRP1	0	0	0	2	519.42	1038.84	15	2	1	NA	1	NA	2	0
TYW1	0	0	2	5	444.51	889.02	15	2	1	NA	1	NA	7	0
TYW5	0	0	5	3	459.03	918.06	15	2	1	NA	1	NA	8	0
U2SURP	0	0	0	8	951.39	1902.78	15	2	1	NA	1	NA	8	0
UACA	0	0	8	7	1360.26	2720.52	15	2	1	NA	1	NA	15	0
UBA3	0	0	1	4	438.57	877.14	15	2	1	NA	1	NA	5	0
UBA52	0	0	0	4	14.52	29.04	15	2	1	NA	1	NA	4	0
UBA6	0	0	3	4	1011.78	2023.56	15	2	1	NA	1	NA	7	0
UBAC1	0	0	0	2	404.91	809.82	15	2	1	NA	1	NA	2	0
UBAP1	0	0	3	2	516.78	1033.56	15	2	1	NA	1	NA	5	0
UBAP1L	0	0	7	8	406.56	813.12	15	2	1	NA	1	NA	15	0
UBAP2L	0	0	4	22	1097.91	2195.82	15	2	1	NA	1	NA	26	0
UBASH3B	0	0	1	8	615.78	1231.56	15	2	1	NA	1	NA	9	0
UBB-UBC	0	0	0	15	159.39	318.78	15	2	1	NA	1	NA	15	0
UBE2B	0	0	0	2	136.95	273.9	15	2	1	NA	1	NA	2	0
UBE2C	0	0	1	3	178.2	356.4	15	2	1	NA	1	NA	4	0
UBE2D1	0	0	1	1	166.32	332.64	15	2	1	NA	1	NA	2	0
UBE2D2	0	0	0	2	138.6	277.2	15	2	1	NA	1	NA	2	0
UBE2G1	0	0	2	2	292.05	584.1	15	2	1	NA	1	NA	4	0
UBE2G2	0	0	1	1	154.44	308.88	15	2	1	NA	1	NA	2	0
UBE2K	0	0	2	0	212.85	425.7	15	2	1	NA	1	NA	2	0
UBE2O	0	0	5	17	1295.91	2591.82	15	2	1	NA	1	NA	22	0
UBE2T	0	0	3	2	196.02	392.04	15	2	1	NA	1	NA	5	0
UBE3B	0	0	5	10	1060.29	2120.58	15	2	1	NA	1	NA	15	0
UBE4A	0	0	1	6	1020.03	2040.06	15	2	1	NA	1	NA	7	0
UBE4B	0	0	4	8	1255.65	2511.3	15	2	1	NA	1	NA	12	0
UBFD1	0	0	1	3	250.8	501.6	15	2	1	NA	1	NA	4	0
UBIAD1	0	0	0	5	331.65	663.3	15	2	1	NA	1	NA	5	0
UBL7	0	0	1	6	377.19	754.38	15	2	1	NA	1	NA	7	0
UBN1	0	0	6	8	1108.8	2217.6	15	2	1	NA	1	NA	14	0
UBQLN4	0	0	1	4	553.41	1106.82	15	2	1	NA	1	NA	5	0
UBR1	0	0	4	5	1705.77	3411.54	15	2	1	NA	1	NA	9	0
UBR7	0	0	0	2	318.78	637.56	15	2	1	NA	1	NA	2	0
UBTD1	0	0	2	4	185.13	370.26	15	2	1	NA	1	NA	6	0
UBTD2	0	0	2	3	232.65	465.3	15	2	1	NA	1	NA	5	0
UBTF	0	0	2	5	476.19	952.38	15	2	1	NA	1	NA	7	0
UBXN10	0	0	9	8	282.15	564.3	15	2	1	NA	1	NA	17	0
UBXN11	0	0	6	5	406.89	813.78	15	2	1	NA	1	NA	11	0
UBXN4	0	0	0	3	504.9	1009.8	15	2	1	NA	1	NA	3	0
UBXN6	0	0	4	5	434.61	869.22	15	2	1	NA	1	NA	9	0
UBXN7	0	0	0	3	465.63	931.26	15	2	1	NA	1	NA	3	0
UCHL5	0	0	0	3	328.68	657.36	15	2	1	NA	1	NA	3	0
UCK1	0	0	1	2	234.63	469.26	15	2	1	NA	1	NA	3	0
UCK2	0	0	0	3	259.38	518.76	15	2	1	NA	1	NA	3	0
UCKL1	0	0	0	11	528.66	1057.32	15	2	1	NA	1	NA	11	0
UEVLD	0	0	4	4	476.19	952.38	15	2	1	NA	1	NA	8	0
UFD1L	0	0	0	6	304.92	609.84	15	2	1	NA	1	NA	6	0
UGCG	0	0	1	2	360.69	721.38	15	2	1	NA	1	NA	3	0
UGDH	0	0	1	5	490.05	980.1	15	2	1	NA	1	NA	6	0
UGGT1	0	0	5	1	1516.68	3033.36	15	2	1	NA	1	NA	6	0
UGT1A1	0	0	6	8	986.04	1972.08	15	2	1	NA	1	NA	14	0
UGT2A1	0	0	1	7	783.09	1566.18	15	2	1	NA	1	NA	8	0
UGT8	0	0	0	6	536.58	1073.16	15	2	1	NA	1	NA	6	0
UGT8L	0	0	7	6	526.68	1053.36	15	2	1	NA	1	NA	13	0
UHRF1	0	0	1	5	693.99	1387.98	15	2	1	NA	1	NA	6	0
UHRF1BP1	0	0	16	18	1457.28	2914.56	15	2	1	NA	1	NA	34	0
UHRF2	0	0	1	3	735.57	1471.14	15	2	1	NA	1	NA	4	0
UIMC1	0	0	8	13	790.35	1580.7	15	2	1	NA	1	NA	21	0
ULK1	0	0	4	5	962.28	1924.56	15	2	1	NA	1	NA	9	0
ULK2	0	0	3	7	1067.22	2134.44	15	2	1	NA	1	NA	10	0
ULK3	0	0	4	7	384.45	768.9	15	2	1	NA	1	NA	11	0
UMOD	0	0	2	1	414.81	829.62	15	2	1	NA	1	NA	3	0
UMPS	0	0	4	5	452.43	904.86	15	2	1	NA	1	NA	9	0
UNC13B	0	0	9	6	1994.85	3989.7	15	2	1	NA	1	NA	15	0
UNC13C	0	0	3	6	1175.46	2350.92	15	2	1	NA	1	NA	9	0
UNC13D	0	0	7	13	1057.32	2114.64	15	2	1	NA	1	NA	20	0
UNC45A	0	0	4	13	922.68	1845.36	15	2	1	NA	1	NA	17	0
UNC45B	0	0	2	16	920.7	1841.4	15	2	1	NA	1	NA	18	0
UNC5A	0	0	6	30	695.64	1391.28	15	2	1	NA	1	NA	36	0
UNC5B	0	0	8	15	862.62	1725.24	15	2	1	NA	1	NA	23	0
UNC5C	0	0	2	9	961.29	1922.58	15	2	1	NA	1	NA	11	0
UNC5D	0	0	1	7	919.71	1839.42	15	2	1	NA	1	NA	8	0
UNC79	0	0	7	8	2622.84	5245.68	15	2	1	NA	1	NA	15	0
UNC80	0	0	2	18	3403.62	6807.24	15	2	1	NA	1	NA	20	0
UNCX	0	0	1	1	184.14	368.28	15	2	1	NA	1	NA	2	0
UNG	0	0	2	4	295.35	590.7	15	2	1	NA	1	NA	6	0
UNK	0	0	2	7	811.8	1623.6	15	2	1	NA	1	NA	9	0
UNKL	0	0	4	1	802.89	1605.78	15	2	1	NA	1	NA	5	0
UPF1	0	0	1	7	1106.82	2213.64	15	2	1	NA	1	NA	8	0
UPF3B	0	0	2	0	470.91	941.82	15	2	1	NA	1	NA	2	0
UPK3B	0	0	8	7	197.01	394.02	15	2	1	NA	1	NA	15	0
UPK3BL	0	0	6	5	243.54	487.08	15	2	1	NA	1	NA	11	0
UPP2	0	0	3	4	312.84	625.68	15	2	1	NA	1	NA	7	0
UQCC1	0	0	4	0	293.7	587.4	15	2	1	NA	1	NA	4	0
UQCRC2	0	0	3	0	453.42	906.84	15	2	1	NA	1	NA	3	0
UQCRFS1	0	0	2	1	201.63	403.26	15	2	1	NA	1	NA	3	0
UQCRQ	0	0	0	2	90.09	180.18	15	2	1	NA	1	NA	2	0
URI1	0	0	1	1	490.38	980.76	15	2	1	NA	1	NA	2	0
UROC1	0	0	6	2	670.23	1340.46	15	2	1	NA	1	NA	8	0
UROD	0	0	3	5	366.3	732.6	15	2	1	NA	1	NA	8	0
UROS	0	0	3	2	274.23	548.46	15	2	1	NA	1	NA	5	0
USH1C	0	0	2	7	793.98	1587.96	15	2	1	NA	1	NA	9	0
USH1G	0	0	1	6	499.95	999.9	15	2	1	NA	1	NA	7	0
USHBP1	0	0	15	14	560.01	1120.02	15	2	1	NA	1	NA	29	0
USO1	0	0	2	6	906.84	1813.68	15	2	1	NA	1	NA	8	0
USP1	0	0	5	10	784.41	1568.82	15	2	1	NA	1	NA	15	0
USP10	0	0	0	7	949.41	1898.82	15	2	1	NA	1	NA	7	0
USP19	0	0	8	15	1420.65	2841.3	15	2	1	NA	1	NA	23	0
USP2	0	0	6	5	275.88	551.76	15	2	1	NA	1	NA	11	0
USP20	0	0	2	10	895.62	1791.24	15	2	1	NA	1	NA	12	0
USP24	0	0	4	11	2524.5	5049	15	2	1	NA	1	NA	15	0
USP28	0	0	3	6	1183.05	2366.1	15	2	1	NA	1	NA	9	0
USP30	0	0	2	4	473.22	946.44	15	2	1	NA	1	NA	6	0
USP31	0	0	3	8	1165.56	2331.12	15	2	1	NA	1	NA	11	0
USP32	0	0	3	14	1588.62	3177.24	15	2	1	NA	1	NA	17	0
USP33	0	0	2	2	885.06	1770.12	15	2	1	NA	1	NA	4	0
USP36	0	0	15	18	1029.27	2058.54	15	2	1	NA	1	NA	33	0
USP37	0	0	2	9	957.33	1914.66	15	2	1	NA	1	NA	11	0
USP38	0	0	1	8	1027.62	2055.24	15	2	1	NA	1	NA	9	0
USP4	0	0	7	14	930.6	1861.2	15	2	1	NA	1	NA	21	0
USP40	0	0	9	10	1233.54	2467.08	15	2	1	NA	1	NA	19	0
USP42	0	0	23	8	874.5	1749	15	2	1	NA	1	NA	31	0
USP43	0	0	14	13	677.16	1354.32	15	2	1	NA	1	NA	27	0
USP46	0	0	1	2	420.75	841.5	15	2	1	NA	1	NA	3	0
USP47	0	0	2	14	1329.57	2659.14	15	2	1	NA	1	NA	16	0
USP49	0	0	2	3	691.02	1382.04	15	2	1	NA	1	NA	5	0
USP51	0	0	1	1	543.51	1087.02	15	2	1	NA	1	NA	2	0
USP54	0	0	9	9	1688.94	3377.88	15	2	1	NA	1	NA	18	0
USP7	0	0	0	6	1093.95	2187.9	15	2	1	NA	1	NA	6	0
USP8	0	0	2	5	1079.1	2158.2	15	2	1	NA	1	NA	7	0
UT2LZ	0	0	5	3	422.73	845.46	15	2	1	NA	1	NA	8	0
UTP11	0	0	0	2	251.46	502.92	15	2	1	NA	1	NA	2	0
UTP14A	0	0	8	20	721.71	1443.42	15	2	1	NA	1	NA	28	0
UTP15	0	0	1	4	505.23	1010.46	15	2	1	NA	1	NA	5	0
UTP18	0	0	3	1	528.66	1057.32	15	2	1	NA	1	NA	4	0
UTP3	0	0	4	3	470.58	941.16	15	2	1	NA	1	NA	7	0
UTP6	0	0	1	1	592.02	1184.04	15	2	1	NA	1	NA	2	0
UTS2R	0	0	2	5	379.17	758.34	15	2	1	NA	1	NA	7	0
UVS.2L	0	0	7	3	336.6	673.2	15	2	1	NA	1	NA	10	0
UVSSA	0	0	6	7	735.57	1471.14	15	2	1	NA	1	NA	13	0
VAC14	0	0	0	2	416.46	832.92	15	2	1	NA	1	NA	2	0
VAMP7	0	0	0	4	211.86	423.72	15	2	1	NA	1	NA	4	0
VANGL2	0	0	1	4	516.78	1033.56	15	2	1	NA	1	NA	5	0
VASH1	0	0	1	3	278.85	557.7	15	2	1	NA	1	NA	4	0
VAT1	0	0	3	4	387.09	774.18	15	2	1	NA	1	NA	7	0
VAV3	0	0	1	6	781.11	1562.22	15	2	1	NA	1	NA	7	0
VCAM1	0	0	5	1	537.57	1075.14	15	2	1	NA	1	NA	6	0
VCAN	0	0	12	3	3416.82	6833.64	15	2	1	NA	1	NA	15	0
VCL	0	0	0	4	1147.74	2295.48	15	2	1	NA	1	NA	4	0
VDAC2	0	0	2	2	294.03	588.06	15	2	1	NA	1	NA	4	0
VDHAP	0	0	4	3	555.39	1110.78	15	2	1	NA	1	NA	7	0
VDR	0	0	1	4	415.14	830.28	15	2	1	NA	1	NA	5	0
VEGFC	0	0	1	1	414.81	829.62	15	2	1	NA	1	NA	2	0
VEGFRKDRL	0	0	4	10	1297.89	2595.78	15	2	1	NA	1	NA	14	0
VEPH1	0	0	1	3	204.93	409.86	15	2	1	NA	1	NA	4	0
VGLL1	0	0	0	2	241.56	483.12	15	2	1	NA	1	NA	2	0
VIL1	0	0	7	9	803.22	1606.44	15	2	1	NA	1	NA	16	0
VKORC1L1	0	0	2	1	175.23	350.46	15	2	1	NA	1	NA	3	0
VLDLR	0	0	13	10	771.87	1543.74	15	2	1	NA	1	NA	23	0
VMP1	0	0	0	3	402.93	805.86	15	2	1	NA	1	NA	3	0
VPS11	0	0	3	0	859.32	1718.64	15	2	1	NA	1	NA	3	0
VPS13A	0	0	5	0	2173.71	4347.42	15	2	1	NA	1	NA	5	0
VPS13C	0	0	9	12	3651.12	7302.24	15	2	1	NA	1	NA	21	0
VPS13D	0	0	16	28	4333.23	8666.46	15	2	1	NA	1	NA	44	0
VPS18	0	0	0	4	966.57	1933.14	15	2	1	NA	1	NA	4	0
VPS26B	0	0	1	3	332.64	665.28	15	2	1	NA	1	NA	4	0
VPS29L	0	0	0	5	180.18	360.36	15	2	1	NA	1	NA	5	0
VPS33A	0	0	1	8	595.98	1191.96	15	2	1	NA	1	NA	9	0
VPS33B	0	0	2	6	604.23	1208.46	15	2	1	NA	1	NA	8	0
VPS35	0	0	1	6	788.04	1576.08	15	2	1	NA	1	NA	7	0
VPS37A	0	0	3	5	377.85	755.7	15	2	1	NA	1	NA	8	0
VPS37B	0	0	2	2	281.82	563.64	15	2	1	NA	1	NA	4	0
VPS37D	0	0	2	0	285.12	570.24	15	2	1	NA	1	NA	2	0
VPS45	0	0	4	10	546.15	1092.3	15	2	1	NA	1	NA	14	0
VPS53	0	0	4	13	823.68	1647.36	15	2	1	NA	1	NA	17	0
VPS72	0	0	6	2	341.22	682.44	15	2	1	NA	1	NA	8	0
VPS8	0	0	5	10	1386.99	2773.98	15	2	1	NA	1	NA	15	0
VRK1	0	0	1	4	409.86	819.72	15	2	1	NA	1	NA	5	0
VRK3	0	0	3	2	383.13	766.26	15	2	1	NA	1	NA	5	0
VRTN	0	0	6	8	668.25	1336.5	15	2	1	NA	1	NA	14	0
VSIG1	0	0	2	3	328.68	657.36	15	2	1	NA	1	NA	5	0
VSIG10	0	0	6	4	421.74	843.48	15	2	1	NA	1	NA	10	0
VSIG10L	0	0	4	10	394.35	788.7	15	2	1	NA	1	NA	14	0
VSTM2L	0	0	4	1	147.84	295.68	15	2	1	NA	1	NA	5	0
VSTM4	0	0	2	3	316.8	633.6	15	2	1	NA	1	NA	5	0
VSX2	0	0	1	2	336.6	673.2	15	2	1	NA	1	NA	3	0
VTG1	0	0	4	4	1819.29	3638.58	15	2	1	NA	1	NA	8	0
VTG2	0	0	10	10	1806.42	3612.84	15	2	1	NA	1	NA	20	0
VTG3	0	0	10	9	2069.1	4138.2	15	2	1	NA	1	NA	19	0
VTI1A	0	0	2	0	226.71	453.42	15	2	1	NA	1	NA	2	0
VTN	0	0	9	8	444.18	888.36	15	2	1	NA	1	NA	17	0
VWA1	0	0	0	8	495	990	15	2	1	NA	1	NA	8	0
VWA2	0	0	15	11	749.43	1498.86	15	2	1	NA	1	NA	26	0
VWA3A	0	0	3	1	1115.07	2230.14	15	2	1	NA	1	NA	4	0
VWA5B1	0	0	30	34	1216.71	2433.42	15	2	1	NA	1	NA	64	0
VWA5B2	0	0	25	33	1283.04	2566.08	15	2	1	NA	1	NA	58	0
VWA9	0	0	0	5	513.81	1027.62	15	2	1	NA	1	NA	5	0
VWCE	0	0	8	17	708.84	1417.68	15	2	1	NA	1	NA	25	0
WAPL	0	0	4	1	1186.02	2372.04	15	2	1	NA	1	NA	5	0
WARS	0	0	2	1	469.26	938.52	15	2	1	NA	1	NA	3	0
WASHC2C	0	0	11	10	1244.43	2488.86	15	2	1	NA	1	NA	21	0
WBP2	0	0	1	1	250.8	501.6	15	2	1	NA	1	NA	2	0
WBSCR17	0	0	1	5	263.34	526.68	15	2	1	NA	1	NA	6	0
WBSCR27	0	0	1	2	227.04	454.08	15	2	1	NA	1	NA	3	0
WDFY1	0	0	1	5	406.89	813.78	15	2	1	NA	1	NA	6	0
WDFY4	0	0	9	9	2547.93	5095.86	15	2	1	NA	1	NA	18	0
WDHD1	0	0	10	6	1117.71	2235.42	15	2	1	NA	1	NA	16	0
WDR1	0	0	3	0	537.24	1074.48	15	2	1	NA	1	NA	3	0
WDR11	0	0	3	7	1187.34	2374.68	15	2	1	NA	1	NA	10	0
WDR12	0	0	4	2	405.57	811.14	15	2	1	NA	1	NA	6	0
WDR17	0	0	5	3	1220.34	2440.68	15	2	1	NA	1	NA	8	0
WDR18	0	0	0	5	428.67	857.34	15	2	1	NA	1	NA	5	0
WDR19	0	0	10	10	1330.56	2661.12	15	2	1	NA	1	NA	20	0
WDR25	0	0	0	2	347.49	694.98	15	2	1	NA	1	NA	2	0
WDR31	0	0	6	4	338.58	677.16	15	2	1	NA	1	NA	10	0
WDR33	0	0	2	2	1310.76	2621.52	15	2	1	NA	1	NA	4	0
WDR34	0	0	5	5	497.97	995.94	15	2	1	NA	1	NA	10	0
WDR36	0	0	2	2	749.1	1498.2	15	2	1	NA	1	NA	4	0
WDR41	0	0	3	3	375.54	751.08	15	2	1	NA	1	NA	6	0
WDR44	0	0	1	3	899.25	1798.5	15	2	1	NA	1	NA	4	0
WDR47	0	0	2	6	950.4	1900.8	15	2	1	NA	1	NA	8	0
WDR5	0	0	0	2	331.65	663.3	15	2	1	NA	1	NA	2	0
WDR53	0	0	2	4	344.19	688.38	15	2	1	NA	1	NA	6	0
WDR54	0	0	7	9	242.55	485.1	15	2	1	NA	1	NA	16	0
WDR55	0	0	1	3	296.34	592.68	15	2	1	NA	1	NA	4	0
WDR6	0	0	21	11	290.4	580.8	15	2	1	NA	1	NA	32	0
WDR63	0	0	7	5	891	1782	15	2	1	NA	1	NA	12	0
WDR66	0	0	13	24	914.76	1829.52	15	2	1	NA	1	NA	37	0
WDR7	0	0	7	19	1442.43	2884.86	15	2	1	NA	1	NA	26	0
WDR70	0	0	0	2	405.57	811.14	15	2	1	NA	1	NA	2	0
WDR72	0	0	10	5	979.11	1958.22	15	2	1	NA	1	NA	15	0
WDR74	0	0	1	2	391.05	782.1	15	2	1	NA	1	NA	3	0
WDR75	0	0	7	8	821.7	1643.4	15	2	1	NA	1	NA	15	0
WDR76	0	0	2	11	478.17	956.34	15	2	1	NA	1	NA	13	0
WDR77	0	0	0	3	361.35	722.7	15	2	1	NA	1	NA	3	0
WDR78	0	0	11	16	671.55	1343.1	15	2	1	NA	1	NA	27	0
WDR81	0	0	20	43	1893.87	3787.74	15	2	1	NA	1	NA	63	0
WDR82	0	0	1	1	296.67	593.34	15	2	1	NA	1	NA	2	0
WDR88	0	0	3	2	363.66	727.32	15	2	1	NA	1	NA	5	0
WDSUB1	0	0	1	2	477.18	954.36	15	2	1	NA	1	NA	3	0
WDTC1	0	0	1	3	680.13	1360.26	15	2	1	NA	1	NA	4	0
WEE1	0	0	2	4	682.11	1364.22	15	2	1	NA	1	NA	6	0
WFDC2-WFDC8	0	0	10	15	593.01	1186.02	15	2	1	NA	1	NA	25	0
WFIKKN1	0	0	1	12	545.49	1090.98	15	2	1	NA	1	NA	13	0
WFIKKN2	0	0	0	8	565.29	1130.58	15	2	1	NA	1	NA	8	0
WFS1	0	0	3	1	866.25	1732.5	15	2	1	NA	1	NA	4	0
WHAMM	0	0	7	7	763.29	1526.58	15	2	1	NA	1	NA	14	0
WHRN	0	0	5	16	593.34	1186.68	15	2	1	NA	1	NA	21	0
WHSC1	0	0	4	3	1295.91	2591.82	15	2	1	NA	1	NA	7	0
WHSC1L1	0	0	2	4	1246.41	2492.82	15	2	1	NA	1	NA	6	0
WIPF1	0	0	1	2	242.55	485.1	15	2	1	NA	1	NA	3	0
WIPI1	0	0	2	5	431.64	863.28	15	2	1	NA	1	NA	7	0
WIPI2	0	0	0	4	401.28	802.56	15	2	1	NA	1	NA	4	0
WISP2	0	0	6	14	572.88	1145.76	15	2	1	NA	1	NA	20	0
WLS	0	0	0	8	462.33	924.66	15	2	1	NA	1	NA	8	0
WNK2	0	0	10	27	2083.62	4167.24	15	2	1	NA	1	NA	37	0
WNT10A	0	0	0	6	365.64	731.28	15	2	1	NA	1	NA	6	0
WNT2B	0	0	1	6	382.14	764.28	15	2	1	NA	1	NA	7	0
WNT3	0	0	1	4	408.54	817.08	15	2	1	NA	1	NA	5	0
WNT4	0	0	0	3	348.48	696.96	15	2	1	NA	1	NA	3	0
WNT7A	0	0	0	5	346.5	693	15	2	1	NA	1	NA	5	0
WNT8A	0	0	4	6	354.42	708.84	15	2	1	NA	1	NA	10	0
WNT8B	0	0	0	5	358.38	716.76	15	2	1	NA	1	NA	5	0
WRAP73	0	0	2	2	445.5	891	15	2	1	NA	1	NA	4	0
WRN	0	0	15	7	1461.57	2923.14	15	2	1	NA	1	NA	22	0
WSB1	0	0	1	2	408.87	817.74	15	2	1	NA	1	NA	3	0
WSB2	0	0	2	6	390.72	781.44	15	2	1	NA	1	NA	8	0
WSCD2	0	0	4	18	506.88	1013.76	15	2	1	NA	1	NA	22	0
WWC1	0	0	2	3	1089.99	2179.98	15	2	1	NA	1	NA	5	0
XAF1	0	0	1	2	334.29	668.58	15	2	1	NA	1	NA	3	0
XBP1	0	0	2	0	361.68	723.36	15	2	1	NA	1	NA	2	0
XIAP	0	0	8	8	489.06	978.12	15	2	1	NA	1	NA	16	0
XIRP2	0	0	2	1	881.76	1763.52	15	2	1	NA	1	NA	3	0
XKR7	0	0	2	8	374.22	748.44	15	2	1	NA	1	NA	10	0
XKR8	0	0	1	1	325.38	650.76	15	2	1	NA	1	NA	2	0
XKRX	0	0	1	2	427.68	855.36	15	2	1	NA	1	NA	3	0
XPC	0	0	8	6	957.33	1914.66	15	2	1	NA	1	NA	14	0
XPNPEP1	0	0	3	3	617.76	1235.52	15	2	1	NA	1	NA	6	0
XPNPEP2	0	0	8	13	676.17	1352.34	15	2	1	NA	1	NA	21	0
XPO7	0	0	3	8	1086.36	2172.72	15	2	1	NA	1	NA	11	0
XPR1	0	0	3	6	715.77	1431.54	15	2	1	NA	1	NA	9	0
XRCC4	0	0	2	2	175.23	350.46	15	2	1	NA	1	NA	4	0
XRCC5	0	0	2	2	722.7	1445.4	15	2	1	NA	1	NA	4	0
XRN1	0	0	3	9	1713.69	3427.38	15	2	1	NA	1	NA	12	0
XXYLT1	0	0	3	4	319.77	639.54	15	2	1	NA	1	NA	7	0
XYLT1	0	0	5	5	940.5	1881	15	2	1	NA	1	NA	10	0
XYLT2	0	0	9	9	848.76	1697.52	15	2	1	NA	1	NA	18	0
YARS	0	0	1	5	522.72	1045.44	15	2	1	NA	1	NA	6	0
YBEY	0	0	1	3	100.32	200.64	15	2	1	NA	1	NA	4	0
YBX1	0	0	3	1	309.54	619.08	15	2	1	NA	1	NA	4	0
YDJC	0	0	3	6	305.91	611.82	15	2	1	NA	1	NA	9	0
YEATS2	0	0	1	7	1379.07	2758.14	15	2	1	NA	1	NA	8	0
YIPF1	0	0	1	7	302.94	605.88	15	2	1	NA	1	NA	8	0
YIPF5	0	0	0	5	253.44	506.88	15	2	1	NA	1	NA	5	0
YIPF7	0	0	0	2	254.43	508.86	15	2	1	NA	1	NA	2	0
YLPM1	0	0	9	29	1856.58	3713.16	15	2	1	NA	1	NA	38	0
YOD1	0	0	0	6	301.95	603.9	15	2	1	NA	1	NA	6	0
YPEL2	0	0	0	2	118.8	237.6	15	2	1	NA	1	NA	2	0
YRDC	0	0	4	5	257.4	514.8	15	2	1	NA	1	NA	9	0
YTHDC2	0	0	7	3	1095.93	2191.86	15	2	1	NA	1	NA	10	0
YTHDF1	0	0	0	4	556.38	1112.76	15	2	1	NA	1	NA	4	0
YWHAB	0	0	0	3	242.55	485.1	15	2	1	NA	1	NA	3	0
YWHAE	0	0	1	1	253.44	506.88	15	2	1	NA	1	NA	2	0
YWHAG	0	0	0	2	245.52	491.04	15	2	1	NA	1	NA	2	0
YY2	0	0	0	2	403.59	807.18	15	2	1	NA	1	NA	2	0
ZAR1	0	0	3	6	354.09	708.18	15	2	1	NA	1	NA	9	0
ZBBX	0	0	4	5	628.65	1257.3	15	2	1	NA	1	NA	9	0
ZBTB1	0	0	1	3	703.89	1407.78	15	2	1	NA	1	NA	4	0
ZBTB17	0	0	7	19	768.9	1537.8	15	2	1	NA	1	NA	26	0
ZBTB25	0	0	3	2	432.63	865.26	15	2	1	NA	1	NA	5	0
ZBTB26	0	0	1	5	434.61	869.22	15	2	1	NA	1	NA	6	0
ZBTB32	0	0	3	9	660.33	1320.66	15	2	1	NA	1	NA	12	0
ZBTB33	0	0	0	3	673.2	1346.4	15	2	1	NA	1	NA	3	0
ZBTB34	0	0	1	1	515.79	1031.58	15	2	1	NA	1	NA	2	0
ZBTB37	0	0	0	3	498.96	997.92	15	2	1	NA	1	NA	3	0
ZBTB38	0	0	10	13	1181.07	2362.14	15	2	1	NA	1	NA	23	0
ZBTB39	0	0	1	5	686.73	1373.46	15	2	1	NA	1	NA	6	0
ZBTB40	0	0	3	3	291.39	582.78	15	2	1	NA	1	NA	6	0
ZBTB41	0	0	2	6	896.94	1793.88	15	2	1	NA	1	NA	8	0
ZBTB43	0	0	0	2	460.35	920.7	15	2	1	NA	1	NA	2	0
ZBTB44	0	0	1	6	647.46	1294.92	15	2	1	NA	1	NA	7	0
ZBTB45	0	0	2	5	411.84	823.68	15	2	1	NA	1	NA	7	0
ZBTB46	0	0	3	10	688.05	1376.1	15	2	1	NA	1	NA	13	0
ZBTB49	0	0	6	7	753.39	1506.78	15	2	1	NA	1	NA	13	0
ZBTB6	0	0	0	4	424.71	849.42	15	2	1	NA	1	NA	4	0
ZBTB7C	0	0	6	7	619.08	1238.16	15	2	1	NA	1	NA	13	0
ZBTB8AL	0	0	2	2	482.13	964.26	15	2	1	NA	1	NA	4	0
ZBTB8B	0	0	4	3	476.19	952.38	15	2	1	NA	1	NA	7	0
ZBTB8OS	0	0	0	2	163.35	326.7	15	2	1	NA	1	NA	2	0
ZC2HC1C	0	0	5	7	498.96	997.92	15	2	1	NA	1	NA	12	0
ZC3H10	0	0	1	8	341.88	683.76	15	2	1	NA	1	NA	9	0
ZC3H11A	0	0	5	6	505.89	1011.78	15	2	1	NA	1	NA	11	0
ZC3H12A	0	0	6	6	671.22	1342.44	15	2	1	NA	1	NA	12	0
ZC3H14	0	0	5	2	723.69	1447.38	15	2	1	NA	1	NA	7	0
ZC3H18	0	0	7	17	957.66	1915.32	15	2	1	NA	1	NA	24	0
ZC3H4	0	0	2	8	729.63	1459.26	15	2	1	NA	1	NA	10	0
ZCCHC10	0	0	0	4	165	330	15	2	1	NA	1	NA	4	0
ZCCHC11	0	0	11	8	1607.43	3214.86	15	2	1	NA	1	NA	19	0
ZCCHC14	0	0	2	9	1074.15	2148.3	15	2	1	NA	1	NA	11	0
ZCCHC17	0	0	3	3	237.6	475.2	15	2	1	NA	1	NA	6	0
ZCCHC24	0	0	1	1	104.61	209.22	15	2	1	NA	1	NA	2	0
ZCCHC4	0	0	4	3	501.93	1003.86	15	2	1	NA	1	NA	7	0
ZCCHC6	0	0	5	2	1464.87	2929.74	15	2	1	NA	1	NA	7	0
ZCCHC7	0	0	2	2	268.95	537.9	15	2	1	NA	1	NA	4	0
ZCCHC8	0	0	0	4	675.18	1350.36	15	2	1	NA	1	NA	4	0
ZDBF2	0	0	5	2	1101.54	2203.08	15	2	1	NA	1	NA	7	0
ZDHHC1	0	0	9	2	537.57	1075.14	15	2	1	NA	1	NA	11	0
ZDHHC12	0	0	4	3	259.38	518.76	15	2	1	NA	1	NA	7	0
ZDHHC16	0	0	3	7	371.25	742.5	15	2	1	NA	1	NA	10	0
ZDHHC18	0	0	1	4	287.1	574.2	15	2	1	NA	1	NA	5	0
ZDHHC2	0	0	2	0	342.54	685.08	15	2	1	NA	1	NA	2	0
ZDHHC22	0	0	1	2	273.24	546.48	15	2	1	NA	1	NA	3	0
ZDHHC4	0	0	3	2	299.97	599.94	15	2	1	NA	1	NA	5	0
ZDHHC5	0	0	6	13	668.58	1337.16	15	2	1	NA	1	NA	19	0
ZDHHC6	0	0	0	2	319.77	639.54	15	2	1	NA	1	NA	2	0
ZDHHC8	0	0	5	10	820.38	1640.76	15	2	1	NA	1	NA	15	0
ZDHHC9	0	0	5	3	379.17	758.34	15	2	1	NA	1	NA	8	0
ZER1	0	0	2	5	759.33	1518.66	15	2	1	NA	1	NA	7	0
ZFAND2A	0	0	1	1	159.39	318.78	15	2	1	NA	1	NA	2	0
ZFAND2B	0	0	2	9	261.36	522.72	15	2	1	NA	1	NA	11	0
ZFAND4	0	0	1	5	661.32	1322.64	15	2	1	NA	1	NA	6	0
ZFHX3	0	0	4	14	2482.59	4965.18	15	2	1	NA	1	NA	18	0
ZFP36L1	0	0	0	3	329.34	658.68	15	2	1	NA	1	NA	3	0
ZFP64	0	0	2	1	683.43	1366.86	15	2	1	NA	1	NA	3	0
ZFP91	0	0	0	5	455.4	910.8	15	2	1	NA	1	NA	5	0
ZFPM1	0	0	17	35	1058.97	2117.94	15	2	1	NA	1	NA	52	0
ZFYVE16	0	0	9	4	1627.56	3255.12	15	2	1	NA	1	NA	13	0
ZFYVE19	0	0	5	2	415.8	831.6	15	2	1	NA	1	NA	7	0
ZFYVE26	0	0	17	11	2538.36	5076.72	15	2	1	NA	1	NA	28	0
ZFYVE27	0	0	7	7	434.94	869.88	15	2	1	NA	1	NA	14	0
ZFYVE28	0	0	3	1	963.27	1926.54	15	2	1	NA	1	NA	4	0
ZFYVE9	0	0	3	5	1402.83	2805.66	15	2	1	NA	1	NA	8	0
ZGPAT	0	0	1	13	521.4	1042.8	15	2	1	NA	1	NA	14	0
ZGRF1	0	0	25	16	2067.45	4134.9	15	2	1	NA	1	NA	41	0
ZHX3	0	0	3	10	919.71	1839.42	15	2	1	NA	1	NA	13	0
ZIC3	0	0	1	2	454.74	909.48	15	2	1	NA	1	NA	3	0
ZMAT2	0	0	1	3	192.06	384.12	15	2	1	NA	1	NA	4	0
ZMAT3	0	0	1	4	287.1	574.2	15	2	1	NA	1	NA	5	0
ZMAT5	0	0	7	4	219.12	438.24	15	2	1	NA	1	NA	11	0
ZMIZ1	0	0	1	5	838.53	1677.06	15	2	1	NA	1	NA	6	0
ZMYM3	0	0	3	11	1420.65	2841.3	15	2	1	NA	1	NA	14	0
ZMYM4	0	0	1	10	1522.62	3045.24	15	2	1	NA	1	NA	11	0
ZMYND10	0	0	9	6	440.22	880.44	15	2	1	NA	1	NA	15	0
ZNF106	0	0	5	7	1789.26	3578.52	15	2	1	NA	1	NA	12	0
ZNF142	0	0	40	36	1919.28	3838.56	15	2	1	NA	1	NA	76	0
ZNF143	0	0	0	5	631.62	1263.24	15	2	1	NA	1	NA	5	0
ZNF148	0	0	1	1	785.07	1570.14	15	2	1	NA	1	NA	2	0
ZNF185L	0	0	16	5	798.93	1597.86	15	2	1	NA	1	NA	21	0
ZNF207	0	0	0	3	445.5	891	15	2	1	NA	1	NA	3	0
ZNF217L	0	0	3	0	1068.21	2136.42	15	2	1	NA	1	NA	3	0
ZNF276	0	0	3	11	533.61	1067.22	15	2	1	NA	1	NA	14	0
ZNF280D	0	0	3	4	683.1	1366.2	15	2	1	NA	1	NA	7	0
ZNF319	0	0	0	3	550.44	1100.88	15	2	1	NA	1	NA	3	0
ZNF330	0	0	1	3	317.79	635.58	15	2	1	NA	1	NA	4	0
ZNF335	0	0	6	13	1321.65	2643.3	15	2	1	NA	1	NA	19	0
ZNF341	0	0	5	10	826.98	1653.96	15	2	1	NA	1	NA	15	0
ZNF346	0	0	3	2	281.16	562.32	15	2	1	NA	1	NA	5	0
ZNF362	0	0	0	3	342.54	685.08	15	2	1	NA	1	NA	3	0
ZNF365	0	0	6	4	374.88	749.76	15	2	1	NA	1	NA	10	0
ZNF366	0	0	6	1	690.69	1381.38	15	2	1	NA	1	NA	7	0
ZNF385B	0	0	2	1	338.58	677.16	15	2	1	NA	1	NA	3	0
ZNF385C	0	0	11	11	438.57	877.14	15	2	1	NA	1	NA	22	0
ZNF408	0	0	14	7	638.55	1277.1	15	2	1	NA	1	NA	21	0
ZNF423	0	0	3	17	1210.44	2420.88	15	2	1	NA	1	NA	20	0
ZNF488	0	0	4	5	529.65	1059.3	15	2	1	NA	1	NA	9	0
ZNF503	0	0	2	8	600.93	1201.86	15	2	1	NA	1	NA	10	0
ZNF511	0	0	2	0	237.93	475.86	15	2	1	NA	1	NA	2	0
ZNF512B	0	0	4	13	856.68	1713.36	15	2	1	NA	1	NA	17	0
ZNF518A	0	0	6	3	1531.53	3063.06	15	2	1	NA	1	NA	9	0
ZNF518B	0	0	6	0	1072.17	2144.34	15	2	1	NA	1	NA	6	0
ZNF532	0	0	1	1	814.77	1629.54	15	2	1	NA	1	NA	2	0
ZNF536	0	0	2	5	637.89	1275.78	15	2	1	NA	1	NA	7	0
ZNF541	0	0	2	3	141.9	283.8	15	2	1	NA	1	NA	5	0
ZNF592	0	0	5	12	1380.06	2760.12	15	2	1	NA	1	NA	17	0
ZNF593	0	0	0	2	98.67	197.34	15	2	1	NA	1	NA	2	0
ZNF598	0	0	3	13	869.22	1738.44	15	2	1	NA	1	NA	16	0
ZNF608	0	0	2	1	1467.18	2934.36	15	2	1	NA	1	NA	3	0
ZNF609	0	0	7	24	1469.82	2939.64	15	2	1	NA	1	NA	31	0
ZNF628	0	0	9	5	1105.17	2210.34	15	2	1	NA	1	NA	14	0
ZNF638	0	0	19	26	2041.71	4083.42	15	2	1	NA	1	NA	45	0
ZNF639	0	0	0	2	484.11	968.22	15	2	1	NA	1	NA	2	0
ZNF648	0	0	2	2	385.11	770.22	15	2	1	NA	1	NA	4	0
ZNF687	0	0	6	1	1251.36	2502.72	15	2	1	NA	1	NA	7	0
ZNF710	0	0	4	21	649.44	1298.88	15	2	1	NA	1	NA	25	0
ZNF750	0	0	4	13	705.87	1411.74	15	2	1	NA	1	NA	17	0
ZNF76	0	0	8	8	579.15	1158.3	15	2	1	NA	1	NA	16	0
ZNF804A	0	0	7	4	1184.04	2368.08	15	2	1	NA	1	NA	11	0
ZNF821	0	0	1	3	394.68	789.36	15	2	1	NA	1	NA	4	0
ZNF827	0	0	6	9	1403.82	2807.64	15	2	1	NA	1	NA	15	0
ZNF831	0	0	6	4	1829.52	3659.04	15	2	1	NA	1	NA	10	0
ZNF839	0	0	2	5	961.29	1922.58	15	2	1	NA	1	NA	7	0
ZNF853	0	0	2	3	292.05	584.1	15	2	1	NA	1	NA	5	0
ZNF862L	0	0	7	14	677.16	1354.32	15	2	1	NA	1	NA	21	0
ZNHIT3	0	0	1	2	100.98	201.96	15	2	1	NA	1	NA	3	0
ZNRF3	0	0	5	2	806.19	1612.38	15	2	1	NA	1	NA	7	0
ZNRF4	0	0	2	4	335.61	671.22	15	2	1	NA	1	NA	6	0
ZONADHL	0	0	35	33	3209.58	6419.16	15	2	1	NA	1	NA	68	0
ZP1	0	0	12	7	543.51	1087.02	15	2	1	NA	1	NA	19	0
ZP2	0	0	3	1	703.89	1407.78	15	2	1	NA	1	NA	4	0
ZP3	0	0	2	11	436.59	873.18	15	2	1	NA	1	NA	13	0
ZP3L1	0	0	16	14	416.79	833.58	15	2	1	NA	1	NA	30	0
ZP3L2	0	0	13	10	467.28	934.56	15	2	1	NA	1	NA	23	0
ZP4	0	0	7	1	569.25	1138.5	15	2	1	NA	1	NA	8	0
ZPBP2	0	0	5	2	377.19	754.38	15	2	1	NA	1	NA	7	0
ZPR1	0	0	5	11	427.68	855.36	15	2	1	NA	1	NA	16	0
ZRANB1	0	0	1	10	731.61	1463.22	15	2	1	NA	1	NA	11	0
ZRANB2	0	0	0	2	331.65	663.3	15	2	1	NA	1	NA	2	0
ZRANB3	0	0	2	3	1117.71	2235.42	15	2	1	NA	1	NA	5	0
ZSWIM5	0	0	2	10	983.07	1966.14	15	2	1	NA	1	NA	12	0
ZSWIM7	0	0	2	4	180.18	360.36	15	2	1	NA	1	NA	6	0
ZSWIM8	0	0	4	14	1802.79	3605.58	15	2	1	NA	1	NA	18	0
ZW10	0	0	2	9	736.56	1473.12	15	2	1	NA	1	NA	11	0
ZWILCH	0	0	3	4	588.06	1176.12	15	2	1	NA	1	NA	7	0
ZXDC	0	0	3	5	852.72	1705.44	15	2	1	NA	1	NA	8	0
ZYG11B	0	0	1	6	673.2	1346.4	15	2	1	NA	1	NA	7	0
ZZZ3	0	0	2	1	896.94	1793.88	15	2	1	NA	1	NA	3	0
mesd	0	0	1	1	218.79	437.58	15	2	1	NA	1	NA	2	0
